"","Date","Absents","Paramset","Infections_or_Exposed_per_day_Patient","Infections_or_Exposed_per_day_HCW","total_infections","nosocomial_proportion","PCR_pooled","LFD_pooled","HCW_symp_test","patient_symp_test","new_hcw_infs","cumulative_hcw_infs","new_pat_infs","cumulative_pats_infs","new_nosocomial_hcw_infs","new_nosocomial_pat_infs"
"1","2020-03-12",1,1,13,21,3892,0.752312435765673,0,0,319,138,9,21,6,9,1,6
"2","2020-03-13",1,1,21,31,3892,0.752312435765673,0,0,319,138,10,31,8,17,NA,8
"3","2020-03-14",3,1,27,46,3892,0.752312435765673,0,0,319,138,15,46,10,27,4,10
"4","2020-03-15",5,1,32,62,3892,0.752312435765673,0,0,319,138,16,62,8,35,6,8
"5","2020-03-16",8,1,30,77,3892,0.752312435765673,0,0,319,138,15,77,5,40,7,5
"6","2020-03-17",10,1,26,95,3892,0.752312435765673,0,0,319,138,18,95,2,42,12,2
"7","2020-03-18",11,1,26,110,3892,0.752312435765673,0,0,319,138,16,111,5,47,7,5
"8","2020-03-19",17,1,29,132,3892,0.752312435765673,0,0,319,138,28,139,5,52,14,5
"9","2020-03-20",22,1,39,160,3892,0.752312435765673,0,0,319,138,32,171,10,62,16,10
"10","2020-03-21",25,1,37,179,3892,0.752312435765673,0,0,319,138,28,199,6,68,16,6
"11","2020-03-22",29,1,28,203,3892,0.752312435765673,0,0,319,138,29,228,2,70,18,2
"12","2020-03-23",34,1,27,216,3892,0.752312435765673,0,0,319,138,29,257,6,76,15,6
"13","2020-03-24",37,1,26,232,3892,0.752312435765673,0,0,319,138,25,282,7,83,13,7
"14","2020-03-25",41,1,38,263,3892,0.752312435765673,0,0,319,138,43,325,13,96,33,13
"15","2020-03-26",38,1,42,276,3892,0.752312435765673,0,0,319,138,31,356,9,105,23,9
"16","2020-03-27",47,1,39,302,3892,0.752312435765673,0,0,319,138,44,400,6,111,34,6
"17","2020-03-28",57,1,37,333,3892,0.752312435765673,0,0,319,138,50,450,5,116,33,5
"18","2020-03-29",59,1,38,349,3892,0.752312435765673,0,0,319,138,36,486,5,121,27,5
"19","2020-03-30",66,1,35,368,3892,0.752312435765673,0,0,319,138,46,532,6,127,29,6
"20","2020-03-31",74,1,30,394,3892,0.752312435765673,0,0,319,138,46,578,4,131,35,4
"21","2020-04-01",83,1,26,420,3892,0.752312435765673,0,0,319,138,55,633,4,135,36,4
"22","2020-04-02",101,1,28,443,3892,0.752312435765673,0,0,319,138,50,683,4,139,43,4
"23","2020-04-03",111,1,25,451,3892,0.752312435765673,0,0,319,138,41,724,3,142,29,3
"24","2020-04-04",116,1,37,481,3892,0.752312435765673,0,0,319,138,58,782,10,152,47,10
"25","2020-04-05",132,1,36,504,3892,0.752312435765673,0,0,319,138,61,843,10,162,48,10
"26","2020-04-06",136,1,37,511,3892,0.752312435765673,0,0,319,138,48,891,7,169,38,7
"27","2020-04-07",142,1,38,543,3892,0.752312435765673,0,0,319,138,56,947,5,174,47,5
"28","2020-04-08",149,1,42,568,3892,0.752312435765673,0,0,319,138,71,1018,11,185,62,11
"29","2020-04-09",150,1,45,589,3892,0.752312435765673,0,0,319,138,59,1077,8,193,45,8
"30","2020-04-10",152,1,47,618,3892,0.752312435765673,0,0,319,138,73,1150,8,201,61,8
"31","2020-04-11",157,1,47,619,3892,0.752312435765673,0,0,319,138,59,1209,10,211,44,10
"32","2020-04-12",160,1,59,637,3892,0.752312435765673,0,0,319,138,72,1281,16,227,50,16
"33","2020-04-13",159,1,62,651,3892,0.752312435765673,0,0,319,138,64,1345,14,241,50,14
"34","2020-04-14",169,1,68,689,3892,0.752312435765673,0,0,319,138,87,1432,12,253,72,12
"35","2020-04-15",177,1,70,699,3892,0.752312435765673,0,0,319,138,84,1516,11,264,66,11
"36","2020-04-16",185,1,75,737,3892,0.752312435765673,0,0,319,138,92,1608,16,280,80,16
"37","2020-04-17",182,1,71,736,3892,0.752312435765673,0,0,319,138,60,1668,15,295,53,15
"38","2020-04-18",179,1,73,766,3892,0.752312435765673,0,0,319,138,88,1756,12,307,76,12
"39","2020-04-19",183,1,74,786,3892,0.752312435765673,0,0,319,138,77,1833,8,315,64,8
"40","2020-04-20",194,1,81,803,3892,0.752312435765673,0,0,319,138,69,1902,18,333,57,18
"41","2020-04-21",207,1,82,829,3892,0.752312435765673,0,0,319,138,88,1990,18,351,71,18
"42","2020-04-22",213,1,84,867,3892,0.752312435765673,0,0,319,138,102,2092,17,368,90,17
"43","2020-04-23",214,1,68,881,3892,0.752312435765673,0,0,319,138,87,2179,10,378,71,10
"44","2020-04-24",218,1,67,859,3892,0.752312435765673,0,0,319,138,60,2239,11,389,54,11
"45","2020-04-25",233,1,59,879,3892,0.752312435765673,0,0,319,138,79,2318,11,400,69,11
"46","2020-04-26",245,1,52,870,3892,0.752312435765673,0,0,319,138,80,2398,8,408,65,8
"47","2020-04-27",260,1,63,852,3892,0.752312435765673,0,0,319,138,53,2451,18,426,38,18
"48","2020-04-28",262,1,69,841,3892,0.752312435765673,0,0,319,138,68,2519,13,439,60,13
"49","2020-04-29",260,1,69,805,3892,0.752312435765673,0,0,319,138,55,2574,9,448,43,9
"50","2020-04-30",260,1,63,800,3892,0.752312435765673,0,0,319,138,74,2648,8,456,49,8
"51","2020-05-01",267,1,55,784,3892,0.752312435765673,0,0,319,138,63,2711,4,460,48,4
"52","2020-05-02",260,1,55,764,3892,0.752312435765673,0,0,319,138,59,2770,7,467,49,7
"53","2020-05-03",248,1,61,751,3892,0.752312435765673,0,0,319,138,53,2823,9,476,40,9
"54","2020-05-04",229,1,52,724,3892,0.752312435765673,0,0,319,138,63,2886,12,488,50,12
"55","2020-05-05",212,1,50,700,3892,0.752312435765673,0,0,319,138,55,2941,4,492,39,4
"56","2020-05-06",208,1,36,671,3892,0.752312435765673,0,0,319,138,46,2987,4,496,40,4
"57","2020-05-07",198,1,36,657,3892,0.752312435765673,0,0,319,138,49,3036,7,503,41,7
"58","2020-05-08",192,1,36,633,3892,0.752312435765673,0,0,319,138,44,3080,6,509,33,6
"59","2020-05-09",185,1,42,598,3892,0.752312435765673,0,0,319,138,35,3115,6,515,32,6
"60","2020-05-10",180,1,44,567,3892,0.752312435765673,0,0,319,138,33,3148,11,526,27,11
"61","2020-05-11",180,1,47,539,3892,0.752312435765673,0,0,319,138,39,3187,13,539,27,13
"62","2020-05-12",174,1,58,515,3892,0.752312435765673,0,0,319,138,32,3219,19,558,27,19
"63","2020-05-13",167,1,65,494,3892,0.752312435765673,0,0,319,138,37,3256,14,572,29,14
"64","2020-05-14",163,1,70,474,3892,0.752312435765673,0,0,319,138,38,3294,15,587,30,15
"65","2020-05-15",153,1,78,461,3892,0.752312435765673,0,0,319,138,32,3326,20,607,28,20
"66","2020-05-16",154,1,84,417,3892,0.752312435765673,0,0,319,138,22,3348,13,620,17,13
"67","2020-05-17",153,1,81,419,3892,0.752312435765673,0,0,319,138,41,3389,18,638,31,18
"68","2020-05-18",144,1,78,408,3892,0.752312435765673,0,0,319,138,36,3425,13,651,31,13
"69","2020-05-19",136,1,70,390,3892,0.752312435765673,0,0,319,138,27,3452,7,658,19,7
"70","2020-05-20",130,1,59,367,3892,0.752312435765673,0,0,319,138,28,3480,10,668,22,10
"71","2020-05-21",125,1,55,348,3892,0.752312435765673,0,0,319,138,24,3504,11,679,19,11
"72","2020-05-22",121,1,54,337,3892,0.752312435765673,0,0,319,138,23,3527,8,687,17,8
"73","2020-05-23",109,1,50,326,3892,0.752312435765673,0,0,319,138,16,3543,6,693,15,6
"74","2020-05-24",96,1,44,308,3892,0.752312435765673,0,0,319,138,23,3566,6,699,14,6
"75","2020-05-25",93,1,44,290,3892,0.752312435765673,0,0,319,138,20,3586,7,706,17,7
"76","2020-05-26",93,1,43,281,3892,0.752312435765673,0,0,319,138,24,3610,4,710,20,4
"77","2020-05-27",89,1,43,272,3892,0.752312435765673,0,0,319,138,19,3629,8,718,15,8
"78","2020-05-28",87,1,42,249,3892,0.752312435765673,0,0,319,138,18,3647,11,729,12,11
"79","2020-05-29",86,1,47,256,3892,0.752312435765673,0,0,319,138,31,3678,11,740,26,11
"80","2020-05-30",86,1,45,242,3892,0.752312435765673,0,0,319,138,13,3691,8,748,11,8
"81","2020-05-31",85,1,48,229,3892,0.752312435765673,0,0,319,138,15,3706,11,759,11,11
"82","2020-06-01",79,1,45,220,3892,0.752312435765673,0,0,319,138,14,3720,7,766,9,7
"83","2020-06-02",76,1,30,208,3892,0.752312435765673,0,0,319,138,18,3738,3,769,9,3
"84","2020-06-03",70,1,40,202,3892,0.752312435765673,0,0,319,138,12,3750,11,780,9,11
"85","2020-06-04",73,1,47,185,3892,0.752312435765673,0,0,319,138,10,3760,9,789,7,9
"86","2020-06-05",69,1,44,181,3892,0.752312435765673,0,0,319,138,15,3775,6,795,14,6
"87","2020-06-06",64,1,43,183,3892,0.752312435765673,0,0,319,138,14,3789,8,803,6,8
"88","2020-06-07",61,1,43,170,3892,0.752312435765673,0,0,319,138,8,3797,5,808,7,5
"89","2020-03-13",1,2,15,15,2763,0.819761129207383,0,0,213,183,9,21,5,8,NA,5
"90","2020-03-14",1,2,13,19,2763,0.819761129207383,0,0,213,183,13,34,3,11,2,3
"91","2020-03-15",1,2,12,28,2763,0.819761129207383,0,0,213,183,12,46,1,12,3,1
"92","2020-03-16",2,2,19,35,2763,0.819761129207383,0,0,213,183,13,59,3,15,3,3
"93","2020-03-17",2,2,15,55,2763,0.819761129207383,0,0,213,183,18,77,5,20,10,5
"94","2020-03-18",4,2,14,65,2763,0.819761129207383,0,0,213,183,15,92,11,31,5,11
"95","2020-03-19",4,2,19,81,2763,0.819761129207383,0,0,213,183,10,102,6,37,3,6
"96","2020-03-20",6,2,33,90,2763,0.819761129207383,0,0,213,183,17,119,4,41,11,4
"97","2020-03-21",11,2,35,111,2763,0.819761129207383,0,0,213,183,20,139,9,50,8,9
"98","2020-03-22",18,2,33,123,2763,0.819761129207383,0,0,213,183,25,164,10,60,13,10
"99","2020-03-23",18,2,38,132,2763,0.819761129207383,0,0,213,183,26,190,7,67,13,7
"100","2020-03-24",24,2,41,146,2763,0.819761129207383,0,0,213,183,20,210,1,68,10,1
"101","2020-03-25",28,2,38,159,2763,0.819761129207383,0,0,213,183,28,238,4,72,22,4
"102","2020-03-26",34,2,44,171,2763,0.819761129207383,0,0,213,183,21,259,12,84,12,12
"103","2020-03-27",39,2,40,193,2763,0.819761129207383,0,0,213,183,27,286,9,93,16,9
"104","2020-03-28",44,2,39,213,2763,0.819761129207383,0,0,213,183,22,308,3,96,13,3
"105","2020-03-29",43,2,40,228,2763,0.819761129207383,0,0,213,183,19,327,5,101,10,5
"106","2020-03-30",54,2,42,236,2763,0.819761129207383,0,0,213,183,25,352,6,107,13,6
"107","2020-03-31",50,2,43,252,2763,0.819761129207383,0,0,213,183,23,375,5,112,14,5
"108","2020-04-01",53,2,46,270,2763,0.819761129207383,0,0,213,183,19,394,12,124,10,12
"109","2020-04-02",60,2,48,287,2763,0.819761129207383,0,0,213,183,27,421,14,138,19,14
"110","2020-04-03",64,2,45,308,2763,0.819761129207383,0,0,213,183,20,441,4,142,10,4
"111","2020-04-04",67,2,45,327,2763,0.819761129207383,0,0,213,183,18,459,14,156,8,14
"112","2020-04-05",73,2,47,341,2763,0.819761129207383,0,0,213,183,23,482,12,168,14,12
"113","2020-04-06",71,2,53,369,2763,0.819761129207383,0,0,213,183,27,509,7,175,15,7
"114","2020-04-07",84,2,52,389,2763,0.819761129207383,0,0,213,183,25,534,16,191,13,16
"115","2020-04-08",90,2,54,413,2763,0.819761129207383,0,0,213,183,17,551,12,203,12,12
"116","2020-04-09",94,2,49,421,2763,0.819761129207383,0,0,213,183,25,576,18,221,15,18
"117","2020-04-10",98,2,53,441,2763,0.819761129207383,0,0,213,183,25,601,16,237,8,16
"118","2020-04-11",104,2,53,456,2763,0.819761129207383,0,0,213,183,23,624,18,255,10,18
"119","2020-04-12",109,2,49,464,2763,0.819761129207383,0,0,213,183,19,643,20,275,8,20
"120","2020-04-13",118,2,60,487,2763,0.819761129207383,0,0,213,183,20,663,22,297,12,22
"121","2020-04-14",122,2,67,502,2763,0.819761129207383,0,0,213,183,26,689,13,310,8,13
"122","2020-04-15",128,2,57,510,2763,0.819761129207383,0,0,213,183,22,711,22,332,12,22
"123","2020-04-16",133,2,52,507,2763,0.819761129207383,0,0,213,183,22,733,19,351,10,19
"124","2020-04-17",136,2,50,503,2763,0.819761129207383,0,0,213,183,17,750,12,363,5,12
"125","2020-04-18",138,2,44,505,2763,0.819761129207383,0,0,213,183,23,773,15,378,15,15
"126","2020-04-19",147,2,55,512,2763,0.819761129207383,0,0,213,183,26,799,11,389,14,11
"127","2020-04-20",155,2,61,517,2763,0.819761129207383,0,0,213,183,21,820,12,401,8,12
"128","2020-04-21",159,2,63,525,2763,0.819761129207383,0,0,213,183,32,852,13,414,20,13
"129","2020-04-22",162,2,69,531,2763,0.819761129207383,0,0,213,183,22,874,17,431,13,17
"130","2020-04-23",153,2,68,552,2763,0.819761129207383,0,0,213,183,24,898,24,455,11,24
"131","2020-04-24",152,2,60,545,2763,0.819761129207383,0,0,213,183,28,926,15,470,12,15
"132","2020-04-25",149,2,50,551,2763,0.819761129207383,0,0,213,183,28,954,5,475,17,5
"133","2020-04-26",140,2,54,536,2763,0.819761129207383,0,0,213,183,37,991,19,494,20,19
"134","2020-04-27",136,2,76,528,2763,0.819761129207383,0,0,213,183,25,1016,11,505,13,11
"135","2020-04-28",140,2,66,513,2763,0.819761129207383,0,0,213,183,34,1050,17,522,17,17
"136","2020-04-29",137,2,59,506,2763,0.819761129207383,0,0,213,183,31,1081,13,535,13,13
"137","2020-04-30",141,2,59,498,2763,0.819761129207383,0,0,213,183,20,1101,11,546,8,11
"138","2020-05-01",142,2,51,483,2763,0.819761129207383,0,0,213,183,21,1122,13,559,14,13
"139","2020-05-02",132,2,56,487,2763,0.819761129207383,0,0,213,183,29,1151,15,574,12,15
"140","2020-05-03",135,2,71,459,2763,0.819761129207383,0,0,213,183,21,1172,14,588,10,14
"141","2020-05-04",131,2,60,445,2763,0.819761129207383,0,0,213,183,42,1214,11,599,30,11
"142","2020-05-05",132,2,53,436,2763,0.819761129207383,0,0,213,183,37,1251,20,619,16,20
"143","2020-05-06",123,2,60,417,2763,0.819761129207383,0,0,213,183,20,1271,21,640,8,21
"144","2020-05-07",116,2,58,402,2763,0.819761129207383,0,0,213,183,28,1299,24,664,16,24
"145","2020-05-08",109,2,59,398,2763,0.819761129207383,0,0,213,183,23,1322,12,676,12,12
"146","2020-05-09",119,2,54,397,2763,0.819761129207383,0,0,213,183,16,1338,17,693,9,17
"147","2020-05-10",112,2,43,387,2763,0.819761129207383,0,0,213,183,25,1363,25,718,15,25
"148","2020-05-11",115,2,41,388,2763,0.819761129207383,0,0,213,183,19,1382,25,743,13,25
"149","2020-05-12",101,2,44,370,2763,0.819761129207383,0,0,213,183,25,1407,17,760,14,17
"150","2020-05-13",103,2,47,341,2763,0.819761129207383,0,0,213,183,16,1423,13,773,10,13
"151","2020-05-14",103,2,41,346,2763,0.819761129207383,0,0,213,183,23,1446,17,790,12,17
"152","2020-05-15",108,2,48,341,2763,0.819761129207383,0,0,213,183,29,1475,21,811,19,21
"153","2020-05-16",101,2,42,348,2763,0.819761129207383,0,0,213,183,24,1499,14,825,13,14
"154","2020-05-17",103,2,44,340,2763,0.819761129207383,0,0,213,183,26,1525,10,835,14,10
"155","2020-05-18",87,2,40,307,2763,0.819761129207383,0,0,213,183,25,1550,17,852,16,17
"156","2020-05-19",87,2,30,295,2763,0.819761129207383,0,0,213,183,18,1568,12,864,12,12
"157","2020-05-20",85,2,22,295,2763,0.819761129207383,0,0,213,183,23,1591,12,876,15,13
"158","2020-05-21",85,2,20,292,2763,0.819761129207383,0,0,213,183,9,1600,9,885,6,9
"159","2020-05-22",79,2,22,280,2763,0.819761129207383,0,0,213,183,17,1617,14,899,10,14
"160","2020-05-23",80,2,20,280,2763,0.819761129207383,0,0,213,183,22,1639,16,915,10,16
"161","2020-05-24",77,2,25,276,2763,0.819761129207383,0,0,213,183,20,1659,18,933,14,18
"162","2020-05-25",79,2,33,263,2763,0.819761129207383,0,0,213,183,12,1671,25,958,7,25
"163","2020-05-26",75,2,42,257,2763,0.819761129207383,0,0,213,183,24,1695,14,972,10,14
"164","2020-05-27",72,2,39,258,2763,0.819761129207383,0,0,213,183,17,1712,9,981,6,9
"165","2020-05-28",77,2,31,252,2763,0.819761129207383,0,0,213,183,10,1722,13,994,5,13
"166","2020-05-29",72,2,23,232,2763,0.819761129207383,0,0,213,183,15,1737,7,1001,7,7
"167","2020-05-30",71,2,26,234,2763,0.819761129207383,0,0,213,183,10,1747,6,1007,6,6
"168","2020-05-31",67,2,34,226,2763,0.819761129207383,0,0,213,183,14,1761,10,1017,11,10
"169","2020-06-01",70,2,36,238,2763,0.819761129207383,0,0,213,183,9,1770,11,1028,4,11
"170","2020-06-02",70,2,28,238,2763,0.819761129207383,0,0,213,183,8,1778,11,1039,7,11
"171","2020-06-03",72,2,24,244,2763,0.819761129207383,0,0,213,183,11,1789,12,1051,4,12
"172","2020-06-04",70,2,20,235,2763,0.819761129207383,0,0,213,183,9,1798,11,1062,5,11
"173","2020-06-05",74,2,19,227,2763,0.819761129207383,0,0,213,183,12,1810,8,1070,6,8
"174","2020-06-06",72,2,17,215,2763,0.819761129207383,0,0,213,183,10,1820,10,1080,6,10
"175","2020-06-07",71,2,16,216,2763,0.819761129207383,0,0,213,183,7,1827,9,1089,5,9
"176","2020-03-14",1,3,38,45,2461,0.600975213327915,0,0,190,493,8,22,7,27,3,7
"177","2020-03-15",2,3,50,63,2461,0.600975213327915,0,0,190,493,8,30,9,36,6,9
"178","2020-03-16",4,3,61,76,2461,0.600975213327915,0,0,190,493,10,40,7,43,6,7
"179","2020-03-17",5,3,68,94,2461,0.600975213327915,0,0,190,493,12,52,9,52,10,9
"180","2020-03-18",8,3,83,113,2461,0.600975213327915,0,0,190,493,19,71,8,60,16,8
"181","2020-03-19",13,3,78,137,2461,0.600975213327915,0,0,190,493,20,91,7,67,20,7
"182","2020-03-20",20,3,78,152,2461,0.600975213327915,0,0,190,493,18,109,8,75,14,8
"183","2020-03-21",27,3,82,161,2461,0.600975213327915,0,0,190,493,31,140,6,81,24,6
"184","2020-03-22",29,3,87,169,2461,0.600975213327915,0,0,190,493,18,158,4,85,17,4
"185","2020-03-23",32,3,97,188,2461,0.600975213327915,0,0,190,493,39,197,8,93,35,8
"186","2020-03-24",34,3,98,206,2461,0.600975213327915,0,0,190,493,38,235,10,103,35,10
"187","2020-03-25",38,3,94,212,2461,0.600975213327915,0,0,190,493,39,274,11,114,38,11
"188","2020-03-26",44,3,91,222,2461,0.600975213327915,0,0,190,493,45,319,12,126,43,12
"189","2020-03-27",44,3,100,244,2461,0.600975213327915,0,0,190,493,51,370,18,144,47,18
"190","2020-03-28",49,3,102,254,2461,0.600975213327915,0,0,190,493,51,421,13,157,48,13
"191","2020-03-29",53,3,113,268,2461,0.600975213327915,0,0,190,493,66,487,15,172,61,15
"192","2020-03-30",60,3,141,270,2461,0.600975213327915,0,0,190,493,62,549,20,192,60,20
"193","2020-03-31",71,3,160,275,2461,0.600975213327915,0,0,190,493,61,610,11,203,58,11
"194","2020-04-01",76,3,147,294,2461,0.600975213327915,0,0,190,493,63,673,13,216,59,13
"195","2020-04-02",78,3,145,306,2461,0.600975213327915,0,0,190,493,75,748,10,226,74,10
"196","2020-04-03",88,3,153,325,2461,0.600975213327915,0,0,190,493,71,819,13,239,68,13
"197","2020-04-04",86,3,152,339,2461,0.600975213327915,0,0,190,493,77,896,12,251,75,12
"198","2020-04-05",89,3,151,349,2461,0.600975213327915,0,0,190,493,98,994,11,262,95,11
"199","2020-04-06",89,3,136,348,2461,0.600975213327915,0,0,190,493,91,1085,9,271,88,9
"200","2020-04-07",83,3,134,340,2461,0.600975213327915,0,0,190,493,95,1180,7,278,92,7
"201","2020-04-08",87,3,147,349,2461,0.600975213327915,0,0,190,493,86,1266,9,287,85,9
"202","2020-04-09",87,3,144,349,2461,0.600975213327915,0,0,190,493,100,1366,12,299,96,12
"203","2020-04-10",83,3,133,347,2461,0.600975213327915,0,0,190,493,122,1488,16,315,113,16
"204","2020-04-11",91,3,136,364,2461,0.600975213327915,0,0,190,493,103,1591,21,336,98,21
"205","2020-04-12",94,3,145,367,2461,0.600975213327915,0,0,190,493,117,1708,21,357,113,21
"206","2020-04-13",97,3,149,370,2461,0.600975213327915,0,0,190,493,129,1837,19,376,126,19
"207","2020-04-14",103,3,148,374,2461,0.600975213327915,0,0,190,493,114,1951,9,385,108,9
"208","2020-04-15",106,3,161,380,2461,0.600975213327915,0,0,190,493,141,2092,15,400,134,15
"209","2020-04-16",109,3,154,403,2461,0.600975213327915,0,0,190,493,126,2218,16,416,123,16
"210","2020-04-17",113,3,164,414,2461,0.600975213327915,0,0,190,493,137,2355,18,434,132,18
"211","2020-04-18",106,3,169,408,2461,0.600975213327915,0,0,190,493,153,2508,16,450,151,16
"212","2020-04-19",104,3,160,401,2461,0.600975213327915,0,0,190,493,157,2665,10,460,155,10
"213","2020-04-20",104,3,144,413,2461,0.600975213327915,0,0,190,493,143,2808,19,479,139,19
"214","2020-04-21",105,3,140,420,2461,0.600975213327915,0,0,190,493,138,2946,14,493,133,14
"215","2020-04-22",108,3,145,428,2461,0.600975213327915,0,0,190,493,114,3060,17,510,112,17
"216","2020-04-23",113,3,133,424,2461,0.600975213327915,0,0,190,493,103,3163,16,526,100,16
"217","2020-04-24",111,3,145,418,2461,0.600975213327915,0,0,190,493,120,3283,19,545,118,19
"218","2020-04-25",115,3,140,421,2461,0.600975213327915,0,0,190,493,164,3447,19,564,161,19
"219","2020-04-26",123,3,126,410,2461,0.600975213327915,0,0,190,493,107,3554,14,578,105,14
"220","2020-04-27",125,3,120,403,2461,0.600975213327915,0,0,190,493,103,3657,19,597,100,19
"221","2020-04-28",131,3,127,398,2461,0.600975213327915,0,0,190,493,108,3765,15,612,106,15
"222","2020-04-29",126,3,133,388,2461,0.600975213327915,0,0,190,493,91,3856,12,624,90,12
"223","2020-04-30",118,3,145,400,2461,0.600975213327915,0,0,190,493,78,3934,15,639,77,15
"224","2020-05-01",124,3,145,404,2461,0.600975213327915,0,0,190,493,107,4041,15,654,105,15
"225","2020-05-02",127,3,176,395,2461,0.600975213327915,0,0,190,493,92,4133,18,672,88,18
"226","2020-05-03",118,3,178,395,2461,0.600975213327915,0,0,190,493,82,4215,14,686,77,14
"227","2020-05-04",120,3,195,388,2461,0.600975213327915,0,0,190,493,79,4294,25,711,78,25
"228","2020-05-05",111,3,191,392,2461,0.600975213327915,0,0,190,493,57,4351,23,734,55,23
"229","2020-05-06",105,3,210,383,2461,0.600975213327915,0,0,190,493,81,4432,24,758,80,24
"230","2020-05-07",104,3,209,378,2461,0.600975213327915,0,0,190,493,55,4487,23,781,53,23
"231","2020-05-08",100,3,219,377,2461,0.600975213327915,0,0,190,493,72,4559,19,800,68,19
"232","2020-05-09",97,3,223,360,2461,0.600975213327915,0,0,190,493,64,4623,26,826,61,26
"233","2020-05-10",107,3,223,353,2461,0.600975213327915,0,0,190,493,37,4660,21,847,34,21
"234","2020-05-11",99,3,224,365,2461,0.600975213327915,0,0,190,493,40,4700,20,867,39,20
"235","2020-05-12",103,3,244,357,2461,0.600975213327915,0,0,190,493,64,4764,14,881,64,14
"236","2020-05-13",104,3,224,360,2461,0.600975213327915,0,0,190,493,42,4806,19,900,37,19
"237","2020-05-14",103,3,224,347,2461,0.600975213327915,0,0,190,493,46,4852,18,918,44,18
"238","2020-05-15",104,3,231,330,2461,0.600975213327915,0,0,190,493,32,4884,14,932,30,14
"239","2020-05-16",101,3,220,315,2461,0.600975213327915,0,0,190,493,30,4914,14,946,29,14
"240","2020-05-17",94,3,216,306,2461,0.600975213327915,0,0,190,493,32,4946,23,969,32,23
"241","2020-05-18",97,3,222,291,2461,0.600975213327915,0,0,190,493,22,4968,15,984,22,15
"242","2020-05-19",90,3,217,292,2461,0.600975213327915,0,0,190,493,28,4996,10,994,25,10
"243","2020-05-20",87,3,215,277,2461,0.600975213327915,0,0,190,493,29,5025,20,1014,27,20
"244","2020-05-21",85,3,212,278,2461,0.600975213327915,0,0,190,493,24,5049,14,1028,21,14
"245","2020-05-22",75,3,213,274,2461,0.600975213327915,0,0,190,493,12,5061,18,1046,12,18
"246","2020-05-23",79,3,181,268,2461,0.600975213327915,0,0,190,493,23,5084,16,1062,22,16
"247","2020-05-24",76,3,178,253,2461,0.600975213327915,0,0,190,493,12,5096,22,1084,12,22
"248","2020-05-25",74,3,182,241,2461,0.600975213327915,0,0,190,493,11,5107,14,1098,10,14
"249","2020-05-26",76,3,171,236,2461,0.600975213327915,0,0,190,493,9,5116,19,1117,8,19
"250","2020-05-27",75,3,172,227,2461,0.600975213327915,0,0,190,493,8,5124,12,1129,8,12
"251","2020-05-28",76,3,188,225,2461,0.600975213327915,0,0,190,493,12,5136,8,1137,12,8
"252","2020-05-29",79,3,196,215,2461,0.600975213327915,0,0,190,493,17,5153,15,1152,17,15
"253","2020-05-30",69,3,183,208,2461,0.600975213327915,0,0,190,493,9,5162,11,1163,8,11
"254","2020-05-31",75,3,187,204,2461,0.600975213327915,0,0,190,493,14,5176,16,1179,14,16
"255","2020-06-01",74,3,189,200,2461,0.600975213327915,0,0,190,493,14,5190,11,1190,11,11
"256","2020-06-02",76,3,188,202,2461,0.600975213327915,0,0,190,493,9,5199,12,1202,8,12
"257","2020-06-03",77,3,189,192,2461,0.600975213327915,0,0,190,493,7,5206,9,1211,5,9
"258","2020-06-04",75,3,191,184,2461,0.600975213327915,0,0,190,493,7,5213,12,1223,7,12
"259","2020-06-05",73,3,183,186,2461,0.600975213327915,0,0,190,493,13,5226,14,1237,13,14
"260","2020-06-06",68,3,177,173,2461,0.600975213327915,0,0,190,493,7,5233,7,1244,6,7
"261","2020-06-07",57,3,183,156,2461,0.600975213327915,0,0,190,493,10,5243,17,1261,10,17
"262","2020-03-13",2,4,13,15,2625,0.83847619047619,0,0,232,170,13,31,21,37,5,21
"263","2020-03-14",2,4,10,24,2625,0.83847619047619,0,0,232,170,17,48,12,49,9,12
"264","2020-03-15",3,4,15,30,2625,0.83847619047619,0,0,232,170,17,65,9,58,10,9
"265","2020-03-16",4,4,22,38,2625,0.83847619047619,0,0,232,170,16,81,20,78,10,20
"266","2020-03-17",4,4,26,49,2625,0.83847619047619,0,0,232,170,36,117,6,84,24,6
"267","2020-03-18",7,4,27,59,2625,0.83847619047619,0,0,232,170,33,150,15,99,19,15
"268","2020-03-19",11,4,36,70,2625,0.83847619047619,0,0,232,170,44,194,11,110,34,11
"269","2020-03-20",14,4,34,83,2625,0.83847619047619,0,0,232,170,47,241,7,117,33,7
"270","2020-03-21",17,4,35,97,2625,0.83847619047619,0,0,232,170,81,322,15,132,64,15
"271","2020-03-22",21,4,33,115,2625,0.83847619047619,0,0,232,170,56,378,11,143,50,11
"272","2020-03-23",31,4,23,138,2625,0.83847619047619,0,0,232,170,60,438,13,156,47,13
"273","2020-03-24",36,4,17,144,2625,0.83847619047619,0,0,232,170,98,536,14,170,85,14
"274","2020-03-25",36,4,22,163,2625,0.83847619047619,0,0,232,170,106,642,13,183,95,13
"275","2020-03-26",40,4,29,178,2625,0.83847619047619,0,0,232,170,103,745,17,200,90,17
"276","2020-03-27",42,4,28,191,2625,0.83847619047619,0,0,232,170,140,885,15,215,130,15
"277","2020-03-28",47,4,35,212,2625,0.83847619047619,0,0,232,170,206,1091,15,230,202,15
"278","2020-03-29",45,4,33,218,2625,0.83847619047619,0,0,232,170,153,1244,13,243,143,13
"279","2020-03-30",44,4,32,229,2625,0.83847619047619,0,0,232,170,215,1459,19,262,205,19
"280","2020-03-31",48,4,35,237,2625,0.83847619047619,0,0,232,170,267,1726,19,281,247,19
"281","2020-04-01",64,4,43,251,2625,0.83847619047619,0,0,232,170,220,1946,20,301,210,20
"282","2020-04-02",65,4,41,258,2625,0.83847619047619,0,0,232,170,350,2296,21,322,342,21
"283","2020-04-03",68,4,43,279,2625,0.83847619047619,0,0,232,170,404,2700,24,346,395,24
"284","2020-04-04",71,4,37,295,2625,0.83847619047619,0,0,232,170,346,3046,28,374,340,28
"285","2020-04-05",88,4,37,320,2625,0.83847619047619,0,0,232,170,329,3375,30,404,322,30
"286","2020-04-06",89,4,39,331,2625,0.83847619047619,0,0,232,170,336,3711,36,440,327,36
"287","2020-04-07",94,4,49,329,2625,0.83847619047619,0,0,232,170,343,4054,21,461,331,21
"288","2020-04-08",85,4,58,346,2625,0.83847619047619,0,0,232,170,330,4384,23,484,325,23
"289","2020-04-09",86,4,48,368,2625,0.83847619047619,0,0,232,170,301,4685,14,498,294,14
"290","2020-04-10",87,4,45,367,2625,0.83847619047619,0,0,232,170,293,4978,37,535,288,38
"291","2020-04-11",92,4,41,380,2625,0.83847619047619,0,0,232,170,223,5201,20,555,220,20
"292","2020-04-12",90,4,41,377,2625,0.83847619047619,0,0,232,170,262,5463,27,582,257,27
"293","2020-04-13",96,4,45,385,2625,0.83847619047619,0,0,232,170,273,5736,13,595,267,13
"294","2020-04-14",104,4,39,386,2625,0.83847619047619,0,0,232,170,168,5904,33,628,163,33
"295","2020-04-15",110,4,34,398,2625,0.83847619047619,0,0,232,170,208,6112,8,636,206,8
"296","2020-04-16",108,4,40,407,2625,0.83847619047619,0,0,232,170,165,6277,16,652,157,16
"297","2020-04-17",114,4,47,402,2625,0.83847619047619,0,0,232,170,118,6395,31,683,112,31
"298","2020-04-18",108,4,56,419,2625,0.83847619047619,0,0,232,170,131,6526,18,701,130,18
"299","2020-04-19",109,4,54,411,2625,0.83847619047619,0,0,232,170,119,6645,30,731,113,30
"300","2020-04-20",107,4,45,426,2625,0.83847619047619,0,0,232,170,85,6730,30,761,78,30
"301","2020-04-21",96,4,42,442,2625,0.83847619047619,0,0,232,170,59,6789,33,794,59,33
"302","2020-04-22",100,4,47,450,2625,0.83847619047619,0,0,232,170,56,6845,20,814,53,20
"303","2020-04-23",109,4,60,446,2625,0.83847619047619,0,0,232,170,64,6909,23,837,60,23
"304","2020-04-24",108,4,62,447,2625,0.83847619047619,0,0,232,170,38,6947,6,843,38,6
"305","2020-04-25",115,4,79,446,2625,0.83847619047619,0,0,232,170,42,6989,32,875,37,32
"306","2020-04-26",127,4,92,438,2625,0.83847619047619,0,0,232,170,31,7020,43,918,28,43
"307","2020-04-27",125,4,85,445,2625,0.83847619047619,0,0,232,170,19,7039,55,973,18,55
"308","2020-04-28",133,4,82,444,2625,0.83847619047619,0,0,232,170,29,7068,35,1008,24,35
"309","2020-04-29",133,4,81,441,2625,0.83847619047619,0,0,232,170,22,7090,24,1032,19,24
"310","2020-04-30",134,4,76,445,2625,0.83847619047619,0,0,232,170,14,7104,14,1046,11,14
"311","2020-05-01",139,4,68,448,2625,0.83847619047619,0,0,232,170,12,7116,43,1089,11,43
"312","2020-05-02",138,4,60,447,2625,0.83847619047619,0,0,232,170,12,7128,39,1128,8,39
"313","2020-05-03",119,4,55,432,2625,0.83847619047619,0,0,232,170,7,7135,25,1153,5,25
"314","2020-05-04",123,4,55,432,2625,0.83847619047619,0,0,232,170,7,7142,21,1174,5,21
"315","2020-05-05",117,4,56,432,2625,0.83847619047619,0,0,232,170,9,7151,33,1207,6,33
"316","2020-05-06",117,4,53,427,2625,0.83847619047619,0,0,232,170,7,7158,12,1219,6,12
"317","2020-05-07",119,4,55,415,2625,0.83847619047619,0,0,232,170,5,7163,16,1235,3,16
"318","2020-05-08",117,4,52,414,2625,0.83847619047619,0,0,232,170,7,7170,7,1242,4,7
"319","2020-05-09",125,4,61,400,2625,0.83847619047619,0,0,232,170,3,7173,9,1251,3,9
"320","2020-05-10",124,4,55,404,2625,0.83847619047619,0,0,232,170,6,7179,10,1261,4,10
"321","2020-05-11",126,4,47,408,2625,0.83847619047619,0,0,232,170,4,7183,10,1271,3,10
"322","2020-05-12",127,4,43,403,2625,0.83847619047619,0,0,232,170,4,7187,20,1291,3,20
"323","2020-05-13",123,4,37,397,2625,0.83847619047619,0,0,232,170,9,7196,23,1314,8,23
"324","2020-05-14",123,4,32,388,2625,0.83847619047619,0,0,232,170,3,7199,8,1322,3,8
"325","2020-05-15",118,4,33,380,2625,0.83847619047619,0,0,232,170,2,7201,14,1336,NA,14
"326","2020-05-16",115,4,28,377,2625,0.83847619047619,0,0,232,170,4,7205,17,1353,3,17
"327","2020-05-17",121,4,35,368,2625,0.83847619047619,0,0,232,170,4,7209,17,1370,3,17
"328","2020-05-18",117,4,34,348,2625,0.83847619047619,0,0,232,170,1,7210,17,1387,1,17
"329","2020-05-19",114,4,34,330,2625,0.83847619047619,0,0,232,170,5,7215,27,1414,2,27
"330","2020-05-20",109,4,35,330,2625,0.83847619047619,0,0,232,170,2,7217,21,1435,2,21
"331","2020-05-21",107,4,32,319,2625,0.83847619047619,0,0,232,170,5,7222,25,1460,3,25
"332","2020-05-22",105,4,31,328,2625,0.83847619047619,0,0,232,170,5,7227,29,1489,3,29
"333","2020-05-23",96,4,47,328,2625,0.83847619047619,0,0,232,170,1,7228,31,1520,1,31
"334","2020-05-24",90,4,58,309,2625,0.83847619047619,0,0,232,170,2,7230,12,1532,NA,12
"335","2020-05-25",80,4,45,305,2625,0.83847619047619,0,0,232,170,3,7233,13,1545,3,13
"336","2020-05-26",85,4,44,307,2625,0.83847619047619,0,0,232,170,3,7236,14,1559,NA,14
"337","2020-05-27",85,4,49,302,2625,0.83847619047619,0,0,232,170,NA,NA,16,1575,NA,16
"338","2020-05-28",85,4,52,303,2625,0.83847619047619,0,0,232,170,1,7237,7,1582,NA,7
"339","2020-05-29",84,4,46,295,2625,0.83847619047619,0,0,232,170,3,7240,10,1592,NA,10
"340","2020-05-30",84,4,53,282,2625,0.83847619047619,0,0,232,170,1,7241,10,1602,1,10
"341","2020-05-31",86,4,64,292,2625,0.83847619047619,0,0,232,170,4,7245,1,1603,2,1
"342","2020-06-01",95,4,54,289,2625,0.83847619047619,0,0,232,170,3,7248,5,1608,1,5
"343","2020-06-02",92,4,57,277,2625,0.83847619047619,0,0,232,170,2,7250,2,1610,NA,2
"344","2020-06-03",95,4,60,277,2625,0.83847619047619,0,0,232,170,4,7254,17,1627,1,17
"345","2020-06-04",89,4,62,272,2625,0.83847619047619,0,0,232,170,2,7256,8,1635,2,8
"346","2020-06-05",87,4,64,251,2625,0.83847619047619,0,0,232,170,1,7257,10,1645,1,10
"347","2020-06-06",83,4,60,240,2625,0.83847619047619,0,0,232,170,1,7258,16,1661,NA,16
"348","2020-06-07",79,4,66,232,2625,0.83847619047619,0,0,232,170,NA,NA,7,1668,NA,7
"349","2020-03-16",1,5,10,35,2259,0.722443559096946,0,0,224,157,7,29,5,11,5,5
"350","2020-03-17",3,5,11,56,2259,0.722443559096946,0,0,224,157,7,36,4,15,1,4
"351","2020-03-18",4,5,11,72,2259,0.722443559096946,0,0,224,157,10,46,6,21,7,6
"352","2020-03-19",7,5,13,84,2259,0.722443559096946,0,0,224,157,10,56,1,22,7,1
"353","2020-03-20",9,5,22,104,2259,0.722443559096946,0,0,224,157,7,63,2,24,6,2
"354","2020-03-21",10,5,31,118,2259,0.722443559096946,0,0,224,157,9,72,3,27,6,3
"355","2020-03-22",16,5,33,130,2259,0.722443559096946,0,0,224,157,13,85,9,36,8,9
"356","2020-03-23",20,5,30,155,2259,0.722443559096946,0,0,224,157,20,105,11,47,17,11
"357","2020-03-24",27,5,28,167,2259,0.722443559096946,0,0,224,157,18,123,13,60,15,13
"358","2020-03-25",33,5,29,179,2259,0.722443559096946,0,0,224,157,15,138,13,73,8,13
"359","2020-03-26",35,5,23,189,2259,0.722443559096946,0,0,224,157,17,155,7,80,14,7
"360","2020-03-27",37,5,26,201,2259,0.722443559096946,0,0,224,157,17,172,12,92,13,12
"361","2020-03-28",50,5,23,221,2259,0.722443559096946,0,0,224,157,20,192,5,97,18,5
"362","2020-03-29",50,5,26,228,2259,0.722443559096946,0,0,224,157,11,203,5,102,10,5
"363","2020-03-30",59,5,28,242,2259,0.722443559096946,0,0,224,157,22,225,4,106,17,4
"364","2020-03-31",57,5,24,253,2259,0.722443559096946,0,0,224,157,31,256,10,116,28,10
"365","2020-04-01",62,5,27,264,2259,0.722443559096946,0,0,224,157,25,281,4,120,19,4
"366","2020-04-02",73,5,31,282,2259,0.722443559096946,0,0,224,157,28,309,10,130,26,10
"367","2020-04-03",81,5,29,296,2259,0.722443559096946,0,0,224,157,27,336,12,142,24,12
"368","2020-04-04",75,5,32,321,2259,0.722443559096946,0,0,224,157,13,349,8,150,10,8
"369","2020-04-05",83,5,39,337,2259,0.722443559096946,0,0,224,157,26,375,12,162,21,12
"370","2020-04-06",82,5,44,341,2259,0.722443559096946,0,0,224,157,24,399,15,177,20,15
"371","2020-04-07",88,5,50,363,2259,0.722443559096946,0,0,224,157,21,420,13,190,19,13
"372","2020-04-08",86,5,49,366,2259,0.722443559096946,0,0,224,157,30,450,12,202,21,12
"373","2020-04-09",86,5,55,369,2259,0.722443559096946,0,0,224,157,31,481,8,210,26,8
"374","2020-04-10",89,5,59,364,2259,0.722443559096946,0,0,224,157,23,504,12,222,19,12
"375","2020-04-11",99,5,65,351,2259,0.722443559096946,0,0,224,157,29,533,16,238,22,16
"376","2020-04-12",101,5,63,345,2259,0.722443559096946,0,0,224,157,28,561,7,245,25,7
"377","2020-04-13",104,5,54,344,2259,0.722443559096946,0,0,224,157,31,592,11,256,23,11
"378","2020-04-14",108,5,57,329,2259,0.722443559096946,0,0,224,157,41,633,8,264,34,8
"379","2020-04-15",115,5,59,326,2259,0.722443559096946,0,0,224,157,28,661,15,279,24,15
"380","2020-04-16",113,5,60,316,2259,0.722443559096946,0,0,224,157,36,697,25,304,34,25
"381","2020-04-17",109,5,55,301,2259,0.722443559096946,0,0,224,157,33,730,15,319,27,15
"382","2020-04-18",109,5,53,301,2259,0.722443559096946,0,0,224,157,24,754,19,338,23,19
"383","2020-04-19",107,5,55,309,2259,0.722443559096946,0,0,224,157,47,801,11,349,40,11
"384","2020-04-20",100,5,48,297,2259,0.722443559096946,0,0,224,157,32,833,9,358,29,9
"385","2020-04-21",95,5,48,307,2259,0.722443559096946,0,0,224,157,46,879,15,373,43,15
"386","2020-04-22",91,5,46,300,2259,0.722443559096946,0,0,224,157,34,913,15,388,28,15
"387","2020-04-23",87,5,48,305,2259,0.722443559096946,0,0,224,157,32,945,19,407,27,19
"388","2020-04-24",89,5,45,318,2259,0.722443559096946,0,0,224,157,47,992,24,431,37,24
"389","2020-04-25",89,5,41,348,2259,0.722443559096946,0,0,224,157,37,1029,16,447,30,16
"390","2020-04-26",87,5,37,367,2259,0.722443559096946,0,0,224,157,33,1062,22,469,28,22
"391","2020-04-27",95,5,39,373,2259,0.722443559096946,0,0,224,157,41,1103,24,493,34,24
"392","2020-04-28",96,5,32,370,2259,0.722443559096946,0,0,224,157,47,1150,22,515,41,22
"393","2020-04-29",97,5,36,392,2259,0.722443559096946,0,0,224,157,36,1186,16,531,34,16
"394","2020-04-30",101,5,43,414,2259,0.722443559096946,0,0,224,157,50,1236,18,549,46,18
"395","2020-05-01",100,5,33,417,2259,0.722443559096946,0,0,224,157,43,1279,12,561,40,12
"396","2020-05-02",90,5,49,428,2259,0.722443559096946,0,0,224,157,53,1332,9,570,44,9
"397","2020-05-03",94,5,47,435,2259,0.722443559096946,0,0,224,157,37,1369,8,578,35,8
"398","2020-05-04",93,5,46,447,2259,0.722443559096946,0,0,224,157,46,1415,19,597,41,19
"399","2020-05-05",107,5,43,440,2259,0.722443559096946,0,0,224,157,42,1457,17,614,38,17
"400","2020-05-06",107,5,41,435,2259,0.722443559096946,0,0,224,157,35,1492,16,630,32,16
"401","2020-05-07",112,5,53,418,2259,0.722443559096946,0,0,224,157,37,1529,9,639,33,9
"402","2020-05-08",122,5,56,414,2259,0.722443559096946,0,0,224,157,35,1564,14,653,33,14
"403","2020-05-09",125,5,55,401,2259,0.722443559096946,0,0,224,157,25,1589,14,667,19,14
"404","2020-05-10",123,5,49,394,2259,0.722443559096946,0,0,224,157,28,1617,18,685,24,18
"405","2020-05-11",121,5,44,383,2259,0.722443559096946,0,0,224,157,41,1658,18,703,35,18
"406","2020-05-12",111,5,43,381,2259,0.722443559096946,0,0,224,157,24,1682,20,723,20,20
"407","2020-05-13",112,5,50,356,2259,0.722443559096946,0,0,224,157,24,1706,10,733,23,10
"408","2020-05-14",104,5,49,341,2259,0.722443559096946,0,0,224,157,29,1735,16,749,23,16
"409","2020-05-15",102,5,51,330,2259,0.722443559096946,0,0,224,157,26,1761,20,769,24,20
"410","2020-05-16",102,5,51,331,2259,0.722443559096946,0,0,224,157,24,1785,16,785,21,16
"411","2020-05-17",97,5,42,310,2259,0.722443559096946,0,0,224,157,17,1802,12,797,11,12
"412","2020-05-18",92,5,38,296,2259,0.722443559096946,0,0,224,157,33,1835,19,816,30,19
"413","2020-05-19",93,5,31,283,2259,0.722443559096946,0,0,224,157,24,1859,11,827,21,11
"414","2020-05-20",87,5,30,278,2259,0.722443559096946,0,0,224,157,35,1894,15,842,29,15
"415","2020-05-21",85,5,28,272,2259,0.722443559096946,0,0,224,157,17,1911,19,861,17,19
"416","2020-05-22",76,5,26,257,2259,0.722443559096946,0,0,224,157,28,1939,25,886,27,25
"417","2020-05-23",77,5,27,251,2259,0.722443559096946,0,0,224,157,24,1963,17,903,22,17
"418","2020-05-24",77,5,31,234,2259,0.722443559096946,0,0,224,157,27,1990,20,923,22,20
"419","2020-05-25",74,5,39,218,2259,0.722443559096946,0,0,224,157,28,2018,14,937,24,14
"420","2020-05-26",65,5,40,201,2259,0.722443559096946,0,0,224,157,29,2047,15,952,24,15
"421","2020-05-27",63,5,46,192,2259,0.722443559096946,0,0,224,157,31,2078,9,961,30,9
"422","2020-05-28",59,5,48,187,2259,0.722443559096946,0,0,224,157,30,2108,8,969,29,8
"423","2020-05-29",56,5,54,166,2259,0.722443559096946,0,0,224,157,26,2134,5,974,23,5
"424","2020-05-30",54,5,51,164,2259,0.722443559096946,0,0,224,157,33,2167,6,980,29,6
"425","2020-05-31",50,5,48,161,2259,0.722443559096946,0,0,224,157,32,2199,16,996,31,16
"426","2020-06-01",51,5,42,157,2259,0.722443559096946,0,0,224,157,26,2225,17,1013,26,17
"427","2020-06-02",50,5,34,153,2259,0.722443559096946,0,0,224,157,22,2247,15,1028,21,15
"428","2020-06-03",46,5,27,150,2259,0.722443559096946,0,0,224,157,26,2273,16,1044,25,16
"429","2020-06-04",49,5,23,149,2259,0.722443559096946,0,0,224,157,28,2301,16,1060,26,16
"430","2020-06-05",46,5,19,143,2259,0.722443559096946,0,0,224,157,22,2323,12,1072,21,12
"431","2020-06-06",40,5,16,143,2259,0.722443559096946,0,0,224,157,34,2357,14,1086,33,14
"432","2020-06-07",44,5,15,138,2259,0.722443559096946,0,0,224,157,19,2376,15,1101,18,15
"433","2020-03-15",1,6,23,44,6742,0.947938297241175,0,0,668,331,7,46,5,20,2,5
"434","2020-03-16",2,6,23,58,6742,0.947938297241175,0,0,668,331,11,57,8,28,5,8
"435","2020-03-17",4,6,25,69,6742,0.947938297241175,0,0,668,331,13,70,4,32,3,4
"436","2020-03-18",4,6,21,83,6742,0.947938297241175,0,0,668,331,10,80,6,38,7,6
"437","2020-03-19",6,6,20,96,6742,0.947938297241175,0,0,668,331,20,100,4,42,12,4
"438","2020-03-20",13,6,21,114,6742,0.947938297241175,0,0,668,331,20,120,9,51,15,9
"439","2020-03-21",20,6,20,129,6742,0.947938297241175,0,0,668,331,19,139,13,64,13,13
"440","2020-03-22",23,6,33,156,6742,0.947938297241175,0,0,668,331,20,159,5,69,13,5
"441","2020-03-23",27,6,37,181,6742,0.947938297241175,0,0,668,331,14,173,11,80,8,11
"442","2020-03-24",31,6,39,208,6742,0.947938297241175,0,0,668,331,11,184,10,90,8,10
"443","2020-03-25",40,6,43,234,6742,0.947938297241175,0,0,668,331,22,206,8,98,17,8
"444","2020-03-26",48,6,38,263,6742,0.947938297241175,0,0,668,331,21,227,11,109,15,11
"445","2020-03-27",48,6,45,291,6742,0.947938297241175,0,0,668,331,17,244,10,119,11,10
"446","2020-03-28",51,6,50,338,6742,0.947938297241175,0,0,668,331,33,277,4,123,25,4
"447","2020-03-29",65,6,44,399,6742,0.947938297241175,0,0,668,331,22,299,4,127,14,4
"448","2020-03-30",73,6,54,457,6742,0.947938297241175,0,0,668,331,17,316,13,140,13,13
"449","2020-03-31",75,6,59,532,6742,0.947938297241175,0,0,668,331,21,337,9,149,17,9
"450","2020-04-01",90,6,59,600,6742,0.947938297241175,0,0,668,331,22,359,8,157,16,8
"451","2020-04-02",106,6,68,705,6742,0.947938297241175,0,0,668,331,24,383,5,162,15,5
"452","2020-04-03",121,6,73,809,6742,0.947938297241175,0,0,668,331,30,413,9,171,25,9
"453","2020-04-04",142,6,70,986,6742,0.947938297241175,0,0,668,331,27,440,5,176,17,5
"454","2020-04-05",159,6,65,1120,6742,0.947938297241175,0,0,668,331,33,473,7,183,24,7
"455","2020-04-06",191,6,63,1238,6742,0.947938297241175,0,0,668,331,19,492,9,192,12,9
"456","2020-04-07",243,6,56,1427,6742,0.947938297241175,0,0,668,331,32,524,3,195,19,3
"457","2020-04-08",274,6,62,1544,6742,0.947938297241175,0,0,668,331,30,554,7,202,17,7
"458","2020-04-09",304,6,82,1765,6742,0.947938297241175,0,0,668,331,35,589,9,211,28,9
"459","2020-04-10",344,6,71,1907,6742,0.947938297241175,0,0,668,331,29,618,11,222,20,11
"460","2020-04-11",384,6,72,2120,6742,0.947938297241175,0,0,668,331,23,641,7,229,16,7
"461","2020-04-12",442,6,57,2347,6742,0.947938297241175,0,0,668,331,26,667,13,242,14,13
"462","2020-04-13",496,6,52,2517,6742,0.947938297241175,0,0,668,331,38,705,7,249,23,7
"463","2020-04-14",530,6,53,2630,6742,0.947938297241175,0,0,668,331,41,746,13,262,32,13
"464","2020-04-15",580,6,52,2716,6742,0.947938297241175,0,0,668,331,19,765,21,283,11,21
"465","2020-04-16",631,6,49,2786,6742,0.947938297241175,0,0,668,331,38,803,23,306,30,23
"466","2020-04-17",684,6,42,2731,6742,0.947938297241175,0,0,668,331,23,826,20,326,17,20
"467","2020-04-18",741,6,32,2704,6742,0.947938297241175,0,0,668,331,30,856,21,347,21,21
"468","2020-04-19",771,6,39,2652,6742,0.947938297241175,0,0,668,331,26,882,23,370,19,23
"469","2020-04-20",805,6,55,2537,6742,0.947938297241175,0,0,668,331,28,910,22,392,17,22
"470","2020-04-21",822,6,59,2459,6742,0.947938297241175,0,0,668,331,33,943,26,418,21,26
"471","2020-04-22",825,6,66,2362,6742,0.947938297241175,0,0,668,331,28,971,11,429,16,11
"472","2020-04-23",836,6,61,2227,6742,0.947938297241175,0,0,668,331,20,991,8,437,15,8
"473","2020-04-24",800,6,60,2067,6742,0.947938297241175,0,0,668,331,31,1022,9,446,20,9
"474","2020-04-25",744,6,74,1951,6742,0.947938297241175,0,0,668,331,22,1044,17,463,13,17
"475","2020-04-26",711,6,65,1836,6742,0.947938297241175,0,0,668,331,18,1062,12,475,15,12
"476","2020-04-27",653,6,77,1691,6742,0.947938297241175,0,0,668,331,25,1087,14,489,15,14
"477","2020-04-28",602,6,82,1550,6742,0.947938297241175,0,0,668,331,21,1108,21,510,13,21
"478","2020-04-29",570,6,87,1427,6742,0.947938297241175,0,0,668,331,22,1130,10,520,15,10
"479","2020-04-30",516,6,92,1295,6742,0.947938297241175,0,0,668,331,24,1154,12,532,14,12
"480","2020-05-01",496,6,96,1182,6742,0.947938297241175,0,0,668,331,25,1179,10,542,16,10
"481","2020-05-02",470,6,94,1073,6742,0.947938297241175,0,0,668,331,12,1191,14,556,7,14
"482","2020-05-03",420,6,88,977,6742,0.947938297241175,0,0,668,331,24,1215,19,575,10,19
"483","2020-05-04",379,6,90,869,6742,0.947938297241175,0,0,668,331,23,1238,19,594,11,19
"484","2020-05-05",361,6,98,791,6742,0.947938297241175,0,0,668,331,21,1259,16,610,15,16
"485","2020-05-06",314,6,93,687,6742,0.947938297241175,0,0,668,331,20,1279,15,625,10,15
"486","2020-05-07",278,6,88,625,6742,0.947938297241175,0,0,668,331,25,1304,21,646,16,21
"487","2020-05-08",247,6,93,574,6742,0.947938297241175,0,0,668,331,29,1333,12,658,15,12
"488","2020-05-09",224,6,103,486,6742,0.947938297241175,0,0,668,331,17,1350,9,667,12,9
"489","2020-05-10",201,6,94,447,6742,0.947938297241175,0,0,668,331,24,1374,10,677,17,10
"490","2020-05-11",189,6,79,400,6742,0.947938297241175,0,0,668,331,16,1390,17,694,9,17
"491","2020-05-12",161,6,75,364,6742,0.947938297241175,0,0,668,331,22,1412,25,719,12,25
"492","2020-05-13",149,6,72,322,6742,0.947938297241175,0,0,668,331,20,1432,14,733,9,14
"493","2020-05-14",131,6,66,292,6742,0.947938297241175,0,0,668,331,22,1454,6,739,17,6
"494","2020-05-15",112,6,65,255,6742,0.947938297241175,0,0,668,331,15,1469,6,745,8,6
"495","2020-05-16",98,6,65,222,6742,0.947938297241175,0,0,668,331,12,1481,5,750,7,5
"496","2020-05-17",89,6,54,206,6742,0.947938297241175,0,0,668,331,12,1493,5,755,8,5
"497","2020-05-18",76,6,50,183,6742,0.947938297241175,0,0,668,331,13,1506,7,762,8,7
"498","2020-05-19",70,6,50,169,6742,0.947938297241175,0,0,668,331,9,1515,7,769,6,7
"499","2020-05-20",57,6,57,145,6742,0.947938297241175,0,0,668,331,15,1530,10,779,9,10
"500","2020-05-21",57,6,47,127,6742,0.947938297241175,0,0,668,331,12,1542,5,784,6,5
"501","2020-05-22",52,6,46,110,6742,0.947938297241175,0,0,668,331,10,1552,22,806,6,22
"502","2020-05-23",46,6,48,97,6742,0.947938297241175,0,0,668,331,21,1573,15,821,11,15
"503","2020-05-24",38,6,49,92,6742,0.947938297241175,0,0,668,331,25,1598,7,828,18,7
"504","2020-05-25",32,6,44,78,6742,0.947938297241175,0,0,668,331,8,1606,18,846,4,18
"505","2020-05-26",27,6,37,68,6742,0.947938297241175,0,0,668,331,10,1616,11,857,7,11
"506","2020-05-27",26,6,36,60,6742,0.947938297241175,0,0,668,331,16,1632,9,866,11,9
"507","2020-05-28",19,6,45,59,6742,0.947938297241175,0,0,668,331,10,1642,5,871,8,5
"508","2020-05-29",16,6,43,55,6742,0.947938297241175,0,0,668,331,14,1656,5,876,6,5
"509","2020-05-30",13,6,36,48,6742,0.947938297241175,0,0,668,331,14,1670,14,890,10,14
"510","2020-05-31",16,6,51,42,6742,0.947938297241175,0,0,668,331,13,1683,10,900,9,10
"511","2020-06-01",17,6,59,36,6742,0.947938297241175,0,0,668,331,14,1697,10,910,14,10
"512","2020-06-02",15,6,62,36,6742,0.947938297241175,0,0,668,331,16,1713,8,918,12,8
"513","2020-06-03",12,6,63,29,6742,0.947938297241175,0,0,668,331,14,1727,7,925,12,7
"514","2020-06-04",11,6,69,31,6742,0.947938297241175,0,0,668,331,9,1736,2,927,8,2
"515","2020-06-05",11,6,68,30,6742,0.947938297241175,0,0,668,331,15,1751,9,936,13,9
"516","2020-06-06",11,6,62,30,6742,0.947938297241175,0,0,668,331,12,1763,5,941,12,5
"517","2020-06-07",10,6,55,29,6742,0.947938297241175,0,0,668,331,9,1772,8,949,9,8
"518","2020-03-14",2,7,12,31,2068,0.47147001934236,0,0,202,132,4,16,15,44,3,15
"519","2020-03-15",3,7,10,50,2068,0.47147001934236,0,0,202,132,4,20,11,55,3,11
"520","2020-03-16",5,7,13,74,2068,0.47147001934236,0,0,202,132,2,22,11,66,1,11
"521","2020-03-17",9,7,15,88,2068,0.47147001934236,0,0,202,132,3,25,12,78,1,12
"522","2020-03-18",12,7,14,102,2068,0.47147001934236,0,0,202,132,6,31,10,88,3,10
"523","2020-03-19",16,7,12,108,2068,0.47147001934236,0,0,202,132,3,34,13,101,NA,13
"524","2020-03-20",22,7,14,129,2068,0.47147001934236,0,0,202,132,7,41,3,104,3,3
"525","2020-03-21",24,7,15,142,2068,0.47147001934236,0,0,202,132,10,51,1,105,5,1
"526","2020-03-22",30,7,13,157,2068,0.47147001934236,0,0,202,132,5,56,13,118,4,13
"527","2020-03-23",36,7,20,177,2068,0.47147001934236,0,0,202,132,14,70,20,138,7,20
"528","2020-03-24",38,7,27,195,2068,0.47147001934236,0,0,202,132,10,80,3,141,7,3
"529","2020-03-25",44,7,35,206,2068,0.47147001934236,0,0,202,132,12,92,9,150,8,9
"530","2020-03-26",51,7,39,213,2068,0.47147001934236,0,0,202,132,13,105,12,162,6,12
"531","2020-03-27",51,7,42,223,2068,0.47147001934236,0,0,202,132,12,117,13,175,9,13
"532","2020-03-28",56,7,36,224,2068,0.47147001934236,0,0,202,132,11,128,7,182,7,7
"533","2020-03-29",60,7,33,221,2068,0.47147001934236,0,0,202,132,11,139,8,190,8,8
"534","2020-03-30",63,7,27,226,2068,0.47147001934236,0,0,202,132,12,151,1,191,9,1
"535","2020-03-31",68,7,21,234,2068,0.47147001934236,0,0,202,132,20,171,5,196,17,5
"536","2020-04-01",67,7,19,246,2068,0.47147001934236,0,0,202,132,20,191,1,197,15,1
"537","2020-04-02",67,7,21,243,2068,0.47147001934236,0,0,202,132,14,205,2,199,12,2
"538","2020-04-03",66,7,20,238,2068,0.47147001934236,0,0,202,132,13,218,NA,NA,9,NA
"539","2020-04-04",71,7,16,256,2068,0.47147001934236,0,0,202,132,17,235,1,200,13,1
"540","2020-04-05",66,7,12,271,2068,0.47147001934236,0,0,202,132,20,255,1,201,15,1
"541","2020-04-06",65,7,12,269,2068,0.47147001934236,0,0,202,132,18,273,12,213,13,12
"542","2020-04-07",64,7,23,265,2068,0.47147001934236,0,0,202,132,18,291,12,225,16,12
"543","2020-04-08",61,7,21,269,2068,0.47147001934236,0,0,202,132,27,318,13,238,26,13
"544","2020-04-09",58,7,31,261,2068,0.47147001934236,0,0,202,132,19,337,11,249,16,11
"545","2020-04-10",59,7,33,265,2068,0.47147001934236,0,0,202,132,20,357,4,253,15,4
"546","2020-04-11",53,7,36,272,2068,0.47147001934236,0,0,202,132,22,379,8,261,17,8
"547","2020-04-12",67,7,43,268,2068,0.47147001934236,0,0,202,132,14,393,3,264,14,3
"548","2020-04-13",61,7,39,276,2068,0.47147001934236,0,0,202,132,19,412,5,269,15,5
"549","2020-04-14",68,7,37,283,2068,0.47147001934236,0,0,202,132,28,440,3,272,21,3
"550","2020-04-15",76,7,35,295,2068,0.47147001934236,0,0,202,132,18,458,7,279,15,7
"551","2020-04-16",82,7,31,298,2068,0.47147001934236,0,0,202,132,28,486,8,287,25,8
"552","2020-04-17",90,7,32,304,2068,0.47147001934236,0,0,202,132,24,510,14,301,20,14
"553","2020-04-18",93,7,32,314,2068,0.47147001934236,0,0,202,132,20,530,14,315,16,14
"554","2020-04-19",85,7,30,312,2068,0.47147001934236,0,0,202,132,28,558,7,322,27,7
"555","2020-04-20",86,7,21,331,2068,0.47147001934236,0,0,202,132,27,585,8,330,21,8
"556","2020-04-21",85,7,25,338,2068,0.47147001934236,0,0,202,132,23,608,5,335,20,5
"557","2020-04-22",88,7,27,344,2068,0.47147001934236,0,0,202,132,29,637,3,338,23,3
"558","2020-04-23",87,7,31,340,2068,0.47147001934236,0,0,202,132,18,655,15,353,16,15
"559","2020-04-24",86,7,32,343,2068,0.47147001934236,0,0,202,132,25,680,23,376,23,23
"560","2020-04-25",87,7,34,335,2068,0.47147001934236,0,0,202,132,35,715,12,388,26,12
"561","2020-04-26",90,7,27,323,2068,0.47147001934236,0,0,202,132,34,749,16,404,32,16
"562","2020-04-27",102,7,26,336,2068,0.47147001934236,0,0,202,132,41,790,11,415,36,11
"563","2020-04-28",96,7,24,329,2068,0.47147001934236,0,0,202,132,20,810,8,423,18,8
"564","2020-04-29",96,7,26,331,2068,0.47147001934236,0,0,202,132,28,838,23,446,22,23
"565","2020-04-30",94,7,30,338,2068,0.47147001934236,0,0,202,132,36,874,13,459,30,13
"566","2020-05-01",91,7,30,348,2068,0.47147001934236,0,0,202,132,21,895,15,474,19,15
"567","2020-05-02",95,7,46,342,2068,0.47147001934236,0,0,202,132,32,927,6,480,25,6
"568","2020-05-03",99,7,58,339,2068,0.47147001934236,0,0,202,132,41,968,4,484,36,4
"569","2020-05-04",104,7,51,329,2068,0.47147001934236,0,0,202,132,26,994,6,490,22,6
"570","2020-05-05",102,7,45,319,2068,0.47147001934236,0,0,202,132,38,1032,9,499,35,9
"571","2020-05-06",89,7,46,313,2068,0.47147001934236,0,0,202,132,31,1063,10,509,27,10
"572","2020-05-07",86,7,44,302,2068,0.47147001934236,0,0,202,132,37,1100,2,511,32,2
"573","2020-05-08",94,7,44,291,2068,0.47147001934236,0,0,202,132,35,1135,4,515,33,4
"574","2020-05-09",96,7,42,287,2068,0.47147001934236,0,0,202,132,39,1174,6,521,36,6
"575","2020-05-10",85,7,42,283,2068,0.47147001934236,0,0,202,132,50,1224,10,531,48,10
"576","2020-05-11",68,7,50,273,2068,0.47147001934236,0,0,202,132,36,1260,9,540,34,9
"577","2020-05-12",77,7,52,276,2068,0.47147001934236,0,0,202,132,39,1299,7,547,32,7
"578","2020-05-13",83,7,50,264,2068,0.47147001934236,0,0,202,132,36,1335,17,564,31,17
"579","2020-05-14",91,7,53,260,2068,0.47147001934236,0,0,202,132,32,1367,12,576,24,12
"580","2020-05-15",81,7,56,257,2068,0.47147001934236,0,0,202,132,67,1434,9,585,61,9
"581","2020-05-16",74,7,55,254,2068,0.47147001934236,0,0,202,132,45,1479,2,587,41,2
"582","2020-05-17",75,7,64,253,2068,0.47147001934236,0,0,202,132,55,1534,14,601,42,14
"583","2020-05-18",77,7,66,252,2068,0.47147001934236,0,0,202,132,40,1574,24,625,38,24
"584","2020-05-19",71,7,63,251,2068,0.47147001934236,0,0,202,132,35,1609,9,634,34,9
"585","2020-05-20",67,7,68,246,2068,0.47147001934236,0,0,202,132,32,1641,9,643,30,9
"586","2020-05-21",64,7,58,239,2068,0.47147001934236,0,0,202,132,56,1697,6,649,53,6
"587","2020-05-22",64,7,51,250,2068,0.47147001934236,0,0,202,132,44,1741,5,654,40,5
"588","2020-05-23",69,7,46,245,2068,0.47147001934236,0,0,202,132,30,1771,3,657,29,3
"589","2020-05-24",70,7,47,248,2068,0.47147001934236,0,0,202,132,45,1816,3,660,39,3
"590","2020-05-25",77,7,43,246,2068,0.47147001934236,0,0,202,132,59,1875,2,662,56,2
"591","2020-05-26",72,7,43,240,2068,0.47147001934236,0,0,202,132,48,1923,8,670,46,8
"592","2020-05-27",80,7,39,235,2068,0.47147001934236,0,0,202,132,43,1966,9,679,42,9
"593","2020-05-28",82,7,36,224,2068,0.47147001934236,0,0,202,132,46,2012,9,688,42,9
"594","2020-05-29",81,7,31,217,2068,0.47147001934236,0,0,202,132,46,2058,19,707,42,19
"595","2020-05-30",70,7,27,208,2068,0.47147001934236,0,0,202,132,38,2096,11,718,37,11
"596","2020-05-31",71,7,37,196,2068,0.47147001934236,0,0,202,132,30,2126,9,727,29,9
"597","2020-06-01",63,7,31,194,2068,0.47147001934236,0,0,202,132,41,2167,11,738,40,11
"598","2020-06-02",64,7,35,183,2068,0.47147001934236,0,0,202,132,34,2201,5,743,33,5
"599","2020-06-03",63,7,32,174,2068,0.47147001934236,0,0,202,132,28,2229,11,754,27,11
"600","2020-06-04",54,7,27,176,2068,0.47147001934236,0,0,202,132,32,2261,8,762,28,8
"601","2020-06-05",57,7,22,160,2068,0.47147001934236,0,0,202,132,38,2299,3,765,34,3
"602","2020-06-06",55,7,20,146,2068,0.47147001934236,0,0,202,132,22,2321,3,768,20,3
"603","2020-06-07",49,7,23,149,2068,0.47147001934236,0,0,202,132,44,2365,1,769,44,1
"604","2020-03-14",1,8,25,24,1976,0.584514170040486,0,0,145,399,9,28,4,16,2,4
"605","2020-03-15",1,8,24,35,1976,0.584514170040486,0,0,145,399,4,32,2,18,1,2
"606","2020-03-16",3,8,30,50,1976,0.584514170040486,0,0,145,399,3,35,5,23,NA,5
"607","2020-03-17",5,8,41,57,1976,0.584514170040486,0,0,145,399,13,48,2,25,1,2
"608","2020-03-18",6,8,45,68,1976,0.584514170040486,0,0,145,399,13,61,NA,NA,3,NA
"609","2020-03-19",10,8,55,74,1976,0.584514170040486,0,0,145,399,11,72,1,26,6,1
"610","2020-03-20",15,8,50,86,1976,0.584514170040486,0,0,145,399,17,89,1,27,7,1
"611","2020-03-21",20,8,57,96,1976,0.584514170040486,0,0,145,399,16,105,4,31,8,4
"612","2020-03-22",20,8,67,105,1976,0.584514170040486,0,0,145,399,9,114,13,44,2,13
"613","2020-03-23",25,8,69,115,1976,0.584514170040486,0,0,145,399,6,120,6,50,3,6
"614","2020-03-24",29,8,75,119,1976,0.584514170040486,0,0,145,399,14,134,6,56,7,6
"615","2020-03-25",31,8,79,128,1976,0.584514170040486,0,0,145,399,21,155,9,65,15,9
"616","2020-03-26",34,8,81,132,1976,0.584514170040486,0,0,145,399,14,169,6,71,8,6
"617","2020-03-27",34,8,78,136,1976,0.584514170040486,0,0,145,399,14,183,6,77,5,6
"618","2020-03-28",34,8,81,142,1976,0.584514170040486,0,0,145,399,13,196,12,89,7,12
"619","2020-03-29",37,8,77,155,1976,0.584514170040486,0,0,145,399,12,208,6,95,4,6
"620","2020-03-30",34,8,75,168,1976,0.584514170040486,0,0,145,399,12,220,2,97,7,2
"621","2020-03-31",36,8,74,172,1976,0.584514170040486,0,0,145,399,17,237,3,100,11,3
"622","2020-04-01",36,8,83,186,1976,0.584514170040486,0,0,145,399,13,250,11,111,8,11
"623","2020-04-02",39,8,87,192,1976,0.584514170040486,0,0,145,399,17,267,9,120,6,9
"624","2020-04-03",38,8,92,205,1976,0.584514170040486,0,0,145,399,23,290,3,123,9,3
"625","2020-04-04",40,8,112,211,1976,0.584514170040486,0,0,145,399,17,307,13,136,7,13
"626","2020-04-05",51,8,113,208,1976,0.584514170040486,0,0,145,399,11,318,6,142,7,6
"627","2020-04-06",56,8,129,228,1976,0.584514170040486,0,0,145,399,21,339,8,150,8,8
"628","2020-04-07",55,8,135,240,1976,0.584514170040486,0,0,145,399,13,352,NA,NA,6,NA
"629","2020-04-08",57,8,137,262,1976,0.584514170040486,0,0,145,399,25,377,5,155,13,5
"630","2020-04-09",52,8,151,271,1976,0.584514170040486,0,0,145,399,18,395,6,161,11,6
"631","2020-04-10",59,8,154,280,1976,0.584514170040486,0,0,145,399,22,417,6,167,16,6
"632","2020-04-11",63,8,154,288,1976,0.584514170040486,0,0,145,399,21,438,8,175,10,8
"633","2020-04-12",67,8,159,301,1976,0.584514170040486,0,0,145,399,16,454,11,186,9,11
"634","2020-04-13",71,8,171,308,1976,0.584514170040486,0,0,145,399,23,477,6,192,12,6
"635","2020-04-14",72,8,169,319,1976,0.584514170040486,0,0,145,399,26,503,12,204,17,12
"636","2020-04-15",74,8,172,317,1976,0.584514170040486,0,0,145,399,29,532,20,224,19,20
"637","2020-04-16",84,8,176,315,1976,0.584514170040486,0,0,145,399,18,550,17,241,15,17
"638","2020-04-17",85,8,182,319,1976,0.584514170040486,0,0,145,399,17,567,14,255,12,14
"639","2020-04-18",85,8,187,325,1976,0.584514170040486,0,0,145,399,16,583,12,267,9,12
"640","2020-04-19",83,8,170,330,1976,0.584514170040486,0,0,145,399,23,606,6,273,12,6
"641","2020-04-20",90,8,170,322,1976,0.584514170040486,0,0,145,399,28,634,9,282,12,9
"642","2020-04-21",97,8,169,323,1976,0.584514170040486,0,0,145,399,25,659,8,290,14,8
"643","2020-04-22",105,8,181,323,1976,0.584514170040486,0,0,145,399,20,679,6,296,11,6
"644","2020-04-23",106,8,193,322,1976,0.584514170040486,0,0,145,399,31,710,3,299,16,3
"645","2020-04-24",105,8,192,325,1976,0.584514170040486,0,0,145,399,24,734,6,305,13,6
"646","2020-04-25",107,8,199,332,1976,0.584514170040486,0,0,145,399,16,750,5,310,10,5
"647","2020-04-26",103,8,215,326,1976,0.584514170040486,0,0,145,399,27,777,3,313,18,3
"648","2020-04-27",93,8,213,322,1976,0.584514170040486,0,0,145,399,31,808,5,318,19,5
"649","2020-04-28",97,8,192,313,1976,0.584514170040486,0,0,145,399,16,824,16,334,8,16
"650","2020-04-29",89,8,195,309,1976,0.584514170040486,0,0,145,399,22,846,5,339,12,5
"651","2020-04-30",88,8,183,302,1976,0.584514170040486,0,0,145,399,23,869,9,348,11,9
"652","2020-05-01",85,8,183,304,1976,0.584514170040486,0,0,145,399,21,890,13,361,10,13
"653","2020-05-02",85,8,162,302,1976,0.584514170040486,0,0,145,399,18,908,11,372,12,11
"654","2020-05-03",85,8,140,304,1976,0.584514170040486,0,0,145,399,18,926,11,383,9,11
"655","2020-05-04",89,8,148,310,1976,0.584514170040486,0,0,145,399,18,944,13,396,11,13
"656","2020-05-05",82,8,144,309,1976,0.584514170040486,0,0,145,399,23,967,12,408,11,12
"657","2020-05-06",85,8,143,315,1976,0.584514170040486,0,0,145,399,16,983,10,418,5,10
"658","2020-05-07",77,8,153,311,1976,0.584514170040486,0,0,145,399,22,1005,10,428,11,10
"659","2020-05-08",80,8,132,299,1976,0.584514170040486,0,0,145,399,19,1024,10,438,13,10
"660","2020-05-09",78,8,128,295,1976,0.584514170040486,0,0,145,399,25,1049,15,453,11,15
"661","2020-05-10",76,8,151,293,1976,0.584514170040486,0,0,145,399,21,1070,17,470,12,17
"662","2020-05-11",71,8,150,292,1976,0.584514170040486,0,0,145,399,14,1084,12,482,7,12
"663","2020-05-12",74,8,156,289,1976,0.584514170040486,0,0,145,399,21,1105,13,495,8,13
"664","2020-05-13",72,8,168,281,1976,0.584514170040486,0,0,145,399,19,1124,18,513,9,18
"665","2020-05-14",77,8,157,280,1976,0.584514170040486,0,0,145,399,14,1138,14,527,7,14
"666","2020-05-15",77,8,165,273,1976,0.584514170040486,0,0,145,399,20,1158,8,535,6,8
"667","2020-05-16",81,8,165,281,1976,0.584514170040486,0,0,145,399,15,1173,9,544,7,9
"668","2020-05-17",85,8,166,282,1976,0.584514170040486,0,0,145,399,13,1186,7,551,10,7
"669","2020-05-18",82,8,177,268,1976,0.584514170040486,0,0,145,399,15,1201,7,558,6,7
"670","2020-05-19",81,8,188,263,1976,0.584514170040486,0,0,145,399,14,1215,5,563,8,5
"671","2020-05-20",84,8,195,271,1976,0.584514170040486,0,0,145,399,6,1221,4,567,2,4
"672","2020-05-21",83,8,193,262,1976,0.584514170040486,0,0,145,399,17,1238,7,574,11,7
"673","2020-05-22",81,8,198,275,1976,0.584514170040486,0,0,145,399,8,1246,7,581,3,7
"674","2020-05-23",75,8,206,258,1976,0.584514170040486,0,0,145,399,11,1257,10,591,8,10
"675","2020-05-24",68,8,192,257,1976,0.584514170040486,0,0,145,399,13,1270,14,605,7,14
"676","2020-05-25",74,8,195,250,1976,0.584514170040486,0,0,145,399,7,1277,11,616,2,11
"677","2020-05-26",67,8,185,235,1976,0.584514170040486,0,0,145,399,8,1285,5,621,5,5
"678","2020-05-27",67,8,175,230,1976,0.584514170040486,0,0,145,399,9,1294,3,624,7,3
"679","2020-05-28",66,8,163,210,1976,0.584514170040486,0,0,145,399,12,1306,7,631,6,7
"680","2020-05-29",66,8,155,209,1976,0.584514170040486,0,0,145,399,9,1315,4,635,3,4
"681","2020-05-30",64,8,152,199,1976,0.584514170040486,0,0,145,399,6,1321,2,637,2,2
"682","2020-05-31",63,8,157,199,1976,0.584514170040486,0,0,145,399,11,1332,2,639,9,2
"683","2020-06-01",60,8,171,192,1976,0.584514170040486,0,0,145,399,7,1339,3,642,3,3
"684","2020-06-02",61,8,174,180,1976,0.584514170040486,0,0,145,399,12,1351,5,647,8,5
"685","2020-06-03",56,8,172,175,1976,0.584514170040486,0,0,145,399,6,1357,3,650,2,3
"686","2020-06-04",53,8,187,168,1976,0.584514170040486,0,0,145,399,5,1362,3,653,3,3
"687","2020-06-05",48,8,177,159,1976,0.584514170040486,0,0,145,399,15,1377,1,654,9,1
"688","2020-06-06",45,8,182,155,1976,0.584514170040486,0,0,145,399,8,1385,1,655,7,1
"689","2020-06-07",42,8,174,153,1976,0.584514170040486,0,0,145,399,5,1390,NA,NA,3,NA
"690","2020-03-15",1,9,15,12,6763,0.986692296318202,0,0,592,232,4,12,2,19,4,2
"691","2020-03-16",2,9,27,17,6763,0.986692296318202,0,0,592,232,2,14,3,22,1,3
"692","2020-03-17",2,9,32,24,6763,0.986692296318202,0,0,592,232,1,15,1,23,1,1
"693","2020-03-18",2,9,35,33,6763,0.986692296318202,0,0,592,232,4,19,4,27,1,4
"694","2020-03-19",4,9,31,47,6763,0.986692296318202,0,0,592,232,4,23,1,28,2,1
"695","2020-03-20",5,9,43,65,6763,0.986692296318202,0,0,592,232,1,24,1,29,1,1
"696","2020-03-21",5,9,51,88,6763,0.986692296318202,0,0,592,232,4,28,3,32,4,3
"697","2020-03-22",7,9,55,116,6763,0.986692296318202,0,0,592,232,5,33,2,34,2,2
"698","2020-03-23",11,9,43,150,6763,0.986692296318202,0,0,592,232,8,41,12,46,4,12
"699","2020-03-24",17,9,41,163,6763,0.986692296318202,0,0,592,232,7,48,14,60,5,14
"700","2020-03-25",20,9,34,201,6763,0.986692296318202,0,0,592,232,11,59,5,65,7,5
"701","2020-03-26",24,9,28,233,6763,0.986692296318202,0,0,592,232,12,71,5,70,10,5
"702","2020-03-27",33,9,29,295,6763,0.986692296318202,0,0,592,232,13,84,15,85,13,15
"703","2020-03-28",45,9,21,349,6763,0.986692296318202,0,0,592,232,16,100,12,97,15,12
"704","2020-03-29",54,9,17,426,6763,0.986692296318202,0,0,592,232,15,115,14,111,14,14
"705","2020-03-30",74,9,17,502,6763,0.986692296318202,0,0,592,232,17,132,10,121,16,10
"706","2020-03-31",84,9,18,586,6763,0.986692296318202,0,0,592,232,23,155,18,139,21,18
"707","2020-04-01",102,9,23,666,6763,0.986692296318202,0,0,592,232,23,178,12,151,23,12
"708","2020-04-02",119,9,26,767,6763,0.986692296318202,0,0,592,232,24,202,8,159,23,8
"709","2020-04-03",146,9,27,869,6763,0.986692296318202,0,0,592,232,25,227,2,161,21,2
"710","2020-04-04",166,9,34,975,6763,0.986692296318202,0,0,592,232,32,259,15,176,29,15
"711","2020-04-05",189,9,31,1074,6763,0.986692296318202,0,0,592,232,28,287,11,187,27,11
"712","2020-04-06",213,9,33,1198,6763,0.986692296318202,0,0,592,232,27,314,14,201,27,14
"713","2020-04-07",240,9,33,1347,6763,0.986692296318202,0,0,592,232,30,344,18,219,28,18
"714","2020-04-08",270,9,43,1519,6763,0.986692296318202,0,0,592,232,35,379,9,228,32,9
"715","2020-04-09",303,9,59,1611,6763,0.986692296318202,0,0,592,232,38,417,13,241,34,13
"716","2020-04-10",320,9,64,1753,6763,0.986692296318202,0,0,592,232,28,445,14,255,25,14
"717","2020-04-11",353,9,59,1915,6763,0.986692296318202,0,0,592,232,49,494,7,262,47,7
"718","2020-04-12",395,9,63,2027,6763,0.986692296318202,0,0,592,232,41,535,4,266,40,4
"719","2020-04-13",419,9,63,2094,6763,0.986692296318202,0,0,592,232,35,570,4,270,34,4
"720","2020-04-14",459,9,75,2216,6763,0.986692296318202,0,0,592,232,46,616,4,274,45,4
"721","2020-04-15",500,9,68,2328,6763,0.986692296318202,0,0,592,232,46,662,4,278,46,4
"722","2020-04-16",545,9,84,2402,6763,0.986692296318202,0,0,592,232,49,711,6,284,48,6
"723","2020-04-17",598,9,82,2453,6763,0.986692296318202,0,0,592,232,56,767,5,289,54,5
"724","2020-04-18",640,9,80,2529,6763,0.986692296318202,0,0,592,232,38,805,5,294,36,5
"725","2020-04-19",669,9,83,2612,6763,0.986692296318202,0,0,592,232,50,855,7,301,50,7
"726","2020-04-20",719,9,73,2618,6763,0.986692296318202,0,0,592,232,75,930,11,312,72,11
"727","2020-04-21",742,9,64,2578,6763,0.986692296318202,0,0,592,232,62,992,19,331,62,19
"728","2020-04-22",755,9,54,2538,6763,0.986692296318202,0,0,592,232,74,1066,9,340,72,9
"729","2020-04-23",770,9,42,2460,6763,0.986692296318202,0,0,592,232,91,1157,10,350,88,10
"730","2020-04-24",769,9,41,2347,6763,0.986692296318202,0,0,592,232,69,1226,21,371,67,21
"731","2020-04-25",743,9,57,2259,6763,0.986692296318202,0,0,592,232,53,1279,20,391,51,20
"732","2020-04-26",708,9,59,2091,6763,0.986692296318202,0,0,592,232,99,1378,9,400,97,9
"733","2020-04-27",669,9,63,1971,6763,0.986692296318202,0,0,592,232,77,1455,14,414,75,14
"734","2020-04-28",642,9,73,1855,6763,0.986692296318202,0,0,592,232,86,1541,10,424,84,10
"735","2020-04-29",610,9,67,1761,6763,0.986692296318202,0,0,592,232,86,1627,10,434,85,10
"736","2020-04-30",564,9,82,1580,6763,0.986692296318202,0,0,592,232,68,1695,14,448,66,14
"737","2020-05-01",521,9,99,1416,6763,0.986692296318202,0,0,592,232,80,1775,5,453,79,5
"738","2020-05-02",493,9,108,1290,6763,0.986692296318202,0,0,592,232,87,1862,4,457,85,4
"739","2020-05-03",477,9,96,1172,6763,0.986692296318202,0,0,592,232,88,1950,1,458,88,1
"740","2020-05-04",426,9,103,1059,6763,0.986692296318202,0,0,592,232,81,2031,5,463,78,5
"741","2020-05-05",385,9,94,955,6763,0.986692296318202,0,0,592,232,81,2112,4,467,79,4
"742","2020-05-06",355,9,101,864,6763,0.986692296318202,0,0,592,232,73,2185,4,471,70,4
"743","2020-05-07",322,9,97,759,6763,0.986692296318202,0,0,592,232,81,2266,9,480,79,9
"744","2020-05-08",285,9,99,680,6763,0.986692296318202,0,0,592,232,64,2330,2,482,60,2
"745","2020-05-09",263,9,98,596,6763,0.986692296318202,0,0,592,232,59,2389,NA,NA,57,NA
"746","2020-05-10",233,9,84,533,6763,0.986692296318202,0,0,592,232,87,2476,2,484,85,2
"747","2020-05-11",220,9,77,466,6763,0.986692296318202,0,0,592,232,84,2560,2,486,82,2
"748","2020-05-12",200,9,84,415,6763,0.986692296318202,0,0,592,232,73,2633,20,506,71,20
"749","2020-05-13",180,9,83,354,6763,0.986692296318202,0,0,592,232,72,2705,6,512,71,6
"750","2020-05-14",161,9,83,311,6763,0.986692296318202,0,0,592,232,81,2786,16,528,81,16
"751","2020-05-15",143,9,77,264,6763,0.986692296318202,0,0,592,232,57,2843,13,541,57,13
"752","2020-05-16",124,9,72,219,6763,0.986692296318202,0,0,592,232,71,2914,9,550,70,9
"753","2020-05-17",108,9,78,187,6763,0.986692296318202,0,0,592,232,73,2987,8,558,72,8
"754","2020-05-18",96,9,73,156,6763,0.986692296318202,0,0,592,232,54,3041,4,562,54,4
"755","2020-05-19",83,9,75,137,6763,0.986692296318202,0,0,592,232,75,3116,7,569,75,7
"756","2020-05-20",65,9,72,118,6763,0.986692296318202,0,0,592,232,64,3180,14,583,64,14
"757","2020-05-21",51,9,69,102,6763,0.986692296318202,0,0,592,232,77,3257,14,597,76,14
"758","2020-05-22",48,9,68,87,6763,0.986692296318202,0,0,592,232,41,3298,8,605,40,8
"759","2020-05-23",38,9,59,82,6763,0.986692296318202,0,0,592,232,60,3358,8,613,60,8
"760","2020-05-24",34,9,58,65,6763,0.986692296318202,0,0,592,232,53,3411,14,627,52,14
"761","2020-05-25",28,9,60,58,6763,0.986692296318202,0,0,592,232,51,3462,15,642,51,15
"762","2020-05-26",24,9,57,52,6763,0.986692296318202,0,0,592,232,67,3529,5,647,67,5
"763","2020-05-27",21,9,45,48,6763,0.986692296318202,0,0,592,232,48,3577,8,655,46,8
"764","2020-05-28",22,9,35,44,6763,0.986692296318202,0,0,592,232,46,3623,16,671,46,16
"765","2020-05-29",17,9,33,37,6763,0.986692296318202,0,0,592,232,50,3673,16,687,49,16
"766","2020-05-30",16,9,40,31,6763,0.986692296318202,0,0,592,232,29,3702,13,700,29,13
"767","2020-05-31",14,9,42,27,6763,0.986692296318202,0,0,592,232,50,3752,18,718,50,18
"768","2020-06-01",12,9,53,28,6763,0.986692296318202,0,0,592,232,37,3789,9,727,37,9
"769","2020-06-02",13,9,48,22,6763,0.986692296318202,0,0,592,232,39,3828,5,732,39,5
"770","2020-06-03",14,9,53,18,6763,0.986692296318202,0,0,592,232,38,3866,2,734,38,2
"771","2020-06-04",9,9,55,16,6763,0.986692296318202,0,0,592,232,29,3895,5,739,28,5
"772","2020-06-05",10,9,52,12,6763,0.986692296318202,0,0,592,232,30,3925,6,745,29,6
"773","2020-06-06",9,9,48,10,6763,0.986692296318202,0,0,592,232,21,3946,8,753,18,8
"774","2020-06-07",7,9,44,9,6763,0.986692296318202,0,0,592,232,25,3971,8,761,25,8
"775","2020-03-14",1,10,21,8,2849,0.932958932958933,0,0,289,244,4,19,1,12,1,1
"776","2020-03-15",1,10,31,10,2849,0.932958932958933,0,0,289,244,9,28,NA,NA,3,NA
"777","2020-03-16",1,10,35,13,2849,0.932958932958933,0,0,289,244,7,35,6,18,2,6
"778","2020-03-17",2,10,36,22,2849,0.932958932958933,0,0,289,244,20,55,NA,NA,9,NA
"779","2020-03-18",2,10,32,27,2849,0.932958932958933,0,0,289,244,12,67,1,19,5,1
"780","2020-03-19",3,10,39,31,2849,0.932958932958933,0,0,289,244,19,86,7,26,13,7
"781","2020-03-20",3,10,35,41,2849,0.932958932958933,0,0,289,244,10,96,8,34,6,8
"782","2020-03-21",5,10,36,47,2849,0.932958932958933,0,0,289,244,23,119,8,42,16,8
"783","2020-03-22",6,10,31,59,2849,0.932958932958933,0,0,289,244,14,133,6,48,10,6
"784","2020-03-23",8,10,29,68,2849,0.932958932958933,0,0,289,244,13,146,9,57,11,9
"785","2020-03-24",9,10,27,76,2849,0.932958932958933,0,0,289,244,22,168,8,65,13,8
"786","2020-03-25",11,10,19,86,2849,0.932958932958933,0,0,289,244,21,189,5,70,14,5
"787","2020-03-26",11,10,17,100,2849,0.932958932958933,0,0,289,244,23,212,14,84,16,14
"788","2020-03-27",20,10,21,115,2849,0.932958932958933,0,0,289,244,29,241,8,92,22,8
"789","2020-03-28",19,10,14,131,2849,0.932958932958933,0,0,289,244,29,270,3,95,18,3
"790","2020-03-29",21,10,16,136,2849,0.932958932958933,0,0,289,244,34,304,11,106,25,11
"791","2020-03-30",24,10,13,153,2849,0.932958932958933,0,0,289,244,19,323,8,114,16,8
"792","2020-03-31",27,10,29,163,2849,0.932958932958933,0,0,289,244,31,354,9,123,26,9
"793","2020-04-01",26,10,26,179,2849,0.932958932958933,0,0,289,244,37,391,9,132,29,9
"794","2020-04-02",31,10,28,176,2849,0.932958932958933,0,0,289,244,36,427,9,141,31,9
"795","2020-04-03",27,10,32,180,2849,0.932958932958933,0,0,289,244,46,473,7,148,36,7
"796","2020-04-04",28,10,36,189,2849,0.932958932958933,0,0,289,244,42,515,8,156,38,8
"797","2020-04-05",34,10,41,205,2849,0.932958932958933,0,0,289,244,39,554,8,164,33,8
"798","2020-04-06",38,10,40,223,2849,0.932958932958933,0,0,289,244,47,601,16,180,39,16
"799","2020-04-07",46,10,35,245,2849,0.932958932958933,0,0,289,244,40,641,9,189,33,9
"800","2020-04-08",60,10,36,252,2849,0.932958932958933,0,0,289,244,52,693,8,197,45,8
"801","2020-04-09",61,10,32,259,2849,0.932958932958933,0,0,289,244,41,734,6,203,37,6
"802","2020-04-10",64,10,26,288,2849,0.932958932958933,0,0,289,244,51,785,6,209,45,6
"803","2020-04-11",76,10,35,314,2849,0.932958932958933,0,0,289,244,50,835,10,219,41,10
"804","2020-04-12",80,10,31,344,2849,0.932958932958933,0,0,289,244,46,881,9,228,40,9
"805","2020-04-13",87,10,32,364,2849,0.932958932958933,0,0,289,244,47,928,19,247,35,19
"806","2020-04-14",85,10,53,374,2849,0.932958932958933,0,0,289,244,52,980,13,260,44,13
"807","2020-04-15",83,10,51,403,2849,0.932958932958933,0,0,289,244,52,1032,10,270,38,10
"808","2020-04-16",92,10,47,423,2849,0.932958932958933,0,0,289,244,40,1072,6,276,33,6
"809","2020-04-17",103,10,58,445,2849,0.932958932958933,0,0,289,244,38,1110,9,285,35,9
"810","2020-04-18",102,10,64,449,2849,0.932958932958933,0,0,289,244,50,1160,8,293,47,8
"811","2020-04-19",106,10,58,473,2849,0.932958932958933,0,0,289,244,53,1213,12,305,49,12
"812","2020-04-20",113,10,53,494,2849,0.932958932958933,0,0,289,244,48,1261,16,321,37,16
"813","2020-04-21",123,10,54,509,2849,0.932958932958933,0,0,289,244,43,1304,5,326,41,5
"814","2020-04-22",131,10,73,520,2849,0.932958932958933,0,0,289,244,56,1360,17,343,51,17
"815","2020-04-23",129,10,67,506,2849,0.932958932958933,0,0,289,244,70,1430,10,353,59,10
"816","2020-04-24",140,10,59,537,2849,0.932958932958933,0,0,289,244,46,1476,9,362,42,9
"817","2020-04-25",144,10,54,556,2849,0.932958932958933,0,0,289,244,54,1530,5,367,49,5
"818","2020-04-26",147,10,54,568,2849,0.932958932958933,0,0,289,244,46,1576,6,373,44,6
"819","2020-04-27",146,10,61,566,2849,0.932958932958933,0,0,289,244,50,1626,22,395,46,22
"820","2020-04-28",167,10,65,562,2849,0.932958932958933,0,0,289,244,29,1655,8,403,25,8
"821","2020-04-29",170,10,84,578,2849,0.932958932958933,0,0,289,244,45,1700,7,410,42,7
"822","2020-04-30",179,10,95,586,2849,0.932958932958933,0,0,289,244,32,1732,10,420,26,10
"823","2020-05-01",176,10,90,590,2849,0.932958932958933,0,0,289,244,27,1759,3,423,22,3
"824","2020-05-02",179,10,85,600,2849,0.932958932958933,0,0,289,244,45,1804,10,433,40,10
"825","2020-05-03",185,10,69,615,2849,0.932958932958933,0,0,289,244,32,1836,20,453,26,20
"826","2020-05-04",186,10,81,606,2849,0.932958932958933,0,0,289,244,45,1881,7,460,40,7
"827","2020-05-05",163,10,77,625,2849,0.932958932958933,0,0,289,244,34,1915,7,467,26,7
"828","2020-05-06",162,10,72,612,2849,0.932958932958933,0,0,289,244,29,1944,12,479,26,12
"829","2020-05-07",164,10,73,622,2849,0.932958932958933,0,0,289,244,34,1978,7,486,28,7
"830","2020-05-08",172,10,72,612,2849,0.932958932958933,0,0,289,244,34,2012,11,497,28,11
"831","2020-05-09",185,10,57,606,2849,0.932958932958933,0,0,289,244,39,2051,8,505,34,8
"832","2020-05-10",182,10,73,577,2849,0.932958932958933,0,0,289,244,33,2084,7,512,27,7
"833","2020-05-11",179,10,75,574,2849,0.932958932958933,0,0,289,244,34,2118,5,517,27,5
"834","2020-05-12",182,10,71,566,2849,0.932958932958933,0,0,289,244,27,2145,9,526,21,9
"835","2020-05-13",184,10,72,549,2849,0.932958932958933,0,0,289,244,18,2163,11,537,13,11
"836","2020-05-14",178,10,67,522,2849,0.932958932958933,0,0,289,244,35,2198,6,543,31,6
"837","2020-05-15",169,10,69,494,2849,0.932958932958933,0,0,289,244,31,2229,9,552,28,9
"838","2020-05-16",153,10,67,506,2849,0.932958932958933,0,0,289,244,36,2265,7,559,27,7
"839","2020-05-17",151,10,66,505,2849,0.932958932958933,0,0,289,244,30,2295,8,567,26,8
"840","2020-05-18",149,10,67,481,2849,0.932958932958933,0,0,289,244,14,2309,3,570,11,3
"841","2020-05-19",143,10,75,477,2849,0.932958932958933,0,0,289,244,20,2329,2,572,13,2
"842","2020-05-20",135,10,60,466,2849,0.932958932958933,0,0,289,244,22,2351,2,574,20,2
"843","2020-05-21",130,10,61,449,2849,0.932958932958933,0,0,289,244,29,2380,2,576,26,2
"844","2020-05-22",113,10,57,429,2849,0.932958932958933,0,0,289,244,24,2404,4,580,19,4
"845","2020-05-23",119,10,56,414,2849,0.932958932958933,0,0,289,244,31,2435,2,582,27,2
"846","2020-05-24",110,10,62,393,2849,0.932958932958933,0,0,289,244,22,2457,6,588,16,6
"847","2020-05-25",111,10,63,373,2849,0.932958932958933,0,0,289,244,21,2478,7,595,15,7
"848","2020-05-26",107,10,71,356,2849,0.932958932958933,0,0,289,244,15,2493,10,605,12,10
"849","2020-05-27",105,10,66,332,2849,0.932958932958933,0,0,289,244,27,2520,4,609,22,4
"850","2020-05-28",107,10,70,311,2849,0.932958932958933,0,0,289,244,16,2536,1,610,15,1
"851","2020-05-29",111,10,75,289,2849,0.932958932958933,0,0,289,244,24,2560,2,612,24,2
"852","2020-05-30",103,10,64,276,2849,0.932958932958933,0,0,289,244,24,2584,10,622,23,10
"853","2020-05-31",105,10,58,256,2849,0.932958932958933,0,0,289,244,18,2602,9,631,17,9
"854","2020-06-01",98,10,55,244,2849,0.932958932958933,0,0,289,244,34,2636,7,638,32,7
"855","2020-06-02",94,10,45,234,2849,0.932958932958933,0,0,289,244,17,2653,1,639,13,1
"856","2020-06-03",83,10,39,218,2849,0.932958932958933,0,0,289,244,25,2678,4,643,22,4
"857","2020-06-04",73,10,35,208,2849,0.932958932958933,0,0,289,244,13,2691,3,646,11,3
"858","2020-06-05",72,10,32,206,2849,0.932958932958933,0,0,289,244,10,2701,2,648,9,2
"859","2020-06-06",64,10,32,194,2849,0.932958932958933,0,0,289,244,16,2717,2,650,13,2
"860","2020-06-07",59,10,32,187,2849,0.932958932958933,0,0,289,244,16,2733,1,651,15,1
"861","2020-03-16",2,11,35,40,3278,0.780658938377059,0,0,295,178,14,77,17,73,7,17
"862","2020-03-17",4,11,39,59,3278,0.780658938377059,0,0,295,178,20,97,17,90,9,17
"863","2020-03-18",4,11,38,67,3278,0.780658938377059,0,0,295,178,20,117,22,112,9,22
"864","2020-03-19",7,11,37,76,3278,0.780658938377059,0,0,295,178,24,141,15,127,13,15
"865","2020-03-20",11,11,33,90,3278,0.780658938377059,0,0,295,178,18,159,16,143,10,16
"866","2020-03-21",17,11,30,105,3278,0.780658938377059,0,0,295,178,18,177,22,165,7,22
"867","2020-03-22",23,11,36,125,3278,0.780658938377059,0,0,295,178,20,197,25,190,9,25
"868","2020-03-23",29,11,35,153,3278,0.780658938377059,0,0,295,178,25,222,21,211,19,21
"869","2020-03-24",38,11,46,164,3278,0.780658938377059,0,0,295,178,29,251,17,228,17,17
"870","2020-03-25",40,11,45,176,3278,0.780658938377059,0,0,295,178,20,271,11,239,10,11
"871","2020-03-26",44,11,51,191,3278,0.780658938377059,0,0,295,178,22,293,18,257,11,18
"872","2020-03-27",49,11,55,221,3278,0.780658938377059,0,0,295,178,34,327,20,277,20,20
"873","2020-03-28",57,11,63,235,3278,0.780658938377059,0,0,295,178,33,360,28,305,22,28
"874","2020-03-29",60,11,56,254,3278,0.780658938377059,0,0,295,178,29,389,31,336,12,31
"875","2020-03-30",57,11,47,266,3278,0.780658938377059,0,0,295,178,30,419,34,370,15,34
"876","2020-03-31",53,11,48,281,3278,0.780658938377059,0,0,295,178,30,449,45,415,21,45
"877","2020-04-01",64,11,43,302,3278,0.780658938377059,0,0,295,178,38,487,21,436,26,21
"878","2020-04-02",68,11,41,311,3278,0.780658938377059,0,0,295,178,28,515,33,469,14,33
"879","2020-04-03",76,11,41,335,3278,0.780658938377059,0,0,295,178,32,547,31,500,22,31
"880","2020-04-04",76,11,42,352,3278,0.780658938377059,0,0,295,178,40,587,31,531,23,31
"881","2020-04-05",80,11,34,364,3278,0.780658938377059,0,0,295,178,40,627,20,551,28,20
"882","2020-04-06",86,11,33,383,3278,0.780658938377059,0,0,295,178,28,655,18,569,16,18
"883","2020-04-07",90,11,45,393,3278,0.780658938377059,0,0,295,178,27,682,24,593,18,24
"884","2020-04-08",89,11,37,417,3278,0.780658938377059,0,0,295,178,33,715,33,626,20,33
"885","2020-04-09",94,11,37,436,3278,0.780658938377059,0,0,295,178,31,746,40,666,19,40
"886","2020-04-10",98,11,39,441,3278,0.780658938377059,0,0,295,178,26,772,17,683,16,17
"887","2020-04-11",97,11,47,459,3278,0.780658938377059,0,0,295,178,45,817,31,714,25,31
"888","2020-04-12",104,11,40,503,3278,0.780658938377059,0,0,295,178,36,853,27,741,24,27
"889","2020-04-13",108,11,48,553,3278,0.780658938377059,0,0,295,178,40,893,36,777,25,36
"890","2020-04-14",121,11,43,560,3278,0.780658938377059,0,0,295,178,39,932,24,801,31,24
"891","2020-04-15",128,11,26,574,3278,0.780658938377059,0,0,295,178,34,966,33,834,22,33
"892","2020-04-16",130,11,29,591,3278,0.780658938377059,0,0,295,178,54,1020,21,855,37,21
"893","2020-04-17",133,11,41,589,3278,0.780658938377059,0,0,295,178,44,1064,34,889,32,34
"894","2020-04-18",145,11,42,646,3278,0.780658938377059,0,0,295,178,30,1094,29,918,19,29
"895","2020-04-19",155,11,44,663,3278,0.780658938377059,0,0,295,178,32,1126,26,944,25,26
"896","2020-04-20",163,11,65,679,3278,0.780658938377059,0,0,295,178,49,1175,18,962,27,18
"897","2020-04-21",164,11,78,681,3278,0.780658938377059,0,0,295,178,43,1218,27,989,27,27
"898","2020-04-22",182,11,84,725,3278,0.780658938377059,0,0,295,178,43,1261,31,1020,26,31
"899","2020-04-23",196,11,76,740,3278,0.780658938377059,0,0,295,178,28,1289,22,1042,20,22
"900","2020-04-24",206,11,75,737,3278,0.780658938377059,0,0,295,178,48,1337,28,1070,32,28
"901","2020-04-25",210,11,85,745,3278,0.780658938377059,0,0,295,178,35,1372,29,1099,23,29
"902","2020-04-26",205,11,92,723,3278,0.780658938377059,0,0,295,178,24,1396,11,1110,16,11
"903","2020-04-27",213,11,79,707,3278,0.780658938377059,0,0,295,178,36,1432,18,1128,21,18
"904","2020-04-28",206,11,70,704,3278,0.780658938377059,0,0,295,178,37,1469,30,1158,27,30
"905","2020-04-29",197,11,75,695,3278,0.780658938377059,0,0,295,178,30,1499,29,1187,19,29
"906","2020-04-30",195,11,68,667,3278,0.780658938377059,0,0,295,178,39,1538,25,1212,26,25
"907","2020-05-01",195,11,61,641,3278,0.780658938377059,0,0,295,178,40,1578,34,1246,22,34
"908","2020-05-02",194,11,64,606,3278,0.780658938377059,0,0,295,178,26,1604,46,1292,16,46
"909","2020-05-03",189,11,80,592,3278,0.780658938377059,0,0,295,178,35,1639,32,1324,17,32
"910","2020-05-04",189,11,71,569,3278,0.780658938377059,0,0,295,178,32,1671,50,1374,19,50
"911","2020-05-05",193,11,80,550,3278,0.780658938377059,0,0,295,178,36,1707,32,1406,21,32
"912","2020-05-06",185,11,79,536,3278,0.780658938377059,0,0,295,178,36,1743,45,1451,21,45
"913","2020-05-07",177,11,75,520,3278,0.780658938377059,0,0,295,178,36,1779,38,1489,25,38
"914","2020-05-08",170,11,72,491,3278,0.780658938377059,0,0,295,178,30,1809,56,1545,18,56
"915","2020-05-09",158,11,67,485,3278,0.780658938377059,0,0,295,178,24,1833,51,1596,15,51
"916","2020-05-10",159,11,75,468,3278,0.780658938377059,0,0,295,178,31,1864,35,1631,18,35
"917","2020-05-11",142,11,67,450,3278,0.780658938377059,0,0,295,178,38,1902,40,1671,26,40
"918","2020-05-12",136,11,53,431,3278,0.780658938377059,0,0,295,178,27,1929,48,1719,22,48
"919","2020-05-13",129,11,63,423,3278,0.780658938377059,0,0,295,178,29,1958,35,1754,18,35
"920","2020-05-14",122,11,67,417,3278,0.780658938377059,0,0,295,178,26,1984,42,1796,17,42
"921","2020-05-15",111,11,61,393,3278,0.780658938377059,0,0,295,178,22,2006,43,1839,10,43
"922","2020-05-16",116,11,62,372,3278,0.780658938377059,0,0,295,178,18,2024,34,1873,11,34
"923","2020-05-17",109,11,56,354,3278,0.780658938377059,0,0,295,178,21,2045,30,1903,14,30
"924","2020-05-18",108,11,51,341,3278,0.780658938377059,0,0,295,178,24,2069,44,1947,17,44
"925","2020-05-19",114,11,50,313,3278,0.780658938377059,0,0,295,178,30,2099,38,1985,19,38
"926","2020-05-20",112,11,53,293,3278,0.780658938377059,0,0,295,178,19,2118,42,2027,13,42
"927","2020-05-21",108,11,50,296,3278,0.780658938377059,0,0,295,178,27,2145,38,2065,16,38
"928","2020-05-22",101,11,49,287,3278,0.780658938377059,0,0,295,178,25,2170,35,2100,15,35
"929","2020-05-23",96,11,39,287,3278,0.780658938377059,0,0,295,178,19,2189,21,2121,11,21
"930","2020-05-24",91,11,51,285,3278,0.780658938377059,0,0,295,178,23,2212,23,2144,17,23
"931","2020-05-25",87,11,60,272,3278,0.780658938377059,0,0,295,178,14,2226,36,2180,10,36
"932","2020-05-26",79,11,64,278,3278,0.780658938377059,0,0,295,178,17,2243,26,2206,12,26
"933","2020-05-27",81,11,66,279,3278,0.780658938377059,0,0,295,178,16,2259,22,2228,8,22
"934","2020-05-28",81,11,60,275,3278,0.780658938377059,0,0,295,178,18,2277,43,2271,15,43
"935","2020-05-29",79,11,47,285,3278,0.780658938377059,0,0,295,178,13,2290,37,2308,7,37
"936","2020-05-30",70,11,49,281,3278,0.780658938377059,0,0,295,178,15,2305,27,2335,6,27
"937","2020-05-31",78,11,52,275,3278,0.780658938377059,0,0,295,178,21,2326,28,2363,10,28
"938","2020-06-01",85,11,43,271,3278,0.780658938377059,0,0,295,178,22,2348,34,2397,15,34
"939","2020-06-02",85,11,46,272,3278,0.780658938377059,0,0,295,178,16,2364,24,2421,9,24
"940","2020-06-03",83,11,39,278,3278,0.780658938377059,0,0,295,178,10,2374,38,2459,8,38
"941","2020-06-04",91,11,36,278,3278,0.780658938377059,0,0,295,178,10,2384,32,2491,7,32
"942","2020-06-05",97,11,34,276,3278,0.780658938377059,0,0,295,178,17,2401,31,2522,11,31
"943","2020-06-06",107,11,35,273,3278,0.780658938377059,0,0,295,178,8,2409,30,2552,5,30
"944","2020-06-07",104,11,34,266,3278,0.780658938377059,0,0,295,178,4,2413,30,2582,4,30
"945","2020-03-14",1,12,12,33,1862,0.515574650912997,0,0,182,211,9,24,NA,NA,2,NA
"946","2020-03-15",2,12,15,45,1862,0.515574650912997,0,0,182,211,7,31,8,20,2,8
"947","2020-03-16",4,12,14,58,1862,0.515574650912997,0,0,182,211,9,40,6,26,5,6
"948","2020-03-17",4,12,15,76,1862,0.515574650912997,0,0,182,211,11,51,7,33,8,7
"949","2020-03-18",8,12,26,91,1862,0.515574650912997,0,0,182,211,11,62,5,38,6,5
"950","2020-03-19",10,12,27,98,1862,0.515574650912997,0,0,182,211,11,73,8,46,8,8
"951","2020-03-20",13,12,24,113,1862,0.515574650912997,0,0,182,211,13,86,7,53,9,7
"952","2020-03-21",17,12,27,128,1862,0.515574650912997,0,0,182,211,17,103,8,61,10,8
"953","2020-03-22",21,12,30,151,1862,0.515574650912997,0,0,182,211,20,123,1,62,18,1
"954","2020-03-23",26,12,34,169,1862,0.515574650912997,0,0,182,211,28,151,2,64,22,2
"955","2020-03-24",31,12,26,181,1862,0.515574650912997,0,0,182,211,14,165,NA,NA,14,NA
"956","2020-03-25",32,12,29,200,1862,0.515574650912997,0,0,182,211,23,188,4,68,21,4
"957","2020-03-26",39,12,34,207,1862,0.515574650912997,0,0,182,211,21,209,11,79,19,11
"958","2020-03-27",44,12,43,221,1862,0.515574650912997,0,0,182,211,17,226,4,83,14,4
"959","2020-03-28",51,12,43,227,1862,0.515574650912997,0,0,182,211,30,256,7,90,24,7
"960","2020-03-29",53,12,41,227,1862,0.515574650912997,0,0,182,211,26,282,7,97,23,7
"961","2020-03-30",52,12,32,232,1862,0.515574650912997,0,0,182,211,32,314,4,101,28,4
"962","2020-03-31",57,12,33,230,1862,0.515574650912997,0,0,182,211,23,337,9,110,16,9
"963","2020-04-01",61,12,37,233,1862,0.515574650912997,0,0,182,211,31,368,11,121,28,11
"964","2020-04-02",56,12,46,239,1862,0.515574650912997,0,0,182,211,23,391,8,129,21,8
"965","2020-04-03",64,12,42,240,1862,0.515574650912997,0,0,182,211,31,422,6,135,26,6
"966","2020-04-04",61,12,51,231,1862,0.515574650912997,0,0,182,211,36,458,3,138,28,3
"967","2020-04-05",64,12,58,232,1862,0.515574650912997,0,0,182,211,44,502,1,139,37,1
"968","2020-04-06",74,12,54,236,1862,0.515574650912997,0,0,182,211,39,541,7,146,32,7
"969","2020-04-07",75,12,61,237,1862,0.515574650912997,0,0,182,211,32,573,10,156,23,10
"970","2020-04-08",70,12,64,224,1862,0.515574650912997,0,0,182,211,37,610,14,170,32,14
"971","2020-04-09",78,12,73,234,1862,0.515574650912997,0,0,182,211,46,656,9,179,39,9
"972","2020-04-10",72,12,87,239,1862,0.515574650912997,0,0,182,211,35,691,8,187,27,8
"973","2020-04-11",72,12,92,243,1862,0.515574650912997,0,0,182,211,36,727,7,194,32,7
"974","2020-04-12",75,12,102,236,1862,0.515574650912997,0,0,182,211,37,764,6,200,31,6
"975","2020-04-13",69,12,98,233,1862,0.515574650912997,0,0,182,211,42,806,4,204,35,4
"976","2020-04-14",71,12,99,237,1862,0.515574650912997,0,0,182,211,32,838,4,208,27,4
"977","2020-04-15",77,12,103,245,1862,0.515574650912997,0,0,182,211,43,881,3,211,38,3
"978","2020-04-16",74,12,101,247,1862,0.515574650912997,0,0,182,211,42,923,11,222,38,11
"979","2020-04-17",75,12,97,243,1862,0.515574650912997,0,0,182,211,35,958,10,232,32,10
"980","2020-04-18",72,12,89,247,1862,0.515574650912997,0,0,182,211,44,1002,13,245,41,13
"981","2020-04-19",71,12,85,254,1862,0.515574650912997,0,0,182,211,33,1035,7,252,27,7
"982","2020-04-20",72,12,87,244,1862,0.515574650912997,0,0,182,211,50,1085,1,253,42,1
"983","2020-04-21",71,12,79,249,1862,0.515574650912997,0,0,182,211,46,1131,1,254,41,1
"984","2020-04-22",70,12,84,252,1862,0.515574650912997,0,0,182,211,41,1172,12,266,35,12
"985","2020-04-23",72,12,93,247,1862,0.515574650912997,0,0,182,211,44,1216,14,280,38,14
"986","2020-04-24",70,12,86,255,1862,0.515574650912997,0,0,182,211,36,1252,13,293,27,13
"987","2020-04-25",68,12,82,268,1862,0.515574650912997,0,0,182,211,44,1296,17,310,36,17
"988","2020-04-26",73,12,80,284,1862,0.515574650912997,0,0,182,211,41,1337,23,333,34,23
"989","2020-04-27",70,12,77,291,1862,0.515574650912997,0,0,182,211,44,1381,11,344,41,11
"990","2020-04-28",71,12,79,299,1862,0.515574650912997,0,0,182,211,37,1418,6,350,35,6
"991","2020-04-29",79,12,71,305,1862,0.515574650912997,0,0,182,211,27,1445,10,360,21,10
"992","2020-04-30",79,12,73,298,1862,0.515574650912997,0,0,182,211,45,1490,12,372,40,12
"993","2020-05-01",79,12,76,298,1862,0.515574650912997,0,0,182,211,47,1537,12,384,37,12
"994","2020-05-02",89,12,80,305,1862,0.515574650912997,0,0,182,211,35,1572,8,392,33,8
"995","2020-05-03",88,12,78,296,1862,0.515574650912997,0,0,182,211,35,1607,5,397,27,5
"996","2020-05-04",90,12,74,310,1862,0.515574650912997,0,0,182,211,38,1645,13,410,32,13
"997","2020-05-05",81,12,82,318,1862,0.515574650912997,0,0,182,211,46,1691,11,421,41,11
"998","2020-05-06",73,12,91,307,1862,0.515574650912997,0,0,182,211,41,1732,9,430,37,9
"999","2020-05-07",75,12,99,312,1862,0.515574650912997,0,0,182,211,27,1759,11,441,21,11
"1000","2020-05-08",74,12,90,296,1862,0.515574650912997,0,0,182,211,44,1803,11,452,39,11
"1001","2020-05-09",73,12,91,284,1862,0.515574650912997,0,0,182,211,31,1834,18,470,25,18
"1002","2020-05-10",69,12,108,281,1862,0.515574650912997,0,0,182,211,32,1866,5,475,25,5
"1003","2020-05-11",75,12,111,274,1862,0.515574650912997,0,0,182,211,43,1909,2,477,39,2
"1004","2020-05-12",79,12,102,272,1862,0.515574650912997,0,0,182,211,34,1943,4,481,31,4
"1005","2020-05-13",81,12,96,256,1862,0.515574650912997,0,0,182,211,30,1973,2,483,28,2
"1006","2020-05-14",76,12,96,259,1862,0.515574650912997,0,0,182,211,19,1992,NA,NA,17,NA
"1007","2020-05-15",76,12,102,263,1862,0.515574650912997,0,0,182,211,30,2022,3,486,25,3
"1008","2020-05-16",75,12,86,260,1862,0.515574650912997,0,0,182,211,38,2060,1,487,36,1
"1009","2020-05-17",72,12,76,259,1862,0.515574650912997,0,0,182,211,35,2095,10,497,28,10
"1010","2020-05-18",69,12,77,257,1862,0.515574650912997,0,0,182,211,17,2112,8,505,15,8
"1011","2020-05-19",73,12,80,252,1862,0.515574650912997,0,0,182,211,25,2137,7,512,24,7
"1012","2020-05-20",73,12,73,253,1862,0.515574650912997,0,0,182,211,35,2172,6,518,31,6
"1013","2020-05-21",82,12,72,238,1862,0.515574650912997,0,0,182,211,26,2198,5,523,24,5
"1014","2020-05-22",86,12,75,232,1862,0.515574650912997,0,0,182,211,41,2239,6,529,37,6
"1015","2020-05-23",84,12,79,235,1862,0.515574650912997,0,0,182,211,25,2264,17,546,19,17
"1016","2020-05-24",84,12,76,221,1862,0.515574650912997,0,0,182,211,18,2282,13,559,15,13
"1017","2020-05-25",79,12,88,214,1862,0.515574650912997,0,0,182,211,27,2309,6,565,20,6
"1018","2020-05-26",78,12,80,208,1862,0.515574650912997,0,0,182,211,27,2336,6,571,24,6
"1019","2020-05-27",79,12,79,210,1862,0.515574650912997,0,0,182,211,28,2364,9,580,20,9
"1020","2020-05-28",68,12,72,205,1862,0.515574650912997,0,0,182,211,31,2395,10,590,30,10
"1021","2020-05-29",65,12,65,200,1862,0.515574650912997,0,0,182,211,23,2418,5,595,19,5
"1022","2020-05-30",63,12,59,187,1862,0.515574650912997,0,0,182,211,21,2439,11,606,18,11
"1023","2020-05-31",63,12,55,178,1862,0.515574650912997,0,0,182,211,31,2470,20,626,26,20
"1024","2020-06-01",65,12,56,167,1862,0.515574650912997,0,0,182,211,20,2490,6,632,20,6
"1025","2020-06-02",58,12,61,157,1862,0.515574650912997,0,0,182,211,14,2504,10,642,12,10
"1026","2020-06-03",53,12,61,150,1862,0.515574650912997,0,0,182,211,16,2520,11,653,15,11
"1027","2020-06-04",49,12,59,146,1862,0.515574650912997,0,0,182,211,24,2544,15,668,23,15
"1028","2020-06-05",44,12,54,141,1862,0.515574650912997,0,0,182,211,14,2558,12,680,14,12
"1029","2020-06-06",44,12,57,139,1862,0.515574650912997,0,0,182,211,19,2577,6,686,16,6
"1030","2020-06-07",43,12,55,124,1862,0.515574650912997,0,0,182,211,21,2598,13,699,18,13
"1031","2020-03-17",1,13,27,30,2030,0.877339901477832,0,0,169,212,21,57,1,14,6,1
"1032","2020-03-18",2,13,26,37,2030,0.877339901477832,0,0,169,212,16,73,4,18,8,4
"1033","2020-03-19",2,13,24,42,2030,0.877339901477832,0,0,169,212,13,86,2,20,5,2
"1034","2020-03-20",3,13,30,48,2030,0.877339901477832,0,0,169,212,22,108,6,26,14,6
"1035","2020-03-21",6,13,33,57,2030,0.877339901477832,0,0,169,212,18,126,11,37,10,11
"1036","2020-03-22",9,13,32,67,2030,0.877339901477832,0,0,169,212,16,142,8,45,13,8
"1037","2020-03-23",11,13,37,76,2030,0.877339901477832,0,0,169,212,26,168,5,50,17,5
"1038","2020-03-24",13,13,46,84,2030,0.877339901477832,0,0,169,212,19,187,2,52,13,2
"1039","2020-03-25",16,13,50,86,2030,0.877339901477832,0,0,169,212,19,206,6,58,12,6
"1040","2020-03-26",17,13,43,92,2030,0.877339901477832,0,0,169,212,25,231,3,61,17,3
"1041","2020-03-27",19,13,38,101,2030,0.877339901477832,0,0,169,212,24,255,7,68,20,7
"1042","2020-03-28",20,13,35,108,2030,0.877339901477832,0,0,169,212,30,285,1,69,23,1
"1043","2020-03-29",18,13,38,114,2030,0.877339901477832,0,0,169,212,26,311,6,75,24,6
"1044","2020-03-30",21,13,44,121,2030,0.877339901477832,0,0,169,212,27,338,4,79,20,4
"1045","2020-03-31",20,13,48,129,2030,0.877339901477832,0,0,169,212,26,364,3,82,23,3
"1046","2020-04-01",25,13,49,133,2030,0.877339901477832,0,0,169,212,33,397,4,86,21,4
"1047","2020-04-02",35,13,43,134,2030,0.877339901477832,0,0,169,212,40,437,6,92,33,6
"1048","2020-04-03",38,13,47,148,2030,0.877339901477832,0,0,169,212,38,475,5,97,33,5
"1049","2020-04-04",42,13,37,150,2030,0.877339901477832,0,0,169,212,41,516,5,102,30,5
"1050","2020-04-05",47,13,46,158,2030,0.877339901477832,0,0,169,212,44,560,12,114,36,12
"1051","2020-04-06",50,13,47,171,2030,0.877339901477832,0,0,169,212,29,589,12,126,24,12
"1052","2020-04-07",58,13,54,182,2030,0.877339901477832,0,0,169,212,40,629,13,139,27,13
"1053","2020-04-08",59,13,56,193,2030,0.877339901477832,0,0,169,212,30,659,11,150,22,11
"1054","2020-04-09",52,13,60,195,2030,0.877339901477832,0,0,169,212,32,691,13,163,26,13
"1055","2020-04-10",47,13,62,202,2030,0.877339901477832,0,0,169,212,31,722,12,175,19,12
"1056","2020-04-11",45,13,57,209,2030,0.877339901477832,0,0,169,212,15,737,13,188,15,13
"1057","2020-04-12",56,13,64,213,2030,0.877339901477832,0,0,169,212,22,759,7,195,17,7
"1058","2020-04-13",54,13,59,223,2030,0.877339901477832,0,0,169,212,30,789,8,203,22,8
"1059","2020-04-14",55,13,51,232,2030,0.877339901477832,0,0,169,212,27,816,8,211,20,8
"1060","2020-04-15",52,13,40,251,2030,0.877339901477832,0,0,169,212,25,841,10,221,11,10
"1061","2020-04-16",55,13,43,265,2030,0.877339901477832,0,0,169,212,32,873,10,231,27,10
"1062","2020-04-17",66,13,47,279,2030,0.877339901477832,0,0,169,212,27,900,11,242,20,11
"1063","2020-04-18",73,13,56,294,2030,0.877339901477832,0,0,169,212,24,924,7,249,11,7
"1064","2020-04-19",64,13,53,319,2030,0.877339901477832,0,0,169,212,29,953,9,258,23,9
"1065","2020-04-20",70,13,52,332,2030,0.877339901477832,0,0,169,212,23,976,5,263,13,5
"1066","2020-04-21",71,13,66,341,2030,0.877339901477832,0,0,169,212,39,1015,5,268,27,5
"1067","2020-04-22",72,13,63,330,2030,0.877339901477832,0,0,169,212,22,1037,5,273,13,5
"1068","2020-04-23",85,13,63,342,2030,0.877339901477832,0,0,169,212,41,1078,7,280,30,7
"1069","2020-04-24",82,13,60,337,2030,0.877339901477832,0,0,169,212,43,1121,4,284,32,4
"1070","2020-04-25",83,13,65,361,2030,0.877339901477832,0,0,169,212,54,1175,4,288,39,4
"1071","2020-04-26",88,13,72,351,2030,0.877339901477832,0,0,169,212,36,1211,3,291,24,3
"1072","2020-04-27",94,13,75,352,2030,0.877339901477832,0,0,169,212,35,1246,9,300,27,9
"1073","2020-04-28",102,13,73,355,2030,0.877339901477832,0,0,169,212,24,1270,4,304,20,4
"1074","2020-04-29",107,13,82,357,2030,0.877339901477832,0,0,169,212,56,1326,9,313,42,9
"1075","2020-04-30",106,13,83,361,2030,0.877339901477832,0,0,169,212,52,1378,10,323,42,10
"1076","2020-05-01",112,13,89,353,2030,0.877339901477832,0,0,169,212,37,1415,4,327,32,4
"1077","2020-05-02",110,13,91,362,2030,0.877339901477832,0,0,169,212,41,1456,17,344,27,17
"1078","2020-05-03",107,13,90,352,2030,0.877339901477832,0,0,169,212,48,1504,5,349,36,5
"1079","2020-05-04",103,13,93,357,2030,0.877339901477832,0,0,169,212,40,1544,11,360,29,11
"1080","2020-05-05",99,13,106,355,2030,0.877339901477832,0,0,169,212,38,1582,1,361,27,1
"1081","2020-05-06",99,13,123,360,2030,0.877339901477832,0,0,169,212,32,1614,5,366,26,5
"1082","2020-05-07",104,13,130,362,2030,0.877339901477832,0,0,169,212,28,1642,19,385,24,19
"1083","2020-05-08",101,13,129,348,2030,0.877339901477832,0,0,169,212,37,1679,10,395,30,10
"1084","2020-05-09",100,13,120,343,2030,0.877339901477832,0,0,169,212,28,1707,9,404,23,9
"1085","2020-05-10",101,13,111,333,2030,0.877339901477832,0,0,169,212,24,1731,7,411,20,7
"1086","2020-05-11",105,13,108,343,2030,0.877339901477832,0,0,169,212,33,1764,8,419,24,8
"1087","2020-05-12",103,13,120,339,2030,0.877339901477832,0,0,169,212,31,1795,6,425,22,6
"1088","2020-05-13",100,13,115,342,2030,0.877339901477832,0,0,169,212,29,1824,11,436,26,11
"1089","2020-05-14",96,13,120,345,2030,0.877339901477832,0,0,169,212,18,1842,10,446,11,10
"1090","2020-05-15",110,13,106,331,2030,0.877339901477832,0,0,169,212,28,1870,9,455,22,9
"1091","2020-05-16",119,13,103,328,2030,0.877339901477832,0,0,169,212,30,1900,7,462,24,7
"1092","2020-05-17",121,13,98,319,2030,0.877339901477832,0,0,169,212,20,1920,2,464,12,2
"1093","2020-05-18",118,13,89,314,2030,0.877339901477832,0,0,169,212,24,1944,4,468,17,4
"1094","2020-05-19",115,13,76,308,2030,0.877339901477832,0,0,169,212,19,1963,5,473,15,5
"1095","2020-05-20",117,13,75,296,2030,0.877339901477832,0,0,169,212,17,1980,NA,NA,13,NA
"1096","2020-05-21",109,13,86,278,2030,0.877339901477832,0,0,169,212,20,2000,5,478,16,5
"1097","2020-05-22",94,13,81,277,2030,0.877339901477832,0,0,169,212,18,2018,3,481,13,3
"1098","2020-05-23",84,13,77,272,2030,0.877339901477832,0,0,169,212,21,2039,8,489,16,8
"1099","2020-05-24",78,13,59,270,2030,0.877339901477832,0,0,169,212,18,2057,5,494,13,5
"1100","2020-05-25",77,13,51,258,2030,0.877339901477832,0,0,169,212,15,2072,10,504,13,10
"1101","2020-05-26",77,13,50,250,2030,0.877339901477832,0,0,169,212,14,2086,6,510,10,6
"1102","2020-05-27",77,13,51,254,2030,0.877339901477832,0,0,169,212,14,2100,11,521,8,11
"1103","2020-05-28",80,13,60,252,2030,0.877339901477832,0,0,169,212,17,2117,9,530,10,9
"1104","2020-05-29",83,13,64,269,2030,0.877339901477832,0,0,169,212,10,2127,10,540,7,10
"1105","2020-05-30",84,13,53,270,2030,0.877339901477832,0,0,169,212,12,2139,5,545,5,5
"1106","2020-05-31",92,13,63,263,2030,0.877339901477832,0,0,169,212,9,2148,9,554,8,9
"1107","2020-06-01",87,13,69,272,2030,0.877339901477832,0,0,169,212,13,2161,2,556,10,2
"1108","2020-06-02",86,13,67,263,2030,0.877339901477832,0,0,169,212,12,2173,1,557,8,1
"1109","2020-06-03",86,13,60,257,2030,0.877339901477832,0,0,169,212,12,2185,1,558,11,1
"1110","2020-06-04",80,13,66,251,2030,0.877339901477832,0,0,169,212,15,2200,2,560,13,2
"1111","2020-06-05",73,13,73,245,2030,0.877339901477832,0,0,169,212,14,2214,2,562,14,2
"1112","2020-06-06",79,13,68,237,2030,0.877339901477832,0,0,169,212,13,2227,3,565,10,3
"1113","2020-06-07",76,13,70,237,2030,0.877339901477832,0,0,169,212,7,2234,1,566,6,1
"1114","2020-03-17",1,14,35,52,5313,0.951439864483343,0,0,446,269,12,70,4,36,7,4
"1115","2020-03-18",3,14,38,70,5313,0.951439864483343,0,0,446,269,15,85,2,38,14,2
"1116","2020-03-19",4,14,41,89,5313,0.951439864483343,0,0,446,269,16,101,2,40,12,2
"1117","2020-03-20",7,14,36,105,5313,0.951439864483343,0,0,446,269,19,120,3,43,14,3
"1118","2020-03-21",9,14,40,135,5313,0.951439864483343,0,0,446,269,18,138,2,45,12,2
"1119","2020-03-22",12,14,40,146,5313,0.951439864483343,0,0,446,269,31,169,9,54,22,9
"1120","2020-03-23",22,14,41,180,5313,0.951439864483343,0,0,446,269,31,200,9,63,29,9
"1121","2020-03-24",28,14,47,212,5313,0.951439864483343,0,0,446,269,33,233,6,69,24,6
"1122","2020-03-25",33,14,49,246,5313,0.951439864483343,0,0,446,269,45,278,12,81,38,12
"1123","2020-03-26",38,14,55,276,5313,0.951439864483343,0,0,446,269,38,316,6,87,31,6
"1124","2020-03-27",45,14,62,316,5313,0.951439864483343,0,0,446,269,46,362,8,95,40,8
"1125","2020-03-28",58,14,62,350,5313,0.951439864483343,0,0,446,269,60,422,7,102,57,7
"1126","2020-03-29",67,14,72,398,5313,0.951439864483343,0,0,446,269,76,498,11,113,65,11
"1127","2020-03-30",74,14,82,438,5313,0.951439864483343,0,0,446,269,84,582,10,123,78,10
"1128","2020-03-31",91,14,72,475,5313,0.951439864483343,0,0,446,269,98,680,10,133,92,10
"1129","2020-04-01",105,14,70,518,5313,0.951439864483343,0,0,446,269,90,770,12,145,85,12
"1130","2020-04-02",130,14,68,566,5313,0.951439864483343,0,0,446,269,127,897,15,160,124,15
"1131","2020-04-03",138,14,71,598,5313,0.951439864483343,0,0,446,269,137,1034,17,177,130,17
"1132","2020-04-04",143,14,71,641,5313,0.951439864483343,0,0,446,269,216,1250,12,189,208,12
"1133","2020-04-05",153,14,70,693,5313,0.951439864483343,0,0,446,269,177,1427,9,198,169,9
"1134","2020-04-06",163,14,64,737,5313,0.951439864483343,0,0,446,269,163,1590,6,204,159,6
"1135","2020-04-07",174,14,59,785,5313,0.951439864483343,0,0,446,269,247,1837,6,210,245,6
"1136","2020-04-08",183,14,60,830,5313,0.951439864483343,0,0,446,269,189,2026,14,224,180,14
"1137","2020-04-09",185,14,61,879,5313,0.951439864483343,0,0,446,269,293,2319,24,248,290,24
"1138","2020-04-10",196,14,70,928,5313,0.951439864483343,0,0,446,269,234,2553,8,256,232,8
"1139","2020-04-11",210,14,81,960,5313,0.951439864483343,0,0,446,269,312,2865,9,265,306,9
"1140","2020-04-12",225,14,85,1014,5313,0.951439864483343,0,0,446,269,340,3205,5,270,336,5
"1141","2020-04-13",231,14,88,1062,5313,0.951439864483343,0,0,446,269,298,3503,4,274,290,4
"1142","2020-04-14",236,14,79,1096,5313,0.951439864483343,0,0,446,269,267,3770,5,279,265,5
"1143","2020-04-15",254,14,82,1150,5313,0.951439864483343,0,0,446,269,248,4018,5,284,245,5
"1144","2020-04-16",273,14,82,1197,5313,0.951439864483343,0,0,446,269,256,4274,5,289,253,5
"1145","2020-04-17",298,14,84,1253,5313,0.951439864483343,0,0,446,269,171,4445,6,295,168,6
"1146","2020-04-18",323,14,87,1289,5313,0.951439864483343,0,0,446,269,195,4640,1,296,191,1
"1147","2020-04-19",331,14,74,1346,5313,0.951439864483343,0,0,446,269,177,4817,10,306,174,10
"1148","2020-04-20",342,14,75,1395,5313,0.951439864483343,0,0,446,269,146,4963,18,324,145,18
"1149","2020-04-21",343,14,80,1420,5313,0.951439864483343,0,0,446,269,177,5140,10,334,175,10
"1150","2020-04-22",344,14,81,1423,5313,0.951439864483343,0,0,446,269,148,5288,6,340,146,6
"1151","2020-04-23",340,14,83,1389,5313,0.951439864483343,0,0,446,269,124,5412,9,349,119,9
"1152","2020-04-24",338,14,90,1396,5313,0.951439864483343,0,0,446,269,117,5529,6,355,115,6
"1153","2020-04-25",339,14,100,1415,5313,0.951439864483343,0,0,446,269,119,5648,22,377,114,22
"1154","2020-04-26",349,14,93,1408,5313,0.951439864483343,0,0,446,269,123,5771,9,386,122,9
"1155","2020-04-27",371,14,88,1366,5313,0.951439864483343,0,0,446,269,87,5858,15,401,84,15
"1156","2020-04-28",373,14,87,1334,5313,0.951439864483343,0,0,446,269,75,5933,15,416,71,15
"1157","2020-04-29",374,14,81,1304,5313,0.951439864483343,0,0,446,269,76,6009,17,433,73,17
"1158","2020-04-30",384,14,86,1257,5313,0.951439864483343,0,0,446,269,62,6071,15,448,58,15
"1159","2020-05-01",397,14,84,1235,5313,0.951439864483343,0,0,446,269,53,6124,24,472,53,24
"1160","2020-05-02",387,14,95,1196,5313,0.951439864483343,0,0,446,269,62,6186,17,489,61,17
"1161","2020-05-03",394,14,97,1148,5313,0.951439864483343,0,0,446,269,44,6230,13,502,43,13
"1162","2020-05-04",382,14,112,1098,5313,0.951439864483343,0,0,446,269,48,6278,14,516,47,14
"1163","2020-05-05",384,14,120,1041,5313,0.951439864483343,0,0,446,269,36,6314,18,534,35,18
"1164","2020-05-06",380,14,128,1019,5313,0.951439864483343,0,0,446,269,22,6336,18,552,22,18
"1165","2020-05-07",363,14,126,955,5313,0.951439864483343,0,0,446,269,22,6358,9,561,18,9
"1166","2020-05-08",331,14,125,918,5313,0.951439864483343,0,0,446,269,41,6399,21,582,40,21
"1167","2020-05-09",315,14,130,876,5313,0.951439864483343,0,0,446,269,15,6414,21,603,14,21
"1168","2020-05-10",284,14,121,804,5313,0.951439864483343,0,0,446,269,24,6438,20,623,22,20
"1169","2020-05-11",261,14,121,745,5313,0.951439864483343,0,0,446,269,17,6455,5,628,14,5
"1170","2020-05-12",253,14,113,716,5313,0.951439864483343,0,0,446,269,20,6475,13,641,17,13
"1171","2020-05-13",236,14,107,669,5313,0.951439864483343,0,0,446,269,20,6495,3,644,19,3
"1172","2020-05-14",221,14,101,632,5313,0.951439864483343,0,0,446,269,9,6504,7,651,8,7
"1173","2020-05-15",215,14,97,590,5313,0.951439864483343,0,0,446,269,12,6516,12,663,10,12
"1174","2020-05-16",202,14,91,550,5313,0.951439864483343,0,0,446,269,8,6524,14,677,8,14
"1175","2020-05-17",195,14,100,522,5313,0.951439864483343,0,0,446,269,13,6537,4,681,11,4
"1176","2020-05-18",189,14,92,490,5313,0.951439864483343,0,0,446,269,7,6544,7,688,7,7
"1177","2020-05-19",174,14,90,452,5313,0.951439864483343,0,0,446,269,11,6555,8,696,10,8
"1178","2020-05-20",162,14,97,424,5313,0.951439864483343,0,0,446,269,6,6561,13,709,4,13
"1179","2020-05-21",151,14,90,387,5313,0.951439864483343,0,0,446,269,6,6567,4,713,4,4
"1180","2020-05-22",134,14,91,363,5313,0.951439864483343,0,0,446,269,5,6572,8,721,5,8
"1181","2020-05-23",130,14,84,348,5313,0.951439864483343,0,0,446,269,1,6573,6,727,1,6
"1182","2020-05-24",124,14,92,305,5313,0.951439864483343,0,0,446,269,8,6581,9,736,6,9
"1183","2020-05-25",113,14,91,269,5313,0.951439864483343,0,0,446,269,5,6586,4,740,4,4
"1184","2020-05-26",103,14,88,235,5313,0.951439864483343,0,0,446,269,4,6590,5,745,3,5
"1185","2020-05-27",97,14,93,211,5313,0.951439864483343,0,0,446,269,2,6592,3,748,2,3
"1186","2020-05-28",91,14,85,198,5313,0.951439864483343,0,0,446,269,3,6595,8,756,2,8
"1187","2020-05-29",87,14,85,188,5313,0.951439864483343,0,0,446,269,4,6599,9,765,4,9
"1188","2020-05-30",72,14,75,166,5313,0.951439864483343,0,0,446,269,NA,NA,3,768,NA,3
"1189","2020-05-31",64,14,79,162,5313,0.951439864483343,0,0,446,269,1,6600,14,782,1,14
"1190","2020-06-01",58,14,80,153,5313,0.951439864483343,0,0,446,269,1,6601,13,795,1,13
"1191","2020-06-02",54,14,79,143,5313,0.951439864483343,0,0,446,269,4,6605,15,810,2,15
"1192","2020-06-03",47,14,73,131,5313,0.951439864483343,0,0,446,269,3,6608,13,823,3,13
"1193","2020-06-04",42,14,72,120,5313,0.951439864483343,0,0,446,269,3,6611,16,839,3,16
"1194","2020-06-05",44,14,79,122,5313,0.951439864483343,0,0,446,269,3,6614,9,848,1,9
"1195","2020-06-06",45,14,74,112,5313,0.951439864483343,0,0,446,269,4,6618,10,858,3,10
"1196","2020-06-07",38,14,80,110,5313,0.951439864483343,0,0,446,269,NA,NA,3,861,NA,3
"1197","2020-03-13",1,15,44,31,7502,0.919354838709677,0,0,602,297,11,23,2,5,1,2
"1198","2020-03-14",3,15,47,48,7502,0.919354838709677,0,0,602,297,8,31,4,9,2,4
"1199","2020-03-15",3,15,50,65,7502,0.919354838709677,0,0,602,297,19,50,1,10,5,1
"1200","2020-03-16",6,15,60,81,7502,0.919354838709677,0,0,602,297,24,74,3,13,8,3
"1201","2020-03-17",8,15,63,116,7502,0.919354838709677,0,0,602,297,15,89,3,16,4,3
"1202","2020-03-18",14,15,61,147,7502,0.919354838709677,0,0,602,297,16,105,2,18,4,2
"1203","2020-03-19",18,15,64,190,7502,0.919354838709677,0,0,602,297,9,114,1,19,3,1
"1204","2020-03-20",26,15,61,235,7502,0.919354838709677,0,0,602,297,25,139,2,21,10,2
"1205","2020-03-21",36,15,65,311,7502,0.919354838709677,0,0,602,297,16,155,4,25,7,4
"1206","2020-03-22",44,15,59,360,7502,0.919354838709677,0,0,602,297,19,174,2,27,8,2
"1207","2020-03-23",51,15,66,407,7502,0.919354838709677,0,0,602,297,28,202,7,34,9,7
"1208","2020-03-24",72,15,69,491,7502,0.919354838709677,0,0,602,297,23,225,9,43,10,9
"1209","2020-03-25",83,15,68,578,7502,0.919354838709677,0,0,602,297,20,245,13,56,12,13
"1210","2020-03-26",99,15,82,660,7502,0.919354838709677,0,0,602,297,23,268,5,61,12,5
"1211","2020-03-27",113,15,82,768,7502,0.919354838709677,0,0,602,297,22,290,10,71,12,10
"1212","2020-03-28",135,15,83,940,7502,0.919354838709677,0,0,602,297,19,309,4,75,7,4
"1213","2020-03-29",153,15,79,1058,7502,0.919354838709677,0,0,602,297,16,325,8,83,10,8
"1214","2020-03-30",185,15,79,1235,7502,0.919354838709677,0,0,602,297,31,356,1,84,18,1
"1215","2020-03-31",198,15,86,1456,7502,0.919354838709677,0,0,602,297,27,383,1,85,12,1
"1216","2020-04-01",233,15,94,1619,7502,0.919354838709677,0,0,602,297,25,408,2,87,16,2
"1217","2020-04-02",277,15,102,1888,7502,0.919354838709677,0,0,602,297,16,424,4,91,8,4
"1218","2020-04-03",325,15,108,2187,7502,0.919354838709677,0,0,602,297,21,445,4,95,7,4
"1219","2020-04-04",369,15,121,2414,7502,0.919354838709677,0,0,602,297,33,478,1,96,19,1
"1220","2020-04-05",427,15,132,2628,7502,0.919354838709677,0,0,602,297,37,515,1,97,13,1
"1221","2020-04-06",479,15,139,2824,7502,0.919354838709677,0,0,602,297,25,540,1,98,11,1
"1222","2020-04-07",567,15,129,3019,7502,0.919354838709677,0,0,602,297,20,560,8,106,10,8
"1223","2020-04-08",635,15,121,3176,7502,0.919354838709677,0,0,602,297,29,589,2,108,11,2
"1224","2020-04-09",694,15,117,3279,7502,0.919354838709677,0,0,602,297,20,609,9,117,12,9
"1225","2020-04-10",760,15,127,3347,7502,0.919354838709677,0,0,602,297,27,636,5,122,14,5
"1226","2020-04-11",809,15,120,3301,7502,0.919354838709677,0,0,602,297,31,667,7,129,15,7
"1227","2020-04-12",860,15,118,3314,7502,0.919354838709677,0,0,602,297,24,691,7,136,14,7
"1228","2020-04-13",894,15,107,3311,7502,0.919354838709677,0,0,602,297,36,727,4,140,16,4
"1229","2020-04-14",895,15,120,3162,7502,0.919354838709677,0,0,602,297,26,753,5,145,13,5
"1230","2020-04-15",912,15,109,3052,7502,0.919354838709677,0,0,602,297,30,783,5,150,12,5
"1231","2020-04-16",932,15,99,2867,7502,0.919354838709677,0,0,602,297,25,808,3,153,9,3
"1232","2020-04-17",915,15,115,2654,7502,0.919354838709677,0,0,602,297,36,844,6,159,21,6
"1233","2020-04-18",898,15,116,2485,7502,0.919354838709677,0,0,602,297,29,873,6,165,11,6
"1234","2020-04-19",875,15,122,2304,7502,0.919354838709677,0,0,602,297,34,907,5,170,22,5
"1235","2020-04-20",835,15,134,2072,7502,0.919354838709677,0,0,602,297,35,942,1,171,15,1
"1236","2020-04-21",791,15,149,1851,7502,0.919354838709677,0,0,602,297,37,979,6,177,20,6
"1237","2020-04-22",723,15,130,1647,7502,0.919354838709677,0,0,602,297,37,1016,3,180,21,3
"1238","2020-04-23",646,15,124,1485,7502,0.919354838709677,0,0,602,297,29,1045,6,186,17,6
"1239","2020-04-24",581,15,111,1302,7502,0.919354838709677,0,0,602,297,25,1070,3,189,11,3
"1240","2020-04-25",526,15,130,1144,7502,0.919354838709677,0,0,602,297,26,1096,11,200,9,11
"1241","2020-04-26",452,15,154,987,7502,0.919354838709677,0,0,602,297,24,1120,2,202,13,2
"1242","2020-04-27",410,15,174,814,7502,0.919354838709677,0,0,602,297,32,1152,5,207,13,5
"1243","2020-04-28",357,15,169,683,7502,0.919354838709677,0,0,602,297,31,1183,2,209,18,2
"1244","2020-04-29",309,15,158,606,7502,0.919354838709677,0,0,602,297,32,1215,4,213,17,4
"1245","2020-04-30",277,15,139,519,7502,0.919354838709677,0,0,602,297,30,1245,6,219,17,6
"1246","2020-05-01",239,15,161,447,7502,0.919354838709677,0,0,602,297,35,1280,4,223,15,4
"1247","2020-05-02",206,15,159,375,7502,0.919354838709677,0,0,602,297,27,1307,16,239,16,16
"1248","2020-05-03",184,15,159,310,7502,0.919354838709677,0,0,602,297,35,1342,16,255,23,16
"1249","2020-05-04",154,15,144,267,7502,0.919354838709677,0,0,602,297,20,1362,8,263,7,8
"1250","2020-05-05",140,15,148,226,7502,0.919354838709677,0,0,602,297,26,1388,7,270,19,7
"1251","2020-05-06",126,15,130,199,7502,0.919354838709677,0,0,602,297,23,1411,8,278,7,8
"1252","2020-05-07",103,15,112,174,7502,0.919354838709677,0,0,602,297,28,1439,8,286,17,8
"1253","2020-05-08",93,15,102,150,7502,0.919354838709677,0,0,602,297,23,1462,6,292,8,6
"1254","2020-05-09",80,15,90,122,7502,0.919354838709677,0,0,602,297,23,1485,6,298,9,6
"1255","2020-05-10",71,15,83,110,7502,0.919354838709677,0,0,602,297,22,1507,10,308,10,10
"1256","2020-05-11",60,15,80,99,7502,0.919354838709677,0,0,602,297,21,1528,17,325,9,17
"1257","2020-05-12",49,15,92,91,7502,0.919354838709677,0,0,602,297,29,1557,11,336,13,11
"1258","2020-05-13",44,15,103,85,7502,0.919354838709677,0,0,602,297,17,1574,7,343,4,7
"1259","2020-05-14",34,15,90,78,7502,0.919354838709677,0,0,602,297,22,1596,11,354,9,11
"1260","2020-05-15",31,15,86,70,7502,0.919354838709677,0,0,602,297,19,1615,12,366,11,12
"1261","2020-05-16",25,15,87,64,7502,0.919354838709677,0,0,602,297,26,1641,11,377,13,11
"1262","2020-05-17",22,15,87,58,7502,0.919354838709677,0,0,602,297,19,1660,14,391,12,14
"1263","2020-05-18",20,15,88,50,7502,0.919354838709677,0,0,602,297,25,1685,13,404,13,13
"1264","2020-05-19",18,15,107,50,7502,0.919354838709677,0,0,602,297,27,1712,12,416,15,12
"1265","2020-05-20",17,15,98,42,7502,0.919354838709677,0,0,602,297,23,1735,11,427,10,11
"1266","2020-05-21",18,15,113,43,7502,0.919354838709677,0,0,602,297,22,1757,3,430,15,3
"1267","2020-05-22",16,15,121,44,7502,0.919354838709677,0,0,602,297,33,1790,7,437,17,7
"1268","2020-05-23",14,15,134,42,7502,0.919354838709677,0,0,602,297,18,1808,5,442,10,5
"1269","2020-05-24",12,15,120,36,7502,0.919354838709677,0,0,602,297,28,1836,9,451,13,9
"1270","2020-05-25",10,15,99,36,7502,0.919354838709677,0,0,602,297,17,1853,8,459,7,8
"1271","2020-05-26",11,15,97,36,7502,0.919354838709677,0,0,602,297,15,1868,4,463,9,4
"1272","2020-05-27",10,15,90,32,7502,0.919354838709677,0,0,602,297,13,1881,6,469,9,6
"1273","2020-05-28",12,15,73,30,7502,0.919354838709677,0,0,602,297,12,1893,6,475,6,6
"1274","2020-05-29",11,15,73,25,7502,0.919354838709677,0,0,602,297,12,1905,4,479,8,4
"1275","2020-05-30",10,15,67,24,7502,0.919354838709677,0,0,602,297,19,1924,4,483,9,4
"1276","2020-05-31",8,15,57,27,7502,0.919354838709677,0,0,602,297,15,1939,14,497,9,14
"1277","2020-06-01",8,15,59,24,7502,0.919354838709677,0,0,602,297,16,1955,4,501,5,4
"1278","2020-06-02",8,15,53,25,7502,0.919354838709677,0,0,602,297,11,1966,4,505,7,4
"1279","2020-06-03",9,15,57,27,7502,0.919354838709677,0,0,602,297,15,1981,7,512,7,7
"1280","2020-06-04",9,15,59,27,7502,0.919354838709677,0,0,602,297,18,1999,1,513,6,1
"1281","2020-06-05",9,15,59,25,7502,0.919354838709677,0,0,602,297,6,2005,2,515,3,2
"1282","2020-06-06",12,15,65,23,7502,0.919354838709677,0,0,602,297,9,2014,2,517,5,2
"1283","2020-06-07",12,15,67,23,7502,0.919354838709677,0,0,602,297,17,2031,6,523,9,6
"1284","2020-03-16",1,16,13,29,2399,0.852855356398499,0,0,217,314,15,50,8,34,5,8
"1285","2020-03-17",3,16,16,36,2399,0.852855356398499,0,0,217,314,8,58,7,41,5,7
"1286","2020-03-18",5,16,25,45,2399,0.852855356398499,0,0,217,314,12,70,11,52,7,11
"1287","2020-03-19",6,16,16,54,2399,0.852855356398499,0,0,217,314,8,78,17,69,5,17
"1288","2020-03-20",7,16,14,58,2399,0.852855356398499,0,0,217,314,12,90,7,76,6,7
"1289","2020-03-21",7,16,19,64,2399,0.852855356398499,0,0,217,314,13,103,14,90,3,14
"1290","2020-03-22",13,16,29,76,2399,0.852855356398499,0,0,217,314,13,116,17,107,5,17
"1291","2020-03-23",14,16,41,91,2399,0.852855356398499,0,0,217,314,16,132,15,122,10,15
"1292","2020-03-24",19,16,45,105,2399,0.852855356398499,0,0,217,314,11,143,17,139,7,17
"1293","2020-03-25",20,16,53,117,2399,0.852855356398499,0,0,217,314,15,158,13,152,13,13
"1294","2020-03-26",20,16,55,127,2399,0.852855356398499,0,0,217,314,17,175,16,168,6,16
"1295","2020-03-27",22,16,57,139,2399,0.852855356398499,0,0,217,314,17,192,13,181,7,13
"1296","2020-03-28",29,16,46,153,2399,0.852855356398499,0,0,217,314,15,207,12,193,6,12
"1297","2020-03-29",27,16,42,153,2399,0.852855356398499,0,0,217,314,24,231,13,206,13,13
"1298","2020-03-30",30,16,41,167,2399,0.852855356398499,0,0,217,314,24,255,15,221,16,15
"1299","2020-03-31",29,16,46,188,2399,0.852855356398499,0,0,217,314,13,268,13,234,7,13
"1300","2020-04-01",36,16,44,193,2399,0.852855356398499,0,0,217,314,23,291,22,256,13,22
"1301","2020-04-02",41,16,50,213,2399,0.852855356398499,0,0,217,314,19,310,20,276,13,20
"1302","2020-04-03",45,16,54,227,2399,0.852855356398499,0,0,217,314,27,337,17,293,19,17
"1303","2020-04-04",47,16,59,222,2399,0.852855356398499,0,0,217,314,25,362,32,325,11,32
"1304","2020-04-05",58,16,53,231,2399,0.852855356398499,0,0,217,314,18,380,25,350,9,25
"1305","2020-04-06",64,16,64,235,2399,0.852855356398499,0,0,217,314,33,413,34,384,18,34
"1306","2020-04-07",71,16,56,241,2399,0.852855356398499,0,0,217,314,28,441,26,410,16,26
"1307","2020-04-08",68,16,57,254,2399,0.852855356398499,0,0,217,314,37,478,36,446,23,36
"1308","2020-04-09",75,16,54,266,2399,0.852855356398499,0,0,217,314,31,509,32,478,15,32
"1309","2020-04-10",78,16,55,269,2399,0.852855356398499,0,0,217,314,29,538,32,510,18,32
"1310","2020-04-11",84,16,66,280,2399,0.852855356398499,0,0,217,314,27,565,32,542,18,32
"1311","2020-04-12",77,16,64,281,2399,0.852855356398499,0,0,217,314,35,600,34,576,22,34
"1312","2020-04-13",81,16,62,290,2399,0.852855356398499,0,0,217,314,27,627,28,604,15,28
"1313","2020-04-14",84,16,65,310,2399,0.852855356398499,0,0,217,314,45,672,28,632,33,28
"1314","2020-04-15",89,16,61,306,2399,0.852855356398499,0,0,217,314,27,699,27,659,14,27
"1315","2020-04-16",91,16,75,314,2399,0.852855356398499,0,0,217,314,25,724,44,703,12,44
"1316","2020-04-17",91,16,79,321,2399,0.852855356398499,0,0,217,314,27,751,33,736,15,33
"1317","2020-04-18",86,16,82,323,2399,0.852855356398499,0,0,217,314,33,784,31,767,19,31
"1318","2020-04-19",85,16,76,345,2399,0.852855356398499,0,0,217,314,34,818,25,792,24,25
"1319","2020-04-20",87,16,70,350,2399,0.852855356398499,0,0,217,314,27,845,23,815,19,23
"1320","2020-04-21",90,16,76,368,2399,0.852855356398499,0,0,217,314,27,872,36,851,14,36
"1321","2020-04-22",86,16,76,368,2399,0.852855356398499,0,0,217,314,23,895,39,890,15,39
"1322","2020-04-23",87,16,86,375,2399,0.852855356398499,0,0,217,314,35,930,52,942,23,52
"1323","2020-04-24",92,16,97,378,2399,0.852855356398499,0,0,217,314,32,962,31,973,22,31
"1324","2020-04-25",96,16,93,380,2399,0.852855356398499,0,0,217,314,25,987,39,1012,15,39
"1325","2020-04-26",104,16,99,383,2399,0.852855356398499,0,0,217,314,28,1015,49,1061,12,49
"1326","2020-04-27",102,16,107,385,2399,0.852855356398499,0,0,217,314,29,1044,44,1105,14,44
"1327","2020-04-28",98,16,106,404,2399,0.852855356398499,0,0,217,314,28,1072,24,1129,16,24
"1328","2020-04-29",118,16,107,401,2399,0.852855356398499,0,0,217,314,28,1100,34,1163,15,34
"1329","2020-04-30",120,16,112,418,2399,0.852855356398499,0,0,217,314,26,1126,31,1194,13,31
"1330","2020-05-01",120,16,95,435,2399,0.852855356398499,0,0,217,314,28,1154,34,1228,15,34
"1331","2020-05-02",116,16,91,454,2399,0.852855356398499,0,0,217,314,26,1180,17,1245,14,17
"1332","2020-05-03",119,16,84,444,2399,0.852855356398499,0,0,217,314,33,1213,17,1262,20,17
"1333","2020-05-04",123,16,86,455,2399,0.852855356398499,0,0,217,314,26,1239,30,1292,14,30
"1334","2020-05-05",126,16,89,456,2399,0.852855356398499,0,0,217,314,29,1268,22,1314,14,22
"1335","2020-05-06",114,16,96,447,2399,0.852855356398499,0,0,217,314,29,1297,26,1340,21,26
"1336","2020-05-07",120,16,84,447,2399,0.852855356398499,0,0,217,314,25,1322,39,1379,12,39
"1337","2020-05-08",113,16,86,444,2399,0.852855356398499,0,0,217,314,24,1346,17,1396,14,17
"1338","2020-05-09",123,16,88,429,2399,0.852855356398499,0,0,217,314,22,1368,26,1422,18,26
"1339","2020-05-10",128,16,94,424,2399,0.852855356398499,0,0,217,314,31,1399,46,1468,19,46
"1340","2020-05-11",124,16,95,424,2399,0.852855356398499,0,0,217,314,31,1430,24,1492,18,24
"1341","2020-05-12",132,16,101,400,2399,0.852855356398499,0,0,217,314,27,1457,28,1520,17,28
"1342","2020-05-13",133,16,93,378,2399,0.852855356398499,0,0,217,314,28,1485,33,1553,23,33
"1343","2020-05-14",128,16,95,373,2399,0.852855356398499,0,0,217,314,26,1511,28,1581,16,28
"1344","2020-05-15",132,16,97,349,2399,0.852855356398499,0,0,217,314,21,1532,35,1616,13,35
"1345","2020-05-16",133,16,100,335,2399,0.852855356398499,0,0,217,314,28,1560,26,1642,17,26
"1346","2020-05-17",127,16,91,322,2399,0.852855356398499,0,0,217,314,19,1579,31,1673,12,31
"1347","2020-05-18",128,16,95,320,2399,0.852855356398499,0,0,217,314,20,1599,40,1713,14,40
"1348","2020-05-19",111,16,82,315,2399,0.852855356398499,0,0,217,314,19,1618,35,1748,9,35
"1349","2020-05-20",112,16,83,319,2399,0.852855356398499,0,0,217,314,31,1649,46,1794,22,46
"1350","2020-05-21",109,16,93,295,2399,0.852855356398499,0,0,217,314,19,1668,40,1834,7,40
"1351","2020-05-22",107,16,104,297,2399,0.852855356398499,0,0,217,314,28,1696,38,1872,17,38
"1352","2020-05-23",97,16,102,296,2399,0.852855356398499,0,0,217,314,18,1714,39,1911,14,39
"1353","2020-05-24",100,16,102,287,2399,0.852855356398499,0,0,217,314,21,1735,39,1950,12,39
"1354","2020-05-25",96,16,104,287,2399,0.852855356398499,0,0,217,314,22,1757,37,1987,13,37
"1355","2020-05-26",96,16,100,288,2399,0.852855356398499,0,0,217,314,11,1768,36,2023,9,36
"1356","2020-05-27",88,16,80,299,2399,0.852855356398499,0,0,217,314,21,1789,27,2050,16,27
"1357","2020-05-28",81,16,71,304,2399,0.852855356398499,0,0,217,314,17,1806,33,2083,12,33
"1358","2020-05-29",87,16,67,303,2399,0.852855356398499,0,0,217,314,17,1823,32,2115,10,32
"1359","2020-05-30",88,16,63,306,2399,0.852855356398499,0,0,217,314,9,1832,27,2142,5,27
"1360","2020-05-31",79,16,72,312,2399,0.852855356398499,0,0,217,314,22,1854,34,2176,19,34
"1361","2020-06-01",79,16,82,305,2399,0.852855356398499,0,0,217,314,14,1868,33,2209,10,33
"1362","2020-06-02",82,16,82,302,2399,0.852855356398499,0,0,217,314,10,1878,32,2241,8,32
"1363","2020-06-03",85,16,84,298,2399,0.852855356398499,0,0,217,314,6,1884,28,2269,3,28
"1364","2020-06-04",93,16,89,301,2399,0.852855356398499,0,0,217,314,19,1903,42,2311,10,42
"1365","2020-06-05",94,16,86,302,2399,0.852855356398499,0,0,217,314,15,1918,25,2336,10,25
"1366","2020-06-06",98,16,84,309,2399,0.852855356398499,0,0,217,314,15,1933,25,2361,10,25
"1367","2020-06-07",98,16,85,301,2399,0.852855356398499,0,0,217,314,11,1944,34,2395,10,34
"1368","2020-03-13",1,17,16,28,1780,0.647191011235955,0,0,148,269,2,4,2,7,2,2
"1369","2020-03-14",2,17,24,39,1780,0.647191011235955,0,0,148,269,2,6,2,9,2,2
"1370","2020-03-15",4,17,20,46,1780,0.647191011235955,0,0,148,269,6,12,6,15,3,6
"1371","2020-03-16",5,17,24,57,1780,0.647191011235955,0,0,148,269,5,17,12,27,5,12
"1372","2020-03-17",6,17,28,69,1780,0.647191011235955,0,0,148,269,7,24,7,34,7,7
"1373","2020-03-18",8,17,22,77,1780,0.647191011235955,0,0,148,269,9,33,9,43,7,9
"1374","2020-03-19",8,17,26,95,1780,0.647191011235955,0,0,148,269,14,47,5,48,10,5
"1375","2020-03-20",8,17,31,113,1780,0.647191011235955,0,0,148,269,20,67,13,61,18,13
"1376","2020-03-21",12,17,38,128,1780,0.647191011235955,0,0,148,269,23,90,13,74,21,13
"1377","2020-03-22",15,17,36,140,1780,0.647191011235955,0,0,148,269,29,119,6,80,27,6
"1378","2020-03-23",23,17,33,150,1780,0.647191011235955,0,0,148,269,36,155,6,86,35,6
"1379","2020-03-24",27,17,40,155,1780,0.647191011235955,0,0,148,269,17,172,3,89,17,3
"1380","2020-03-25",32,17,47,165,1780,0.647191011235955,0,0,148,269,42,214,3,92,41,3
"1381","2020-03-26",43,17,46,174,1780,0.647191011235955,0,0,148,269,37,251,1,93,36,1
"1382","2020-03-27",46,17,51,172,1780,0.647191011235955,0,0,148,269,69,320,2,95,67,2
"1383","2020-03-28",44,17,51,183,1780,0.647191011235955,0,0,148,269,65,385,NA,NA,64,NA
"1384","2020-03-29",46,17,45,195,1780,0.647191011235955,0,0,148,269,92,477,NA,NA,91,NA
"1385","2020-03-30",40,17,50,194,1780,0.647191011235955,0,0,148,269,87,564,5,100,87,5
"1386","2020-03-31",43,17,50,203,1780,0.647191011235955,0,0,148,269,97,661,4,104,93,4
"1387","2020-04-01",43,17,49,206,1780,0.647191011235955,0,0,148,269,102,763,5,109,102,5
"1388","2020-04-02",40,17,47,213,1780,0.647191011235955,0,0,148,269,132,895,7,116,130,7
"1389","2020-04-03",47,17,46,228,1780,0.647191011235955,0,0,148,269,148,1043,3,119,148,3
"1390","2020-04-04",65,17,46,235,1780,0.647191011235955,0,0,148,269,152,1195,8,127,147,8
"1391","2020-04-05",67,17,44,249,1780,0.647191011235955,0,0,148,269,156,1351,8,135,156,9
"1392","2020-04-06",75,17,48,255,1780,0.647191011235955,0,0,148,269,174,1525,3,138,170,3
"1393","2020-04-07",77,17,40,268,1780,0.647191011235955,0,0,148,269,210,1735,5,143,210,5
"1394","2020-04-08",73,17,45,275,1780,0.647191011235955,0,0,148,269,234,1969,11,154,232,11
"1395","2020-04-09",79,17,44,287,1780,0.647191011235955,0,0,148,269,169,2138,21,175,168,21
"1396","2020-04-10",88,17,51,289,1780,0.647191011235955,0,0,148,269,237,2375,8,183,235,8
"1397","2020-04-11",78,17,60,295,1780,0.647191011235955,0,0,148,269,263,2638,7,190,262,7
"1398","2020-04-12",76,17,63,290,1780,0.647191011235955,0,0,148,269,241,2879,16,206,239,16
"1399","2020-04-13",75,17,61,307,1780,0.647191011235955,0,0,148,269,196,3075,12,218,196,12
"1400","2020-04-14",81,17,65,324,1780,0.647191011235955,0,0,148,269,251,3326,21,239,251,21
"1401","2020-04-15",90,17,78,320,1780,0.647191011235955,0,0,148,269,276,3602,12,251,273,12
"1402","2020-04-16",88,17,93,335,1780,0.647191011235955,0,0,148,269,247,3849,27,278,246,27
"1403","2020-04-17",80,17,94,326,1780,0.647191011235955,0,0,148,269,225,4074,15,293,225,15
"1404","2020-04-18",82,17,95,321,1780,0.647191011235955,0,0,148,269,247,4321,11,304,246,11
"1405","2020-04-19",85,17,96,330,1780,0.647191011235955,0,0,148,269,268,4589,13,317,268,13
"1406","2020-04-20",85,17,112,321,1780,0.647191011235955,0,0,148,269,241,4830,7,324,240,7
"1407","2020-04-21",84,17,120,318,1780,0.647191011235955,0,0,148,269,182,5012,5,329,181,5
"1408","2020-04-22",81,17,117,315,1780,0.647191011235955,0,0,148,269,174,5186,6,335,174,6
"1409","2020-04-23",76,17,101,307,1780,0.647191011235955,0,0,148,269,177,5363,NA,NA,174,NA
"1410","2020-04-24",70,17,92,308,1780,0.647191011235955,0,0,148,269,134,5497,7,342,134,7
"1411","2020-04-25",71,17,89,297,1780,0.647191011235955,0,0,148,269,169,5666,16,358,168,16
"1412","2020-04-26",76,17,83,288,1780,0.647191011235955,0,0,148,269,85,5751,13,371,85,13
"1413","2020-04-27",80,17,85,284,1780,0.647191011235955,0,0,148,269,124,5875,12,383,123,12
"1414","2020-04-28",78,17,97,282,1780,0.647191011235955,0,0,148,269,107,5982,18,401,107,18
"1415","2020-04-29",85,17,84,271,1780,0.647191011235955,0,0,148,269,98,6080,11,412,98,11
"1416","2020-04-30",92,17,73,268,1780,0.647191011235955,0,0,148,269,55,6135,26,438,55,26
"1417","2020-05-01",99,17,67,258,1780,0.647191011235955,0,0,148,269,85,6220,23,461,84,23
"1418","2020-05-02",98,17,70,246,1780,0.647191011235955,0,0,148,269,59,6279,24,485,57,24
"1419","2020-05-03",94,17,80,233,1780,0.647191011235955,0,0,148,269,69,6348,19,504,69,19
"1420","2020-05-04",91,17,88,224,1780,0.647191011235955,0,0,148,269,55,6403,18,522,54,18
"1421","2020-05-05",84,17,89,225,1780,0.647191011235955,0,0,148,269,55,6458,13,535,53,13
"1422","2020-05-06",73,17,93,232,1780,0.647191011235955,0,0,148,269,39,6497,21,556,38,21
"1423","2020-05-07",67,17,95,230,1780,0.647191011235955,0,0,148,269,24,6521,16,572,24,16
"1424","2020-05-08",67,17,85,234,1780,0.647191011235955,0,0,148,269,26,6547,17,589,25,17
"1425","2020-05-09",62,17,75,231,1780,0.647191011235955,0,0,148,269,21,6568,19,608,21,19
"1426","2020-05-10",65,17,71,235,1780,0.647191011235955,0,0,148,269,27,6595,10,618,26,10
"1427","2020-05-11",56,17,84,230,1780,0.647191011235955,0,0,148,269,15,6610,9,627,14,9
"1428","2020-05-12",56,17,96,232,1780,0.647191011235955,0,0,148,269,13,6623,22,649,13,22
"1429","2020-05-13",64,17,100,234,1780,0.647191011235955,0,0,148,269,12,6635,14,663,12,14
"1430","2020-05-14",67,17,72,237,1780,0.647191011235955,0,0,148,269,12,6647,19,682,12,19
"1431","2020-05-15",69,17,64,229,1780,0.647191011235955,0,0,148,269,5,6652,14,696,4,14
"1432","2020-05-16",69,17,58,214,1780,0.647191011235955,0,0,148,269,5,6657,16,712,4,16
"1433","2020-05-17",68,17,54,212,1780,0.647191011235955,0,0,148,269,8,6665,18,730,8,18
"1434","2020-05-18",69,17,52,200,1780,0.647191011235955,0,0,148,269,6,6671,11,741,6,11
"1435","2020-05-19",68,17,51,185,1780,0.647191011235955,0,0,148,269,3,6674,17,758,3,17
"1436","2020-05-20",68,17,47,178,1780,0.647191011235955,0,0,148,269,10,6684,10,768,10,10
"1437","2020-05-21",61,17,44,159,1780,0.647191011235955,0,0,148,269,4,6688,10,778,4,10
"1438","2020-05-22",50,17,64,153,1780,0.647191011235955,0,0,148,269,2,6690,14,792,2,14
"1439","2020-05-23",50,17,72,156,1780,0.647191011235955,0,0,148,269,4,6694,5,797,3,5
"1440","2020-05-24",47,17,67,163,1780,0.647191011235955,0,0,148,269,5,6699,14,811,3,14
"1441","2020-05-25",51,17,69,157,1780,0.647191011235955,0,0,148,269,NA,NA,14,825,NA,14
"1442","2020-05-26",52,17,74,154,1780,0.647191011235955,0,0,148,269,1,6700,10,835,1,10
"1443","2020-05-27",46,17,66,156,1780,0.647191011235955,0,0,148,269,2,6702,4,839,2,4
"1444","2020-05-28",46,17,59,143,1780,0.647191011235955,0,0,148,269,2,6704,3,842,2,3
"1445","2020-05-29",51,17,48,145,1780,0.647191011235955,0,0,148,269,NA,NA,8,850,NA,8
"1446","2020-05-30",51,17,56,152,1780,0.647191011235955,0,0,148,269,2,6706,12,862,2,12
"1447","2020-05-31",47,17,55,153,1780,0.647191011235955,0,0,148,269,2,6708,8,870,2,8
"1448","2020-06-01",47,17,51,146,1780,0.647191011235955,0,0,148,269,2,6710,11,881,2,11
"1449","2020-06-02",45,17,48,148,1780,0.647191011235955,0,0,148,269,1,6711,10,891,1,10
"1450","2020-06-03",44,17,47,148,1780,0.647191011235955,0,0,148,269,NA,NA,9,900,NA,9
"1451","2020-06-04",48,17,41,142,1780,0.647191011235955,0,0,148,269,NA,NA,13,913,NA,13
"1452","2020-06-05",43,17,43,140,1780,0.647191011235955,0,0,148,269,NA,NA,8,921,NA,8
"1453","2020-06-06",40,17,43,142,1780,0.647191011235955,0,0,148,269,NA,NA,7,928,NA,7
"1454","2020-06-07",39,17,41,138,1780,0.647191011235955,0,0,148,269,NA,NA,9,937,NA,9
"1455","2020-03-14",1,18,47,16,2384,0.863674496644295,0,0,200,303,2,8,2,18,NA,2
"1456","2020-03-15",1,18,50,20,2384,0.863674496644295,0,0,200,303,2,10,11,29,1,11
"1457","2020-03-16",2,18,50,21,2384,0.863674496644295,0,0,200,303,3,13,8,37,1,8
"1458","2020-03-17",2,18,53,24,2384,0.863674496644295,0,0,200,303,9,22,5,42,7,5
"1459","2020-03-18",3,18,53,30,2384,0.863674496644295,0,0,200,303,6,28,4,46,5,4
"1460","2020-03-19",3,18,59,31,2384,0.863674496644295,0,0,200,303,4,32,11,57,2,11
"1461","2020-03-20",4,18,51,38,2384,0.863674496644295,0,0,200,303,10,42,6,63,8,6
"1462","2020-03-21",4,18,38,46,2384,0.863674496644295,0,0,200,303,8,50,7,70,6,7
"1463","2020-03-22",5,18,44,49,2384,0.863674496644295,0,0,200,303,14,64,4,74,12,4
"1464","2020-03-23",8,18,62,61,2384,0.863674496644295,0,0,200,303,11,75,2,76,10,2
"1465","2020-03-24",14,18,51,66,2384,0.863674496644295,0,0,200,303,11,86,3,79,10,3
"1466","2020-03-25",17,18,54,73,2384,0.863674496644295,0,0,200,303,13,99,1,80,10,1
"1467","2020-03-26",19,18,54,83,2384,0.863674496644295,0,0,200,303,20,119,1,81,16,1
"1468","2020-03-27",20,18,62,91,2384,0.863674496644295,0,0,200,303,18,137,4,85,16,4
"1469","2020-03-28",24,18,54,95,2384,0.863674496644295,0,0,200,303,21,158,NA,NA,17,NA
"1470","2020-03-29",26,18,50,100,2384,0.863674496644295,0,0,200,303,13,171,4,89,12,4
"1471","2020-03-30",28,18,48,107,2384,0.863674496644295,0,0,200,303,21,192,2,91,19,2
"1472","2020-03-31",25,18,41,123,2384,0.863674496644295,0,0,200,303,23,215,9,100,22,9
"1473","2020-04-01",24,18,28,132,2384,0.863674496644295,0,0,200,303,19,234,5,105,18,5
"1474","2020-04-02",32,18,25,140,2384,0.863674496644295,0,0,200,303,16,250,4,109,15,4
"1475","2020-04-03",38,18,20,142,2384,0.863674496644295,0,0,200,303,20,270,11,120,15,11
"1476","2020-04-04",37,18,21,154,2384,0.863674496644295,0,0,200,303,22,292,8,128,19,8
"1477","2020-04-05",44,18,22,160,2384,0.863674496644295,0,0,200,303,29,321,11,139,28,11
"1478","2020-04-06",42,18,36,166,2384,0.863674496644295,0,0,200,303,29,350,4,143,26,4
"1479","2020-04-07",45,18,42,178,2384,0.863674496644295,0,0,200,303,34,384,3,146,34,3
"1480","2020-04-08",49,18,47,190,2384,0.863674496644295,0,0,200,303,29,413,8,154,29,8
"1481","2020-04-09",50,18,51,194,2384,0.863674496644295,0,0,200,303,30,443,2,156,27,2
"1482","2020-04-10",47,18,45,200,2384,0.863674496644295,0,0,200,303,39,482,3,159,37,3
"1483","2020-04-11",51,18,48,204,2384,0.863674496644295,0,0,200,303,40,522,10,169,37,10
"1484","2020-04-12",49,18,51,204,2384,0.863674496644295,0,0,200,303,51,573,3,172,48,3
"1485","2020-04-13",53,18,46,206,2384,0.863674496644295,0,0,200,303,46,619,6,178,42,6
"1486","2020-04-14",56,18,38,213,2384,0.863674496644295,0,0,200,303,38,657,18,196,36,18
"1487","2020-04-15",58,18,40,215,2384,0.863674496644295,0,0,200,303,50,707,8,204,47,8
"1488","2020-04-16",54,18,41,221,2384,0.863674496644295,0,0,200,303,51,758,8,212,47,8
"1489","2020-04-17",59,18,57,225,2384,0.863674496644295,0,0,200,303,48,806,15,227,44,15
"1490","2020-04-18",70,18,60,226,2384,0.863674496644295,0,0,200,303,44,850,18,245,42,18
"1491","2020-04-19",68,18,61,244,2384,0.863674496644295,0,0,200,303,58,908,6,251,56,6
"1492","2020-04-20",66,18,59,248,2384,0.863674496644295,0,0,200,303,60,968,6,257,54,6
"1493","2020-04-21",68,18,60,258,2384,0.863674496644295,0,0,200,303,55,1023,6,263,55,6
"1494","2020-04-22",80,18,57,265,2384,0.863674496644295,0,0,200,303,57,1080,19,282,51,19
"1495","2020-04-23",84,18,53,262,2384,0.863674496644295,0,0,200,303,28,1108,6,288,27,6
"1496","2020-04-24",80,18,70,266,2384,0.863674496644295,0,0,200,303,64,1172,8,296,61,8
"1497","2020-04-25",76,18,70,281,2384,0.863674496644295,0,0,200,303,51,1223,7,303,49,7
"1498","2020-04-26",85,18,70,292,2384,0.863674496644295,0,0,200,303,57,1280,8,311,52,8
"1499","2020-04-27",89,18,66,307,2384,0.863674496644295,0,0,200,303,55,1335,10,321,55,10
"1500","2020-04-28",86,18,66,304,2384,0.863674496644295,0,0,200,303,45,1380,17,338,45,17
"1501","2020-04-29",75,18,88,302,2384,0.863674496644295,0,0,200,303,61,1441,20,358,59,20
"1502","2020-04-30",81,18,94,309,2384,0.863674496644295,0,0,200,303,60,1501,25,383,56,25
"1503","2020-05-01",84,18,92,303,2384,0.863674496644295,0,0,200,303,55,1556,9,392,55,9
"1504","2020-05-02",76,18,83,299,2384,0.863674496644295,0,0,200,303,61,1617,14,406,58,14
"1505","2020-05-03",72,18,67,313,2384,0.863674496644295,0,0,200,303,69,1686,7,413,65,7
"1506","2020-05-04",74,18,59,314,2384,0.863674496644295,0,0,200,303,45,1731,17,430,43,17
"1507","2020-05-05",84,18,56,331,2384,0.863674496644295,0,0,200,303,66,1797,11,441,64,11
"1508","2020-05-06",83,18,52,334,2384,0.863674496644295,0,0,200,303,50,1847,11,452,47,11
"1509","2020-05-07",76,18,46,331,2384,0.863674496644295,0,0,200,303,61,1908,11,463,60,11
"1510","2020-05-08",81,18,41,337,2384,0.863674496644295,0,0,200,303,47,1955,11,474,47,11
"1511","2020-05-09",89,18,44,347,2384,0.863674496644295,0,0,200,303,46,2001,6,480,42,6
"1512","2020-05-10",94,18,59,370,2384,0.863674496644295,0,0,200,303,45,2046,18,498,41,18
"1513","2020-05-11",93,18,57,381,2384,0.863674496644295,0,0,200,303,46,2092,8,506,45,8
"1514","2020-05-12",92,18,54,389,2384,0.863674496644295,0,0,200,303,46,2138,15,521,44,15
"1515","2020-05-13",96,18,62,384,2384,0.863674496644295,0,0,200,303,40,2178,10,531,38,10
"1516","2020-05-14",97,18,64,394,2384,0.863674496644295,0,0,200,303,45,2223,14,545,43,14
"1517","2020-05-15",96,18,62,432,2384,0.863674496644295,0,0,200,303,28,2251,15,560,27,15
"1518","2020-05-16",102,18,52,442,2384,0.863674496644295,0,0,200,303,54,2305,15,575,53,15
"1519","2020-05-17",99,18,56,456,2384,0.863674496644295,0,0,200,303,46,2351,12,587,43,12
"1520","2020-05-18",105,18,79,461,2384,0.863674496644295,0,0,200,303,42,2393,16,603,42,16
"1521","2020-05-19",109,18,72,453,2384,0.863674496644295,0,0,200,303,42,2435,19,622,41,19
"1522","2020-05-20",114,18,59,445,2384,0.863674496644295,0,0,200,303,33,2468,10,632,33,10
"1523","2020-05-21",120,18,59,471,2384,0.863674496644295,0,0,200,303,32,2500,10,642,32,10
"1524","2020-05-22",128,18,51,472,2384,0.863674496644295,0,0,200,303,25,2525,7,649,23,7
"1525","2020-05-23",128,18,40,455,2384,0.863674496644295,0,0,200,303,28,2553,11,660,27,11
"1526","2020-05-24",130,18,37,461,2384,0.863674496644295,0,0,200,303,25,2578,14,674,18,14
"1527","2020-05-25",141,18,39,481,2384,0.863674496644295,0,0,200,303,31,2609,13,687,28,13
"1528","2020-05-26",139,18,44,491,2384,0.863674496644295,0,0,200,303,21,2630,18,705,20,18
"1529","2020-05-27",139,18,44,485,2384,0.863674496644295,0,0,200,303,14,2644,10,715,12,10
"1530","2020-05-28",140,18,51,484,2384,0.863674496644295,0,0,200,303,23,2667,16,731,23,16
"1531","2020-05-29",139,18,61,485,2384,0.863674496644295,0,0,200,303,19,2686,16,747,18,16
"1532","2020-05-30",145,18,63,473,2384,0.863674496644295,0,0,200,303,18,2704,5,752,14,5
"1533","2020-05-31",151,18,63,462,2384,0.863674496644295,0,0,200,303,18,2722,5,757,16,5
"1534","2020-06-01",145,18,60,471,2384,0.863674496644295,0,0,200,303,23,2745,10,767,21,10
"1535","2020-06-02",141,18,57,447,2384,0.863674496644295,0,0,200,303,15,2760,6,773,13,6
"1536","2020-06-03",144,18,54,424,2384,0.863674496644295,0,0,200,303,9,2769,2,775,8,2
"1537","2020-06-04",145,18,55,406,2384,0.863674496644295,0,0,200,303,18,2787,5,780,17,5
"1538","2020-06-05",138,18,47,404,2384,0.863674496644295,0,0,200,303,19,2806,5,785,19,5
"1539","2020-06-06",134,18,39,391,2384,0.863674496644295,0,0,200,303,15,2821,4,789,14,4
"1540","2020-06-07",123,18,26,388,2384,0.863674496644295,0,0,200,303,19,2840,6,795,19,6
"1541","2020-03-13",1,19,13,19,1415,0.51095406360424,0,0,129,185,4,17,7,20,1,7
"1542","2020-03-14",3,19,16,28,1415,0.51095406360424,0,0,129,185,5,22,11,31,1,11
"1543","2020-03-15",3,19,11,32,1415,0.51095406360424,0,0,129,185,6,28,5,36,2,5
"1544","2020-03-16",4,19,16,35,1415,0.51095406360424,0,0,129,185,12,40,7,43,3,7
"1545","2020-03-17",6,19,19,47,1415,0.51095406360424,0,0,129,185,19,59,6,49,7,6
"1546","2020-03-18",8,19,10,59,1415,0.51095406360424,0,0,129,185,8,67,4,53,4,4
"1547","2020-03-19",10,19,11,70,1415,0.51095406360424,0,0,129,185,12,79,4,57,6,4
"1548","2020-03-20",9,19,12,86,1415,0.51095406360424,0,0,129,185,16,95,3,60,8,3
"1549","2020-03-21",9,19,17,100,1415,0.51095406360424,0,0,129,185,18,113,3,63,13,3
"1550","2020-03-22",13,19,30,102,1415,0.51095406360424,0,0,129,185,22,135,6,69,18,6
"1551","2020-03-23",15,19,31,103,1415,0.51095406360424,0,0,129,185,30,165,7,76,19,7
"1552","2020-03-24",21,19,30,113,1415,0.51095406360424,0,0,129,185,19,184,11,87,11,11
"1553","2020-03-25",25,19,35,128,1415,0.51095406360424,0,0,129,185,22,206,8,95,13,8
"1554","2020-03-26",33,19,34,132,1415,0.51095406360424,0,0,129,185,25,231,11,106,17,11
"1555","2020-03-27",34,19,34,136,1415,0.51095406360424,0,0,129,185,34,265,13,119,25,13
"1556","2020-03-28",37,19,43,137,1415,0.51095406360424,0,0,129,185,23,288,18,137,18,18
"1557","2020-03-29",39,19,41,139,1415,0.51095406360424,0,0,129,185,39,327,4,141,24,4
"1558","2020-03-30",42,19,33,138,1415,0.51095406360424,0,0,129,185,32,359,5,146,25,5
"1559","2020-03-31",45,19,33,146,1415,0.51095406360424,0,0,129,185,35,394,4,150,28,4
"1560","2020-04-01",42,19,40,152,1415,0.51095406360424,0,0,129,185,40,434,5,155,29,5
"1561","2020-04-02",35,19,42,154,1415,0.51095406360424,0,0,129,185,29,463,2,157,17,2
"1562","2020-04-03",39,19,43,165,1415,0.51095406360424,0,0,129,185,42,505,4,161,33,4
"1563","2020-04-04",43,19,44,164,1415,0.51095406360424,0,0,129,185,39,544,9,170,34,9
"1564","2020-04-05",42,19,42,164,1415,0.51095406360424,0,0,129,185,45,589,4,174,35,4
"1565","2020-04-06",41,19,41,173,1415,0.51095406360424,0,0,129,185,41,630,4,178,33,4
"1566","2020-04-07",40,19,33,177,1415,0.51095406360424,0,0,129,185,42,672,13,191,34,13
"1567","2020-04-08",46,19,33,185,1415,0.51095406360424,0,0,129,185,53,725,2,193,43,2
"1568","2020-04-09",54,19,27,186,1415,0.51095406360424,0,0,129,185,54,779,4,197,46,4
"1569","2020-04-10",58,19,32,188,1415,0.51095406360424,0,0,129,185,45,824,9,206,37,9
"1570","2020-04-11",58,19,38,196,1415,0.51095406360424,0,0,129,185,50,874,10,216,41,10
"1571","2020-04-12",64,19,40,198,1415,0.51095406360424,0,0,129,185,75,949,3,219,68,3
"1572","2020-04-13",63,19,41,206,1415,0.51095406360424,0,0,129,185,91,1040,13,232,72,13
"1573","2020-04-14",59,19,51,218,1415,0.51095406360424,0,0,129,185,46,1086,5,237,35,5
"1574","2020-04-15",56,19,61,230,1415,0.51095406360424,0,0,129,185,55,1141,1,238,39,1
"1575","2020-04-16",52,19,71,224,1415,0.51095406360424,0,0,129,185,60,1201,7,245,54,7
"1576","2020-04-17",53,19,76,220,1415,0.51095406360424,0,0,129,185,54,1255,14,259,46,14
"1577","2020-04-18",58,19,70,217,1415,0.51095406360424,0,0,129,185,95,1350,9,268,81,9
"1578","2020-04-19",58,19,65,226,1415,0.51095406360424,0,0,129,185,64,1414,11,279,57,11
"1579","2020-04-20",64,19,59,230,1415,0.51095406360424,0,0,129,185,68,1482,22,301,56,22
"1580","2020-04-21",62,19,60,232,1415,0.51095406360424,0,0,129,185,66,1548,23,324,52,23
"1581","2020-04-22",67,19,54,238,1415,0.51095406360424,0,0,129,185,92,1640,15,339,80,15
"1582","2020-04-23",68,19,48,250,1415,0.51095406360424,0,0,129,185,65,1705,11,350,53,11
"1583","2020-04-24",66,19,42,251,1415,0.51095406360424,0,0,129,185,58,1763,11,361,52,11
"1584","2020-04-25",58,19,45,249,1415,0.51095406360424,0,0,129,185,61,1824,18,379,54,18
"1585","2020-04-26",56,19,38,252,1415,0.51095406360424,0,0,129,185,50,1874,25,404,46,25
"1586","2020-04-27",61,19,40,258,1415,0.51095406360424,0,0,129,185,54,1928,9,413,42,9
"1587","2020-04-28",67,19,43,252,1415,0.51095406360424,0,0,129,185,60,1988,9,422,51,9
"1588","2020-04-29",68,19,44,249,1415,0.51095406360424,0,0,129,185,59,2047,18,440,50,18
"1589","2020-04-30",70,19,41,244,1415,0.51095406360424,0,0,129,185,40,2087,7,447,34,7
"1590","2020-05-01",66,19,52,247,1415,0.51095406360424,0,0,129,185,61,2148,5,452,50,5
"1591","2020-05-02",75,19,57,251,1415,0.51095406360424,0,0,129,185,35,2183,8,460,28,8
"1592","2020-05-03",82,19,58,245,1415,0.51095406360424,0,0,129,185,52,2235,24,484,41,24
"1593","2020-05-04",75,19,65,241,1415,0.51095406360424,0,0,129,185,50,2285,8,492,41,8
"1594","2020-05-05",75,19,66,236,1415,0.51095406360424,0,0,129,185,40,2325,19,511,28,19
"1595","2020-05-06",72,19,62,236,1415,0.51095406360424,0,0,129,185,35,2360,13,524,31,13
"1596","2020-05-07",70,19,68,232,1415,0.51095406360424,0,0,129,185,44,2404,10,534,29,10
"1597","2020-05-08",73,19,67,226,1415,0.51095406360424,0,0,129,185,28,2432,5,539,20,5
"1598","2020-05-09",63,19,71,232,1415,0.51095406360424,0,0,129,185,47,2479,12,551,39,12
"1599","2020-05-10",59,19,78,226,1415,0.51095406360424,0,0,129,185,38,2517,23,574,28,23
"1600","2020-05-11",62,19,71,216,1415,0.51095406360424,0,0,129,185,28,2545,7,581,25,7
"1601","2020-05-12",60,19,69,212,1415,0.51095406360424,0,0,129,185,31,2576,4,585,24,4
"1602","2020-05-13",59,19,77,205,1415,0.51095406360424,0,0,129,185,34,2610,20,605,27,20
"1603","2020-05-14",65,19,76,198,1415,0.51095406360424,0,0,129,185,36,2646,13,618,26,13
"1604","2020-05-15",65,19,68,201,1415,0.51095406360424,0,0,129,185,22,2668,7,625,18,7
"1605","2020-05-16",65,19,60,201,1415,0.51095406360424,0,0,129,185,20,2688,9,634,13,9
"1606","2020-05-17",60,19,56,192,1415,0.51095406360424,0,0,129,185,28,2716,6,640,22,6
"1607","2020-05-18",58,19,47,182,1415,0.51095406360424,0,0,129,185,25,2741,7,647,20,7
"1608","2020-05-19",59,19,46,180,1415,0.51095406360424,0,0,129,185,19,2760,6,653,13,6
"1609","2020-05-20",58,19,41,173,1415,0.51095406360424,0,0,129,185,22,2782,6,659,15,6
"1610","2020-05-21",53,19,43,170,1415,0.51095406360424,0,0,129,185,32,2814,10,669,25,10
"1611","2020-05-22",54,19,45,158,1415,0.51095406360424,0,0,129,185,26,2840,8,677,21,8
"1612","2020-05-23",54,19,50,147,1415,0.51095406360424,0,0,129,185,29,2869,4,681,21,4
"1613","2020-05-24",56,19,56,142,1415,0.51095406360424,0,0,129,185,29,2898,14,695,24,14
"1614","2020-05-25",49,19,50,137,1415,0.51095406360424,0,0,129,185,17,2915,15,710,14,15
"1615","2020-05-26",50,19,47,131,1415,0.51095406360424,0,0,129,185,28,2943,17,727,18,17
"1616","2020-05-27",49,19,38,124,1415,0.51095406360424,0,0,129,185,19,2962,12,739,16,12
"1617","2020-05-28",47,19,33,122,1415,0.51095406360424,0,0,129,185,25,2987,5,744,19,5
"1618","2020-05-29",45,19,36,121,1415,0.51095406360424,0,0,129,185,42,3029,5,749,34,5
"1619","2020-05-30",46,19,28,114,1415,0.51095406360424,0,0,129,185,26,3055,12,761,24,12
"1620","2020-05-31",40,19,25,112,1415,0.51095406360424,0,0,129,185,20,3075,9,770,16,9
"1621","2020-06-01",43,19,21,105,1415,0.51095406360424,0,0,129,185,18,3093,5,775,15,5
"1622","2020-06-02",39,19,23,102,1415,0.51095406360424,0,0,129,185,28,3121,11,786,24,11
"1623","2020-06-03",37,19,25,95,1415,0.51095406360424,0,0,129,185,29,3150,4,790,25,4
"1624","2020-06-04",33,19,22,92,1415,0.51095406360424,0,0,129,185,26,3176,8,798,21,8
"1625","2020-06-05",32,19,14,101,1415,0.51095406360424,0,0,129,185,24,3200,6,804,23,6
"1626","2020-06-06",31,19,13,97,1415,0.51095406360424,0,0,129,185,22,3222,4,808,18,4
"1627","2020-06-07",32,19,13,98,1415,0.51095406360424,0,0,129,185,18,3240,7,815,16,7
"1628","2020-03-15",1,20,21,11,3994,0.966199298948423,0,0,341,228,8,19,10,18,5,10
"1629","2020-03-16",1,20,19,13,3994,0.966199298948423,0,0,341,228,5,24,6,24,NA,6
"1630","2020-03-17",2,20,19,14,3994,0.966199298948423,0,0,341,228,6,30,5,29,5,5
"1631","2020-03-18",2,20,20,18,3994,0.966199298948423,0,0,341,228,8,38,5,34,7,5
"1632","2020-03-19",3,20,16,21,3994,0.966199298948423,0,0,341,228,6,44,7,41,3,7
"1633","2020-03-20",4,20,14,22,3994,0.966199298948423,0,0,341,228,8,52,9,50,5,9
"1634","2020-03-21",4,20,16,26,3994,0.966199298948423,0,0,341,228,9,61,8,58,7,8
"1635","2020-03-22",6,20,15,29,3994,0.966199298948423,0,0,341,228,15,76,3,61,11,3
"1636","2020-03-23",7,20,27,34,3994,0.966199298948423,0,0,341,228,10,86,12,73,8,12
"1637","2020-03-24",6,20,39,39,3994,0.966199298948423,0,0,341,228,9,95,12,85,9,12
"1638","2020-03-25",8,20,38,49,3994,0.966199298948423,0,0,341,228,8,103,12,97,5,12
"1639","2020-03-26",8,20,30,59,3994,0.966199298948423,0,0,341,228,9,112,8,105,5,8
"1640","2020-03-27",8,20,45,69,3994,0.966199298948423,0,0,341,228,14,126,4,109,11,4
"1641","2020-03-28",11,20,46,83,3994,0.966199298948423,0,0,341,228,18,144,6,115,16,6
"1642","2020-03-29",14,20,56,95,3994,0.966199298948423,0,0,341,228,13,157,6,121,12,6
"1643","2020-03-30",17,20,54,107,3994,0.966199298948423,0,0,341,228,16,173,9,130,15,9
"1644","2020-03-31",21,20,62,129,3994,0.966199298948423,0,0,341,228,20,193,15,145,17,15
"1645","2020-04-01",23,20,67,150,3994,0.966199298948423,0,0,341,228,11,204,9,154,8,9
"1646","2020-04-02",23,20,58,164,3994,0.966199298948423,0,0,341,228,13,217,8,162,10,8
"1647","2020-04-03",24,20,50,183,3994,0.966199298948423,0,0,341,228,19,236,10,172,16,10
"1648","2020-04-04",30,20,60,203,3994,0.966199298948423,0,0,341,228,11,247,5,177,8,5
"1649","2020-04-05",33,20,67,223,3994,0.966199298948423,0,0,341,228,16,263,16,193,15,16
"1650","2020-04-06",34,20,69,237,3994,0.966199298948423,0,0,341,228,24,287,10,203,23,10
"1651","2020-04-07",39,20,67,245,3994,0.966199298948423,0,0,341,228,24,311,11,214,23,11
"1652","2020-04-08",47,20,64,266,3994,0.966199298948423,0,0,341,228,25,336,13,227,20,13
"1653","2020-04-09",54,20,66,287,3994,0.966199298948423,0,0,341,228,19,355,13,240,18,13
"1654","2020-04-10",66,20,60,299,3994,0.966199298948423,0,0,341,228,21,376,13,253,16,13
"1655","2020-04-11",71,20,52,329,3994,0.966199298948423,0,0,341,228,29,405,4,257,25,4
"1656","2020-04-12",73,20,46,337,3994,0.966199298948423,0,0,341,228,22,427,19,276,16,19
"1657","2020-04-13",79,20,42,349,3994,0.966199298948423,0,0,341,228,21,448,10,286,16,10
"1658","2020-04-14",80,20,32,369,3994,0.966199298948423,0,0,341,228,27,475,11,297,23,11
"1659","2020-04-15",82,20,33,387,3994,0.966199298948423,0,0,341,228,41,516,5,302,30,5
"1660","2020-04-16",89,20,34,403,3994,0.966199298948423,0,0,341,228,28,544,8,310,26,8
"1661","2020-04-17",102,20,37,433,3994,0.966199298948423,0,0,341,228,35,579,10,320,33,10
"1662","2020-04-18",105,20,37,447,3994,0.966199298948423,0,0,341,228,35,614,17,337,33,17
"1663","2020-04-19",111,20,43,467,3994,0.966199298948423,0,0,341,228,44,658,8,345,39,8
"1664","2020-04-20",116,20,43,509,3994,0.966199298948423,0,0,341,228,36,694,10,355,32,10
"1665","2020-04-21",134,20,56,529,3994,0.966199298948423,0,0,341,228,31,725,19,374,27,19
"1666","2020-04-22",146,20,48,558,3994,0.966199298948423,0,0,341,228,24,749,10,384,20,10
"1667","2020-04-23",154,20,51,616,3994,0.966199298948423,0,0,341,228,44,793,11,395,42,11
"1668","2020-04-24",146,20,75,648,3994,0.966199298948423,0,0,341,228,28,821,10,405,23,10
"1669","2020-04-25",166,20,84,661,3994,0.966199298948423,0,0,341,228,43,864,13,418,40,13
"1670","2020-04-26",171,20,73,714,3994,0.966199298948423,0,0,341,228,20,884,14,432,19,14
"1671","2020-04-27",177,20,78,751,3994,0.966199298948423,0,0,341,228,38,922,14,446,34,14
"1672","2020-04-28",186,20,75,781,3994,0.966199298948423,0,0,341,228,28,950,14,460,26,14
"1673","2020-04-29",183,20,73,796,3994,0.966199298948423,0,0,341,228,37,987,21,481,35,21
"1674","2020-04-30",191,20,69,799,3994,0.966199298948423,0,0,341,228,39,1026,16,497,36,16
"1675","2020-05-01",209,20,56,812,3994,0.966199298948423,0,0,341,228,33,1059,16,513,25,16
"1676","2020-05-02",199,20,48,833,3994,0.966199298948423,0,0,341,228,36,1095,17,530,33,17
"1677","2020-05-03",206,20,42,850,3994,0.966199298948423,0,0,341,228,25,1120,16,546,23,16
"1678","2020-05-04",233,20,39,862,3994,0.966199298948423,0,0,341,228,36,1156,16,562,30,16
"1679","2020-05-05",238,20,36,860,3994,0.966199298948423,0,0,341,228,27,1183,25,587,26,25
"1680","2020-05-06",257,20,35,843,3994,0.966199298948423,0,0,341,228,35,1218,28,615,29,28
"1681","2020-05-07",257,20,38,853,3994,0.966199298948423,0,0,341,228,37,1255,30,645,34,30
"1682","2020-05-08",257,20,39,840,3994,0.966199298948423,0,0,341,228,24,1279,19,664,23,19
"1683","2020-05-09",264,20,31,846,3994,0.966199298948423,0,0,341,228,28,1307,30,694,23,30
"1684","2020-05-10",268,20,30,851,3994,0.966199298948423,0,0,341,228,29,1336,18,712,26,18
"1685","2020-05-11",254,20,28,847,3994,0.966199298948423,0,0,341,228,41,1377,14,726,38,14
"1686","2020-05-12",243,20,44,839,3994,0.966199298948423,0,0,341,228,25,1402,28,754,23,28
"1687","2020-05-13",230,20,44,826,3994,0.966199298948423,0,0,341,228,33,1435,21,775,31,21
"1688","2020-05-14",232,20,57,834,3994,0.966199298948423,0,0,341,228,24,1459,19,794,22,19
"1689","2020-05-15",225,20,64,797,3994,0.966199298948423,0,0,341,228,25,1484,17,811,22,17
"1690","2020-05-16",229,20,63,792,3994,0.966199298948423,0,0,341,228,29,1513,19,830,27,19
"1691","2020-05-17",223,20,55,789,3994,0.966199298948423,0,0,341,228,21,1534,22,852,20,22
"1692","2020-05-18",221,20,50,770,3994,0.966199298948423,0,0,341,228,24,1558,11,863,20,11
"1693","2020-05-19",236,20,54,772,3994,0.966199298948423,0,0,341,228,26,1584,11,874,24,11
"1694","2020-05-20",235,20,63,765,3994,0.966199298948423,0,0,341,228,26,1610,15,889,24,15
"1695","2020-05-21",238,20,67,775,3994,0.966199298948423,0,0,341,228,25,1635,19,908,22,19
"1696","2020-05-22",236,20,56,742,3994,0.966199298948423,0,0,341,228,23,1658,16,924,22,16
"1697","2020-05-23",231,20,57,734,3994,0.966199298948423,0,0,341,228,24,1682,12,936,23,12
"1698","2020-05-24",240,20,61,716,3994,0.966199298948423,0,0,341,228,23,1705,7,943,20,7
"1699","2020-05-25",238,20,64,692,3994,0.966199298948423,0,0,341,228,18,1723,5,948,16,5
"1700","2020-05-26",220,20,58,682,3994,0.966199298948423,0,0,341,228,22,1745,6,954,21,6
"1701","2020-05-27",221,20,52,648,3994,0.966199298948423,0,0,341,228,29,1774,6,960,27,6
"1702","2020-05-28",211,20,61,624,3994,0.966199298948423,0,0,341,228,24,1798,13,973,22,13
"1703","2020-05-29",215,20,71,612,3994,0.966199298948423,0,0,341,228,32,1830,12,985,31,12
"1704","2020-05-30",212,20,68,582,3994,0.966199298948423,0,0,341,228,24,1854,5,990,23,5
"1705","2020-05-31",206,20,75,577,3994,0.966199298948423,0,0,341,228,18,1872,14,1004,17,14
"1706","2020-06-01",203,20,65,550,3994,0.966199298948423,0,0,341,228,26,1898,14,1018,26,14
"1707","2020-06-02",194,20,54,518,3994,0.966199298948423,0,0,341,228,17,1915,10,1028,16,10
"1708","2020-06-03",189,20,45,497,3994,0.966199298948423,0,0,341,228,19,1934,10,1038,19,10
"1709","2020-06-04",178,20,43,474,3994,0.966199298948423,0,0,341,228,22,1956,11,1049,21,11
"1710","2020-06-05",158,20,41,457,3994,0.966199298948423,0,0,341,228,22,1978,17,1066,21,17
"1711","2020-06-06",152,20,43,420,3994,0.966199298948423,0,0,341,228,21,1999,9,1075,17,9
"1712","2020-06-07",144,20,38,393,3994,0.966199298948423,0,0,341,228,22,2021,13,1088,21,13
