"","Date","Absents","Paramset","Infections_or_Exposed_per_day_Patient","Infections_or_Exposed_per_day_HCW","total_infections","nosocomial_proportion","PCR_pooled","LFD_pooled","HCW_symp_test","patient_symp_test","new_hcw_infs","cumulative_hcw_infs","new_pat_infs","cumulative_pats_infs","new_nosocomial_hcw_infs","new_nosocomial_pat_infs"
"1","2020-03-13",4,1,26,71,3936,0.471290650406504,8445,28104,234,476,27,71,12,19,4,12
"2","2020-03-14",9,1,26,97,3936,0.471290650406504,8445,28104,234,476,26,97,3,22,6,3
"3","2020-03-15",11,1,22,126,3936,0.471290650406504,8445,28104,234,476,29,126,3,25,11,3
"4","2020-03-16",14,1,26,164,3936,0.471290650406504,8445,28104,234,476,38,164,5,30,15,5
"5","2020-03-17",17,1,32,193,3936,0.471290650406504,8445,28104,234,476,32,196,9,39,11,9
"6","2020-03-18",26,1,43,224,3936,0.471290650406504,8445,28104,234,476,36,232,12,51,8,12
"7","2020-03-19",35,1,56,251,3936,0.471290650406504,8445,28104,234,476,38,270,18,69,12,18
"8","2020-03-20",53,1,63,284,3936,0.471290650406504,8445,28104,234,476,41,311,14,83,13,14
"9","2020-03-21",76,1,74,308,3936,0.471290650406504,8445,28104,234,476,31,342,16,99,13,16
"10","2020-03-22",84,1,73,346,3936,0.471290650406504,8445,28104,234,476,48,390,13,112,19,13
"11","2020-03-23",85,1,74,360,3936,0.471290650406504,8445,28104,234,476,34,424,7,119,18,7
"12","2020-03-24",99,1,78,381,3936,0.471290650406504,8445,28104,234,476,51,475,14,133,33,14
"13","2020-03-25",99,1,63,389,3936,0.471290650406504,8445,28104,234,476,35,510,4,137,19,4
"14","2020-03-26",108,1,67,396,3936,0.471290650406504,8445,28104,234,476,43,553,10,147,23,10
"15","2020-03-27",128,1,75,422,3936,0.471290650406504,8445,28104,234,476,63,616,15,162,40,15
"16","2020-03-28",128,1,69,443,3936,0.471290650406504,8445,28104,234,476,50,666,10,172,25,10
"17","2020-03-29",127,1,59,477,3936,0.471290650406504,8445,28104,234,476,60,726,10,182,32,10
"18","2020-03-30",132,1,68,501,3936,0.471290650406504,8445,28104,234,476,56,782,15,197,28,15
"19","2020-03-31",122,1,78,516,3936,0.471290650406504,8445,28104,234,476,55,837,16,213,31,16
"20","2020-04-01",132,1,83,525,3936,0.471290650406504,8445,28104,234,476,46,883,24,237,27,24
"21","2020-04-02",137,1,86,535,3936,0.471290650406504,8445,28104,234,476,59,942,21,258,37,21
"22","2020-04-03",146,1,77,531,3936,0.471290650406504,8445,28104,234,476,36,978,13,271,19,13
"23","2020-04-04",185,1,78,552,3936,0.471290650406504,8445,28104,234,476,61,1039,8,279,33,8
"24","2020-04-05",190,1,79,566,3936,0.471290650406504,8445,28104,234,476,64,1103,11,290,33,11
"25","2020-04-06",179,1,74,595,3936,0.471290650406504,8445,28104,234,476,79,1182,8,298,45,8
"26","2020-04-07",185,1,72,609,3936,0.471290650406504,8445,28104,234,476,52,1234,10,308,25,10
"27","2020-04-08",189,1,58,613,3936,0.471290650406504,8445,28104,234,476,53,1287,7,315,27,7
"28","2020-04-09",187,1,59,633,3936,0.471290650406504,8445,28104,234,476,67,1354,10,325,38,10
"29","2020-04-10",214,1,62,636,3936,0.471290650406504,8445,28104,234,476,55,1409,13,338,26,13
"30","2020-04-11",201,1,72,632,3936,0.471290650406504,8445,28104,234,476,51,1460,17,355,28,17
"31","2020-04-12",215,1,83,638,3936,0.471290650406504,8445,28104,234,476,58,1518,18,373,33,18
"32","2020-04-13",217,1,87,631,3936,0.471290650406504,8445,28104,234,476,53,1571,17,390,29,17
"33","2020-04-14",205,1,92,621,3936,0.471290650406504,8445,28104,234,476,46,1617,15,405,23,15
"34","2020-04-15",210,1,106,621,3936,0.471290650406504,8445,28104,234,476,58,1675,25,430,32,25
"35","2020-04-16",202,1,108,631,3936,0.471290650406504,8445,28104,234,476,57,1732,26,456,28,26
"36","2020-04-17",220,1,115,622,3936,0.471290650406504,8445,28104,234,476,64,1796,21,477,31,21
"37","2020-04-18",208,1,120,637,3936,0.471290650406504,8445,28104,234,476,76,1872,32,509,36,32
"38","2020-04-19",187,1,138,626,3936,0.471290650406504,8445,28104,234,476,52,1924,30,539,26,30
"39","2020-04-20",195,1,162,628,3936,0.471290650406504,8445,28104,234,476,56,1980,42,581,24,42
"40","2020-04-21",210,1,158,640,3936,0.471290650406504,8445,28104,234,476,61,2041,32,613,35,32
"41","2020-04-22",207,1,148,627,3936,0.471290650406504,8445,28104,234,476,48,2089,17,630,32,17
"42","2020-04-23",216,1,128,618,3936,0.471290650406504,8445,28104,234,476,48,2137,17,647,19,17
"43","2020-04-24",229,1,118,634,3936,0.471290650406504,8445,28104,234,476,69,2206,11,658,30,11
"44","2020-04-25",233,1,104,632,3936,0.471290650406504,8445,28104,234,476,55,2261,12,670,24,12
"45","2020-04-26",220,1,102,637,3936,0.471290650406504,8445,28104,234,476,62,2323,7,677,28,7
"46","2020-04-27",217,1,113,644,3936,0.471290650406504,8445,28104,234,476,57,2380,30,707,30,30
"47","2020-04-28",200,1,120,636,3936,0.471290650406504,8445,28104,234,476,51,2431,25,732,29,25
"48","2020-04-29",196,1,116,643,3936,0.471290650406504,8445,28104,234,476,53,2484,11,743,30,11
"49","2020-04-30",197,1,121,632,3936,0.471290650406504,8445,28104,234,476,58,2542,32,775,31,32
"50","2020-05-01",214,1,140,636,3936,0.471290650406504,8445,28104,234,476,62,2604,33,808,34,33
"51","2020-05-02",225,1,143,621,3936,0.471290650406504,8445,28104,234,476,52,2656,31,839,26,31
"52","2020-05-03",192,1,131,627,3936,0.471290650406504,8445,28104,234,476,58,2714,14,853,24,14
"53","2020-05-04",171,1,127,608,3936,0.471290650406504,8445,28104,234,476,45,2759,25,878,30,25
"54","2020-05-05",177,1,127,605,3936,0.471290650406504,8445,28104,234,476,49,2808,14,892,12,14
"55","2020-05-06",179,1,131,591,3936,0.471290650406504,8445,28104,234,476,46,2854,26,918,26,26
"56","2020-05-07",181,1,140,575,3936,0.471290650406504,8445,28104,234,476,48,2902,30,948,24,30
"57","2020-05-08",175,1,149,564,3936,0.471290650406504,8445,28104,234,476,48,2950,31,979,26,31
"58","2020-05-09",175,1,142,563,3936,0.471290650406504,8445,28104,234,476,49,2999,19,998,25,19
"59","2020-05-10",180,1,132,542,3936,0.471290650406504,8445,28104,234,476,41,3040,27,1025,22,27
"60","2020-05-11",184,1,124,543,3936,0.471290650406504,8445,28104,234,476,41,3081,17,1042,17,17
"61","2020-05-12",175,1,152,529,3936,0.471290650406504,8445,28104,234,476,44,3125,37,1079,22,37
"62","2020-05-13",171,1,158,535,3936,0.471290650406504,8445,28104,234,476,46,3171,34,1113,26,34
"63","2020-05-14",167,1,136,513,3936,0.471290650406504,8445,28104,234,476,34,3205,20,1133,21,20
"64","2020-05-15",165,1,143,494,3936,0.471290650406504,8445,28104,234,476,32,3237,25,1158,15,25
"65","2020-05-16",177,1,153,464,3936,0.471290650406504,8445,28104,234,476,25,3262,30,1188,15,30
"66","2020-05-17",171,1,157,456,3936,0.471290650406504,8445,28104,234,476,32,3294,27,1215,13,27
"67","2020-05-18",159,1,150,422,3936,0.471290650406504,8445,28104,234,476,27,3321,23,1238,13,23
"68","2020-05-19",154,1,136,406,3936,0.471290650406504,8445,28104,234,476,35,3356,22,1260,22,22
"69","2020-05-20",150,1,125,377,3936,0.471290650406504,8445,28104,234,476,16,3372,16,1276,7,16
"70","2020-05-21",147,1,114,374,3936,0.471290650406504,8445,28104,234,476,28,3400,13,1289,10,13
"71","2020-05-22",152,1,113,353,3936,0.471290650406504,8445,28104,234,476,29,3429,16,1305,12,16
"72","2020-05-23",133,1,105,339,3936,0.471290650406504,8445,28104,234,476,29,3458,12,1317,11,12
"73","2020-05-24",121,1,99,323,3936,0.471290650406504,8445,28104,234,476,26,3484,11,1328,9,11
"74","2020-05-25",117,1,101,318,3936,0.471290650406504,8445,28104,234,476,27,3511,20,1348,11,20
"75","2020-05-26",108,1,88,311,3936,0.471290650406504,8445,28104,234,476,32,3543,10,1358,16,10
"76","2020-05-27",98,1,94,302,3936,0.471290650406504,8445,28104,234,476,22,3565,13,1371,10,13
"77","2020-05-28",102,1,74,291,3936,0.471290650406504,8445,28104,234,476,17,3582,8,1379,9,8
"78","2020-05-29",103,1,69,283,3936,0.471290650406504,8445,28104,234,476,22,3604,6,1385,9,6
"79","2020-05-30",102,1,74,270,3936,0.471290650406504,8445,28104,234,476,13,3617,12,1397,6,12
"80","2020-05-31",82,1,81,258,3936,0.471290650406504,8445,28104,234,476,23,3640,14,1411,8,14
"81","2020-06-01",80,1,77,255,3936,0.471290650406504,8445,28104,234,476,21,3661,8,1419,7,8
"82","2020-06-02",78,1,74,248,3936,0.471290650406504,8445,28104,234,476,19,3680,13,1432,8,13
"83","2020-06-03",83,1,71,243,3936,0.471290650406504,8445,28104,234,476,23,3703,7,1439,13,7
"84","2020-06-04",69,1,61,233,3936,0.471290650406504,8445,28104,234,476,11,3714,5,1444,7,5
"85","2020-06-05",69,1,66,223,3936,0.471290650406504,8445,28104,234,476,22,3736,18,1462,13,18
"86","2020-06-06",65,1,73,224,3936,0.471290650406504,8445,28104,234,476,19,3755,16,1478,6,16
"87","2020-06-07",73,1,71,220,3936,0.471290650406504,8445,28104,234,476,18,3773,9,1487,7,9
"88","2020-03-12",1,2,20,23,4636,0.790336496980155,8235,29691,241,308,23,38,8,11,1,8
"89","2020-03-13",1,2,28,35,4636,0.790336496980155,8235,29691,241,308,27,65,13,24,3,13
"90","2020-03-14",4,2,23,48,4636,0.790336496980155,8235,29691,241,308,15,80,10,34,4,10
"91","2020-03-15",8,2,24,70,4636,0.790336496980155,8235,29691,241,308,25,105,11,45,5,11
"92","2020-03-16",9,2,38,90,4636,0.790336496980155,8235,29691,241,308,28,133,4,49,9,4
"93","2020-03-17",9,2,33,113,4636,0.790336496980155,8235,29691,241,308,28,161,13,62,12,13
"94","2020-03-18",13,2,34,133,4636,0.790336496980155,8235,29691,241,308,33,194,12,74,12,12
"95","2020-03-19",16,2,42,159,4636,0.790336496980155,8235,29691,241,308,35,229,15,89,15,15
"96","2020-03-20",29,2,44,179,4636,0.790336496980155,8235,29691,241,308,21,250,16,105,9,16
"97","2020-03-21",53,2,48,209,4636,0.790336496980155,8235,29691,241,308,35,285,13,118,15,13
"98","2020-03-22",58,2,39,239,4636,0.790336496980155,8235,29691,241,308,36,321,6,124,22,6
"99","2020-03-23",62,2,38,271,4636,0.790336496980155,8235,29691,241,308,37,358,13,137,20,13
"100","2020-03-24",66,2,39,310,4636,0.790336496980155,8235,29691,241,308,28,386,2,139,13,2
"101","2020-03-25",70,2,46,329,4636,0.790336496980155,8235,29691,241,308,38,424,10,149,27,10
"102","2020-03-26",76,2,48,376,4636,0.790336496980155,8235,29691,241,308,46,470,12,161,23,12
"103","2020-03-27",100,2,46,402,4636,0.790336496980155,8235,29691,241,308,39,509,11,172,17,11
"104","2020-03-28",93,2,51,443,4636,0.790336496980155,8235,29691,241,308,41,550,12,184,21,12
"105","2020-03-29",103,2,54,467,4636,0.790336496980155,8235,29691,241,308,44,594,14,198,26,14
"106","2020-03-30",109,2,55,499,4636,0.790336496980155,8235,29691,241,308,63,657,20,218,33,20
"107","2020-03-31",111,2,56,536,4636,0.790336496980155,8235,29691,241,308,43,700,11,229,27,11
"108","2020-04-01",119,2,58,581,4636,0.790336496980155,8235,29691,241,308,53,753,11,240,32,11
"109","2020-04-02",138,2,62,617,4636,0.790336496980155,8235,29691,241,308,59,812,11,251,34,11
"110","2020-04-03",166,2,69,656,4636,0.790336496980155,8235,29691,241,308,44,856,15,266,27,15
"111","2020-04-04",194,2,79,672,4636,0.790336496980155,8235,29691,241,308,51,907,14,280,28,14
"112","2020-04-05",208,2,78,712,4636,0.790336496980155,8235,29691,241,308,48,955,15,295,31,15
"113","2020-04-06",206,2,69,734,4636,0.790336496980155,8235,29691,241,308,74,1029,17,312,47,17
"114","2020-04-07",218,2,79,754,4636,0.790336496980155,8235,29691,241,308,67,1096,12,324,51,12
"115","2020-04-08",226,2,93,790,4636,0.790336496980155,8235,29691,241,308,62,1158,9,333,44,9
"116","2020-04-09",230,2,105,799,4636,0.790336496980155,8235,29691,241,308,67,1225,24,357,42,24
"117","2020-04-10",279,2,98,868,4636,0.790336496980155,8235,29691,241,308,51,1276,16,373,26,16
"118","2020-04-11",287,2,90,890,4636,0.790336496980155,8235,29691,241,308,65,1341,26,399,36,26
"119","2020-04-12",271,2,92,934,4636,0.790336496980155,8235,29691,241,308,68,1409,18,417,50,18
"120","2020-04-13",275,2,91,951,4636,0.790336496980155,8235,29691,241,308,62,1471,19,436,39,19
"121","2020-04-14",287,2,95,981,4636,0.790336496980155,8235,29691,241,308,64,1535,21,457,44,21
"122","2020-04-15",299,2,96,997,4636,0.790336496980155,8235,29691,241,308,66,1601,21,478,44,21
"123","2020-04-16",305,2,93,1019,4636,0.790336496980155,8235,29691,241,308,58,1659,28,506,32,28
"124","2020-04-17",335,2,92,1029,4636,0.790336496980155,8235,29691,241,308,63,1722,13,519,40,13
"125","2020-04-18",361,2,99,1032,4636,0.790336496980155,8235,29691,241,308,61,1783,16,535,34,16
"126","2020-04-19",346,2,98,1062,4636,0.790336496980155,8235,29691,241,308,53,1836,24,559,36,24
"127","2020-04-20",351,2,89,1057,4636,0.790336496980155,8235,29691,241,308,55,1891,21,580,32,21
"128","2020-04-21",333,2,84,1036,4636,0.790336496980155,8235,29691,241,308,52,1943,37,617,26,37
"129","2020-04-22",345,2,82,991,4636,0.790336496980155,8235,29691,241,308,64,2007,22,639,40,22
"130","2020-04-23",350,2,78,990,4636,0.790336496980155,8235,29691,241,308,55,2062,28,667,33,28
"131","2020-04-24",366,2,74,953,4636,0.790336496980155,8235,29691,241,308,75,2137,27,694,54,27
"132","2020-04-25",347,2,88,939,4636,0.790336496980155,8235,29691,241,308,69,2206,34,728,43,34
"133","2020-04-26",325,2,74,951,4636,0.790336496980155,8235,29691,241,308,60,2266,27,755,35,27
"134","2020-04-27",318,2,74,928,4636,0.790336496980155,8235,29691,241,308,57,2323,33,788,36,33
"135","2020-04-28",314,2,84,897,4636,0.790336496980155,8235,29691,241,308,62,2385,27,815,46,27
"136","2020-04-29",298,2,100,875,4636,0.790336496980155,8235,29691,241,308,47,2432,31,846,26,31
"137","2020-04-30",277,2,91,855,4636,0.790336496980155,8235,29691,241,308,58,2490,20,866,41,20
"138","2020-05-01",287,2,98,859,4636,0.790336496980155,8235,29691,241,308,47,2537,23,889,33,23
"139","2020-05-02",291,2,98,817,4636,0.790336496980155,8235,29691,241,308,47,2584,18,907,28,18
"140","2020-05-03",289,2,117,762,4636,0.790336496980155,8235,29691,241,308,77,2661,25,932,51,25
"141","2020-05-04",273,2,126,747,4636,0.790336496980155,8235,29691,241,308,60,2721,19,951,37,19
"142","2020-05-05",266,2,130,714,4636,0.790336496980155,8235,29691,241,308,76,2797,20,971,49,20
"143","2020-05-06",256,2,120,686,4636,0.790336496980155,8235,29691,241,308,53,2850,16,987,32,16
"144","2020-05-07",257,2,124,658,4636,0.790336496980155,8235,29691,241,308,50,2900,23,1010,35,23
"145","2020-05-08",251,2,125,639,4636,0.790336496980155,8235,29691,241,308,55,2955,18,1028,30,18
"146","2020-05-09",251,2,115,626,4636,0.790336496980155,8235,29691,241,308,44,2999,22,1050,27,22
"147","2020-05-10",217,2,104,597,4636,0.790336496980155,8235,29691,241,308,55,3054,9,1059,32,9
"148","2020-05-11",209,2,103,573,4636,0.790336496980155,8235,29691,241,308,54,3108,18,1077,34,18
"149","2020-05-12",199,2,100,551,4636,0.790336496980155,8235,29691,241,308,46,3154,17,1094,30,17
"150","2020-05-13",205,2,80,542,4636,0.790336496980155,8235,29691,241,308,44,3198,20,1114,28,20
"151","2020-05-14",207,2,83,527,4636,0.790336496980155,8235,29691,241,308,40,3238,26,1140,28,26
"152","2020-05-15",186,2,77,501,4636,0.790336496980155,8235,29691,241,308,45,3283,21,1161,28,21
"153","2020-05-16",173,2,84,494,4636,0.790336496980155,8235,29691,241,308,50,3333,28,1189,38,28
"154","2020-05-17",177,2,90,469,4636,0.790336496980155,8235,29691,241,308,33,3366,31,1220,24,31
"155","2020-05-18",168,2,98,454,4636,0.790336496980155,8235,29691,241,308,26,3392,23,1243,15,23
"156","2020-05-19",167,2,81,435,4636,0.790336496980155,8235,29691,241,308,34,3426,15,1258,21,15
"157","2020-05-20",155,2,72,413,4636,0.790336496980155,8235,29691,241,308,28,3454,16,1274,16,16
"158","2020-05-21",144,2,79,383,4636,0.790336496980155,8235,29691,241,308,29,3483,14,1288,14,14
"159","2020-05-22",142,2,82,368,4636,0.790336496980155,8235,29691,241,308,31,3514,11,1299,22,11
"160","2020-05-23",157,2,88,366,4636,0.790336496980155,8235,29691,241,308,29,3543,18,1317,17,18
"161","2020-05-24",134,2,97,351,4636,0.790336496980155,8235,29691,241,308,29,3572,18,1335,17,18
"162","2020-05-25",121,2,102,321,4636,0.790336496980155,8235,29691,241,308,29,3601,14,1349,19,14
"163","2020-05-26",113,2,83,307,4636,0.790336496980155,8235,29691,241,308,19,3620,13,1362,14,13
"164","2020-05-27",107,2,62,287,4636,0.790336496980155,8235,29691,241,308,31,3651,9,1371,23,9
"165","2020-05-28",102,2,55,275,4636,0.790336496980155,8235,29691,241,308,21,3672,11,1382,10,11
"166","2020-05-29",101,2,52,247,4636,0.790336496980155,8235,29691,241,308,21,3693,12,1394,11,12
"167","2020-05-30",96,2,43,235,4636,0.790336496980155,8235,29691,241,308,18,3711,15,1409,12,15
"168","2020-05-31",91,2,50,216,4636,0.790336496980155,8235,29691,241,308,23,3734,13,1422,14,13
"169","2020-06-01",90,2,50,210,4636,0.790336496980155,8235,29691,241,308,21,3755,14,1436,13,14
"170","2020-06-02",84,2,51,202,4636,0.790336496980155,8235,29691,241,308,21,3776,10,1446,15,10
"171","2020-06-03",82,2,52,196,4636,0.790336496980155,8235,29691,241,308,15,3791,8,1454,8,8
"172","2020-06-04",74,2,46,178,4636,0.790336496980155,8235,29691,241,308,16,3807,11,1465,6,11
"173","2020-06-05",73,2,48,165,4636,0.790336496980155,8235,29691,241,308,24,3831,10,1475,12,10
"174","2020-06-06",63,2,37,164,4636,0.790336496980155,8235,29691,241,308,10,3841,7,1482,8,7
"175","2020-06-07",60,2,28,168,4636,0.790336496980155,8235,29691,241,308,16,3857,10,1492,13,10
"176","2020-03-08",1,3,0,0,4915,0.660223804679552,8325,31173,294,871,NA,NA,NA,NA,NA,NA
"177","2020-03-09",1,3,0,0,4915,0.660223804679552,8325,31173,294,871,NA,NA,NA,NA,NA,NA
"178","2020-03-10",0,3,0,0,4915,0.660223804679552,8325,31173,294,871,1,1,1,1,1,1
"179","2020-03-11",0,3,0,0,4915,0.660223804679552,8325,31173,294,871,10,11,9,10,1,9
"180","2020-03-12",0,3,0,0,4915,0.660223804679552,8325,31173,294,871,10,21,10,20,5,10
"181","2020-03-13",2,3,42,54,4915,0.660223804679552,8325,31173,294,871,8,29,8,28,3,8
"182","2020-03-14",4,3,42,72,4915,0.660223804679552,8325,31173,294,871,13,42,10,38,8,10
"183","2020-03-15",11,3,52,98,4915,0.660223804679552,8325,31173,294,871,24,66,8,46,15,8
"184","2020-03-16",14,3,58,134,4915,0.660223804679552,8325,31173,294,871,25,91,8,54,19,8
"185","2020-03-17",15,3,86,170,4915,0.660223804679552,8325,31173,294,871,24,115,17,71,19,17
"186","2020-03-18",22,3,117,206,4915,0.660223804679552,8325,31173,294,871,27,142,20,91,21,20
"187","2020-03-19",27,3,134,253,4915,0.660223804679552,8325,31173,294,871,37,179,20,111,31,20
"188","2020-03-20",37,3,144,300,4915,0.660223804679552,8325,31173,294,871,48,227,14,125,39,14
"189","2020-03-21",47,3,146,334,4915,0.660223804679552,8325,31173,294,871,48,275,24,149,42,24
"190","2020-03-22",60,3,157,386,4915,0.660223804679552,8325,31173,294,871,57,332,24,173,52,24
"191","2020-03-23",79,3,157,426,4915,0.660223804679552,8325,31173,294,871,45,377,30,203,33,30
"192","2020-03-24",97,3,161,470,4915,0.660223804679552,8325,31173,294,871,55,432,26,229,49,26
"193","2020-03-25",103,3,162,510,4915,0.660223804679552,8325,31173,294,871,62,494,27,256,55,27
"194","2020-03-26",112,3,153,565,4915,0.660223804679552,8325,31173,294,871,75,569,20,276,70,20
"195","2020-03-27",136,3,189,612,4915,0.660223804679552,8325,31173,294,871,73,642,14,290,70,14
"196","2020-03-28",190,3,201,663,4915,0.660223804679552,8325,31173,294,871,77,719,16,306,75,16
"197","2020-03-29",187,3,187,707,4915,0.660223804679552,8325,31173,294,871,84,803,21,327,75,21
"198","2020-03-30",182,3,168,727,4915,0.660223804679552,8325,31173,294,871,77,880,19,346,69,19
"199","2020-03-31",184,3,164,771,4915,0.660223804679552,8325,31173,294,871,91,971,16,362,86,16
"200","2020-04-01",201,3,182,800,4915,0.660223804679552,8325,31173,294,871,106,1077,14,376,99,14
"201","2020-04-02",223,3,170,834,4915,0.660223804679552,8325,31173,294,871,95,1172,12,388,87,12
"202","2020-04-03",252,3,178,861,4915,0.660223804679552,8325,31173,294,871,105,1277,16,404,97,16
"203","2020-04-04",277,3,194,895,4915,0.660223804679552,8325,31173,294,871,113,1390,15,419,106,15
"204","2020-04-05",272,3,207,941,4915,0.660223804679552,8325,31173,294,871,119,1509,18,437,114,18
"205","2020-04-06",257,3,222,993,4915,0.660223804679552,8325,31173,294,871,122,1631,10,447,117,10
"206","2020-04-07",263,3,214,1001,4915,0.660223804679552,8325,31173,294,871,102,1733,16,463,98,16
"207","2020-04-08",279,3,191,1028,4915,0.660223804679552,8325,31173,294,871,148,1881,15,478,140,15
"208","2020-04-09",289,3,206,1036,4915,0.660223804679552,8325,31173,294,871,116,1997,14,492,107,14
"209","2020-04-10",335,3,237,1038,4915,0.660223804679552,8325,31173,294,871,137,2134,9,501,132,9
"210","2020-04-11",334,3,243,1069,4915,0.660223804679552,8325,31173,294,871,106,2240,24,525,105,24
"211","2020-04-12",349,3,240,1083,4915,0.660223804679552,8325,31173,294,871,144,2384,14,539,139,14
"212","2020-04-13",336,3,224,1064,4915,0.660223804679552,8325,31173,294,871,138,2522,23,562,134,23
"213","2020-04-14",340,3,214,1075,4915,0.660223804679552,8325,31173,294,871,131,2653,31,593,124,31
"214","2020-04-15",331,3,205,1063,4915,0.660223804679552,8325,31173,294,871,102,2755,49,642,99,49
"215","2020-04-16",336,3,207,1064,4915,0.660223804679552,8325,31173,294,871,140,2895,46,688,134,46
"216","2020-04-17",383,3,214,1021,4915,0.660223804679552,8325,31173,294,871,111,3006,31,719,106,31
"217","2020-04-18",370,3,196,1010,4915,0.660223804679552,8325,31173,294,871,130,3136,36,755,123,36
"218","2020-04-19",368,3,186,1002,4915,0.660223804679552,8325,31173,294,871,131,3267,41,796,123,41
"219","2020-04-20",369,3,175,984,4915,0.660223804679552,8325,31173,294,871,108,3375,33,829,102,33
"220","2020-04-21",350,3,168,935,4915,0.660223804679552,8325,31173,294,871,127,3502,32,861,119,32
"221","2020-04-22",343,3,215,897,4915,0.660223804679552,8325,31173,294,871,113,3615,27,888,104,27
"222","2020-04-23",331,3,241,903,4915,0.660223804679552,8325,31173,294,871,95,3710,41,929,91,41
"223","2020-04-24",342,3,239,855,4915,0.660223804679552,8325,31173,294,871,102,3812,33,962,96,33
"224","2020-04-25",325,3,239,841,4915,0.660223804679552,8325,31173,294,871,91,3903,34,996,86,34
"225","2020-04-26",290,3,241,799,4915,0.660223804679552,8325,31173,294,871,99,4002,22,1018,91,22
"226","2020-04-27",285,3,240,790,4915,0.660223804679552,8325,31173,294,871,70,4072,24,1042,63,24
"227","2020-04-28",275,3,232,764,4915,0.660223804679552,8325,31173,294,871,89,4161,19,1061,82,19
"228","2020-04-29",269,3,242,731,4915,0.660223804679552,8325,31173,294,871,74,4235,28,1089,70,28
"229","2020-04-30",263,3,245,710,4915,0.660223804679552,8325,31173,294,871,84,4319,24,1113,82,24
"230","2020-05-01",224,3,246,690,4915,0.660223804679552,8325,31173,294,871,54,4373,28,1141,51,28
"231","2020-05-02",229,3,247,666,4915,0.660223804679552,8325,31173,294,871,68,4441,16,1157,60,16
"232","2020-05-03",220,3,253,647,4915,0.660223804679552,8325,31173,294,871,51,4492,17,1174,44,17
"233","2020-05-04",210,3,275,644,4915,0.660223804679552,8325,31173,294,871,61,4553,17,1191,51,17
"234","2020-05-05",190,3,260,615,4915,0.660223804679552,8325,31173,294,871,42,4595,23,1214,38,23
"235","2020-05-06",185,3,292,609,4915,0.660223804679552,8325,31173,294,871,45,4640,26,1240,39,26
"236","2020-05-07",175,3,295,599,4915,0.660223804679552,8325,31173,294,871,40,4680,18,1258,39,18
"237","2020-05-08",169,3,292,583,4915,0.660223804679552,8325,31173,294,871,24,4704,26,1284,18,26
"238","2020-05-09",167,3,279,570,4915,0.660223804679552,8325,31173,294,871,34,4738,24,1308,32,24
"239","2020-05-10",172,3,274,552,4915,0.660223804679552,8325,31173,294,871,37,4775,21,1329,33,21
"240","2020-05-11",175,3,293,548,4915,0.660223804679552,8325,31173,294,871,45,4820,14,1343,40,14
"241","2020-05-12",170,3,280,528,4915,0.660223804679552,8325,31173,294,871,29,4849,12,1355,26,12
"242","2020-05-13",174,3,281,501,4915,0.660223804679552,8325,31173,294,871,24,4873,14,1369,21,14
"243","2020-05-14",178,3,275,493,4915,0.660223804679552,8325,31173,294,871,30,4903,17,1386,25,17
"244","2020-05-15",180,3,258,461,4915,0.660223804679552,8325,31173,294,871,29,4932,12,1398,24,12
"245","2020-05-16",179,3,261,455,4915,0.660223804679552,8325,31173,294,871,32,4964,15,1413,28,15
"246","2020-05-17",168,3,265,443,4915,0.660223804679552,8325,31173,294,871,14,4978,8,1421,12,8
"247","2020-05-18",157,3,278,410,4915,0.660223804679552,8325,31173,294,871,21,4999,25,1446,19,25
"248","2020-05-19",151,3,291,374,4915,0.660223804679552,8325,31173,294,871,24,5023,26,1472,22,26
"249","2020-05-20",143,3,276,358,4915,0.660223804679552,8325,31173,294,871,22,5045,35,1507,21,35
"250","2020-05-21",129,3,259,339,4915,0.660223804679552,8325,31173,294,871,15,5060,21,1528,10,21
"251","2020-05-22",117,3,247,311,4915,0.660223804679552,8325,31173,294,871,28,5088,11,1539,26,11
"252","2020-05-23",111,3,255,305,4915,0.660223804679552,8325,31173,294,871,16,5104,11,1550,15,11
"253","2020-05-24",107,3,272,287,4915,0.660223804679552,8325,31173,294,871,18,5122,8,1558,14,8
"254","2020-05-25",110,3,274,274,4915,0.660223804679552,8325,31173,294,871,17,5139,8,1566,14,8
"255","2020-05-26",109,3,260,264,4915,0.660223804679552,8325,31173,294,871,19,5158,7,1573,16,7
"256","2020-05-27",103,3,252,255,4915,0.660223804679552,8325,31173,294,871,18,5176,21,1594,16,21
"257","2020-05-28",98,3,251,252,4915,0.660223804679552,8325,31173,294,871,11,5187,17,1611,8,17
"258","2020-05-29",96,3,270,257,4915,0.660223804679552,8325,31173,294,871,12,5199,13,1624,11,13
"259","2020-05-30",95,3,260,250,4915,0.660223804679552,8325,31173,294,871,13,5212,26,1650,12,26
"260","2020-05-31",84,3,269,241,4915,0.660223804679552,8325,31173,294,871,10,5222,27,1677,10,27
"261","2020-06-01",74,3,262,231,4915,0.660223804679552,8325,31173,294,871,17,5239,18,1695,13,18
"262","2020-06-02",70,3,275,223,4915,0.660223804679552,8325,31173,294,871,8,5247,16,1711,6,16
"263","2020-06-03",65,3,255,206,4915,0.660223804679552,8325,31173,294,871,13,5260,20,1731,12,20
"264","2020-06-04",71,3,241,190,4915,0.660223804679552,8325,31173,294,871,14,5274,14,1745,11,14
"265","2020-06-05",73,3,235,180,4915,0.660223804679552,8325,31173,294,871,8,5282,15,1760,8,15
"266","2020-06-06",72,3,224,173,4915,0.660223804679552,8325,31173,294,871,7,5289,17,1777,6,17
"267","2020-06-07",63,3,207,168,4915,0.660223804679552,8325,31173,294,871,12,5301,18,1795,8,18
"268","2020-03-13",1,4,23,35,4020,0.800746268656716,8280,28921,227,419,25,79,9,47,16,9
"269","2020-03-14",3,4,24,48,4020,0.800746268656716,8280,28921,227,419,31,110,9,56,15,9
"270","2020-03-15",9,4,36,60,4020,0.800746268656716,8280,28921,227,419,36,146,3,59,15,3
"271","2020-03-16",10,4,41,84,4020,0.800746268656716,8280,28921,227,419,44,190,5,64,22,5
"272","2020-03-17",9,4,53,110,4020,0.800746268656716,8280,28921,227,419,26,216,5,69,13,5
"273","2020-03-18",11,4,65,134,4020,0.800746268656716,8280,28921,227,419,47,263,11,80,21,11
"274","2020-03-19",13,4,75,171,4020,0.800746268656716,8280,28921,227,419,70,333,22,102,37,22
"275","2020-03-20",27,4,70,192,4020,0.800746268656716,8280,28921,227,419,47,380,29,131,27,29
"276","2020-03-21",35,4,69,218,4020,0.800746268656716,8280,28921,227,419,43,423,13,144,20,13
"277","2020-03-22",53,4,57,274,4020,0.800746268656716,8280,28921,227,419,50,473,22,166,23,22
"278","2020-03-23",60,4,59,296,4020,0.800746268656716,8280,28921,227,419,38,511,31,197,21,31
"279","2020-03-24",66,4,73,317,4020,0.800746268656716,8280,28921,227,419,60,571,14,211,35,14
"280","2020-03-25",81,4,79,346,4020,0.800746268656716,8280,28921,227,419,55,626,10,221,38,10
"281","2020-03-26",93,4,89,376,4020,0.800746268656716,8280,28921,227,419,52,678,5,226,32,5
"282","2020-03-27",112,4,95,393,4020,0.800746268656716,8280,28921,227,419,62,740,12,238,36,12
"283","2020-03-28",125,4,86,409,4020,0.800746268656716,8280,28921,227,419,50,790,42,280,28,42
"284","2020-03-29",120,4,102,437,4020,0.800746268656716,8280,28921,227,419,76,866,16,296,48,16
"285","2020-03-30",127,4,106,434,4020,0.800746268656716,8280,28921,227,419,63,929,24,320,43,24
"286","2020-03-31",121,4,107,453,4020,0.800746268656716,8280,28921,227,419,57,986,25,345,38,25
"287","2020-04-01",116,4,112,465,4020,0.800746268656716,8280,28921,227,419,58,1044,21,366,36,21
"288","2020-04-02",121,4,107,496,4020,0.800746268656716,8280,28921,227,419,73,1117,28,394,45,28
"289","2020-04-03",135,4,103,520,4020,0.800746268656716,8280,28921,227,419,48,1165,57,451,37,57
"290","2020-04-04",148,4,91,528,4020,0.800746268656716,8280,28921,227,419,71,1236,59,510,47,59
"291","2020-04-05",169,4,105,553,4020,0.800746268656716,8280,28921,227,419,78,1314,24,534,50,24
"292","2020-04-06",174,4,114,566,4020,0.800746268656716,8280,28921,227,419,65,1379,53,587,45,53
"293","2020-04-07",171,4,123,585,4020,0.800746268656716,8280,28921,227,419,69,1448,19,606,48,19
"294","2020-04-08",180,4,119,607,4020,0.800746268656716,8280,28921,227,419,75,1523,19,625,43,19
"295","2020-04-09",184,4,111,612,4020,0.800746268656716,8280,28921,227,419,64,1587,14,639,41,14
"296","2020-04-10",213,4,122,617,4020,0.800746268656716,8280,28921,227,419,62,1649,10,649,44,10
"297","2020-04-11",199,4,109,628,4020,0.800746268656716,8280,28921,227,419,81,1730,50,699,55,50
"298","2020-04-12",198,4,113,636,4020,0.800746268656716,8280,28921,227,419,79,1809,47,746,52,47
"299","2020-04-13",199,4,122,656,4020,0.800746268656716,8280,28921,227,419,62,1871,45,791,45,45
"300","2020-04-14",195,4,132,657,4020,0.800746268656716,8280,28921,227,419,58,1929,26,817,37,26
"301","2020-04-15",191,4,128,672,4020,0.800746268656716,8280,28921,227,419,62,1991,20,837,38,20
"302","2020-04-16",188,4,112,675,4020,0.800746268656716,8280,28921,227,419,64,2055,14,851,47,14
"303","2020-04-17",204,4,100,689,4020,0.800746268656716,8280,28921,227,419,57,2112,7,858,38,7
"304","2020-04-18",220,4,94,718,4020,0.800746268656716,8280,28921,227,419,56,2168,59,917,35,59
"305","2020-04-19",221,4,98,724,4020,0.800746268656716,8280,28921,227,419,55,2223,60,977,35,60
"306","2020-04-20",208,4,100,740,4020,0.800746268656716,8280,28921,227,419,60,2283,36,1013,42,36
"307","2020-04-21",205,4,106,774,4020,0.800746268656716,8280,28921,227,419,60,2343,31,1044,39,31
"308","2020-04-22",219,4,109,773,4020,0.800746268656716,8280,28921,227,419,68,2411,46,1090,41,46
"309","2020-04-23",235,4,119,776,4020,0.800746268656716,8280,28921,227,419,61,2472,42,1132,44,42
"310","2020-04-24",257,4,109,764,4020,0.800746268656716,8280,28921,227,419,74,2546,22,1154,42,22
"311","2020-04-25",276,4,96,750,4020,0.800746268656716,8280,28921,227,419,65,2611,49,1203,46,49
"312","2020-04-26",256,4,102,746,4020,0.800746268656716,8280,28921,227,419,63,2674,32,1235,45,32
"313","2020-04-27",266,4,90,750,4020,0.800746268656716,8280,28921,227,419,75,2749,49,1284,50,49
"314","2020-04-28",267,4,115,759,4020,0.800746268656716,8280,28921,227,419,61,2810,23,1307,43,23
"315","2020-04-29",263,4,130,721,4020,0.800746268656716,8280,28921,227,419,54,2864,33,1340,36,33
"316","2020-04-30",250,4,124,714,4020,0.800746268656716,8280,28921,227,419,63,2927,26,1366,34,26
"317","2020-05-01",262,4,106,703,4020,0.800746268656716,8280,28921,227,419,47,2974,13,1379,31,13
"318","2020-05-02",246,4,109,699,4020,0.800746268656716,8280,28921,227,419,46,3020,10,1389,28,10
"319","2020-05-03",232,4,103,677,4020,0.800746268656716,8280,28921,227,419,46,3066,13,1402,27,13
"320","2020-05-04",226,4,119,674,4020,0.800746268656716,8280,28921,227,419,63,3129,52,1454,32,52
"321","2020-05-05",223,4,114,666,4020,0.800746268656716,8280,28921,227,419,58,3187,49,1503,28,49
"322","2020-05-06",217,4,135,639,4020,0.800746268656716,8280,28921,227,419,45,3232,56,1559,27,56
"323","2020-05-07",217,4,128,641,4020,0.800746268656716,8280,28921,227,419,59,3291,61,1620,35,61
"324","2020-05-08",200,4,119,645,4020,0.800746268656716,8280,28921,227,419,54,3345,45,1665,27,45
"325","2020-05-09",205,4,110,625,4020,0.800746268656716,8280,28921,227,419,55,3400,45,1710,33,45
"326","2020-05-10",206,4,100,631,4020,0.800746268656716,8280,28921,227,419,52,3452,37,1747,28,37
"327","2020-05-11",205,4,90,619,4020,0.800746268656716,8280,28921,227,419,41,3493,58,1805,28,58
"328","2020-05-12",191,4,99,611,4020,0.800746268656716,8280,28921,227,419,65,3558,24,1829,39,24
"329","2020-05-13",192,4,89,584,4020,0.800746268656716,8280,28921,227,419,43,3601,12,1841,31,12
"330","2020-05-14",192,4,82,553,4020,0.800746268656716,8280,28921,227,419,37,3638,33,1874,22,33
"331","2020-05-15",207,4,82,522,4020,0.800746268656716,8280,28921,227,419,41,3679,23,1897,30,23
"332","2020-05-16",194,4,100,508,4020,0.800746268656716,8280,28921,227,419,48,3727,26,1923,32,26
"333","2020-05-17",182,4,97,487,4020,0.800746268656716,8280,28921,227,419,33,3760,50,1973,17,50
"334","2020-05-18",171,4,82,447,4020,0.800746268656716,8280,28921,227,419,39,3799,24,1997,24,24
"335","2020-05-19",164,4,79,438,4020,0.800746268656716,8280,28921,227,419,27,3826,17,2014,16,17
"336","2020-05-20",161,4,71,417,4020,0.800746268656716,8280,28921,227,419,40,3866,18,2032,23,18
"337","2020-05-21",153,4,65,396,4020,0.800746268656716,8280,28921,227,419,29,3895,50,2082,22,50
"338","2020-05-22",153,4,59,379,4020,0.800746268656716,8280,28921,227,419,37,3932,25,2107,22,25
"339","2020-05-23",150,4,68,348,4020,0.800746268656716,8280,28921,227,419,38,3970,21,2128,18,21
"340","2020-05-24",136,4,67,335,4020,0.800746268656716,8280,28921,227,419,33,4003,26,2154,22,26
"341","2020-05-25",131,4,73,313,4020,0.800746268656716,8280,28921,227,419,27,4030,42,2196,19,42
"342","2020-05-26",130,4,67,313,4020,0.800746268656716,8280,28921,227,419,25,4055,44,2240,19,44
"343","2020-05-27",126,4,63,305,4020,0.800746268656716,8280,28921,227,419,31,4086,27,2267,19,27
"344","2020-05-28",119,4,58,290,4020,0.800746268656716,8280,28921,227,419,30,4116,21,2288,24,21
"345","2020-05-29",112,4,47,279,4020,0.800746268656716,8280,28921,227,419,26,4142,37,2325,20,37
"346","2020-05-30",105,4,52,272,4020,0.800746268656716,8280,28921,227,419,32,4174,37,2362,21,37
"347","2020-05-31",98,4,52,258,4020,0.800746268656716,8280,28921,227,419,22,4196,44,2406,17,44
"348","2020-06-01",100,4,53,249,4020,0.800746268656716,8280,28921,227,419,32,4228,22,2428,18,22
"349","2020-06-02",87,4,65,237,4020,0.800746268656716,8280,28921,227,419,33,4261,28,2456,17,28
"350","2020-06-03",77,4,74,227,4020,0.800746268656716,8280,28921,227,419,25,4286,23,2479,14,23
"351","2020-06-04",75,4,78,212,4020,0.800746268656716,8280,28921,227,419,25,4311,10,2489,11,10
"352","2020-06-05",76,4,70,204,4020,0.800746268656716,8280,28921,227,419,25,4336,14,2503,18,14
"353","2020-06-06",83,4,68,188,4020,0.800746268656716,8280,28921,227,419,15,4351,18,2521,9,18
"354","2020-06-07",66,4,62,177,4020,0.800746268656716,8280,28921,227,419,23,4374,30,2551,18,30
"355","2020-03-13",1,5,18,37,4310,0.74245939675174,8460,30586,229,307,9,16,13,38,NA,13
"356","2020-03-14",7,5,20,53,4310,0.74245939675174,8460,30586,229,307,14,30,6,44,7,6
"357","2020-03-15",10,5,25,66,4310,0.74245939675174,8460,30586,229,307,6,36,14,58,2,14
"358","2020-03-16",13,5,22,92,4310,0.74245939675174,8460,30586,229,307,9,45,18,76,5,18
"359","2020-03-17",15,5,18,105,4310,0.74245939675174,8460,30586,229,307,15,60,19,95,9,19
"360","2020-03-18",16,5,18,132,4310,0.74245939675174,8460,30586,229,307,23,83,11,106,14,11
"361","2020-03-19",23,5,24,154,4310,0.74245939675174,8460,30586,229,307,16,99,20,126,13,20
"362","2020-03-20",43,5,26,172,4310,0.74245939675174,8460,30586,229,307,31,130,10,136,18,10
"363","2020-03-21",53,5,24,209,4310,0.74245939675174,8460,30586,229,307,21,151,30,166,16,30
"364","2020-03-22",52,5,22,240,4310,0.74245939675174,8460,30586,229,307,36,187,24,190,30,24
"365","2020-03-23",50,5,21,262,4310,0.74245939675174,8460,30586,229,307,23,210,18,208,16,18
"366","2020-03-24",56,5,27,281,4310,0.74245939675174,8460,30586,229,307,42,252,19,227,35,19
"367","2020-03-25",70,5,30,310,4310,0.74245939675174,8460,30586,229,307,50,302,13,240,38,13
"368","2020-03-26",71,5,39,347,4310,0.74245939675174,8460,30586,229,307,67,369,16,256,62,16
"369","2020-03-27",95,5,43,380,4310,0.74245939675174,8460,30586,229,307,63,432,13,269,56,13
"370","2020-03-28",104,5,39,405,4310,0.74245939675174,8460,30586,229,307,60,492,15,284,52,15
"371","2020-03-29",105,5,43,442,4310,0.74245939675174,8460,30586,229,307,55,547,20,304,51,20
"372","2020-03-30",110,5,44,477,4310,0.74245939675174,8460,30586,229,307,86,633,13,317,83,13
"373","2020-03-31",113,5,46,509,4310,0.74245939675174,8460,30586,229,307,71,704,21,338,60,21
"374","2020-04-01",121,5,45,545,4310,0.74245939675174,8460,30586,229,307,104,808,26,364,99,26
"375","2020-04-02",137,5,46,559,4310,0.74245939675174,8460,30586,229,307,81,889,25,389,74,25
"376","2020-04-03",162,5,49,601,4310,0.74245939675174,8460,30586,229,307,110,999,36,425,99,36
"377","2020-04-04",197,5,50,612,4310,0.74245939675174,8460,30586,229,307,94,1093,26,451,85,26
"378","2020-04-05",204,5,42,646,4310,0.74245939675174,8460,30586,229,307,84,1177,25,476,77,25
"379","2020-04-06",204,5,47,701,4310,0.74245939675174,8460,30586,229,307,103,1280,18,494,95,18
"380","2020-04-07",216,5,43,725,4310,0.74245939675174,8460,30586,229,307,88,1368,32,526,79,32
"381","2020-04-08",214,5,51,765,4310,0.74245939675174,8460,30586,229,307,120,1488,22,548,114,22
"382","2020-04-09",220,5,54,772,4310,0.74245939675174,8460,30586,229,307,124,1612,31,579,122,31
"383","2020-04-10",241,5,60,797,4310,0.74245939675174,8460,30586,229,307,120,1732,42,621,113,42
"384","2020-04-11",226,5,74,802,4310,0.74245939675174,8460,30586,229,307,111,1843,36,657,108,36
"385","2020-04-12",229,5,74,811,4310,0.74245939675174,8460,30586,229,307,130,1973,24,681,125,24
"386","2020-04-13",227,5,72,863,4310,0.74245939675174,8460,30586,229,307,150,2123,26,707,142,26
"387","2020-04-14",215,5,81,863,4310,0.74245939675174,8460,30586,229,307,153,2276,31,738,139,31
"388","2020-04-15",222,5,78,862,4310,0.74245939675174,8460,30586,229,307,174,2450,29,767,165,29
"389","2020-04-16",224,5,69,889,4310,0.74245939675174,8460,30586,229,307,153,2603,30,797,144,30
"390","2020-04-17",285,5,66,900,4310,0.74245939675174,8460,30586,229,307,161,2764,40,837,153,40
"391","2020-04-18",324,5,69,896,4310,0.74245939675174,8460,30586,229,307,162,2926,46,883,157,46
"392","2020-04-19",284,5,78,892,4310,0.74245939675174,8460,30586,229,307,143,3069,43,926,138,43
"393","2020-04-20",279,5,83,878,4310,0.74245939675174,8460,30586,229,307,153,3222,25,951,151,25
"394","2020-04-21",286,5,82,855,4310,0.74245939675174,8460,30586,229,307,183,3405,26,977,179,26
"395","2020-04-22",284,5,68,826,4310,0.74245939675174,8460,30586,229,307,166,3571,40,1017,161,40
"396","2020-04-23",280,5,72,822,4310,0.74245939675174,8460,30586,229,307,144,3715,33,1050,132,33
"397","2020-04-24",292,5,64,819,4310,0.74245939675174,8460,30586,229,307,135,3850,29,1079,125,29
"398","2020-04-25",280,5,59,801,4310,0.74245939675174,8460,30586,229,307,143,3993,23,1102,136,23
"399","2020-04-26",268,5,70,789,4310,0.74245939675174,8460,30586,229,307,96,4089,40,1142,89,40
"400","2020-04-27",253,5,76,769,4310,0.74245939675174,8460,30586,229,307,124,4213,27,1169,121,27
"401","2020-04-28",256,5,86,730,4310,0.74245939675174,8460,30586,229,307,101,4314,31,1200,97,31
"402","2020-04-29",261,5,86,715,4310,0.74245939675174,8460,30586,229,307,107,4421,23,1223,102,23
"403","2020-04-30",252,5,83,699,4310,0.74245939675174,8460,30586,229,307,82,4503,25,1248,80,25
"404","2020-05-01",244,5,99,690,4310,0.74245939675174,8460,30586,229,307,85,4588,44,1292,81,44
"405","2020-05-02",236,5,96,695,4310,0.74245939675174,8460,30586,229,307,82,4670,29,1321,80,29
"406","2020-05-03",223,5,81,697,4310,0.74245939675174,8460,30586,229,307,79,4749,47,1368,75,47
"407","2020-05-04",233,5,66,679,4310,0.74245939675174,8460,30586,229,307,61,4810,52,1420,55,52
"408","2020-05-05",223,5,55,659,4310,0.74245939675174,8460,30586,229,307,72,4882,35,1455,69,35
"409","2020-05-06",210,5,58,656,4310,0.74245939675174,8460,30586,229,307,51,4933,26,1481,43,26
"410","2020-05-07",222,5,66,637,4310,0.74245939675174,8460,30586,229,307,46,4979,33,1514,45,33
"411","2020-05-08",220,5,70,619,4310,0.74245939675174,8460,30586,229,307,54,5033,35,1549,49,35
"412","2020-05-09",232,5,67,595,4310,0.74245939675174,8460,30586,229,307,32,5065,24,1573,27,24
"413","2020-05-10",213,5,63,579,4310,0.74245939675174,8460,30586,229,307,45,5110,31,1604,39,31
"414","2020-05-11",200,5,70,560,4310,0.74245939675174,8460,30586,229,307,44,5154,48,1652,40,48
"415","2020-05-12",199,5,65,532,4310,0.74245939675174,8460,30586,229,307,33,5187,44,1696,30,44
"416","2020-05-13",194,5,62,521,4310,0.74245939675174,8460,30586,229,307,30,5217,37,1733,28,37
"417","2020-05-14",176,5,61,495,4310,0.74245939675174,8460,30586,229,307,27,5244,36,1769,24,36
"418","2020-05-15",173,5,81,475,4310,0.74245939675174,8460,30586,229,307,25,5269,27,1796,24,27
"419","2020-05-16",159,5,91,464,4310,0.74245939675174,8460,30586,229,307,19,5288,23,1819,17,23
"420","2020-05-17",157,5,96,445,4310,0.74245939675174,8460,30586,229,307,19,5307,24,1843,17,24
"421","2020-05-18",154,5,87,413,4310,0.74245939675174,8460,30586,229,307,28,5335,24,1867,23,24
"422","2020-05-19",132,5,106,396,4310,0.74245939675174,8460,30586,229,307,14,5349,14,1881,11,14
"423","2020-05-20",132,5,103,390,4310,0.74245939675174,8460,30586,229,307,27,5376,18,1899,23,18
"424","2020-05-21",135,5,95,387,4310,0.74245939675174,8460,30586,229,307,21,5397,22,1921,17,22
"425","2020-05-22",126,5,98,386,4310,0.74245939675174,8460,30586,229,307,17,5414,21,1942,13,21
"426","2020-05-23",125,5,86,378,4310,0.74245939675174,8460,30586,229,307,15,5429,12,1954,12,12
"427","2020-05-24",115,5,81,363,4310,0.74245939675174,8460,30586,229,307,11,5440,23,1977,11,23
"428","2020-05-25",110,5,74,356,4310,0.74245939675174,8460,30586,229,307,14,5454,34,2011,13,34
"429","2020-05-26",120,5,76,337,4310,0.74245939675174,8460,30586,229,307,12,5466,20,2031,8,20
"430","2020-05-27",120,5,81,331,4310,0.74245939675174,8460,30586,229,307,14,5480,17,2048,10,17
"431","2020-05-28",116,5,73,313,4310,0.74245939675174,8460,30586,229,307,8,5488,25,2073,6,25
"432","2020-05-29",116,5,67,299,4310,0.74245939675174,8460,30586,229,307,7,5495,11,2084,6,11
"433","2020-05-30",116,5,65,289,4310,0.74245939675174,8460,30586,229,307,6,5501,19,2103,6,19
"434","2020-05-31",108,5,57,269,4310,0.74245939675174,8460,30586,229,307,6,5507,13,2116,6,13
"435","2020-06-01",101,5,47,253,4310,0.74245939675174,8460,30586,229,307,11,5518,7,2123,6,7
"436","2020-06-02",89,5,45,244,4310,0.74245939675174,8460,30586,229,307,7,5525,27,2150,5,27
"437","2020-06-03",86,5,45,231,4310,0.74245939675174,8460,30586,229,307,2,5527,28,2178,1,28
"438","2020-06-04",81,5,45,215,4310,0.74245939675174,8460,30586,229,307,4,5531,23,2201,3,23
"439","2020-06-05",83,5,44,206,4310,0.74245939675174,8460,30586,229,307,4,5535,30,2231,4,30
"440","2020-06-06",75,5,45,203,4310,0.74245939675174,8460,30586,229,307,6,5541,23,2254,4,23
"441","2020-06-07",62,5,44,201,4310,0.74245939675174,8460,30586,229,307,6,5547,7,2261,5,7
"442","2020-03-14",2,6,58,38,4018,0.792434046789448,8280,28328,200,617,16,55,4,46,3,4
"443","2020-03-15",3,6,59,58,4018,0.792434046789448,8280,28328,200,617,29,84,4,50,13,4
"444","2020-03-16",3,6,51,77,4018,0.792434046789448,8280,28328,200,617,28,112,2,52,9,2
"445","2020-03-17",6,6,47,104,4018,0.792434046789448,8280,28328,200,617,24,136,3,55,13,3
"446","2020-03-18",12,6,42,131,4018,0.792434046789448,8280,28328,200,617,30,166,5,60,10,5
"447","2020-03-19",17,6,43,152,4018,0.792434046789448,8280,28328,200,617,26,192,18,78,16,18
"448","2020-03-20",25,6,31,177,4018,0.792434046789448,8280,28328,200,617,46,238,15,93,34,15
"449","2020-03-21",36,6,31,204,4018,0.792434046789448,8280,28328,200,617,40,278,10,103,30,10
"450","2020-03-22",52,6,28,224,4018,0.792434046789448,8280,28328,200,617,52,330,12,115,35,12
"451","2020-03-23",53,6,25,248,4018,0.792434046789448,8280,28328,200,617,47,377,6,121,34,6
"452","2020-03-24",55,6,27,277,4018,0.792434046789448,8280,28328,200,617,51,428,6,127,42,6
"453","2020-03-25",61,6,40,299,4018,0.792434046789448,8280,28328,200,617,47,475,7,134,35,7
"454","2020-03-26",68,6,43,325,4018,0.792434046789448,8280,28328,200,617,56,531,24,158,40,24
"455","2020-03-27",82,6,43,346,4018,0.792434046789448,8280,28328,200,617,61,592,28,186,47,28
"456","2020-03-28",95,6,59,366,4018,0.792434046789448,8280,28328,200,617,55,647,17,203,45,17
"457","2020-03-29",100,6,72,379,4018,0.792434046789448,8280,28328,200,617,73,720,13,216,59,13
"458","2020-03-30",108,6,63,407,4018,0.792434046789448,8280,28328,200,617,80,800,25,241,69,25
"459","2020-03-31",120,6,53,464,4018,0.792434046789448,8280,28328,200,617,70,870,9,250,58,9
"460","2020-04-01",127,6,45,489,4018,0.792434046789448,8280,28328,200,617,77,947,17,267,56,17
"461","2020-04-02",129,6,49,524,4018,0.792434046789448,8280,28328,200,617,75,1022,22,289,60,22
"462","2020-04-03",143,6,44,532,4018,0.792434046789448,8280,28328,200,617,88,1110,35,324,75,35
"463","2020-04-04",156,6,61,544,4018,0.792434046789448,8280,28328,200,617,89,1199,29,353,73,29
"464","2020-04-05",163,6,77,582,4018,0.792434046789448,8280,28328,200,617,84,1283,39,392,69,39
"465","2020-04-06",170,6,75,584,4018,0.792434046789448,8280,28328,200,617,90,1373,29,421,71,29
"466","2020-04-07",170,6,89,583,4018,0.792434046789448,8280,28328,200,617,100,1473,26,447,92,26
"467","2020-04-08",168,6,88,593,4018,0.792434046789448,8280,28328,200,617,68,1541,25,472,58,25
"468","2020-04-09",174,6,126,631,4018,0.792434046789448,8280,28328,200,617,98,1639,40,512,84,40
"469","2020-04-10",214,6,116,644,4018,0.792434046789448,8280,28328,200,617,85,1724,23,535,71,23
"470","2020-04-11",219,6,112,666,4018,0.792434046789448,8280,28328,200,617,112,1836,35,570,98,35
"471","2020-04-12",203,6,107,689,4018,0.792434046789448,8280,28328,200,617,94,1930,25,595,81,25
"472","2020-04-13",207,6,129,708,4018,0.792434046789448,8280,28328,200,617,87,2017,24,619,70,24
"473","2020-04-14",211,6,137,740,4018,0.792434046789448,8280,28328,200,617,98,2115,22,641,84,22
"474","2020-04-15",225,6,128,759,4018,0.792434046789448,8280,28328,200,617,82,2197,48,689,69,48
"475","2020-04-16",237,6,130,759,4018,0.792434046789448,8280,28328,200,617,88,2285,24,713,71,24
"476","2020-04-17",256,6,140,767,4018,0.792434046789448,8280,28328,200,617,91,2376,35,748,73,35
"477","2020-04-18",272,6,174,790,4018,0.792434046789448,8280,28328,200,617,123,2499,32,780,110,32
"478","2020-04-19",269,6,181,793,4018,0.792434046789448,8280,28328,200,617,91,2590,54,834,79,54
"479","2020-04-20",259,6,184,778,4018,0.792434046789448,8280,28328,200,617,96,2686,29,863,76,29
"480","2020-04-21",259,6,185,782,4018,0.792434046789448,8280,28328,200,617,84,2770,20,883,75,20
"481","2020-04-22",257,6,181,779,4018,0.792434046789448,8280,28328,200,617,100,2870,14,897,86,14
"482","2020-04-23",255,6,157,777,4018,0.792434046789448,8280,28328,200,617,89,2959,8,905,75,8
"483","2020-04-24",259,6,156,774,4018,0.792434046789448,8280,28328,200,617,59,3018,10,915,52,10
"484","2020-04-25",252,6,146,795,4018,0.792434046789448,8280,28328,200,617,73,3091,8,923,65,8
"485","2020-04-26",243,6,163,769,4018,0.792434046789448,8280,28328,200,617,55,3146,37,960,38,37
"486","2020-04-27",238,6,162,743,4018,0.792434046789448,8280,28328,200,617,61,3207,44,1004,41,44
"487","2020-04-28",235,6,145,733,4018,0.792434046789448,8280,28328,200,617,75,3282,25,1029,61,25
"488","2020-04-29",242,6,137,713,4018,0.792434046789448,8280,28328,200,617,79,3361,28,1057,66,28
"489","2020-04-30",244,6,152,686,4018,0.792434046789448,8280,28328,200,617,61,3422,31,1088,49,31
"490","2020-05-01",249,6,153,669,4018,0.792434046789448,8280,28328,200,617,75,3497,30,1118,57,30
"491","2020-05-02",233,6,137,643,4018,0.792434046789448,8280,28328,200,617,50,3547,37,1155,39,37
"492","2020-05-03",233,6,171,629,4018,0.792434046789448,8280,28328,200,617,55,3602,24,1179,48,24
"493","2020-05-04",233,6,166,621,4018,0.792434046789448,8280,28328,200,617,54,3656,33,1212,44,33
"494","2020-05-05",222,6,167,605,4018,0.792434046789448,8280,28328,200,617,69,3725,25,1237,59,25
"495","2020-05-06",212,6,159,586,4018,0.792434046789448,8280,28328,200,617,51,3776,34,1271,41,34
"496","2020-05-07",208,6,165,572,4018,0.792434046789448,8280,28328,200,617,56,3832,23,1294,46,23
"497","2020-05-08",215,6,146,556,4018,0.792434046789448,8280,28328,200,617,46,3878,39,1333,38,39
"498","2020-05-09",225,6,132,547,4018,0.792434046789448,8280,28328,200,617,42,3920,34,1367,35,34
"499","2020-05-10",211,6,118,528,4018,0.792434046789448,8280,28328,200,617,43,3963,24,1391,31,24
"500","2020-05-11",203,6,112,518,4018,0.792434046789448,8280,28328,200,617,30,3993,20,1411,23,20
"501","2020-05-12",183,6,143,521,4018,0.792434046789448,8280,28328,200,617,29,4022,29,1440,22,29
"502","2020-05-13",176,6,131,509,4018,0.792434046789448,8280,28328,200,617,46,4068,20,1460,35,20
"503","2020-05-14",163,6,116,507,4018,0.792434046789448,8280,28328,200,617,39,4107,25,1485,28,25
"504","2020-05-15",157,6,126,489,4018,0.792434046789448,8280,28328,200,617,36,4143,21,1506,27,21
"505","2020-05-16",165,6,126,463,4018,0.792434046789448,8280,28328,200,617,26,4169,16,1522,16,16
"506","2020-05-17",148,6,140,448,4018,0.792434046789448,8280,28328,200,617,32,4201,30,1552,24,30
"507","2020-05-18",140,6,123,423,4018,0.792434046789448,8280,28328,200,617,36,4237,29,1581,26,29
"508","2020-05-19",149,6,120,402,4018,0.792434046789448,8280,28328,200,617,30,4267,25,1606,18,25
"509","2020-05-20",142,6,138,394,4018,0.792434046789448,8280,28328,200,617,37,4304,28,1634,28,28
"510","2020-05-21",139,6,147,377,4018,0.792434046789448,8280,28328,200,617,24,4328,21,1655,21,21
"511","2020-05-22",143,6,140,379,4018,0.792434046789448,8280,28328,200,617,29,4357,20,1675,25,20
"512","2020-05-23",138,6,152,372,4018,0.792434046789448,8280,28328,200,617,24,4381,6,1681,16,6
"513","2020-05-24",129,6,155,364,4018,0.792434046789448,8280,28328,200,617,24,4405,19,1700,19,19
"514","2020-05-25",120,6,172,348,4018,0.792434046789448,8280,28328,200,617,12,4417,12,1712,9,12
"515","2020-05-26",100,6,190,331,4018,0.792434046789448,8280,28328,200,617,18,4435,22,1734,12,22
"516","2020-05-27",99,6,178,336,4018,0.792434046789448,8280,28328,200,617,26,4461,13,1747,20,13
"517","2020-05-28",99,6,163,325,4018,0.792434046789448,8280,28328,200,617,20,4481,21,1768,14,21
"518","2020-05-29",96,6,132,315,4018,0.792434046789448,8280,28328,200,617,26,4507,10,1778,20,10
"519","2020-05-30",96,6,128,303,4018,0.792434046789448,8280,28328,200,617,19,4526,10,1788,15,10
"520","2020-05-31",85,6,128,293,4018,0.792434046789448,8280,28328,200,617,17,4543,11,1799,10,11
"521","2020-06-01",90,6,122,277,4018,0.792434046789448,8280,28328,200,617,13,4556,11,1810,6,11
"522","2020-06-02",94,6,127,282,4018,0.792434046789448,8280,28328,200,617,10,4566,8,1818,7,8
"523","2020-06-03",92,6,147,274,4018,0.792434046789448,8280,28328,200,617,22,4588,21,1839,14,21
"524","2020-06-04",91,6,140,268,4018,0.792434046789448,8280,28328,200,617,8,4596,22,1861,6,22
"525","2020-06-05",93,6,142,253,4018,0.792434046789448,8280,28328,200,617,9,4605,13,1874,7,13
"526","2020-06-06",92,6,138,248,4018,0.792434046789448,8280,28328,200,617,10,4615,12,1886,6,12
"527","2020-06-07",98,6,124,256,4018,0.792434046789448,8280,28328,200,617,9,4624,10,1896,3,10
"528","2020-03-13",1,7,9,68,3986,0.468138484696438,8250,28565,248,256,11,29,3,19,5,3
"529","2020-03-14",7,7,7,93,3986,0.468138484696438,8250,28565,248,256,12,41,18,37,8,18
"530","2020-03-15",8,7,16,133,3986,0.468138484696438,8250,28565,248,256,21,62,11,48,13,11
"531","2020-03-16",16,7,26,169,3986,0.468138484696438,8250,28565,248,256,11,73,2,50,5,2
"532","2020-03-17",22,7,31,210,3986,0.468138484696438,8250,28565,248,256,19,92,19,69,11,19
"533","2020-03-18",32,7,34,235,3986,0.468138484696438,8250,28565,248,256,15,107,6,75,9,6
"534","2020-03-19",42,7,44,264,3986,0.468138484696438,8250,28565,248,256,36,143,4,79,28,4
"535","2020-03-20",61,7,40,290,3986,0.468138484696438,8250,28565,248,256,23,166,7,86,22,7
"536","2020-03-21",63,7,35,330,3986,0.468138484696438,8250,28565,248,256,31,197,23,109,23,23
"537","2020-03-22",82,7,26,366,3986,0.468138484696438,8250,28565,248,256,39,236,19,128,37,19
"538","2020-03-23",88,7,29,392,3986,0.468138484696438,8250,28565,248,256,39,275,26,154,34,26
"539","2020-03-24",98,7,29,419,3986,0.468138484696438,8250,28565,248,256,42,317,13,167,34,13
"540","2020-03-25",100,7,37,440,3986,0.468138484696438,8250,28565,248,256,51,368,16,183,44,16
"541","2020-03-26",109,7,35,459,3986,0.468138484696438,8250,28565,248,256,41,409,16,199,36,16
"542","2020-03-27",123,7,39,469,3986,0.468138484696438,8250,28565,248,256,55,464,13,212,52,13
"543","2020-03-28",136,7,42,471,3986,0.468138484696438,8250,28565,248,256,66,530,9,221,57,9
"544","2020-03-29",148,7,39,475,3986,0.468138484696438,8250,28565,248,256,68,598,9,230,60,9
"545","2020-03-30",151,7,29,493,3986,0.468138484696438,8250,28565,248,256,56,654,24,254,50,24
"546","2020-03-31",146,7,30,507,3986,0.468138484696438,8250,28565,248,256,43,697,12,266,37,12
"547","2020-04-01",158,7,34,535,3986,0.468138484696438,8250,28565,248,256,64,761,6,272,56,6
"548","2020-04-02",162,7,30,539,3986,0.468138484696438,8250,28565,248,256,69,830,6,278,62,6
"549","2020-04-03",186,7,47,562,3986,0.468138484696438,8250,28565,248,256,95,925,23,301,85,23
"550","2020-04-04",203,7,46,573,3986,0.468138484696438,8250,28565,248,256,73,998,14,315,67,14
"551","2020-04-05",183,7,50,579,3986,0.468138484696438,8250,28565,248,256,89,1087,33,348,77,33
"552","2020-04-06",175,7,52,597,3986,0.468138484696438,8250,28565,248,256,67,1154,27,375,55,27
"553","2020-04-07",185,7,48,578,3986,0.468138484696438,8250,28565,248,256,77,1231,28,403,68,28
"554","2020-04-08",182,7,49,601,3986,0.468138484696438,8250,28565,248,256,73,1304,22,425,66,22
"555","2020-04-09",180,7,56,612,3986,0.468138484696438,8250,28565,248,256,118,1422,8,433,109,8
"556","2020-04-10",191,7,68,613,3986,0.468138484696438,8250,28565,248,256,109,1531,7,440,104,7
"557","2020-04-11",177,7,65,614,3986,0.468138484696438,8250,28565,248,256,108,1639,9,449,95,9
"558","2020-04-12",199,7,67,604,3986,0.468138484696438,8250,28565,248,256,98,1737,32,481,88,32
"559","2020-04-13",207,7,61,602,3986,0.468138484696438,8250,28565,248,256,98,1835,32,513,89,32
"560","2020-04-14",190,7,59,601,3986,0.468138484696438,8250,28565,248,256,85,1920,43,556,78,43
"561","2020-04-15",187,7,56,627,3986,0.468138484696438,8250,28565,248,256,93,2013,36,592,88,36
"562","2020-04-16",183,7,49,615,3986,0.468138484696438,8250,28565,248,256,111,2124,38,630,107,38
"563","2020-04-17",215,7,60,606,3986,0.468138484696438,8250,28565,248,256,83,2207,22,652,80,22
"564","2020-04-18",216,7,66,609,3986,0.468138484696438,8250,28565,248,256,117,2324,8,660,112,8
"565","2020-04-19",190,7,72,600,3986,0.468138484696438,8250,28565,248,256,97,2421,10,670,94,10
"566","2020-04-20",182,7,79,616,3986,0.468138484696438,8250,28565,248,256,91,2512,6,676,82,6
"567","2020-04-21",197,7,76,617,3986,0.468138484696438,8250,28565,248,256,119,2631,13,689,108,13
"568","2020-04-22",202,7,77,615,3986,0.468138484696438,8250,28565,248,256,129,2760,37,726,117,37
"569","2020-04-23",204,7,69,603,3986,0.468138484696438,8250,28565,248,256,76,2836,36,762,68,36
"570","2020-04-24",180,7,61,614,3986,0.468138484696438,8250,28565,248,256,106,2942,43,805,98,43
"571","2020-04-25",202,7,53,630,3986,0.468138484696438,8250,28565,248,256,101,3043,30,835,96,30
"572","2020-04-26",212,7,58,639,3986,0.468138484696438,8250,28565,248,256,88,3131,21,856,82,21
"573","2020-04-27",219,7,71,630,3986,0.468138484696438,8250,28565,248,256,89,3220,12,868,85,12
"574","2020-04-28",201,7,72,627,3986,0.468138484696438,8250,28565,248,256,94,3314,12,880,90,12
"575","2020-04-29",202,7,75,643,3986,0.468138484696438,8250,28565,248,256,108,3422,45,925,103,45
"576","2020-04-30",204,7,77,626,3986,0.468138484696438,8250,28565,248,256,99,3521,20,945,87,20
"577","2020-05-01",237,7,74,610,3986,0.468138484696438,8250,28565,248,256,85,3606,43,988,77,43
"578","2020-05-02",227,7,76,593,3986,0.468138484696438,8250,28565,248,256,82,3688,34,1022,70,34
"579","2020-05-03",200,7,69,580,3986,0.468138484696438,8250,28565,248,256,82,3770,23,1045,75,23
"580","2020-05-04",192,7,67,559,3986,0.468138484696438,8250,28565,248,256,72,3842,9,1054,66,9
"581","2020-05-05",179,7,82,558,3986,0.468138484696438,8250,28565,248,256,70,3912,16,1070,67,16
"582","2020-05-06",178,7,83,557,3986,0.468138484696438,8250,28565,248,256,69,3981,30,1100,61,30
"583","2020-05-07",181,7,83,546,3986,0.468138484696438,8250,28565,248,256,61,4042,18,1118,57,18
"584","2020-05-08",184,7,97,539,3986,0.468138484696438,8250,28565,248,256,63,4105,36,1154,59,36
"585","2020-05-09",178,7,102,525,3986,0.468138484696438,8250,28565,248,256,67,4172,21,1175,62,21
"586","2020-05-10",180,7,98,525,3986,0.468138484696438,8250,28565,248,256,55,4227,20,1195,51,20
"587","2020-05-11",181,7,93,526,3986,0.468138484696438,8250,28565,248,256,57,4284,12,1207,53,12
"588","2020-05-12",177,7,88,504,3986,0.468138484696438,8250,28565,248,256,78,4362,26,1233,74,26
"589","2020-05-13",176,7,73,497,3986,0.468138484696438,8250,28565,248,256,47,4409,41,1274,44,41
"590","2020-05-14",166,7,77,474,3986,0.468138484696438,8250,28565,248,256,45,4454,22,1296,42,22
"591","2020-05-15",157,7,71,463,3986,0.468138484696438,8250,28565,248,256,49,4503,25,1321,41,25
"592","2020-05-16",164,7,72,447,3986,0.468138484696438,8250,28565,248,256,49,4552,20,1341,43,20
"593","2020-05-17",148,7,69,431,3986,0.468138484696438,8250,28565,248,256,29,4581,10,1351,27,10
"594","2020-05-18",150,7,63,426,3986,0.468138484696438,8250,28565,248,256,33,4614,24,1375,29,24
"595","2020-05-19",147,7,53,414,3986,0.468138484696438,8250,28565,248,256,39,4653,10,1385,35,10
"596","2020-05-20",146,7,57,399,3986,0.468138484696438,8250,28565,248,256,25,4678,10,1395,21,10
"597","2020-05-21",148,7,58,377,3986,0.468138484696438,8250,28565,248,256,34,4712,8,1403,32,8
"598","2020-05-22",151,7,62,369,3986,0.468138484696438,8250,28565,248,256,32,4744,11,1414,28,11
"599","2020-05-23",140,7,53,354,3986,0.468138484696438,8250,28565,248,256,26,4770,27,1441,23,27
"600","2020-05-24",133,7,51,355,3986,0.468138484696438,8250,28565,248,256,27,4797,8,1449,25,8
"601","2020-05-25",119,7,62,355,3986,0.468138484696438,8250,28565,248,256,20,4817,10,1459,13,10
"602","2020-05-26",120,7,65,353,3986,0.468138484696438,8250,28565,248,256,21,4838,9,1468,20,9
"603","2020-05-27",116,7,69,358,3986,0.468138484696438,8250,28565,248,256,12,4850,23,1491,10,23
"604","2020-05-28",114,7,65,351,3986,0.468138484696438,8250,28565,248,256,16,4866,32,1523,14,32
"605","2020-05-29",124,7,60,339,3986,0.468138484696438,8250,28565,248,256,21,4887,47,1570,18,47
"606","2020-05-30",128,7,62,331,3986,0.468138484696438,8250,28565,248,256,22,4909,17,1587,19,17
"607","2020-05-31",116,7,60,314,3986,0.468138484696438,8250,28565,248,256,11,4920,18,1605,11,18
"608","2020-06-01",112,7,63,310,3986,0.468138484696438,8250,28565,248,256,12,4932,11,1616,9,11
"609","2020-06-02",105,7,65,298,3986,0.468138484696438,8250,28565,248,256,9,4941,8,1624,7,8
"610","2020-06-03",95,7,58,297,3986,0.468138484696438,8250,28565,248,256,13,4954,14,1638,10,14
"611","2020-06-04",92,7,55,288,3986,0.468138484696438,8250,28565,248,256,12,4966,24,1662,11,24
"612","2020-06-05",81,7,50,275,3986,0.468138484696438,8250,28565,248,256,13,4979,13,1675,10,13
"613","2020-06-06",77,7,51,264,3986,0.468138484696438,8250,28565,248,256,11,4990,14,1689,10,14
"614","2020-06-07",74,7,55,273,3986,0.468138484696438,8250,28565,248,256,9,4999,10,1699,5,10
"615","2020-03-15",2,8,74,106,4493,0.700645448475406,8325,29603,225,695,28,103,5,36,11,5
"616","2020-03-16",7,8,87,130,4493,0.700645448475406,8325,29603,225,695,27,130,6,42,15,6
"617","2020-03-17",12,8,92,165,4493,0.700645448475406,8325,29603,225,695,27,157,5,47,13,5
"618","2020-03-18",19,8,105,196,4493,0.700645448475406,8325,29603,225,695,36,193,10,57,21,10
"619","2020-03-19",27,8,106,223,4493,0.700645448475406,8325,29603,225,695,30,223,17,74,21,17
"620","2020-03-20",39,8,115,268,4493,0.700645448475406,8325,29603,225,695,24,247,12,86,16,12
"621","2020-03-21",66,8,134,304,4493,0.700645448475406,8325,29603,225,695,41,288,8,94,23,8
"622","2020-03-22",84,8,141,331,4493,0.700645448475406,8325,29603,225,695,42,330,17,111,25,17
"623","2020-03-23",96,8,148,378,4493,0.700645448475406,8325,29603,225,695,31,361,13,124,18,13
"624","2020-03-24",95,8,139,416,4493,0.700645448475406,8325,29603,225,695,41,402,19,143,25,19
"625","2020-03-25",107,8,131,441,4493,0.700645448475406,8325,29603,225,695,47,449,16,159,34,16
"626","2020-03-26",116,8,144,483,4493,0.700645448475406,8325,29603,225,695,48,497,19,178,36,19
"627","2020-03-27",155,8,143,501,4493,0.700645448475406,8325,29603,225,695,45,542,30,208,29,30
"628","2020-03-28",174,8,139,535,4493,0.700645448475406,8325,29603,225,695,42,584,18,226,24,18
"629","2020-03-29",183,8,142,574,4493,0.700645448475406,8325,29603,225,695,38,622,12,238,25,12
"630","2020-03-30",179,8,132,621,4493,0.700645448475406,8325,29603,225,695,43,665,5,243,29,5
"631","2020-03-31",193,8,139,637,4493,0.700645448475406,8325,29603,225,695,49,714,4,247,32,4
"632","2020-04-01",194,8,158,652,4493,0.700645448475406,8325,29603,225,695,60,774,10,257,44,10
"633","2020-04-02",212,8,174,690,4493,0.700645448475406,8325,29603,225,695,33,807,11,268,20,11
"634","2020-04-03",220,8,195,721,4493,0.700645448475406,8325,29603,225,695,42,849,17,285,26,17
"635","2020-04-04",241,8,194,745,4493,0.700645448475406,8325,29603,225,695,59,908,17,302,38,17
"636","2020-04-05",238,8,203,808,4493,0.700645448475406,8325,29603,225,695,47,955,12,314,33,12
"637","2020-04-06",235,8,223,818,4493,0.700645448475406,8325,29603,225,695,52,1007,14,328,40,14
"638","2020-04-07",238,8,208,841,4493,0.700645448475406,8325,29603,225,695,43,1050,28,356,29,28
"639","2020-04-08",248,8,198,858,4493,0.700645448475406,8325,29603,225,695,54,1104,23,379,35,23
"640","2020-04-09",247,8,188,863,4493,0.700645448475406,8325,29603,225,695,49,1153,18,397,34,18
"641","2020-04-10",282,8,206,886,4493,0.700645448475406,8325,29603,225,695,49,1202,11,408,38,11
"642","2020-04-11",274,8,200,895,4493,0.700645448475406,8325,29603,225,695,50,1252,15,423,32,15
"643","2020-04-12",304,8,219,886,4493,0.700645448475406,8325,29603,225,695,66,1318,18,441,48,18
"644","2020-04-13",294,8,215,909,4493,0.700645448475406,8325,29603,225,695,54,1372,24,465,37,24
"645","2020-04-14",286,8,203,891,4493,0.700645448475406,8325,29603,225,695,56,1428,19,484,34,19
"646","2020-04-15",292,8,210,878,4493,0.700645448475406,8325,29603,225,695,51,1479,24,508,35,24
"647","2020-04-16",291,8,207,885,4493,0.700645448475406,8325,29603,225,695,41,1520,32,540,26,32
"648","2020-04-17",301,8,188,885,4493,0.700645448475406,8325,29603,225,695,58,1578,29,569,37,29
"649","2020-04-18",322,8,185,871,4493,0.700645448475406,8325,29603,225,695,37,1615,23,592,22,23
"650","2020-04-19",261,8,216,892,4493,0.700645448475406,8325,29603,225,695,36,1651,25,617,22,25
"651","2020-04-20",258,8,222,902,4493,0.700645448475406,8325,29603,225,695,43,1694,22,639,29,22
"652","2020-04-21",271,8,237,903,4493,0.700645448475406,8325,29603,225,695,48,1742,21,660,28,21
"653","2020-04-22",268,8,260,882,4493,0.700645448475406,8325,29603,225,695,38,1780,20,680,28,20
"654","2020-04-23",262,8,260,866,4493,0.700645448475406,8325,29603,225,695,49,1829,26,706,34,26
"655","2020-04-24",310,8,219,874,4493,0.700645448475406,8325,29603,225,695,39,1868,39,745,23,39
"656","2020-04-25",325,8,211,872,4493,0.700645448475406,8325,29603,225,695,41,1909,34,779,30,34
"657","2020-04-26",313,8,235,862,4493,0.700645448475406,8325,29603,225,695,54,1963,25,804,37,25
"658","2020-04-27",308,8,262,839,4493,0.700645448475406,8325,29603,225,695,53,2016,24,828,37,24
"659","2020-04-28",293,8,272,830,4493,0.700645448475406,8325,29603,225,695,24,2040,27,855,17,27
"660","2020-04-29",293,8,262,819,4493,0.700645448475406,8325,29603,225,695,39,2079,44,899,23,44
"661","2020-04-30",293,8,261,800,4493,0.700645448475406,8325,29603,225,695,42,2121,37,936,33,37
"662","2020-05-01",306,8,231,781,4493,0.700645448475406,8325,29603,225,695,41,2162,30,966,27,30
"663","2020-05-02",286,8,253,759,4493,0.700645448475406,8325,29603,225,695,45,2207,35,1001,30,35
"664","2020-05-03",285,8,274,737,4493,0.700645448475406,8325,29603,225,695,44,2251,25,1026,26,25
"665","2020-05-04",271,8,295,739,4493,0.700645448475406,8325,29603,225,695,42,2293,17,1043,27,17
"666","2020-05-05",262,8,304,715,4493,0.700645448475406,8325,29603,225,695,42,2335,20,1063,30,20
"667","2020-05-06",251,8,283,691,4493,0.700645448475406,8325,29603,225,695,34,2369,37,1100,22,37
"668","2020-05-07",244,8,285,654,4493,0.700645448475406,8325,29603,225,695,31,2400,14,1114,17,14
"669","2020-05-08",232,8,260,622,4493,0.700645448475406,8325,29603,225,695,48,2448,31,1145,34,31
"670","2020-05-09",241,8,255,590,4493,0.700645448475406,8325,29603,225,695,35,2483,17,1162,23,17
"671","2020-05-10",198,8,240,556,4493,0.700645448475406,8325,29603,225,695,39,2522,26,1188,28,26
"672","2020-05-11",193,8,230,548,4493,0.700645448475406,8325,29603,225,695,32,2554,19,1207,17,19
"673","2020-05-12",187,8,225,514,4493,0.700645448475406,8325,29603,225,695,24,2578,16,1223,15,16
"674","2020-05-13",187,8,217,498,4493,0.700645448475406,8325,29603,225,695,31,2609,12,1235,24,12
"675","2020-05-14",188,8,215,473,4493,0.700645448475406,8325,29603,225,695,28,2637,23,1258,15,23
"676","2020-05-15",181,8,226,444,4493,0.700645448475406,8325,29603,225,695,34,2671,20,1278,21,20
"677","2020-05-16",173,8,218,423,4493,0.700645448475406,8325,29603,225,695,24,2695,29,1307,19,29
"678","2020-05-17",165,8,208,393,4493,0.700645448475406,8325,29603,225,695,31,2726,16,1323,18,16
"679","2020-05-18",157,8,213,355,4493,0.700645448475406,8325,29603,225,695,25,2751,11,1334,18,11
"680","2020-05-19",147,8,217,334,4493,0.700645448475406,8325,29603,225,695,27,2778,5,1339,19,5
"681","2020-05-20",135,8,207,310,4493,0.700645448475406,8325,29603,225,695,32,2810,3,1342,18,3
"682","2020-05-21",122,8,232,298,4493,0.700645448475406,8325,29603,225,695,18,2828,4,1346,12,4
"683","2020-05-22",117,8,210,281,4493,0.700645448475406,8325,29603,225,695,27,2855,5,1351,19,5
"684","2020-05-23",109,8,204,269,4493,0.700645448475406,8325,29603,225,695,27,2882,17,1368,16,17
"685","2020-05-24",95,8,187,256,4493,0.700645448475406,8325,29603,225,695,22,2904,7,1375,15,7
"686","2020-05-25",92,8,190,251,4493,0.700645448475406,8325,29603,225,695,38,2942,12,1387,28,12
"687","2020-05-26",83,8,180,239,4493,0.700645448475406,8325,29603,225,695,32,2974,11,1398,23,11
"688","2020-05-27",79,8,180,233,4493,0.700645448475406,8325,29603,225,695,16,2990,17,1415,11,17
"689","2020-05-28",77,8,170,222,4493,0.700645448475406,8325,29603,225,695,27,3017,20,1435,15,20
"690","2020-05-29",74,8,180,209,4493,0.700645448475406,8325,29603,225,695,29,3046,17,1452,17,17
"691","2020-05-30",77,8,166,200,4493,0.700645448475406,8325,29603,225,695,33,3079,15,1467,23,15
"692","2020-05-31",71,8,167,196,4493,0.700645448475406,8325,29603,225,695,20,3099,11,1478,12,11
"693","2020-06-01",68,8,157,185,4493,0.700645448475406,8325,29603,225,695,33,3132,16,1494,22,16
"694","2020-06-02",71,8,154,180,4493,0.700645448475406,8325,29603,225,695,8,3140,16,1510,6,16
"695","2020-06-03",73,8,156,172,4493,0.700645448475406,8325,29603,225,695,10,3150,10,1520,8,10
"696","2020-06-04",73,8,177,162,4493,0.700645448475406,8325,29603,225,695,20,3170,6,1526,15,6
"697","2020-06-05",70,8,182,143,4493,0.700645448475406,8325,29603,225,695,23,3193,9,1535,16,9
"698","2020-06-06",60,8,184,140,4493,0.700645448475406,8325,29603,225,695,14,3207,11,1546,8,11
"699","2020-06-07",54,8,197,133,4493,0.700645448475406,8325,29603,225,695,14,3221,5,1551,13,5
"700","2020-03-15",5,9,53,28,5709,0.961989840602557,8325,31551,315,427,13,31,14,76,7,14
"701","2020-03-16",5,9,60,34,5709,0.961989840602557,8325,31551,315,427,8,39,10,86,5,10
"702","2020-03-17",3,9,56,46,5709,0.961989840602557,8325,31551,315,427,19,58,14,100,17,14
"703","2020-03-18",3,9,52,68,5709,0.961989840602557,8325,31551,315,427,22,80,14,114,18,14
"704","2020-03-19",5,9,50,83,5709,0.961989840602557,8325,31551,315,427,21,101,17,131,17,17
"705","2020-03-20",13,9,49,106,5709,0.961989840602557,8325,31551,315,427,23,124,23,154,20,23
"706","2020-03-21",19,9,60,122,5709,0.961989840602557,8325,31551,315,427,22,146,23,177,19,23
"707","2020-03-22",24,9,59,145,5709,0.961989840602557,8325,31551,315,427,33,179,23,200,30,23
"708","2020-03-23",25,9,55,178,5709,0.961989840602557,8325,31551,315,427,33,212,28,228,29,28
"709","2020-03-24",26,9,46,196,5709,0.961989840602557,8325,31551,315,427,34,246,29,257,30,29
"710","2020-03-25",32,9,50,216,5709,0.961989840602557,8325,31551,315,427,42,288,18,275,40,18
"711","2020-03-26",40,9,53,257,5709,0.961989840602557,8325,31551,315,427,51,339,11,286,48,11
"712","2020-03-27",51,9,60,301,5709,0.961989840602557,8325,31551,315,427,44,383,28,314,43,28
"713","2020-03-28",59,9,79,359,5709,0.961989840602557,8325,31551,315,427,47,430,16,330,46,16
"714","2020-03-29",79,9,86,394,5709,0.961989840602557,8325,31551,315,427,69,499,9,339,69,9
"715","2020-03-30",86,9,81,436,5709,0.961989840602557,8325,31551,315,427,60,559,8,347,54,8
"716","2020-03-31",90,9,70,502,5709,0.961989840602557,8325,31551,315,427,71,630,8,355,70,8
"717","2020-04-01",109,9,75,556,5709,0.961989840602557,8325,31551,315,427,67,697,3,358,65,3
"718","2020-04-02",117,9,87,621,5709,0.961989840602557,8325,31551,315,427,81,778,10,368,78,10
"719","2020-04-03",161,9,94,678,5709,0.961989840602557,8325,31551,315,427,85,863,1,369,80,1
"720","2020-04-04",193,9,102,743,5709,0.961989840602557,8325,31551,315,427,115,978,2,371,114,2
"721","2020-04-05",205,9,94,799,5709,0.961989840602557,8325,31551,315,427,119,1097,7,378,113,7
"722","2020-04-06",219,9,122,864,5709,0.961989840602557,8325,31551,315,427,107,1204,2,380,101,2
"723","2020-04-07",234,9,125,938,5709,0.961989840602557,8325,31551,315,427,116,1320,9,389,114,9
"724","2020-04-08",246,9,110,997,5709,0.961989840602557,8325,31551,315,427,119,1439,21,410,114,21
"725","2020-04-09",273,9,110,1071,5709,0.961989840602557,8325,31551,315,427,121,1560,13,423,117,13
"726","2020-04-10",351,9,105,1120,5709,0.961989840602557,8325,31551,315,427,113,1673,11,434,111,11
"727","2020-04-11",350,9,112,1235,5709,0.961989840602557,8325,31551,315,427,110,1783,10,444,110,10
"728","2020-04-12",371,9,123,1292,5709,0.961989840602557,8325,31551,315,427,139,1922,29,473,135,29
"729","2020-04-13",391,9,128,1346,5709,0.961989840602557,8325,31551,315,427,105,2027,18,491,104,18
"730","2020-04-14",387,9,153,1405,5709,0.961989840602557,8325,31551,315,427,156,2183,37,528,150,37
"731","2020-04-15",409,9,147,1424,5709,0.961989840602557,8325,31551,315,427,150,2333,10,538,147,10
"732","2020-04-16",419,9,154,1492,5709,0.961989840602557,8325,31551,315,427,110,2443,20,558,105,20
"733","2020-04-17",486,9,146,1516,5709,0.961989840602557,8325,31551,315,427,123,2566,21,579,120,21
"734","2020-04-18",504,9,133,1549,5709,0.961989840602557,8325,31551,315,427,121,2687,29,608,117,29
"735","2020-04-19",498,9,117,1571,5709,0.961989840602557,8325,31551,315,427,129,2816,21,629,125,21
"736","2020-04-20",507,9,127,1593,5709,0.961989840602557,8325,31551,315,427,119,2935,36,665,119,36
"737","2020-04-21",509,9,116,1627,5709,0.961989840602557,8325,31551,315,427,114,3049,17,682,111,17
"738","2020-04-22",502,9,125,1639,5709,0.961989840602557,8325,31551,315,427,134,3183,13,695,133,13
"739","2020-04-23",506,9,130,1673,5709,0.961989840602557,8325,31551,315,427,101,3284,33,728,98,33
"740","2020-04-24",559,9,114,1655,5709,0.961989840602557,8325,31551,315,427,130,3414,26,754,127,26
"741","2020-04-25",573,9,108,1634,5709,0.961989840602557,8325,31551,315,427,102,3516,45,799,98,45
"742","2020-04-26",524,9,95,1610,5709,0.961989840602557,8325,31551,315,427,107,3623,24,823,100,24
"743","2020-04-27",530,9,79,1591,5709,0.961989840602557,8325,31551,315,427,74,3697,10,833,71,10
"744","2020-04-28",522,9,114,1536,5709,0.961989840602557,8325,31551,315,427,99,3796,27,860,99,27
"745","2020-04-29",525,9,106,1472,5709,0.961989840602557,8325,31551,315,427,103,3899,27,887,102,27
"746","2020-04-30",520,9,121,1421,5709,0.961989840602557,8325,31551,315,427,97,3996,44,931,91,44
"747","2020-05-01",533,9,137,1384,5709,0.961989840602557,8325,31551,315,427,73,4069,57,988,70,57
"748","2020-05-02",525,9,145,1301,5709,0.961989840602557,8325,31551,315,427,53,4122,33,1021,51,33
"749","2020-05-03",468,9,135,1232,5709,0.961989840602557,8325,31551,315,427,64,4186,54,1075,61,54
"750","2020-05-04",440,9,133,1143,5709,0.961989840602557,8325,31551,315,427,50,4236,23,1098,48,23
"751","2020-05-05",420,9,114,1050,5709,0.961989840602557,8325,31551,315,427,81,4317,17,1115,75,17
"752","2020-05-06",396,9,102,996,5709,0.961989840602557,8325,31551,315,427,65,4382,23,1138,63,23
"753","2020-05-07",387,9,102,926,5709,0.961989840602557,8325,31551,315,427,46,4428,31,1169,46,31
"754","2020-05-08",336,9,89,857,5709,0.961989840602557,8325,31551,315,427,57,4485,23,1192,57,23
"755","2020-05-09",307,9,91,788,5709,0.961989840602557,8325,31551,315,427,39,4524,45,1237,36,45
"756","2020-05-10",277,9,93,718,5709,0.961989840602557,8325,31551,315,427,40,4564,21,1258,39,21
"757","2020-05-11",261,9,100,666,5709,0.961989840602557,8325,31551,315,427,32,4596,9,1267,29,9
"758","2020-05-12",245,9,115,604,5709,0.961989840602557,8325,31551,315,427,51,4647,11,1278,47,11
"759","2020-05-13",234,9,125,562,5709,0.961989840602557,8325,31551,315,427,30,4677,33,1311,29,33
"760","2020-05-14",205,9,123,519,5709,0.961989840602557,8325,31551,315,427,42,4719,12,1323,39,12
"761","2020-05-15",209,9,121,499,5709,0.961989840602557,8325,31551,315,427,22,4741,19,1342,19,19
"762","2020-05-16",199,9,126,464,5709,0.961989840602557,8325,31551,315,427,21,4762,13,1355,21,13
"763","2020-05-17",175,9,126,432,5709,0.961989840602557,8325,31551,315,427,21,4783,18,1373,20,18
"764","2020-05-18",168,9,110,399,5709,0.961989840602557,8325,31551,315,427,21,4804,20,1393,19,20
"765","2020-05-19",162,9,136,375,5709,0.961989840602557,8325,31551,315,427,25,4829,13,1406,25,13
"766","2020-05-20",156,9,147,345,5709,0.961989840602557,8325,31551,315,427,24,4853,12,1418,23,12
"767","2020-05-21",152,9,141,297,5709,0.961989840602557,8325,31551,315,427,18,4871,8,1426,17,8
"768","2020-05-22",135,9,129,277,5709,0.961989840602557,8325,31551,315,427,18,4889,9,1435,16,9
"769","2020-05-23",124,9,116,253,5709,0.961989840602557,8325,31551,315,427,14,4903,29,1464,12,29
"770","2020-05-24",105,9,110,231,5709,0.961989840602557,8325,31551,315,427,9,4912,19,1483,9,19
"771","2020-05-25",92,9,118,219,5709,0.961989840602557,8325,31551,315,427,16,4928,24,1507,15,24
"772","2020-05-26",81,9,120,215,5709,0.961989840602557,8325,31551,315,427,7,4935,31,1538,6,31
"773","2020-05-27",72,9,117,193,5709,0.961989840602557,8325,31551,315,427,15,4950,36,1574,14,36
"774","2020-05-28",72,9,112,179,5709,0.961989840602557,8325,31551,315,427,11,4961,29,1603,11,29
"775","2020-05-29",59,9,118,165,5709,0.961989840602557,8325,31551,315,427,11,4972,19,1622,8,19
"776","2020-05-30",60,9,103,159,5709,0.961989840602557,8325,31551,315,427,13,4985,20,1642,12,20
"777","2020-05-31",58,9,103,142,5709,0.961989840602557,8325,31551,315,427,8,4993,26,1668,8,26
"778","2020-06-01",56,9,100,137,5709,0.961989840602557,8325,31551,315,427,5,4998,49,1717,5,49
"779","2020-06-02",49,9,88,132,5709,0.961989840602557,8325,31551,315,427,7,5005,25,1742,5,25
"780","2020-06-03",47,9,78,118,5709,0.961989840602557,8325,31551,315,427,7,5012,28,1770,6,28
"781","2020-06-04",41,9,86,115,5709,0.961989840602557,8325,31551,315,427,7,5019,19,1789,6,19
"782","2020-06-05",43,9,82,110,5709,0.961989840602557,8325,31551,315,427,10,5029,16,1805,9,16
"783","2020-06-06",39,9,78,102,5709,0.961989840602557,8325,31551,315,427,4,5033,22,1827,3,22
"784","2020-06-07",41,9,86,91,5709,0.961989840602557,8325,31551,315,427,12,5045,19,1846,11,19
"785","2020-03-14",2,10,61,19,5710,0.945709281961471,8220,30963,339,591,13,48,2,26,3,2
"786","2020-03-15",2,10,75,24,5710,0.945709281961471,8220,30963,339,591,22,70,3,29,13,3
"787","2020-03-16",1,10,72,31,5710,0.945709281961471,8220,30963,339,591,20,90,16,45,11,16
"788","2020-03-17",6,10,76,48,5710,0.945709281961471,8220,30963,339,591,23,113,4,49,8,4
"789","2020-03-18",7,10,72,56,5710,0.945709281961471,8220,30963,339,591,22,135,3,52,11,3
"790","2020-03-19",7,10,71,67,5710,0.945709281961471,8220,30963,339,591,26,161,14,66,17,14
"791","2020-03-20",11,10,67,85,5710,0.945709281961471,8220,30963,339,591,28,189,9,75,17,9
"792","2020-03-21",13,10,79,101,5710,0.945709281961471,8220,30963,339,591,39,228,8,83,26,8
"793","2020-03-22",20,10,80,127,5710,0.945709281961471,8220,30963,339,591,39,267,9,92,26,9
"794","2020-03-23",27,10,68,156,5710,0.945709281961471,8220,30963,339,591,43,310,9,101,33,9
"795","2020-03-24",26,10,67,186,5710,0.945709281961471,8220,30963,339,591,52,362,8,109,42,8
"796","2020-03-25",30,10,59,214,5710,0.945709281961471,8220,30963,339,591,37,399,8,117,25,8
"797","2020-03-26",36,10,67,229,5710,0.945709281961471,8220,30963,339,591,59,458,9,126,44,9
"798","2020-03-27",45,10,80,262,5710,0.945709281961471,8220,30963,339,591,56,514,12,138,37,12
"799","2020-03-28",51,10,77,313,5710,0.945709281961471,8220,30963,339,591,58,572,12,150,43,12
"800","2020-03-29",77,10,87,355,5710,0.945709281961471,8220,30963,339,591,52,624,6,156,44,6
"801","2020-03-30",84,10,81,398,5710,0.945709281961471,8220,30963,339,591,62,686,12,168,48,12
"802","2020-03-31",82,10,92,460,5710,0.945709281961471,8220,30963,339,591,71,757,12,180,61,12
"803","2020-04-01",91,10,91,517,5710,0.945709281961471,8220,30963,339,591,79,836,9,189,65,9
"804","2020-04-02",100,10,87,583,5710,0.945709281961471,8220,30963,339,591,72,908,13,202,64,13
"805","2020-04-03",154,10,77,642,5710,0.945709281961471,8220,30963,339,591,74,982,12,214,65,12
"806","2020-04-04",194,10,91,720,5710,0.945709281961471,8220,30963,339,591,78,1060,19,233,70,19
"807","2020-04-05",193,10,94,781,5710,0.945709281961471,8220,30963,339,591,79,1139,13,246,68,13
"808","2020-04-06",200,10,87,860,5710,0.945709281961471,8220,30963,339,591,81,1220,15,261,67,15
"809","2020-04-07",208,10,109,928,5710,0.945709281961471,8220,30963,339,591,73,1293,21,282,55,21
"810","2020-04-08",228,10,111,984,5710,0.945709281961471,8220,30963,339,591,85,1378,21,303,72,21
"811","2020-04-09",241,10,123,1072,5710,0.945709281961471,8220,30963,339,591,83,1461,21,324,68,21
"812","2020-04-10",319,10,107,1192,5710,0.945709281961471,8220,30963,339,591,115,1576,22,346,100,22
"813","2020-04-11",364,10,106,1288,5710,0.945709281961471,8220,30963,339,591,97,1673,12,358,91,12
"814","2020-04-12",331,10,104,1356,5710,0.945709281961471,8220,30963,339,591,101,1774,20,378,84,20
"815","2020-04-13",332,10,97,1422,5710,0.945709281961471,8220,30963,339,591,93,1867,18,396,77,18
"816","2020-04-14",357,10,124,1508,5710,0.945709281961471,8220,30963,339,591,98,1965,22,418,93,22
"817","2020-04-15",377,10,144,1543,5710,0.945709281961471,8220,30963,339,591,102,2067,15,433,82,15
"818","2020-04-16",413,10,156,1598,5710,0.945709281961471,8220,30963,339,591,99,2166,18,451,90,18
"819","2020-04-17",501,10,154,1632,5710,0.945709281961471,8220,30963,339,591,82,2248,18,469,69,18
"820","2020-04-18",489,10,172,1663,5710,0.945709281961471,8220,30963,339,591,84,2332,15,484,79,15
"821","2020-04-19",500,10,182,1647,5710,0.945709281961471,8220,30963,339,591,100,2432,19,503,88,19
"822","2020-04-20",517,10,218,1689,5710,0.945709281961471,8220,30963,339,591,100,2532,15,518,89,15
"823","2020-04-21",527,10,206,1680,5710,0.945709281961471,8220,30963,339,591,88,2620,11,529,75,11
"824","2020-04-22",536,10,190,1703,5710,0.945709281961471,8220,30963,339,591,66,2686,11,540,50,11
"825","2020-04-23",523,10,183,1680,5710,0.945709281961471,8220,30963,339,591,92,2778,13,553,81,13
"826","2020-04-24",573,10,197,1645,5710,0.945709281961471,8220,30963,339,591,71,2849,7,560,63,7
"827","2020-04-25",572,10,199,1608,5710,0.945709281961471,8220,30963,339,591,72,2921,22,582,61,22
"828","2020-04-26",545,10,190,1596,5710,0.945709281961471,8220,30963,339,591,84,3005,15,597,74,15
"829","2020-04-27",544,10,189,1567,5710,0.945709281961471,8220,30963,339,591,89,3094,10,607,72,10
"830","2020-04-28",534,10,181,1540,5710,0.945709281961471,8220,30963,339,591,67,3161,19,626,59,19
"831","2020-04-29",523,10,155,1492,5710,0.945709281961471,8220,30963,339,591,69,3230,25,651,65,25
"832","2020-04-30",527,10,173,1438,5710,0.945709281961471,8220,30963,339,591,62,3292,17,668,54,17
"833","2020-05-01",552,10,170,1381,5710,0.945709281961471,8220,30963,339,591,86,3378,22,690,72,22
"834","2020-05-02",566,10,173,1300,5710,0.945709281961471,8220,30963,339,591,52,3430,14,704,41,14
"835","2020-05-03",504,10,168,1245,5710,0.945709281961471,8220,30963,339,591,41,3471,26,730,29,26
"836","2020-05-04",487,10,153,1167,5710,0.945709281961471,8220,30963,339,591,57,3528,28,758,47,28
"837","2020-05-05",464,10,132,1084,5710,0.945709281961471,8220,30963,339,591,58,3586,28,786,48,28
"838","2020-05-06",443,10,129,1018,5710,0.945709281961471,8220,30963,339,591,49,3635,15,801,38,15
"839","2020-05-07",420,10,133,938,5710,0.945709281961471,8220,30963,339,591,46,3681,27,828,36,27
"840","2020-05-08",361,10,155,877,5710,0.945709281961471,8220,30963,339,591,54,3735,25,853,43,25
"841","2020-05-09",329,10,156,819,5710,0.945709281961471,8220,30963,339,591,53,3788,13,866,41,13
"842","2020-05-10",323,10,145,766,5710,0.945709281961471,8220,30963,339,591,41,3829,19,885,30,19
"843","2020-05-11",303,10,138,710,5710,0.945709281961471,8220,30963,339,591,41,3870,15,900,26,15
"844","2020-05-12",280,10,134,659,5710,0.945709281961471,8220,30963,339,591,48,3918,16,916,38,16
"845","2020-05-13",278,10,136,606,5710,0.945709281961471,8220,30963,339,591,47,3965,5,921,36,5
"846","2020-05-14",266,10,156,546,5710,0.945709281961471,8220,30963,339,591,37,4002,11,932,31,11
"847","2020-05-15",217,10,177,499,5710,0.945709281961471,8220,30963,339,591,37,4039,10,942,26,10
"848","2020-05-16",221,10,185,455,5710,0.945709281961471,8220,30963,339,591,41,4080,18,960,33,18
"849","2020-05-17",183,10,189,409,5710,0.945709281961471,8220,30963,339,591,27,4107,12,972,25,12
"850","2020-05-18",164,10,192,368,5710,0.945709281961471,8220,30963,339,591,22,4129,23,995,16,23
"851","2020-05-19",155,10,172,327,5710,0.945709281961471,8220,30963,339,591,26,4155,11,1006,19,11
"852","2020-05-20",138,10,157,308,5710,0.945709281961471,8220,30963,339,591,30,4185,10,1016,23,10
"853","2020-05-21",123,10,140,278,5710,0.945709281961471,8220,30963,339,591,26,4211,12,1028,19,12
"854","2020-05-22",112,10,131,255,5710,0.945709281961471,8220,30963,339,591,34,4245,20,1048,27,20
"855","2020-05-23",88,10,126,238,5710,0.945709281961471,8220,30963,339,591,33,4278,13,1061,28,13
"856","2020-05-24",77,10,113,218,5710,0.945709281961471,8220,30963,339,591,17,4295,32,1093,16,32
"857","2020-05-25",67,10,99,194,5710,0.945709281961471,8220,30963,339,591,19,4314,12,1105,14,12
"858","2020-05-26",65,10,106,177,5710,0.945709281961471,8220,30963,339,591,20,4334,5,1110,14,5
"859","2020-05-27",59,10,96,151,5710,0.945709281961471,8220,30963,339,591,21,4355,4,1114,16,4
"860","2020-05-28",60,10,95,132,5710,0.945709281961471,8220,30963,339,591,14,4369,4,1118,11,4
"861","2020-05-29",54,10,93,115,5710,0.945709281961471,8220,30963,339,591,11,4380,3,1121,8,3
"862","2020-05-30",53,10,91,102,5710,0.945709281961471,8220,30963,339,591,23,4403,7,1128,18,7
"863","2020-05-31",44,10,89,89,5710,0.945709281961471,8220,30963,339,591,13,4416,11,1139,8,11
"864","2020-06-01",41,10,90,84,5710,0.945709281961471,8220,30963,339,591,18,4434,4,1143,11,4
"865","2020-06-02",36,10,106,70,5710,0.945709281961471,8220,30963,339,591,13,4447,10,1153,12,10
"866","2020-06-03",32,10,100,58,5710,0.945709281961471,8220,30963,339,591,19,4466,6,1159,16,6
"867","2020-06-04",27,10,90,57,5710,0.945709281961471,8220,30963,339,591,13,4479,5,1164,9,5
"868","2020-06-05",23,10,91,55,5710,0.945709281961471,8220,30963,339,591,6,4485,8,1172,6,8
"869","2020-06-06",20,10,91,51,5710,0.945709281961471,8220,30963,339,591,12,4497,4,1176,9,4
"870","2020-06-07",20,10,77,48,5710,0.945709281961471,8220,30963,339,591,18,4515,1,1177,13,1
"871","2020-03-14",3,11,68,62,5823,0.815215524643654,8490,33013,345,551,18,72,7,39,4,7
"872","2020-03-15",7,11,68,84,5823,0.815215524643654,8490,33013,345,551,26,98,14,53,7,14
"873","2020-03-16",7,11,66,110,5823,0.815215524643654,8490,33013,345,551,36,134,12,65,11,12
"874","2020-03-17",10,11,69,142,5823,0.815215524643654,8490,33013,345,551,37,171,30,95,6,30
"875","2020-03-18",14,11,60,172,5823,0.815215524643654,8490,33013,345,551,36,207,39,134,12,39
"876","2020-03-19",20,11,50,211,5823,0.815215524643654,8490,33013,345,551,52,259,25,159,26,25
"877","2020-03-20",40,11,58,257,5823,0.815215524643654,8490,33013,345,551,56,315,39,198,31,39
"878","2020-03-21",62,11,66,296,5823,0.815215524643654,8490,33013,345,551,45,360,26,224,30,26
"879","2020-03-22",69,11,79,353,5823,0.815215524643654,8490,33013,345,551,58,418,35,259,41,35
"880","2020-03-23",70,11,55,404,5823,0.815215524643654,8490,33013,345,551,57,475,32,291,39,32
"881","2020-03-24",77,11,53,485,5823,0.815215524643654,8490,33013,345,551,67,542,30,321,49,30
"882","2020-03-25",98,11,44,552,5823,0.815215524643654,8490,33013,345,551,60,602,33,354,39,33
"883","2020-03-26",113,11,39,613,5823,0.815215524643654,8490,33013,345,551,90,692,22,376,68,22
"884","2020-03-27",152,11,36,692,5823,0.815215524643654,8490,33013,345,551,84,776,48,424,67,48
"885","2020-03-28",199,11,67,761,5823,0.815215524643654,8490,33013,345,551,81,857,41,465,55,41
"886","2020-03-29",213,11,88,828,5823,0.815215524643654,8490,33013,345,551,87,944,30,495,64,30
"887","2020-03-30",220,11,89,889,5823,0.815215524643654,8490,33013,345,551,63,1007,24,519,46,24
"888","2020-03-31",232,11,98,963,5823,0.815215524643654,8490,33013,345,551,91,1098,30,549,67,30
"889","2020-04-01",238,11,98,1070,5823,0.815215524643654,8490,33013,345,551,88,1186,46,595,72,46
"890","2020-04-02",251,11,81,1121,5823,0.815215524643654,8490,33013,345,551,100,1286,25,620,79,25
"891","2020-04-03",331,11,83,1198,5823,0.815215524643654,8490,33013,345,551,84,1370,25,645,65,25
"892","2020-04-04",331,11,99,1263,5823,0.815215524643654,8490,33013,345,551,93,1463,43,688,71,43
"893","2020-04-05",355,11,105,1302,5823,0.815215524643654,8490,33013,345,551,113,1576,46,734,92,46
"894","2020-04-06",379,11,105,1360,5823,0.815215524643654,8490,33013,345,551,114,1690,49,783,89,49
"895","2020-04-07",393,11,109,1366,5823,0.815215524643654,8490,33013,345,551,90,1780,45,828,69,45
"896","2020-04-08",398,11,125,1417,5823,0.815215524643654,8490,33013,345,551,104,1884,27,855,78,27
"897","2020-04-09",418,11,117,1461,5823,0.815215524643654,8490,33013,345,551,104,1988,44,899,84,44
"898","2020-04-10",522,11,108,1501,5823,0.815215524643654,8490,33013,345,551,85,2073,62,961,71,62
"899","2020-04-11",522,11,130,1547,5823,0.815215524643654,8490,33013,345,551,103,2176,45,1006,80,45
"900","2020-04-12",517,11,155,1542,5823,0.815215524643654,8490,33013,345,551,101,2277,45,1051,77,45
"901","2020-04-13",527,11,166,1539,5823,0.815215524643654,8490,33013,345,551,96,2373,31,1082,71,31
"902","2020-04-14",514,11,145,1553,5823,0.815215524643654,8490,33013,345,551,91,2464,27,1109,72,27
"903","2020-04-15",531,11,126,1515,5823,0.815215524643654,8490,33013,345,551,88,2552,33,1142,70,33
"904","2020-04-16",533,11,107,1502,5823,0.815215524643654,8490,33013,345,551,85,2637,34,1176,64,34
"905","2020-04-17",557,11,96,1484,5823,0.815215524643654,8490,33013,345,551,75,2712,48,1224,62,48
"906","2020-04-18",568,11,90,1475,5823,0.815215524643654,8490,33013,345,551,88,2800,26,1250,69,26
"907","2020-04-19",488,11,113,1446,5823,0.815215524643654,8490,33013,345,551,76,2876,24,1274,52,24
"908","2020-04-20",461,11,139,1443,5823,0.815215524643654,8490,33013,345,551,82,2958,28,1302,56,28
"909","2020-04-21",451,11,143,1401,5823,0.815215524643654,8490,33013,345,551,61,3019,30,1332,40,30
"910","2020-04-22",445,11,148,1350,5823,0.815215524643654,8490,33013,345,551,72,3091,55,1387,57,55
"911","2020-04-23",442,11,121,1302,5823,0.815215524643654,8490,33013,345,551,95,3186,57,1444,69,57
"912","2020-04-24",455,11,107,1270,5823,0.815215524643654,8490,33013,345,551,50,3236,44,1488,30,44
"913","2020-04-25",439,11,104,1223,5823,0.815215524643654,8490,33013,345,551,79,3315,38,1526,53,38
"914","2020-04-26",405,11,134,1190,5823,0.815215524643654,8490,33013,345,551,48,3363,50,1576,37,50
"915","2020-04-27",410,11,160,1130,5823,0.815215524643654,8490,33013,345,551,64,3427,44,1620,43,44
"916","2020-04-28",385,11,182,1060,5823,0.815215524643654,8490,33013,345,551,56,3483,30,1650,33,30
"917","2020-04-29",374,11,190,1016,5823,0.815215524643654,8490,33013,345,551,50,3533,38,1688,34,38
"918","2020-04-30",359,11,175,949,5823,0.815215524643654,8490,33013,345,551,44,3577,42,1730,28,42
"919","2020-05-01",325,11,158,885,5823,0.815215524643654,8490,33013,345,551,63,3640,52,1782,39,52
"920","2020-05-02",318,11,131,851,5823,0.815215524643654,8490,33013,345,551,56,3696,43,1825,37,43
"921","2020-05-03",297,11,116,793,5823,0.815215524643654,8490,33013,345,551,39,3735,48,1873,18,48
"922","2020-05-04",282,11,117,747,5823,0.815215524643654,8490,33013,345,551,52,3787,65,1938,31,65
"923","2020-05-05",279,11,109,700,5823,0.815215524643654,8490,33013,345,551,53,3840,36,1974,37,36
"924","2020-05-06",271,11,116,644,5823,0.815215524643654,8490,33013,345,551,56,3896,59,2033,30,59
"925","2020-05-07",257,11,120,588,5823,0.815215524643654,8490,33013,345,551,65,3961,57,2090,49,57
"926","2020-05-08",245,11,126,557,5823,0.815215524643654,8490,33013,345,551,41,4002,54,2144,21,54
"927","2020-05-09",246,11,120,527,5823,0.815215524643654,8490,33013,345,551,47,4049,41,2185,32,41
"928","2020-05-10",228,11,136,485,5823,0.815215524643654,8490,33013,345,551,39,4088,49,2234,27,49
"929","2020-05-11",205,11,130,457,5823,0.815215524643654,8490,33013,345,551,40,4128,56,2290,22,56
"930","2020-05-12",190,11,132,419,5823,0.815215524643654,8490,33013,345,551,30,4158,44,2334,18,44
"931","2020-05-13",175,11,147,396,5823,0.815215524643654,8490,33013,345,551,32,4190,42,2376,19,42
"932","2020-05-14",164,11,146,367,5823,0.815215524643654,8490,33013,345,551,41,4231,54,2430,27,54
"933","2020-05-15",146,11,169,347,5823,0.815215524643654,8490,33013,345,551,31,4262,39,2469,15,39
"934","2020-05-16",130,11,179,330,5823,0.815215524643654,8490,33013,345,551,38,4300,42,2511,23,42
"935","2020-05-17",118,11,189,316,5823,0.815215524643654,8490,33013,345,551,26,4326,57,2568,13,57
"936","2020-05-18",115,11,180,302,5823,0.815215524643654,8490,33013,345,551,32,4358,51,2619,16,51
"937","2020-05-19",108,11,184,284,5823,0.815215524643654,8490,33013,345,551,22,4380,50,2669,9,50
"938","2020-05-20",112,11,172,273,5823,0.815215524643654,8490,33013,345,551,21,4401,42,2711,13,42
"939","2020-05-21",114,11,178,272,5823,0.815215524643654,8490,33013,345,551,22,4423,39,2750,12,39
"940","2020-05-22",113,11,148,256,5823,0.815215524643654,8490,33013,345,551,18,4441,31,2781,10,31
"941","2020-05-23",113,11,136,246,5823,0.815215524643654,8490,33013,345,551,30,4471,50,2831,20,50
"942","2020-05-24",91,11,129,236,5823,0.815215524643654,8490,33013,345,551,15,4486,58,2889,12,58
"943","2020-05-25",90,11,126,229,5823,0.815215524643654,8490,33013,345,551,22,4508,53,2942,17,53
"944","2020-05-26",86,11,137,216,5823,0.815215524643654,8490,33013,345,551,21,4529,56,2998,10,56
"945","2020-05-27",81,11,137,207,5823,0.815215524643654,8490,33013,345,551,19,4548,42,3040,7,42
"946","2020-05-28",71,11,137,188,5823,0.815215524643654,8490,33013,345,551,23,4571,37,3077,11,37
"947","2020-05-29",71,11,134,165,5823,0.815215524643654,8490,33013,345,551,34,4605,51,3128,29,51
"948","2020-05-30",66,11,124,161,5823,0.815215524643654,8490,33013,345,551,16,4621,46,3174,14,46
"949","2020-05-31",66,11,120,151,5823,0.815215524643654,8490,33013,345,551,17,4638,46,3220,13,46
"950","2020-06-01",61,11,106,141,5823,0.815215524643654,8490,33013,345,551,17,4655,39,3259,11,39
"951","2020-06-02",54,11,95,133,5823,0.815215524643654,8490,33013,345,551,12,4667,50,3309,8,50
"952","2020-06-03",47,11,84,129,5823,0.815215524643654,8490,33013,345,551,9,4676,47,3356,5,47
"953","2020-06-04",46,11,75,121,5823,0.815215524643654,8490,33013,345,551,11,4687,32,3388,7,32
"954","2020-06-05",42,11,71,117,5823,0.815215524643654,8490,33013,345,551,6,4693,38,3426,4,38
"955","2020-06-06",45,11,80,110,5823,0.815215524643654,8490,33013,345,551,8,4701,39,3465,4,39
"956","2020-06-07",41,11,76,105,5823,0.815215524643654,8490,33013,345,551,11,4712,18,3483,7,18
"957","2020-03-13",1,12,29,65,4014,0.575734927752865,8325,28511,205,373,8,35,1,18,2,1
"958","2020-03-14",2,12,36,80,4014,0.575734927752865,8325,28511,205,373,13,48,4,22,9,4
"959","2020-03-15",8,12,43,105,4014,0.575734927752865,8325,28511,205,373,12,60,13,35,8,13
"960","2020-03-16",10,12,38,133,4014,0.575734927752865,8325,28511,205,373,24,84,10,45,13,10
"961","2020-03-17",12,12,46,159,4014,0.575734927752865,8325,28511,205,373,26,110,15,60,11,15
"962","2020-03-18",20,12,54,187,4014,0.575734927752865,8325,28511,205,373,26,136,19,79,15,19
"963","2020-03-19",32,12,63,217,4014,0.575734927752865,8325,28511,205,373,39,175,21,100,22,21
"964","2020-03-20",48,12,70,227,4014,0.575734927752865,8325,28511,205,373,26,201,15,115,18,15
"965","2020-03-21",82,12,72,259,4014,0.575734927752865,8325,28511,205,373,31,232,12,127,22,12
"966","2020-03-22",89,12,64,283,4014,0.575734927752865,8325,28511,205,373,60,292,6,133,50,6
"967","2020-03-23",89,12,63,304,4014,0.575734927752865,8325,28511,205,373,31,323,10,143,24,10
"968","2020-03-24",93,12,55,316,4014,0.575734927752865,8325,28511,205,373,35,358,20,163,28,20
"969","2020-03-25",92,12,54,330,4014,0.575734927752865,8325,28511,205,373,42,400,20,183,38,20
"970","2020-03-26",92,12,55,357,4014,0.575734927752865,8325,28511,205,373,45,445,18,201,37,18
"971","2020-03-27",115,12,55,362,4014,0.575734927752865,8325,28511,205,373,40,485,19,220,33,19
"972","2020-03-28",103,12,58,375,4014,0.575734927752865,8325,28511,205,373,41,526,14,234,36,14
"973","2020-03-29",101,12,59,397,4014,0.575734927752865,8325,28511,205,373,51,577,31,265,41,31
"974","2020-03-30",108,12,69,426,4014,0.575734927752865,8325,28511,205,373,42,619,21,286,35,21
"975","2020-03-31",113,12,66,434,4014,0.575734927752865,8325,28511,205,373,63,682,19,305,49,19
"976","2020-04-01",117,12,70,459,4014,0.575734927752865,8325,28511,205,373,54,736,28,333,46,28
"977","2020-04-02",126,12,73,487,4014,0.575734927752865,8325,28511,205,373,60,796,17,350,53,17
"978","2020-04-03",141,12,77,500,4014,0.575734927752865,8325,28511,205,373,61,857,15,365,50,15
"979","2020-04-04",143,12,79,511,4014,0.575734927752865,8325,28511,205,373,47,904,7,372,38,7
"980","2020-04-05",157,12,71,519,4014,0.575734927752865,8325,28511,205,373,65,969,35,407,50,35
"981","2020-04-06",159,12,83,550,4014,0.575734927752865,8325,28511,205,373,62,1031,29,436,48,29
"982","2020-04-07",158,12,82,573,4014,0.575734927752865,8325,28511,205,373,57,1088,23,459,47,23
"983","2020-04-08",172,12,75,590,4014,0.575734927752865,8325,28511,205,373,68,1156,23,482,60,23
"984","2020-04-09",175,12,94,615,4014,0.575734927752865,8325,28511,205,373,56,1212,19,501,53,19
"985","2020-04-10",193,12,90,613,4014,0.575734927752865,8325,28511,205,373,61,1273,32,533,51,32
"986","2020-04-11",221,12,94,628,4014,0.575734927752865,8325,28511,205,373,56,1329,10,543,47,10
"987","2020-04-12",211,12,90,654,4014,0.575734927752865,8325,28511,205,373,65,1394,26,569,52,26
"988","2020-04-13",219,12,90,662,4014,0.575734927752865,8325,28511,205,373,70,1464,28,597,60,28
"989","2020-04-14",213,12,97,666,4014,0.575734927752865,8325,28511,205,373,52,1516,28,625,38,28
"990","2020-04-15",217,12,106,680,4014,0.575734927752865,8325,28511,205,373,85,1601,20,645,71,20
"991","2020-04-16",221,12,109,684,4014,0.575734927752865,8325,28511,205,373,72,1673,9,654,61,9
"992","2020-04-17",242,12,117,691,4014,0.575734927752865,8325,28511,205,373,72,1745,12,666,67,12
"993","2020-04-18",240,12,112,693,4014,0.575734927752865,8325,28511,205,373,87,1832,9,675,69,9
"994","2020-04-19",229,12,114,695,4014,0.575734927752865,8325,28511,205,373,62,1894,21,696,52,21
"995","2020-04-20",221,12,115,689,4014,0.575734927752865,8325,28511,205,373,69,1963,19,715,56,19
"996","2020-04-21",219,12,143,680,4014,0.575734927752865,8325,28511,205,373,92,2055,21,736,80,21
"997","2020-04-22",212,12,134,682,4014,0.575734927752865,8325,28511,205,373,60,2115,21,757,50,21
"998","2020-04-23",208,12,132,676,4014,0.575734927752865,8325,28511,205,373,74,2189,28,785,56,28
"999","2020-04-24",230,12,143,673,4014,0.575734927752865,8325,28511,205,373,51,2240,9,794,43,9
"1000","2020-04-25",223,12,146,686,4014,0.575734927752865,8325,28511,205,373,59,2299,12,806,46,12
"1001","2020-04-26",219,12,144,683,4014,0.575734927752865,8325,28511,205,373,62,2361,16,822,52,16
"1002","2020-04-27",225,12,151,690,4014,0.575734927752865,8325,28511,205,373,76,2437,6,828,66,6
"1003","2020-04-28",225,12,152,694,4014,0.575734927752865,8325,28511,205,373,60,2497,31,859,50,31
"1004","2020-04-29",230,12,158,679,4014,0.575734927752865,8325,28511,205,373,58,2555,34,893,49,34
"1005","2020-04-30",227,12,144,669,4014,0.575734927752865,8325,28511,205,373,60,2615,21,914,52,21
"1006","2020-05-01",234,12,153,653,4014,0.575734927752865,8325,28511,205,373,65,2680,11,925,57,11
"1007","2020-05-02",251,12,141,642,4014,0.575734927752865,8325,28511,205,373,64,2744,17,942,55,17
"1008","2020-05-03",221,12,150,656,4014,0.575734927752865,8325,28511,205,373,55,2799,18,960,47,18
"1009","2020-05-04",207,12,151,656,4014,0.575734927752865,8325,28511,205,373,61,2860,29,989,54,29
"1010","2020-05-05",204,12,142,683,4014,0.575734927752865,8325,28511,205,373,70,2930,14,1003,61,14
"1011","2020-05-06",196,12,143,676,4014,0.575734927752865,8325,28511,205,373,49,2979,34,1037,40,34
"1012","2020-05-07",204,12,129,665,4014,0.575734927752865,8325,28511,205,373,62,3041,18,1055,49,18
"1013","2020-05-08",215,12,136,659,4014,0.575734927752865,8325,28511,205,373,61,3102,20,1075,47,20
"1014","2020-05-09",221,12,128,632,4014,0.575734927752865,8325,28511,205,373,48,3150,12,1087,43,12
"1015","2020-05-10",229,12,114,620,4014,0.575734927752865,8325,28511,205,373,57,3207,16,1103,46,16
"1016","2020-05-11",221,12,107,617,4014,0.575734927752865,8325,28511,205,373,48,3255,7,1110,44,7
"1017","2020-05-12",215,12,117,602,4014,0.575734927752865,8325,28511,205,373,42,3297,17,1127,35,17
"1018","2020-05-13",213,12,112,582,4014,0.575734927752865,8325,28511,205,373,43,3340,9,1136,36,9
"1019","2020-05-14",201,12,117,562,4014,0.575734927752865,8325,28511,205,373,36,3376,6,1142,34,6
"1020","2020-05-15",190,12,117,550,4014,0.575734927752865,8325,28511,205,373,27,3403,19,1161,22,19
"1021","2020-05-16",174,12,132,543,4014,0.575734927752865,8325,28511,205,373,42,3445,27,1188,34,27
"1022","2020-05-17",162,12,147,515,4014,0.575734927752865,8325,28511,205,373,38,3483,21,1209,29,21
"1023","2020-05-18",166,12,147,486,4014,0.575734927752865,8325,28511,205,373,23,3506,10,1219,18,10
"1024","2020-05-19",163,12,137,473,4014,0.575734927752865,8325,28511,205,373,28,3534,9,1228,20,9
"1025","2020-05-20",164,12,125,445,4014,0.575734927752865,8325,28511,205,373,24,3558,3,1231,20,3
"1026","2020-05-21",162,12,122,419,4014,0.575734927752865,8325,28511,205,373,28,3586,8,1239,17,8
"1027","2020-05-22",158,12,106,404,4014,0.575734927752865,8325,28511,205,373,31,3617,2,1241,30,2
"1028","2020-05-23",157,12,108,391,4014,0.575734927752865,8325,28511,205,373,29,3646,12,1253,21,12
"1029","2020-05-24",144,12,106,376,4014,0.575734927752865,8325,28511,205,373,31,3677,14,1267,26,14
"1030","2020-05-25",136,12,98,354,4014,0.575734927752865,8325,28511,205,373,30,3707,12,1279,23,12
"1031","2020-05-26",129,12,91,330,4014,0.575734927752865,8325,28511,205,373,26,3733,8,1287,22,8
"1032","2020-05-27",122,12,85,321,4014,0.575734927752865,8325,28511,205,373,22,3755,6,1293,17,6
"1033","2020-05-28",121,12,83,316,4014,0.575734927752865,8325,28511,205,373,18,3773,4,1297,14,4
"1034","2020-05-29",116,12,87,299,4014,0.575734927752865,8325,28511,205,373,23,3796,4,1301,19,4
"1035","2020-05-30",102,12,89,280,4014,0.575734927752865,8325,28511,205,373,21,3817,12,1313,17,12
"1036","2020-05-31",92,12,86,265,4014,0.575734927752865,8325,28511,205,373,15,3832,7,1320,15,7
"1037","2020-06-01",81,12,93,264,4014,0.575734927752865,8325,28511,205,373,13,3845,13,1333,11,13
"1038","2020-06-02",81,12,86,261,4014,0.575734927752865,8325,28511,205,373,17,3862,17,1350,10,17
"1039","2020-06-03",75,12,78,250,4014,0.575734927752865,8325,28511,205,373,14,3876,15,1365,12,15
"1040","2020-06-04",68,12,81,235,4014,0.575734927752865,8325,28511,205,373,14,3890,16,1381,12,16
"1041","2020-06-05",69,12,82,232,4014,0.575734927752865,8325,28511,205,373,17,3907,9,1390,14,9
"1042","2020-06-06",76,12,76,225,4014,0.575734927752865,8325,28511,205,373,12,3919,9,1399,9,9
"1043","2020-06-07",88,12,72,214,4014,0.575734927752865,8325,28511,205,373,13,3932,5,1404,11,5
"1044","2020-03-13",1,13,24,20,5640,0.908333333333333,8370,31482,343,447,10,37,4,12,1,4
"1045","2020-03-14",2,13,23,24,5640,0.908333333333333,8370,31482,343,447,16,53,2,14,4,2
"1046","2020-03-15",6,13,34,35,5640,0.908333333333333,8370,31482,343,447,13,66,4,18,4,4
"1047","2020-03-16",6,13,42,47,5640,0.908333333333333,8370,31482,343,447,26,92,4,22,10,4
"1048","2020-03-17",3,13,47,64,5640,0.908333333333333,8370,31482,343,447,13,105,2,24,7,2
"1049","2020-03-18",7,13,48,71,5640,0.908333333333333,8370,31482,343,447,28,133,1,25,14,1
"1050","2020-03-19",10,13,60,91,5640,0.908333333333333,8370,31482,343,447,26,159,6,31,12,6
"1051","2020-03-20",14,13,67,107,5640,0.908333333333333,8370,31482,343,447,24,183,5,36,8,5
"1052","2020-03-21",23,13,63,121,5640,0.908333333333333,8370,31482,343,447,41,224,4,40,23,4
"1053","2020-03-22",29,13,65,145,5640,0.908333333333333,8370,31482,343,447,37,261,NA,NA,24,NA
"1054","2020-03-23",35,13,56,156,5640,0.908333333333333,8370,31482,343,447,34,295,2,42,18,2
"1055","2020-03-24",36,13,69,173,5640,0.908333333333333,8370,31482,343,447,32,327,7,49,27,7
"1056","2020-03-25",37,13,74,197,5640,0.908333333333333,8370,31482,343,447,50,377,10,59,39,10
"1057","2020-03-26",45,13,75,228,5640,0.908333333333333,8370,31482,343,447,53,430,10,69,36,10
"1058","2020-03-27",58,13,83,278,5640,0.908333333333333,8370,31482,343,447,51,481,12,81,37,12
"1059","2020-03-28",68,13,84,302,5640,0.908333333333333,8370,31482,343,447,55,536,7,88,38,7
"1060","2020-03-29",82,13,86,334,5640,0.908333333333333,8370,31482,343,447,59,595,9,97,46,9
"1061","2020-03-30",80,13,91,384,5640,0.908333333333333,8370,31482,343,447,62,657,10,107,47,10
"1062","2020-03-31",88,13,96,413,5640,0.908333333333333,8370,31482,343,447,58,715,4,111,44,4
"1063","2020-04-01",97,13,93,455,5640,0.908333333333333,8370,31482,343,447,65,780,6,117,55,6
"1064","2020-04-02",104,13,95,498,5640,0.908333333333333,8370,31482,343,447,53,833,7,124,47,7
"1065","2020-04-03",129,13,96,563,5640,0.908333333333333,8370,31482,343,447,89,922,9,133,66,9
"1066","2020-04-04",164,13,104,619,5640,0.908333333333333,8370,31482,343,447,59,981,6,139,44,6
"1067","2020-04-05",169,13,109,706,5640,0.908333333333333,8370,31482,343,447,73,1054,10,149,53,10
"1068","2020-04-06",171,13,108,769,5640,0.908333333333333,8370,31482,343,447,99,1153,8,157,83,8
"1069","2020-04-07",180,13,104,856,5640,0.908333333333333,8370,31482,343,447,77,1230,8,165,64,8
"1070","2020-04-08",202,13,105,918,5640,0.908333333333333,8370,31482,343,447,87,1317,6,171,69,6
"1071","2020-04-09",228,13,116,989,5640,0.908333333333333,8370,31482,343,447,71,1388,8,179,52,8
"1072","2020-04-10",314,13,126,1047,5640,0.908333333333333,8370,31482,343,447,80,1468,19,198,70,19
"1073","2020-04-11",348,13,132,1140,5640,0.908333333333333,8370,31482,343,447,74,1542,24,222,64,24
"1074","2020-04-12",354,13,126,1219,5640,0.908333333333333,8370,31482,343,447,81,1623,9,231,67,9
"1075","2020-04-13",364,13,122,1260,5640,0.908333333333333,8370,31482,343,447,120,1743,15,246,105,15
"1076","2020-04-14",376,13,111,1326,5640,0.908333333333333,8370,31482,343,447,79,1822,16,262,59,16
"1077","2020-04-15",379,13,117,1422,5640,0.908333333333333,8370,31482,343,447,74,1896,17,279,59,17
"1078","2020-04-16",387,13,132,1449,5640,0.908333333333333,8370,31482,343,447,100,1996,9,288,85,9
"1079","2020-04-17",467,13,120,1510,5640,0.908333333333333,8370,31482,343,447,71,2067,8,296,60,8
"1080","2020-04-18",456,13,114,1546,5640,0.908333333333333,8370,31482,343,447,69,2136,14,310,57,14
"1081","2020-04-19",473,13,120,1574,5640,0.908333333333333,8370,31482,343,447,75,2211,19,329,62,19
"1082","2020-04-20",492,13,132,1599,5640,0.908333333333333,8370,31482,343,447,68,2279,13,342,59,13
"1083","2020-04-21",492,13,133,1631,5640,0.908333333333333,8370,31482,343,447,70,2349,11,353,61,11
"1084","2020-04-22",517,13,131,1645,5640,0.908333333333333,8370,31482,343,447,65,2414,6,359,54,6
"1085","2020-04-23",531,13,129,1659,5640,0.908333333333333,8370,31482,343,447,72,2486,16,375,60,16
"1086","2020-04-24",575,13,123,1628,5640,0.908333333333333,8370,31482,343,447,70,2556,11,386,56,11
"1087","2020-04-25",577,13,140,1668,5640,0.908333333333333,8370,31482,343,447,69,2625,7,393,58,7
"1088","2020-04-26",539,13,155,1624,5640,0.908333333333333,8370,31482,343,447,71,2696,17,410,55,17
"1089","2020-04-27",540,13,153,1602,5640,0.908333333333333,8370,31482,343,447,60,2756,18,428,46,18
"1090","2020-04-28",546,13,147,1522,5640,0.908333333333333,8370,31482,343,447,53,2809,16,444,43,16
"1091","2020-04-29",527,13,174,1475,5640,0.908333333333333,8370,31482,343,447,62,2871,18,462,48,18
"1092","2020-04-30",510,13,168,1412,5640,0.908333333333333,8370,31482,343,447,53,2924,15,477,46,15
"1093","2020-05-01",521,13,162,1327,5640,0.908333333333333,8370,31482,343,447,63,2987,28,505,52,28
"1094","2020-05-02",515,13,152,1261,5640,0.908333333333333,8370,31482,343,447,63,3050,4,509,45,4
"1095","2020-05-03",444,13,151,1230,5640,0.908333333333333,8370,31482,343,447,73,3123,11,520,60,11
"1096","2020-05-04",434,13,161,1159,5640,0.908333333333333,8370,31482,343,447,49,3172,6,526,38,6
"1097","2020-05-05",398,13,175,1136,5640,0.908333333333333,8370,31482,343,447,40,3212,4,530,30,4
"1098","2020-05-06",395,13,175,1060,5640,0.908333333333333,8370,31482,343,447,56,3268,7,537,44,7
"1099","2020-05-07",381,13,169,991,5640,0.908333333333333,8370,31482,343,447,47,3315,12,549,37,12
"1100","2020-05-08",358,13,177,905,5640,0.908333333333333,8370,31482,343,447,39,3354,12,561,30,12
"1101","2020-05-09",354,13,177,826,5640,0.908333333333333,8370,31482,343,447,37,3391,9,570,28,9
"1102","2020-05-10",339,13,164,785,5640,0.908333333333333,8370,31482,343,447,50,3441,9,579,34,9
"1103","2020-05-11",313,13,150,739,5640,0.908333333333333,8370,31482,343,447,45,3486,18,597,36,18
"1104","2020-05-12",297,13,135,681,5640,0.908333333333333,8370,31482,343,447,32,3518,12,609,24,12
"1105","2020-05-13",284,13,137,626,5640,0.908333333333333,8370,31482,343,447,37,3555,11,620,27,11
"1106","2020-05-14",275,13,128,575,5640,0.908333333333333,8370,31482,343,447,36,3591,9,629,27,9
"1107","2020-05-15",235,13,123,535,5640,0.908333333333333,8370,31482,343,447,32,3623,23,652,23,23
"1108","2020-05-16",213,13,120,503,5640,0.908333333333333,8370,31482,343,447,40,3663,22,674,29,22
"1109","2020-05-17",195,13,124,461,5640,0.908333333333333,8370,31482,343,447,30,3693,16,690,22,16
"1110","2020-05-18",180,13,118,418,5640,0.908333333333333,8370,31482,343,447,30,3723,15,705,21,15
"1111","2020-05-19",163,13,120,388,5640,0.908333333333333,8370,31482,343,447,37,3760,27,732,28,27
"1112","2020-05-20",148,13,126,365,5640,0.908333333333333,8370,31482,343,447,33,3793,23,755,24,23
"1113","2020-05-21",133,13,135,326,5640,0.908333333333333,8370,31482,343,447,37,3830,14,769,28,14
"1114","2020-05-22",116,13,131,308,5640,0.908333333333333,8370,31482,343,447,33,3863,12,781,23,12
"1115","2020-05-23",115,13,135,282,5640,0.908333333333333,8370,31482,343,447,27,3890,6,787,21,6
"1116","2020-05-24",105,13,131,273,5640,0.908333333333333,8370,31482,343,447,24,3914,16,803,20,16
"1117","2020-05-25",100,13,133,254,5640,0.908333333333333,8370,31482,343,447,25,3939,9,812,15,9
"1118","2020-05-26",103,13,136,236,5640,0.908333333333333,8370,31482,343,447,24,3963,12,824,18,12
"1119","2020-05-27",99,13,137,212,5640,0.908333333333333,8370,31482,343,447,23,3986,17,841,19,17
"1120","2020-05-28",97,13,132,202,5640,0.908333333333333,8370,31482,343,447,22,4008,8,849,13,8
"1121","2020-05-29",88,13,128,185,5640,0.908333333333333,8370,31482,343,447,18,4026,9,858,13,9
"1122","2020-05-30",77,13,127,175,5640,0.908333333333333,8370,31482,343,447,16,4042,7,865,11,7
"1123","2020-05-31",79,13,126,150,5640,0.908333333333333,8370,31482,343,447,20,4062,5,870,11,5
"1124","2020-06-01",71,13,111,132,5640,0.908333333333333,8370,31482,343,447,8,4070,3,873,5,3
"1125","2020-06-02",53,13,115,121,5640,0.908333333333333,8370,31482,343,447,27,4097,5,878,20,5
"1126","2020-06-03",47,13,103,105,5640,0.908333333333333,8370,31482,343,447,22,4119,10,888,19,10
"1127","2020-06-04",43,13,99,88,5640,0.908333333333333,8370,31482,343,447,14,4133,11,899,10,11
"1128","2020-06-05",42,13,101,85,5640,0.908333333333333,8370,31482,343,447,24,4157,3,902,20,3
"1129","2020-06-06",40,13,101,74,5640,0.908333333333333,8370,31482,343,447,15,4172,10,912,13,10
"1130","2020-06-07",25,13,91,69,5640,0.908333333333333,8370,31482,343,447,16,4188,4,916,16,4
"1131","2020-03-12",1,14,28,21,5427,0.906946747742768,8325,31209,312,574,12,19,7,13,4,7
"1132","2020-03-13",2,14,33,29,5427,0.906946747742768,8325,31209,312,574,9,28,15,28,6,15
"1133","2020-03-14",4,14,42,42,5427,0.906946747742768,8325,31209,312,574,10,38,16,44,5,16
"1134","2020-03-15",3,14,47,66,5427,0.906946747742768,8325,31209,312,574,20,58,8,52,10,8
"1135","2020-03-16",2,14,53,91,5427,0.906946747742768,8325,31209,312,574,19,77,4,56,14,4
"1136","2020-03-17",5,14,63,115,5427,0.906946747742768,8325,31209,312,574,27,104,3,59,19,3
"1137","2020-03-18",13,14,73,141,5427,0.906946747742768,8325,31209,312,574,27,131,2,61,17,2
"1138","2020-03-19",22,14,76,176,5427,0.906946747742768,8325,31209,312,574,24,155,3,64,15,3
"1139","2020-03-20",29,14,75,219,5427,0.906946747742768,8325,31209,312,574,27,182,NA,NA,17,NA
"1140","2020-03-21",43,14,101,263,5427,0.906946747742768,8325,31209,312,574,30,212,2,66,19,2
"1141","2020-03-22",55,14,113,313,5427,0.906946747742768,8325,31209,312,574,26,238,2,68,14,2
"1142","2020-03-23",60,14,118,346,5427,0.906946747742768,8325,31209,312,574,35,273,3,71,25,3
"1143","2020-03-24",72,14,116,388,5427,0.906946747742768,8325,31209,312,574,37,310,2,73,25,2
"1144","2020-03-25",74,14,130,433,5427,0.906946747742768,8325,31209,312,574,37,347,5,78,29,5
"1145","2020-03-26",75,14,131,479,5427,0.906946747742768,8325,31209,312,574,51,398,13,91,37,13
"1146","2020-03-27",104,14,121,527,5427,0.906946747742768,8325,31209,312,574,41,439,5,96,35,5
"1147","2020-03-28",128,14,118,578,5427,0.906946747742768,8325,31209,312,574,39,478,18,114,29,18
"1148","2020-03-29",153,14,120,623,5427,0.906946747742768,8325,31209,312,574,46,524,14,128,39,14
"1149","2020-03-30",164,14,114,670,5427,0.906946747742768,8325,31209,312,574,53,577,3,131,36,3
"1150","2020-03-31",163,14,104,708,5427,0.906946747742768,8325,31209,312,574,75,652,5,136,58,5
"1151","2020-04-01",174,14,99,773,5427,0.906946747742768,8325,31209,312,574,55,707,5,141,45,5
"1152","2020-04-02",197,14,92,818,5427,0.906946747742768,8325,31209,312,574,59,766,6,147,51,6
"1153","2020-04-03",241,14,88,873,5427,0.906946747742768,8325,31209,312,574,52,818,5,152,44,5
"1154","2020-04-04",262,14,95,921,5427,0.906946747742768,8325,31209,312,574,53,871,17,169,42,17
"1155","2020-04-05",253,14,109,974,5427,0.906946747742768,8325,31209,312,574,75,946,24,193,61,24
"1156","2020-04-06",256,14,95,1030,5427,0.906946747742768,8325,31209,312,574,43,989,11,204,36,11
"1157","2020-04-07",265,14,96,1063,5427,0.906946747742768,8325,31209,312,574,52,1041,22,226,43,22
"1158","2020-04-08",291,14,99,1132,5427,0.906946747742768,8325,31209,312,574,64,1105,18,244,51,18
"1159","2020-04-09",296,14,99,1164,5427,0.906946747742768,8325,31209,312,574,87,1192,39,283,64,39
"1160","2020-04-10",371,14,86,1202,5427,0.906946747742768,8325,31209,312,574,60,1252,18,301,51,18
"1161","2020-04-11",392,14,94,1221,5427,0.906946747742768,8325,31209,312,574,77,1329,11,312,65,11
"1162","2020-04-12",397,14,94,1281,5427,0.906946747742768,8325,31209,312,574,74,1403,6,318,64,6
"1163","2020-04-13",401,14,102,1326,5427,0.906946747742768,8325,31209,312,574,78,1481,34,352,66,34
"1164","2020-04-14",402,14,126,1344,5427,0.906946747742768,8325,31209,312,574,78,1559,25,377,72,25
"1165","2020-04-15",400,14,161,1333,5427,0.906946747742768,8325,31209,312,574,75,1634,15,392,65,15
"1166","2020-04-16",414,14,178,1347,5427,0.906946747742768,8325,31209,312,574,64,1698,23,415,56,23
"1167","2020-04-17",482,14,186,1333,5427,0.906946747742768,8325,31209,312,574,81,1779,31,446,67,31
"1168","2020-04-18",491,14,198,1351,5427,0.906946747742768,8325,31209,312,574,81,1860,43,489,68,43
"1169","2020-04-19",445,14,203,1368,5427,0.906946747742768,8325,31209,312,574,61,1921,37,526,51,37
"1170","2020-04-20",441,14,200,1347,5427,0.906946747742768,8325,31209,312,574,63,1984,33,559,56,33
"1171","2020-04-21",433,14,174,1359,5427,0.906946747742768,8325,31209,312,574,68,2052,41,600,55,41
"1172","2020-04-22",433,14,176,1343,5427,0.906946747742768,8325,31209,312,574,59,2111,30,630,50,30
"1173","2020-04-23",435,14,177,1325,5427,0.906946747742768,8325,31209,312,574,69,2180,17,647,59,17
"1174","2020-04-24",439,14,182,1298,5427,0.906946747742768,8325,31209,312,574,69,2249,22,669,59,22
"1175","2020-04-25",443,14,182,1241,5427,0.906946747742768,8325,31209,312,574,87,2336,12,681,74,12
"1176","2020-04-26",441,14,157,1216,5427,0.906946747742768,8325,31209,312,574,56,2392,42,723,43,42
"1177","2020-04-27",427,14,146,1166,5427,0.906946747742768,8325,31209,312,574,44,2436,25,748,35,25
"1178","2020-04-28",429,14,140,1127,5427,0.906946747742768,8325,31209,312,574,63,2499,25,773,52,25
"1179","2020-04-29",421,14,147,1074,5427,0.906946747742768,8325,31209,312,574,46,2545,20,793,36,20
"1180","2020-04-30",413,14,143,1049,5427,0.906946747742768,8325,31209,312,574,54,2599,35,828,40,35
"1181","2020-05-01",399,14,146,997,5427,0.906946747742768,8325,31209,312,574,49,2648,24,852,40,24
"1182","2020-05-02",378,14,146,951,5427,0.906946747742768,8325,31209,312,574,48,2696,10,862,40,10
"1183","2020-05-03",335,14,137,898,5427,0.906946747742768,8325,31209,312,574,44,2740,49,911,37,49
"1184","2020-05-04",323,14,135,849,5427,0.906946747742768,8325,31209,312,574,56,2796,29,940,47,29
"1185","2020-05-05",311,14,138,793,5427,0.906946747742768,8325,31209,312,574,52,2848,36,976,44,36
"1186","2020-05-06",302,14,141,740,5427,0.906946747742768,8325,31209,312,574,41,2889,25,1001,32,25
"1187","2020-05-07",277,14,137,691,5427,0.906946747742768,8325,31209,312,574,51,2940,27,1028,43,27
"1188","2020-05-08",246,14,145,622,5427,0.906946747742768,8325,31209,312,574,37,2977,12,1040,30,12
"1189","2020-05-09",244,14,144,588,5427,0.906946747742768,8325,31209,312,574,49,3026,11,1051,41,11
"1190","2020-05-10",223,14,137,548,5427,0.906946747742768,8325,31209,312,574,39,3065,4,1055,33,4
"1191","2020-05-11",219,14,130,518,5427,0.906946747742768,8325,31209,312,574,39,3104,12,1067,37,12
"1192","2020-05-12",206,14,115,473,5427,0.906946747742768,8325,31209,312,574,49,3153,34,1101,38,34
"1193","2020-05-13",194,14,108,437,5427,0.906946747742768,8325,31209,312,574,40,3193,18,1119,31,18
"1194","2020-05-14",193,14,110,405,5427,0.906946747742768,8325,31209,312,574,45,3238,11,1130,36,11
"1195","2020-05-15",168,14,107,382,5427,0.906946747742768,8325,31209,312,574,33,3271,27,1157,30,27
"1196","2020-05-16",157,14,108,373,5427,0.906946747742768,8325,31209,312,574,30,3301,23,1180,25,23
"1197","2020-05-17",138,14,105,344,5427,0.906946747742768,8325,31209,312,574,44,3345,27,1207,40,27
"1198","2020-05-18",124,14,111,328,5427,0.906946747742768,8325,31209,312,574,26,3371,17,1224,18,17
"1199","2020-05-19",109,14,124,313,5427,0.906946747742768,8325,31209,312,574,37,3408,13,1237,34,13
"1200","2020-05-20",108,14,149,293,5427,0.906946747742768,8325,31209,312,574,26,3434,39,1276,21,39
"1201","2020-05-21",97,14,142,279,5427,0.906946747742768,8325,31209,312,574,26,3460,29,1305,20,29
"1202","2020-05-22",101,14,127,275,5427,0.906946747742768,8325,31209,312,574,35,3495,22,1327,28,22
"1203","2020-05-23",97,14,113,262,5427,0.906946747742768,8325,31209,312,574,27,3522,42,1369,22,42
"1204","2020-05-24",90,14,110,245,5427,0.906946747742768,8325,31209,312,574,32,3554,26,1395,26,26
"1205","2020-05-25",88,14,105,235,5427,0.906946747742768,8325,31209,312,574,21,3575,36,1431,15,36
"1206","2020-05-26",89,14,85,233,5427,0.906946747742768,8325,31209,312,574,30,3605,40,1471,26,40
"1207","2020-05-27",85,14,96,232,5427,0.906946747742768,8325,31209,312,574,38,3643,29,1500,27,29
"1208","2020-05-28",79,14,98,213,5427,0.906946747742768,8325,31209,312,574,22,3665,17,1517,18,17
"1209","2020-05-29",85,14,103,200,5427,0.906946747742768,8325,31209,312,574,30,3695,12,1529,22,12
"1210","2020-05-30",72,14,118,189,5427,0.906946747742768,8325,31209,312,574,24,3719,19,1548,21,19
"1211","2020-05-31",65,14,132,179,5427,0.906946747742768,8325,31209,312,574,18,3737,22,1570,12,22
"1212","2020-06-01",65,14,123,178,5427,0.906946747742768,8325,31209,312,574,16,3753,22,1592,13,22
"1213","2020-06-02",62,14,122,161,5427,0.906946747742768,8325,31209,312,574,25,3778,22,1614,22,22
"1214","2020-06-03",57,14,124,154,5427,0.906946747742768,8325,31209,312,574,25,3803,40,1654,18,40
"1215","2020-06-04",53,14,115,149,5427,0.906946747742768,8325,31209,312,574,22,3825,19,1673,18,19
"1216","2020-06-05",44,14,114,138,5427,0.906946747742768,8325,31209,312,574,12,3837,25,1698,9,25
"1217","2020-06-06",41,14,117,130,5427,0.906946747742768,8325,31209,312,574,24,3861,23,1721,20,23
"1218","2020-06-07",39,14,118,129,5427,0.906946747742768,8325,31209,312,574,30,3891,16,1737,24,16
"1219","2020-03-14",3,15,58,109,4614,0.599479843953186,8445,31396,256,733,25,93,NA,NA,2,NA
"1220","2020-03-15",6,15,55,144,4614,0.599479843953186,8445,31396,256,733,40,133,4,9,5,4
"1221","2020-03-16",9,15,54,187,4614,0.599479843953186,8445,31396,256,733,36,169,10,19,9,10
"1222","2020-03-17",24,15,48,210,4614,0.599479843953186,8445,31396,256,733,42,211,8,27,16,8
"1223","2020-03-18",32,15,58,252,4614,0.599479843953186,8445,31396,256,733,28,239,4,31,14,4
"1224","2020-03-19",41,15,69,316,4614,0.599479843953186,8445,31396,256,733,34,273,16,47,12,16
"1225","2020-03-20",56,15,97,354,4614,0.599479843953186,8445,31396,256,733,40,313,5,52,18,5
"1226","2020-03-21",67,15,93,389,4614,0.599479843953186,8445,31396,256,733,48,361,3,55,31,3
"1227","2020-03-22",103,15,97,430,4614,0.599479843953186,8445,31396,256,733,51,412,2,57,27,2
"1228","2020-03-23",113,15,117,445,4614,0.599479843953186,8445,31396,256,733,45,457,2,59,23,2
"1229","2020-03-24",101,15,108,473,4614,0.599479843953186,8445,31396,256,733,50,507,4,63,29,4
"1230","2020-03-25",115,15,98,494,4614,0.599479843953186,8445,31396,256,733,47,554,8,71,24,8
"1231","2020-03-26",126,15,83,514,4614,0.599479843953186,8445,31396,256,733,45,599,7,78,21,7
"1232","2020-03-27",178,15,87,532,4614,0.599479843953186,8445,31396,256,733,48,647,8,86,23,8
"1233","2020-03-28",189,15,109,547,4614,0.599479843953186,8445,31396,256,733,41,688,8,94,27,8
"1234","2020-03-29",171,15,109,582,4614,0.599479843953186,8445,31396,256,733,57,745,4,98,28,4
"1235","2020-03-30",177,15,124,599,4614,0.599479843953186,8445,31396,256,733,51,796,3,101,26,3
"1236","2020-03-31",183,15,113,615,4614,0.599479843953186,8445,31396,256,733,48,844,5,106,22,5
"1237","2020-04-01",178,15,110,612,4614,0.599479843953186,8445,31396,256,733,69,913,6,112,43,6
"1238","2020-04-02",179,15,138,636,4614,0.599479843953186,8445,31396,256,733,52,965,4,116,36,4
"1239","2020-04-03",184,15,182,641,4614,0.599479843953186,8445,31396,256,733,63,1028,15,131,31,15
"1240","2020-04-04",215,15,201,665,4614,0.599479843953186,8445,31396,256,733,51,1079,8,139,26,8
"1241","2020-04-05",203,15,192,689,4614,0.599479843953186,8445,31396,256,733,54,1133,10,149,19,10
"1242","2020-04-06",191,15,219,705,4614,0.599479843953186,8445,31396,256,733,67,1200,9,158,43,9
"1243","2020-04-07",195,15,195,705,4614,0.599479843953186,8445,31396,256,733,43,1243,9,167,24,9
"1244","2020-04-08",196,15,172,714,4614,0.599479843953186,8445,31396,256,733,71,1314,10,177,35,10
"1245","2020-04-09",202,15,148,726,4614,0.599479843953186,8445,31396,256,733,49,1363,13,190,29,13
"1246","2020-04-10",238,15,141,729,4614,0.599479843953186,8445,31396,256,733,63,1426,22,212,36,22
"1247","2020-04-11",228,15,162,747,4614,0.599479843953186,8445,31396,256,733,58,1484,11,223,32,11
"1248","2020-04-12",252,15,185,766,4614,0.599479843953186,8445,31396,256,733,43,1527,12,235,15,12
"1249","2020-04-13",255,15,193,763,4614,0.599479843953186,8445,31396,256,733,57,1584,8,243,33,8
"1250","2020-04-14",244,15,178,759,4614,0.599479843953186,8445,31396,256,733,52,1636,9,252,29,9
"1251","2020-04-15",259,15,169,757,4614,0.599479843953186,8445,31396,256,733,65,1701,5,257,43,5
"1252","2020-04-16",265,15,146,757,4614,0.599479843953186,8445,31396,256,733,48,1749,6,263,31,6
"1253","2020-04-17",268,15,135,751,4614,0.599479843953186,8445,31396,256,733,53,1802,15,278,31,15
"1254","2020-04-18",268,15,183,746,4614,0.599479843953186,8445,31396,256,733,63,1865,12,290,31,12
"1255","2020-04-19",247,15,212,732,4614,0.599479843953186,8445,31396,256,733,54,1919,20,310,31,20
"1256","2020-04-20",246,15,209,725,4614,0.599479843953186,8445,31396,256,733,67,1986,18,328,33,18
"1257","2020-04-21",256,15,207,709,4614,0.599479843953186,8445,31396,256,733,46,2032,6,334,26,6
"1258","2020-04-22",265,15,213,717,4614,0.599479843953186,8445,31396,256,733,59,2091,14,348,27,14
"1259","2020-04-23",260,15,213,710,4614,0.599479843953186,8445,31396,256,733,37,2128,9,357,21,9
"1260","2020-04-24",252,15,203,717,4614,0.599479843953186,8445,31396,256,733,64,2192,9,366,28,9
"1261","2020-04-25",263,15,229,701,4614,0.599479843953186,8445,31396,256,733,68,2260,5,371,39,5
"1262","2020-04-26",243,15,214,707,4614,0.599479843953186,8445,31396,256,733,70,2330,12,383,36,12
"1263","2020-04-27",245,15,221,711,4614,0.599479843953186,8445,31396,256,733,48,2378,21,404,29,21
"1264","2020-04-28",238,15,199,716,4614,0.599479843953186,8445,31396,256,733,41,2419,11,415,18,11
"1265","2020-04-29",217,15,180,712,4614,0.599479843953186,8445,31396,256,733,61,2480,9,424,30,9
"1266","2020-04-30",205,15,168,705,4614,0.599479843953186,8445,31396,256,733,47,2527,6,430,27,6
"1267","2020-05-01",221,15,159,686,4614,0.599479843953186,8445,31396,256,733,43,2570,14,444,21,14
"1268","2020-05-02",222,15,132,663,4614,0.599479843953186,8445,31396,256,733,50,2620,10,454,27,10
"1269","2020-05-03",228,15,127,643,4614,0.599479843953186,8445,31396,256,733,44,2664,12,466,20,12
"1270","2020-05-04",224,15,160,639,4614,0.599479843953186,8445,31396,256,733,42,2706,9,475,22,9
"1271","2020-05-05",217,15,200,634,4614,0.599479843953186,8445,31396,256,733,44,2750,21,496,21,21
"1272","2020-05-06",211,15,231,634,4614,0.599479843953186,8445,31396,256,733,47,2797,16,512,23,16
"1273","2020-05-07",228,15,257,625,4614,0.599479843953186,8445,31396,256,733,51,2848,14,526,15,14
"1274","2020-05-08",210,15,252,622,4614,0.599479843953186,8445,31396,256,733,43,2891,30,556,22,30
"1275","2020-05-09",230,15,249,619,4614,0.599479843953186,8445,31396,256,733,41,2932,14,570,19,14
"1276","2020-05-10",213,15,247,614,4614,0.599479843953186,8445,31396,256,733,55,2987,10,580,26,10
"1277","2020-05-11",203,15,261,597,4614,0.599479843953186,8445,31396,256,733,45,3032,16,596,25,16
"1278","2020-05-12",209,15,231,603,4614,0.599479843953186,8445,31396,256,733,29,3061,11,607,11,11
"1279","2020-05-13",217,15,192,592,4614,0.599479843953186,8445,31396,256,733,41,3102,6,613,17,6
"1280","2020-05-14",208,15,178,576,4614,0.599479843953186,8445,31396,256,733,33,3135,12,625,17,12
"1281","2020-05-15",238,15,165,567,4614,0.599479843953186,8445,31396,256,733,31,3166,7,632,19,7
"1282","2020-05-16",217,15,166,568,4614,0.599479843953186,8445,31396,256,733,31,3197,13,645,9,13
"1283","2020-05-17",218,15,178,543,4614,0.599479843953186,8445,31396,256,733,26,3223,10,655,9,10
"1284","2020-05-18",202,15,172,537,4614,0.599479843953186,8445,31396,256,733,38,3261,5,660,12,5
"1285","2020-05-19",192,15,146,509,4614,0.599479843953186,8445,31396,256,733,26,3287,6,666,9,6
"1286","2020-05-20",187,15,144,489,4614,0.599479843953186,8445,31396,256,733,44,3331,10,676,20,10
"1287","2020-05-21",179,15,184,458,4614,0.599479843953186,8445,31396,256,733,27,3358,12,688,13,12
"1288","2020-05-22",161,15,184,441,4614,0.599479843953186,8445,31396,256,733,33,3391,9,697,17,9
"1289","2020-05-23",176,15,166,433,4614,0.599479843953186,8445,31396,256,733,27,3418,6,703,12,6
"1290","2020-05-24",147,15,160,413,4614,0.599479843953186,8445,31396,256,733,28,3446,6,709,11,6
"1291","2020-05-25",134,15,182,397,4614,0.599479843953186,8445,31396,256,733,27,3473,12,721,17,12
"1292","2020-05-26",122,15,183,383,4614,0.599479843953186,8445,31396,256,733,32,3505,14,735,15,14
"1293","2020-05-27",112,15,181,376,4614,0.599479843953186,8445,31396,256,733,37,3542,11,746,14,11
"1294","2020-05-28",113,15,167,365,4614,0.599479843953186,8445,31396,256,733,32,3574,10,756,21,10
"1295","2020-05-29",118,15,163,362,4614,0.599479843953186,8445,31396,256,733,24,3598,7,763,9,7
"1296","2020-05-30",115,15,181,351,4614,0.599479843953186,8445,31396,256,733,25,3623,7,770,13,7
"1297","2020-05-31",112,15,192,330,4614,0.599479843953186,8445,31396,256,733,17,3640,11,781,5,11
"1298","2020-06-01",109,15,175,326,4614,0.599479843953186,8445,31396,256,733,26,3666,10,791,13,10
"1299","2020-06-02",110,15,168,325,4614,0.599479843953186,8445,31396,256,733,22,3688,11,802,12,11
"1300","2020-06-03",115,15,164,320,4614,0.599479843953186,8445,31396,256,733,21,3709,5,807,12,5
"1301","2020-06-04",112,15,136,310,4614,0.599479843953186,8445,31396,256,733,27,3736,8,815,14,8
"1302","2020-06-05",109,15,131,316,4614,0.599479843953186,8445,31396,256,733,20,3756,4,819,11,4
"1303","2020-06-06",104,15,129,302,4614,0.599479843953186,8445,31396,256,733,17,3773,12,831,8,12
"1304","2020-06-07",110,15,135,288,4614,0.599479843953186,8445,31396,256,733,24,3797,12,843,13,12
"1305","2020-03-13",2,16,42,16,5640,0.906205673758865,8355,31920,332,693,19,45,11,37,NA,11
"1306","2020-03-14",2,16,44,30,5640,0.906205673758865,8355,31920,332,693,31,76,24,61,9,24
"1307","2020-03-15",4,16,53,36,5640,0.906205673758865,8355,31920,332,693,30,106,22,83,7,22
"1308","2020-03-16",5,16,67,44,5640,0.906205673758865,8355,31920,332,693,24,130,19,102,5,19
"1309","2020-03-17",5,16,74,59,5640,0.906205673758865,8355,31920,332,693,37,167,21,123,16,21
"1310","2020-03-18",7,16,70,82,5640,0.906205673758865,8355,31920,332,693,33,200,23,146,20,23
"1311","2020-03-19",11,16,80,96,5640,0.906205673758865,8355,31920,332,693,29,229,21,167,22,21
"1312","2020-03-20",14,16,72,125,5640,0.906205673758865,8355,31920,332,693,51,280,26,193,36,26
"1313","2020-03-21",23,16,98,143,5640,0.906205673758865,8355,31920,332,693,43,323,32,225,29,32
"1314","2020-03-22",28,16,113,175,5640,0.906205673758865,8355,31920,332,693,35,358,38,263,20,38
"1315","2020-03-23",30,16,105,193,5640,0.906205673758865,8355,31920,332,693,60,418,36,299,45,36
"1316","2020-03-24",32,16,105,232,5640,0.906205673758865,8355,31920,332,693,56,474,29,328,41,29
"1317","2020-03-25",43,16,100,278,5640,0.906205673758865,8355,31920,332,693,54,528,17,345,41,17
"1318","2020-03-26",51,16,98,333,5640,0.906205673758865,8355,31920,332,693,63,591,32,377,43,32
"1319","2020-03-27",71,16,94,376,5640,0.906205673758865,8355,31920,332,693,58,649,33,410,45,33
"1320","2020-03-28",88,16,98,416,5640,0.906205673758865,8355,31920,332,693,68,717,28,438,46,28
"1321","2020-03-29",122,16,96,450,5640,0.906205673758865,8355,31920,332,693,78,795,20,458,60,20
"1322","2020-03-30",126,16,99,517,5640,0.906205673758865,8355,31920,332,693,83,878,15,473,67,15
"1323","2020-03-31",129,16,109,560,5640,0.906205673758865,8355,31920,332,693,53,931,28,501,43,28
"1324","2020-04-01",137,16,120,637,5640,0.906205673758865,8355,31920,332,693,68,999,43,544,57,43
"1325","2020-04-02",141,16,126,681,5640,0.906205673758865,8355,31920,332,693,80,1079,34,578,65,34
"1326","2020-04-03",204,16,141,750,5640,0.906205673758865,8355,31920,332,693,78,1157,53,631,57,53
"1327","2020-04-04",217,16,143,805,5640,0.906205673758865,8355,31920,332,693,80,1237,37,668,62,37
"1328","2020-04-05",223,16,142,841,5640,0.906205673758865,8355,31920,332,693,110,1347,41,709,82,41
"1329","2020-04-06",239,16,138,900,5640,0.906205673758865,8355,31920,332,693,68,1415,51,760,53,51
"1330","2020-04-07",243,16,150,923,5640,0.906205673758865,8355,31920,332,693,84,1499,34,794,61,34
"1331","2020-04-08",254,16,151,972,5640,0.906205673758865,8355,31920,332,693,79,1578,33,827,64,33
"1332","2020-04-09",274,16,159,1026,5640,0.906205673758865,8355,31920,332,693,72,1650,27,854,50,27
"1333","2020-04-10",304,16,172,1068,5640,0.906205673758865,8355,31920,332,693,100,1750,46,900,83,46
"1334","2020-04-11",335,16,183,1103,5640,0.906205673758865,8355,31920,332,693,89,1839,31,931,69,31
"1335","2020-04-12",317,16,160,1158,5640,0.906205673758865,8355,31920,332,693,73,1912,52,983,53,52
"1336","2020-04-13",320,16,152,1214,5640,0.906205673758865,8355,31920,332,693,102,2014,41,1024,80,41
"1337","2020-04-14",334,16,161,1263,5640,0.906205673758865,8355,31920,332,693,69,2083,32,1056,55,32
"1338","2020-04-15",347,16,153,1348,5640,0.906205673758865,8355,31920,332,693,65,2148,34,1090,47,34
"1339","2020-04-16",353,16,156,1405,5640,0.906205673758865,8355,31920,332,693,77,2225,33,1123,57,33
"1340","2020-04-17",435,16,160,1467,5640,0.906205673758865,8355,31920,332,693,87,2312,31,1154,74,31
"1341","2020-04-18",491,16,175,1536,5640,0.906205673758865,8355,31920,332,693,78,2390,37,1191,69,37
"1342","2020-04-19",454,16,188,1569,5640,0.906205673758865,8355,31920,332,693,94,2484,57,1248,77,57
"1343","2020-04-20",446,16,176,1578,5640,0.906205673758865,8355,31920,332,693,77,2561,38,1286,62,38
"1344","2020-04-21",464,16,173,1634,5640,0.906205673758865,8355,31920,332,693,79,2640,56,1342,63,56
"1345","2020-04-22",480,16,179,1675,5640,0.906205673758865,8355,31920,332,693,76,2716,69,1411,54,69
"1346","2020-04-23",494,16,175,1672,5640,0.906205673758865,8355,31920,332,693,81,2797,45,1456,65,45
"1347","2020-04-24",572,16,184,1673,5640,0.906205673758865,8355,31920,332,693,89,2886,24,1480,75,24
"1348","2020-04-25",536,16,176,1667,5640,0.906205673758865,8355,31920,332,693,80,2966,37,1517,57,37
"1349","2020-04-26",533,16,181,1616,5640,0.906205673758865,8355,31920,332,693,73,3039,62,1579,59,62
"1350","2020-04-27",545,16,175,1595,5640,0.906205673758865,8355,31920,332,693,55,3094,59,1638,39,59
"1351","2020-04-28",534,16,170,1527,5640,0.906205673758865,8355,31920,332,693,48,3142,50,1688,38,50
"1352","2020-04-29",528,16,150,1477,5640,0.906205673758865,8355,31920,332,693,74,3216,54,1742,61,54
"1353","2020-04-30",518,16,154,1377,5640,0.906205673758865,8355,31920,332,693,55,3271,47,1789,46,47
"1354","2020-05-01",506,16,177,1307,5640,0.906205673758865,8355,31920,332,693,60,3331,23,1812,49,23
"1355","2020-05-02",489,16,175,1250,5640,0.906205673758865,8355,31920,332,693,54,3385,54,1866,36,54
"1356","2020-05-03",429,16,197,1182,5640,0.906205673758865,8355,31920,332,693,56,3441,66,1932,40,66
"1357","2020-05-04",404,16,216,1104,5640,0.906205673758865,8355,31920,332,693,63,3504,63,1995,47,63
"1358","2020-05-05",398,16,209,1036,5640,0.906205673758865,8355,31920,332,693,52,3556,57,2052,37,57
"1359","2020-05-06",389,16,190,965,5640,0.906205673758865,8355,31920,332,693,54,3610,43,2095,39,43
"1360","2020-05-07",379,16,194,893,5640,0.906205673758865,8355,31920,332,693,42,3652,61,2156,33,61
"1361","2020-05-08",360,16,203,839,5640,0.906205673758865,8355,31920,332,693,43,3695,33,2189,33,33
"1362","2020-05-09",347,16,187,758,5640,0.906205673758865,8355,31920,332,693,33,3728,35,2224,21,35
"1363","2020-05-10",324,16,184,713,5640,0.906205673758865,8355,31920,332,693,33,3761,37,2261,25,37
"1364","2020-05-11",312,16,206,686,5640,0.906205673758865,8355,31920,332,693,52,3813,41,2302,33,41
"1365","2020-05-12",283,16,221,629,5640,0.906205673758865,8355,31920,332,693,28,3841,33,2335,23,33
"1366","2020-05-13",262,16,223,569,5640,0.906205673758865,8355,31920,332,693,30,3871,32,2367,19,32
"1367","2020-05-14",250,16,214,517,5640,0.906205673758865,8355,31920,332,693,35,3906,35,2402,24,35
"1368","2020-05-15",183,16,204,479,5640,0.906205673758865,8355,31920,332,693,27,3933,44,2446,19,44
"1369","2020-05-16",171,16,179,433,5640,0.906205673758865,8355,31920,332,693,19,3952,33,2479,11,33
"1370","2020-05-17",168,16,173,388,5640,0.906205673758865,8355,31920,332,693,23,3975,34,2513,16,34
"1371","2020-05-18",157,16,164,363,5640,0.906205673758865,8355,31920,332,693,17,3992,41,2554,14,41
"1372","2020-05-19",140,16,142,325,5640,0.906205673758865,8355,31920,332,693,25,4017,30,2584,15,30
"1373","2020-05-20",129,16,135,300,5640,0.906205673758865,8355,31920,332,693,20,4037,33,2617,11,33
"1374","2020-05-21",112,16,134,283,5640,0.906205673758865,8355,31920,332,693,26,4063,47,2664,16,47
"1375","2020-05-22",107,16,140,266,5640,0.906205673758865,8355,31920,332,693,18,4081,25,2689,11,25
"1376","2020-05-23",111,16,129,245,5640,0.906205673758865,8355,31920,332,693,28,4109,40,2729,19,40
"1377","2020-05-24",95,16,134,233,5640,0.906205673758865,8355,31920,332,693,18,4127,22,2751,9,22
"1378","2020-05-25",87,16,140,216,5640,0.906205673758865,8355,31920,332,693,20,4147,36,2787,13,36
"1379","2020-05-26",85,16,136,203,5640,0.906205673758865,8355,31920,332,693,16,4163,32,2819,14,32
"1380","2020-05-27",80,16,123,199,5640,0.906205673758865,8355,31920,332,693,20,4183,28,2847,10,28
"1381","2020-05-28",83,16,126,184,5640,0.906205673758865,8355,31920,332,693,15,4198,21,2868,8,21
"1382","2020-05-29",79,16,115,168,5640,0.906205673758865,8355,31920,332,693,12,4210,37,2905,7,37
"1383","2020-05-30",73,16,118,148,5640,0.906205673758865,8355,31920,332,693,13,4223,27,2932,7,27
"1384","2020-05-31",64,16,103,129,5640,0.906205673758865,8355,31920,332,693,15,4238,17,2949,3,17
"1385","2020-06-01",59,16,100,118,5640,0.906205673758865,8355,31920,332,693,9,4247,17,2966,4,17
"1386","2020-06-02",54,16,118,109,5640,0.906205673758865,8355,31920,332,693,11,4258,25,2991,7,25
"1387","2020-06-03",50,16,125,95,5640,0.906205673758865,8355,31920,332,693,15,4273,19,3010,9,19
"1388","2020-06-04",43,16,128,86,5640,0.906205673758865,8355,31920,332,693,10,4283,36,3046,10,36
"1389","2020-06-05",42,16,133,79,5640,0.906205673758865,8355,31920,332,693,6,4289,41,3087,4,41
"1390","2020-06-06",33,16,130,78,5640,0.906205673758865,8355,31920,332,693,14,4303,28,3115,7,28
"1391","2020-06-07",24,16,118,71,5640,0.906205673758865,8355,31920,332,693,11,4314,50,3165,6,50
"1392","2020-03-14",4,17,41,55,4785,0.760919540229885,8505,31254,257,574,5,17,11,48,4,11
"1393","2020-03-15",7,17,37,84,4785,0.760919540229885,8505,31254,257,574,11,28,7,55,9,7
"1394","2020-03-16",7,17,34,112,4785,0.760919540229885,8505,31254,257,574,6,34,16,71,4,16
"1395","2020-03-17",10,17,35,135,4785,0.760919540229885,8505,31254,257,574,13,47,9,80,11,9
"1396","2020-03-18",14,17,39,162,4785,0.760919540229885,8505,31254,257,574,22,69,4,84,14,4
"1397","2020-03-19",16,17,50,186,4785,0.760919540229885,8505,31254,257,574,16,85,4,88,13,4
"1398","2020-03-20",31,17,63,227,4785,0.760919540229885,8505,31254,257,574,24,109,11,99,19,11
"1399","2020-03-21",57,17,63,258,4785,0.760919540229885,8505,31254,257,574,21,130,16,115,20,16
"1400","2020-03-22",59,17,60,303,4785,0.760919540229885,8505,31254,257,574,26,156,11,126,24,11
"1401","2020-03-23",63,17,56,335,4785,0.760919540229885,8505,31254,257,574,38,194,7,133,34,7
"1402","2020-03-24",71,17,57,371,4785,0.760919540229885,8505,31254,257,574,23,217,1,134,23,1
"1403","2020-03-25",78,17,54,393,4785,0.760919540229885,8505,31254,257,574,33,250,7,141,26,7
"1404","2020-03-26",89,17,74,432,4785,0.760919540229885,8505,31254,257,574,54,304,15,156,50,15
"1405","2020-03-27",104,17,90,472,4785,0.760919540229885,8505,31254,257,574,53,357,12,168,51,12
"1406","2020-03-28",116,17,99,489,4785,0.760919540229885,8505,31254,257,574,67,424,22,190,64,22
"1407","2020-03-29",128,17,93,532,4785,0.760919540229885,8505,31254,257,574,52,476,26,216,51,26
"1408","2020-03-30",137,17,102,577,4785,0.760919540229885,8505,31254,257,574,74,550,13,229,72,13
"1409","2020-03-31",142,17,87,603,4785,0.760919540229885,8505,31254,257,574,85,635,11,240,80,11
"1410","2020-04-01",159,17,91,644,4785,0.760919540229885,8505,31254,257,574,83,718,12,252,81,12
"1411","2020-04-02",175,17,114,677,4785,0.760919540229885,8505,31254,257,574,81,799,18,270,76,18
"1412","2020-04-03",218,17,127,720,4785,0.760919540229885,8505,31254,257,574,97,896,23,293,91,23
"1413","2020-04-04",276,17,132,750,4785,0.760919540229885,8505,31254,257,574,95,991,20,313,92,20
"1414","2020-04-05",271,17,137,788,4785,0.760919540229885,8505,31254,257,574,91,1082,8,321,87,8
"1415","2020-04-06",240,17,150,815,4785,0.760919540229885,8505,31254,257,574,111,1193,40,361,110,40
"1416","2020-04-07",249,17,150,846,4785,0.760919540229885,8505,31254,257,574,127,1320,30,391,124,30
"1417","2020-04-08",261,17,151,860,4785,0.760919540229885,8505,31254,257,574,126,1446,20,411,124,20
"1418","2020-04-09",265,17,163,903,4785,0.760919540229885,8505,31254,257,574,138,1584,15,426,131,15
"1419","2020-04-10",316,17,154,912,4785,0.760919540229885,8505,31254,257,574,127,1711,13,439,127,13
"1420","2020-04-11",297,17,173,956,4785,0.760919540229885,8505,31254,257,574,179,1890,27,466,175,27
"1421","2020-04-12",303,17,161,970,4785,0.760919540229885,8505,31254,257,574,135,2025,31,497,134,31
"1422","2020-04-13",318,17,156,990,4785,0.760919540229885,8505,31254,257,574,140,2165,17,514,135,17
"1423","2020-04-14",325,17,145,1007,4785,0.760919540229885,8505,31254,257,574,156,2321,44,558,152,44
"1424","2020-04-15",321,17,173,997,4785,0.760919540229885,8505,31254,257,574,145,2466,24,582,143,24
"1425","2020-04-16",323,17,165,1007,4785,0.760919540229885,8505,31254,257,574,174,2640,36,618,173,36
"1426","2020-04-17",350,17,179,1013,4785,0.760919540229885,8505,31254,257,574,143,2783,20,638,139,20
"1427","2020-04-18",345,17,174,1040,4785,0.760919540229885,8505,31254,257,574,152,2935,18,656,148,18
"1428","2020-04-19",344,17,193,1040,4785,0.760919540229885,8505,31254,257,574,142,3077,14,670,141,14
"1429","2020-04-20",341,17,187,1039,4785,0.760919540229885,8505,31254,257,574,153,3230,27,697,151,27
"1430","2020-04-21",325,17,175,1041,4785,0.760919540229885,8505,31254,257,574,169,3399,19,716,167,19
"1431","2020-04-22",320,17,146,1043,4785,0.760919540229885,8505,31254,257,574,147,3546,23,739,146,23
"1432","2020-04-23",316,17,130,1020,4785,0.760919540229885,8505,31254,257,574,178,3724,24,763,175,24
"1433","2020-04-24",360,17,123,999,4785,0.760919540229885,8505,31254,257,574,142,3866,17,780,139,17
"1434","2020-04-25",369,17,113,988,4785,0.760919540229885,8505,31254,257,574,140,4006,14,794,137,14
"1435","2020-04-26",348,17,133,932,4785,0.760919540229885,8505,31254,257,574,114,4120,9,803,114,9
"1436","2020-04-27",345,17,162,909,4785,0.760919540229885,8505,31254,257,574,129,4249,9,812,126,9
"1437","2020-04-28",344,17,155,899,4785,0.760919540229885,8505,31254,257,574,102,4351,36,848,100,36
"1438","2020-04-29",347,17,155,887,4785,0.760919540229885,8505,31254,257,574,109,4460,16,864,107,16
"1439","2020-04-30",342,17,165,839,4785,0.760919540229885,8505,31254,257,574,88,4548,31,895,86,31
"1440","2020-05-01",314,17,175,819,4785,0.760919540229885,8505,31254,257,574,96,4644,27,922,94,27
"1441","2020-05-02",317,17,179,788,4785,0.760919540229885,8505,31254,257,574,64,4708,40,962,59,40
"1442","2020-05-03",260,17,173,753,4785,0.760919540229885,8505,31254,257,574,78,4786,21,983,78,21
"1443","2020-05-04",244,17,177,730,4785,0.760919540229885,8505,31254,257,574,61,4847,21,1004,60,21
"1444","2020-05-05",231,17,182,719,4785,0.760919540229885,8505,31254,257,574,54,4901,18,1022,53,18
"1445","2020-05-06",225,17,187,682,4785,0.760919540229885,8505,31254,257,574,64,4965,11,1033,64,11
"1446","2020-05-07",225,17,165,654,4785,0.760919540229885,8505,31254,257,574,63,5028,16,1049,55,16
"1447","2020-05-08",238,17,180,636,4785,0.760919540229885,8505,31254,257,574,51,5079,3,1052,48,3
"1448","2020-05-09",230,17,173,616,4785,0.760919540229885,8505,31254,257,574,48,5127,14,1066,45,14
"1449","2020-05-10",219,17,171,596,4785,0.760919540229885,8505,31254,257,574,31,5158,14,1080,28,14
"1450","2020-05-11",206,17,145,578,4785,0.760919540229885,8505,31254,257,574,37,5195,27,1107,37,27
"1451","2020-05-12",194,17,145,547,4785,0.760919540229885,8505,31254,257,574,40,5235,25,1132,38,25
"1452","2020-05-13",189,17,135,529,4785,0.760919540229885,8505,31254,257,574,35,5270,26,1158,33,26
"1453","2020-05-14",176,17,136,514,4785,0.760919540229885,8505,31254,257,574,38,5308,20,1178,38,20
"1454","2020-05-15",172,17,133,487,4785,0.760919540229885,8505,31254,257,574,35,5343,17,1195,34,17
"1455","2020-05-16",175,17,131,462,4785,0.760919540229885,8505,31254,257,574,20,5363,28,1223,19,28
"1456","2020-05-17",149,17,150,444,4785,0.760919540229885,8505,31254,257,574,26,5389,22,1245,25,22
"1457","2020-05-18",145,17,146,435,4785,0.760919540229885,8505,31254,257,574,22,5411,15,1260,22,15
"1458","2020-05-19",148,17,151,404,4785,0.760919540229885,8505,31254,257,574,22,5433,31,1291,21,31
"1459","2020-05-20",144,17,152,393,4785,0.760919540229885,8505,31254,257,574,19,5452,32,1323,17,32
"1460","2020-05-21",147,17,143,367,4785,0.760919540229885,8505,31254,257,574,15,5467,17,1340,14,17
"1461","2020-05-22",130,17,137,353,4785,0.760919540229885,8505,31254,257,574,18,5485,22,1362,16,22
"1462","2020-05-23",121,17,131,341,4785,0.760919540229885,8505,31254,257,574,13,5498,15,1377,12,15
"1463","2020-05-24",122,17,130,334,4785,0.760919540229885,8505,31254,257,574,12,5510,18,1395,11,18
"1464","2020-05-25",113,17,123,319,4785,0.760919540229885,8505,31254,257,574,9,5519,25,1420,9,25
"1465","2020-05-26",106,17,118,296,4785,0.760919540229885,8505,31254,257,574,21,5540,21,1441,21,21
"1466","2020-05-27",97,17,102,292,4785,0.760919540229885,8505,31254,257,574,9,5549,17,1458,9,17
"1467","2020-05-28",87,17,106,286,4785,0.760919540229885,8505,31254,257,574,9,5558,17,1475,8,17
"1468","2020-05-29",87,17,97,267,4785,0.760919540229885,8505,31254,257,574,14,5572,27,1502,12,27
"1469","2020-05-30",82,17,91,254,4785,0.760919540229885,8505,31254,257,574,13,5585,13,1515,11,13
"1470","2020-05-31",77,17,87,244,4785,0.760919540229885,8505,31254,257,574,8,5593,16,1531,8,16
"1471","2020-06-01",82,17,81,230,4785,0.760919540229885,8505,31254,257,574,6,5599,16,1547,5,16
"1472","2020-06-02",73,17,78,214,4785,0.760919540229885,8505,31254,257,574,13,5612,11,1558,13,11
"1473","2020-06-03",67,17,80,211,4785,0.760919540229885,8505,31254,257,574,4,5616,13,1571,4,13
"1474","2020-06-04",65,17,92,195,4785,0.760919540229885,8505,31254,257,574,10,5626,13,1584,9,13
"1475","2020-06-05",67,17,95,184,4785,0.760919540229885,8505,31254,257,574,6,5632,11,1595,5,11
"1476","2020-06-06",65,17,92,166,4785,0.760919540229885,8505,31254,257,574,4,5636,13,1608,4,13
"1477","2020-06-07",61,17,84,145,4785,0.760919540229885,8505,31254,257,574,2,5638,15,1623,2,15
"1478","2020-03-14",2,18,48,41,5082,0.88685556867375,8385,32160,291,639,7,19,19,52,3,19
"1479","2020-03-15",7,18,59,62,5082,0.88685556867375,8385,32160,291,639,5,24,25,77,3,25
"1480","2020-03-16",6,18,56,73,5082,0.88685556867375,8385,32160,291,639,7,31,7,84,2,7
"1481","2020-03-17",9,18,69,92,5082,0.88685556867375,8385,32160,291,639,17,48,20,104,12,20
"1482","2020-03-18",10,18,59,107,5082,0.88685556867375,8385,32160,291,639,9,57,12,116,6,12
"1483","2020-03-19",15,18,54,142,5082,0.88685556867375,8385,32160,291,639,13,70,15,131,12,15
"1484","2020-03-20",20,18,60,161,5082,0.88685556867375,8385,32160,291,639,19,89,9,140,11,9
"1485","2020-03-21",34,18,81,187,5082,0.88685556867375,8385,32160,291,639,18,107,19,159,17,19
"1486","2020-03-22",33,18,89,217,5082,0.88685556867375,8385,32160,291,639,28,135,18,177,22,18
"1487","2020-03-23",42,18,106,248,5082,0.88685556867375,8385,32160,291,639,32,167,11,188,28,11
"1488","2020-03-24",50,18,94,271,5082,0.88685556867375,8385,32160,291,639,34,201,8,196,29,8
"1489","2020-03-25",59,18,96,305,5082,0.88685556867375,8385,32160,291,639,35,236,10,206,33,10
"1490","2020-03-26",67,18,93,331,5082,0.88685556867375,8385,32160,291,639,30,266,18,224,24,18
"1491","2020-03-27",83,18,101,375,5082,0.88685556867375,8385,32160,291,639,43,309,22,246,40,22
"1492","2020-03-28",112,18,97,426,5082,0.88685556867375,8385,32160,291,639,66,375,18,264,62,18
"1493","2020-03-29",123,18,81,475,5082,0.88685556867375,8385,32160,291,639,54,429,22,286,50,22
"1494","2020-03-30",117,18,96,501,5082,0.88685556867375,8385,32160,291,639,54,483,15,301,53,15
"1495","2020-03-31",124,18,91,510,5082,0.88685556867375,8385,32160,291,639,86,569,20,321,82,20
"1496","2020-04-01",130,18,81,532,5082,0.88685556867375,8385,32160,291,639,81,650,16,337,79,16
"1497","2020-04-02",142,18,78,556,5082,0.88685556867375,8385,32160,291,639,95,745,9,346,90,9
"1498","2020-04-03",175,18,89,613,5082,0.88685556867375,8385,32160,291,639,88,833,11,357,84,11
"1499","2020-04-04",179,18,90,646,5082,0.88685556867375,8385,32160,291,639,101,934,22,379,96,22
"1500","2020-04-05",196,18,115,687,5082,0.88685556867375,8385,32160,291,639,100,1034,11,390,96,11
"1501","2020-04-06",194,18,126,715,5082,0.88685556867375,8385,32160,291,639,128,1162,12,402,125,12
"1502","2020-04-07",195,18,128,742,5082,0.88685556867375,8385,32160,291,639,127,1289,29,431,123,29
"1503","2020-04-08",211,18,127,772,5082,0.88685556867375,8385,32160,291,639,109,1398,25,456,105,25
"1504","2020-04-09",218,18,107,834,5082,0.88685556867375,8385,32160,291,639,134,1532,14,470,128,14
"1505","2020-04-10",271,18,99,889,5082,0.88685556867375,8385,32160,291,639,187,1719,14,484,178,14
"1506","2020-04-11",279,18,91,922,5082,0.88685556867375,8385,32160,291,639,181,1900,13,497,177,13
"1507","2020-04-12",284,18,133,931,5082,0.88685556867375,8385,32160,291,639,161,2061,7,504,158,7
"1508","2020-04-13",296,18,136,974,5082,0.88685556867375,8385,32160,291,639,158,2219,11,515,157,11
"1509","2020-04-14",301,18,160,976,5082,0.88685556867375,8385,32160,291,639,168,2387,30,545,160,30
"1510","2020-04-15",306,18,170,1000,5082,0.88685556867375,8385,32160,291,639,151,2538,36,581,144,36
"1511","2020-04-16",328,18,193,1042,5082,0.88685556867375,8385,32160,291,639,171,2709,40,621,168,40
"1512","2020-04-17",366,18,159,1029,5082,0.88685556867375,8385,32160,291,639,140,2849,17,638,137,17
"1513","2020-04-18",397,18,130,1051,5082,0.88685556867375,8385,32160,291,639,169,3018,45,683,166,45
"1514","2020-04-19",353,18,113,1046,5082,0.88685556867375,8385,32160,291,639,130,3148,45,728,129,45
"1515","2020-04-20",352,18,114,1042,5082,0.88685556867375,8385,32160,291,639,177,3325,49,777,172,49
"1516","2020-04-21",354,18,110,1080,5082,0.88685556867375,8385,32160,291,639,145,3470,34,811,142,34
"1517","2020-04-22",347,18,131,1116,5082,0.88685556867375,8385,32160,291,639,170,3640,20,831,166,20
"1518","2020-04-23",315,18,156,1092,5082,0.88685556867375,8385,32160,291,639,128,3768,19,850,126,19
"1519","2020-04-24",353,18,167,1105,5082,0.88685556867375,8385,32160,291,639,139,3907,36,886,137,36
"1520","2020-04-25",338,18,156,1100,5082,0.88685556867375,8385,32160,291,639,120,4027,36,922,114,36
"1521","2020-04-26",343,18,141,1086,5082,0.88685556867375,8385,32160,291,639,133,4160,32,954,128,32
"1522","2020-04-27",333,18,119,1080,5082,0.88685556867375,8385,32160,291,639,111,4271,30,984,107,30
"1523","2020-04-28",317,18,119,1082,5082,0.88685556867375,8385,32160,291,639,132,4403,20,1004,128,20
"1524","2020-04-29",321,18,157,1093,5082,0.88685556867375,8385,32160,291,639,96,4499,23,1027,94,23
"1525","2020-04-30",335,18,144,1078,5082,0.88685556867375,8385,32160,291,639,117,4616,35,1062,115,35
"1526","2020-05-01",339,18,171,1056,5082,0.88685556867375,8385,32160,291,639,92,4708,34,1096,85,34
"1527","2020-05-02",347,18,174,1034,5082,0.88685556867375,8385,32160,291,639,77,4785,29,1125,72,29
"1528","2020-05-03",344,18,151,1022,5082,0.88685556867375,8385,32160,291,639,86,4871,18,1143,86,18
"1529","2020-05-04",338,18,132,990,5082,0.88685556867375,8385,32160,291,639,69,4940,13,1156,66,13
"1530","2020-05-05",336,18,126,957,5082,0.88685556867375,8385,32160,291,639,82,5022,14,1170,79,14
"1531","2020-05-06",347,18,135,914,5082,0.88685556867375,8385,32160,291,639,61,5083,12,1182,58,12
"1532","2020-05-07",336,18,132,887,5082,0.88685556867375,8385,32160,291,639,50,5133,25,1207,47,25
"1533","2020-05-08",339,18,154,852,5082,0.88685556867375,8385,32160,291,639,48,5181,37,1244,46,37
"1534","2020-05-09",338,18,141,839,5082,0.88685556867375,8385,32160,291,639,47,5228,30,1274,44,30
"1535","2020-05-10",293,18,132,820,5082,0.88685556867375,8385,32160,291,639,44,5272,23,1297,43,23
"1536","2020-05-11",293,18,127,775,5082,0.88685556867375,8385,32160,291,639,34,5306,16,1313,32,16
"1537","2020-05-12",276,18,139,755,5082,0.88685556867375,8385,32160,291,639,34,5340,20,1333,33,20
"1538","2020-05-13",256,18,162,718,5082,0.88685556867375,8385,32160,291,639,38,5378,27,1360,36,27
"1539","2020-05-14",259,18,143,697,5082,0.88685556867375,8385,32160,291,639,22,5400,27,1387,21,27
"1540","2020-05-15",240,18,141,682,5082,0.88685556867375,8385,32160,291,639,30,5430,44,1431,29,44
"1541","2020-05-16",251,18,127,655,5082,0.88685556867375,8385,32160,291,639,20,5450,34,1465,20,34
"1542","2020-05-17",235,18,121,605,5082,0.88685556867375,8385,32160,291,639,18,5468,25,1490,18,25
"1543","2020-05-18",219,18,118,561,5082,0.88685556867375,8385,32160,291,639,19,5487,25,1515,18,25
"1544","2020-05-19",218,18,104,546,5082,0.88685556867375,8385,32160,291,639,18,5505,23,1538,14,23
"1545","2020-05-20",214,18,91,507,5082,0.88685556867375,8385,32160,291,639,22,5527,10,1548,22,10
"1546","2020-05-21",202,18,90,492,5082,0.88685556867375,8385,32160,291,639,19,5546,11,1559,18,11
"1547","2020-05-22",197,18,84,457,5082,0.88685556867375,8385,32160,291,639,12,5558,17,1576,12,17
"1548","2020-05-23",175,18,100,422,5082,0.88685556867375,8385,32160,291,639,15,5573,18,1594,14,18
"1549","2020-05-24",171,18,91,395,5082,0.88685556867375,8385,32160,291,639,11,5584,15,1609,9,15
"1550","2020-05-25",164,18,77,373,5082,0.88685556867375,8385,32160,291,639,8,5592,11,1620,7,11
"1551","2020-05-26",151,18,84,347,5082,0.88685556867375,8385,32160,291,639,8,5600,19,1639,7,19
"1552","2020-05-27",142,18,99,310,5082,0.88685556867375,8385,32160,291,639,2,5602,10,1649,2,10
"1553","2020-05-28",142,18,122,292,5082,0.88685556867375,8385,32160,291,639,3,5605,14,1663,3,14
"1554","2020-05-29",126,18,151,265,5082,0.88685556867375,8385,32160,291,639,6,5611,11,1674,5,11
"1555","2020-05-30",114,18,147,251,5082,0.88685556867375,8385,32160,291,639,5,5616,15,1689,5,15
"1556","2020-05-31",102,18,134,234,5082,0.88685556867375,8385,32160,291,639,5,5621,9,1698,3,9
"1557","2020-06-01",95,18,110,221,5082,0.88685556867375,8385,32160,291,639,8,5629,15,1713,8,15
"1558","2020-06-02",89,18,103,202,5082,0.88685556867375,8385,32160,291,639,1,5630,22,1735,1,22
"1559","2020-06-03",82,18,93,191,5082,0.88685556867375,8385,32160,291,639,4,5634,16,1751,3,16
"1560","2020-06-04",73,18,106,186,5082,0.88685556867375,8385,32160,291,639,4,5638,12,1763,3,12
"1561","2020-06-05",62,18,102,179,5082,0.88685556867375,8385,32160,291,639,6,5644,16,1779,4,16
"1562","2020-06-06",60,18,96,161,5082,0.88685556867375,8385,32160,291,639,2,5646,11,1790,1,11
"1563","2020-06-07",66,18,82,147,5082,0.88685556867375,8385,32160,291,639,3,5649,4,1794,2,4
"1564","2020-03-13",1,19,31,57,3299,0.631100333434374,8535,25579,171,368,18,43,20,49,NA,20
"1565","2020-03-14",6,19,38,75,3299,0.631100333434374,8535,25579,171,368,19,62,20,69,6,20
"1566","2020-03-15",6,19,34,103,3299,0.631100333434374,8535,25579,171,368,22,84,16,85,8,16
"1567","2020-03-16",6,19,32,130,3299,0.631100333434374,8535,25579,171,368,26,110,9,94,10,9
"1568","2020-03-17",8,19,33,155,3299,0.631100333434374,8535,25579,171,368,32,142,14,108,14,14
"1569","2020-03-18",13,19,35,187,3299,0.631100333434374,8535,25579,171,368,31,173,10,118,16,10
"1570","2020-03-19",16,19,53,212,3299,0.631100333434374,8535,25579,171,368,40,213,5,123,31,5
"1571","2020-03-20",26,19,50,228,3299,0.631100333434374,8535,25579,171,368,50,263,9,132,37,9
"1572","2020-03-21",66,19,54,261,3299,0.631100333434374,8535,25579,171,368,49,312,18,150,35,18
"1573","2020-03-22",75,19,54,292,3299,0.631100333434374,8535,25579,171,368,66,378,17,167,53,17
"1574","2020-03-23",70,19,59,309,3299,0.631100333434374,8535,25579,171,368,62,440,6,173,46,6
"1575","2020-03-24",77,19,70,335,3299,0.631100333434374,8535,25579,171,368,96,536,3,176,81,3
"1576","2020-03-25",82,19,69,356,3299,0.631100333434374,8535,25579,171,368,96,632,6,182,86,6
"1577","2020-03-26",97,19,72,391,3299,0.631100333434374,8535,25579,171,368,86,718,3,185,69,3
"1578","2020-03-27",131,19,93,406,3299,0.631100333434374,8535,25579,171,368,104,822,4,189,83,4
"1579","2020-03-28",117,19,97,416,3299,0.631100333434374,8535,25579,171,368,94,916,25,214,83,25
"1580","2020-03-29",136,19,84,425,3299,0.631100333434374,8535,25579,171,368,109,1025,34,248,96,34
"1581","2020-03-30",144,19,67,437,3299,0.631100333434374,8535,25579,171,368,111,1136,13,261,92,13
"1582","2020-03-31",141,19,59,459,3299,0.631100333434374,8535,25579,171,368,121,1257,20,281,108,20
"1583","2020-04-01",147,19,52,488,3299,0.631100333434374,8535,25579,171,368,154,1411,11,292,140,11
"1584","2020-04-02",146,19,59,473,3299,0.631100333434374,8535,25579,171,368,124,1535,8,300,110,8
"1585","2020-04-03",152,19,62,478,3299,0.631100333434374,8535,25579,171,368,148,1683,10,310,134,10
"1586","2020-04-04",160,19,72,495,3299,0.631100333434374,8535,25579,171,368,139,1822,26,336,121,26
"1587","2020-04-05",150,19,70,495,3299,0.631100333434374,8535,25579,171,368,128,1950,16,352,111,16
"1588","2020-04-06",142,19,72,491,3299,0.631100333434374,8535,25579,171,368,150,2100,27,379,140,27
"1589","2020-04-07",143,19,87,491,3299,0.631100333434374,8535,25579,171,368,121,2221,25,404,102,25
"1590","2020-04-08",149,19,98,504,3299,0.631100333434374,8535,25579,171,368,156,2377,26,430,144,26
"1591","2020-04-09",145,19,102,517,3299,0.631100333434374,8535,25579,171,368,173,2550,17,447,156,17
"1592","2020-04-10",161,19,89,520,3299,0.631100333434374,8535,25579,171,368,159,2709,14,461,146,14
"1593","2020-04-11",163,19,91,528,3299,0.631100333434374,8535,25579,171,368,158,2867,29,490,144,29
"1594","2020-04-12",152,19,94,550,3299,0.631100333434374,8535,25579,171,368,124,2991,44,534,107,44
"1595","2020-04-13",156,19,107,556,3299,0.631100333434374,8535,25579,171,368,128,3119,34,568,116,34
"1596","2020-04-14",160,19,118,561,3299,0.631100333434374,8535,25579,171,368,147,3266,12,580,131,12
"1597","2020-04-15",157,19,130,559,3299,0.631100333434374,8535,25579,171,368,103,3369,13,593,90,13
"1598","2020-04-16",166,19,138,546,3299,0.631100333434374,8535,25579,171,368,137,3506,11,604,121,11
"1599","2020-04-17",189,19,135,554,3299,0.631100333434374,8535,25579,171,368,110,3616,9,613,103,9
"1600","2020-04-18",196,19,141,534,3299,0.631100333434374,8535,25579,171,368,125,3741,12,625,106,12
"1601","2020-04-19",196,19,135,525,3299,0.631100333434374,8535,25579,171,368,114,3855,33,658,102,33
"1602","2020-04-20",183,19,133,516,3299,0.631100333434374,8535,25579,171,368,137,3992,39,697,128,39
"1603","2020-04-21",171,19,129,515,3299,0.631100333434374,8535,25579,171,368,95,4087,25,722,79,25
"1604","2020-04-22",175,19,118,506,3299,0.631100333434374,8535,25579,171,368,93,4180,25,747,82,25
"1605","2020-04-23",168,19,121,500,3299,0.631100333434374,8535,25579,171,368,85,4265,20,767,74,20
"1606","2020-04-24",156,19,143,489,3299,0.631100333434374,8535,25579,171,368,100,4365,13,780,88,13
"1607","2020-04-25",158,19,141,482,3299,0.631100333434374,8535,25579,171,368,92,4457,14,794,78,14
"1608","2020-04-26",164,19,143,494,3299,0.631100333434374,8535,25579,171,368,84,4541,32,826,70,32
"1609","2020-04-27",167,19,130,502,3299,0.631100333434374,8535,25579,171,368,73,4614,45,871,66,45
"1610","2020-04-28",162,19,139,492,3299,0.631100333434374,8535,25579,171,368,62,4676,42,913,56,42
"1611","2020-04-29",160,19,156,487,3299,0.631100333434374,8535,25579,171,368,65,4741,47,960,52,47
"1612","2020-04-30",165,19,175,486,3299,0.631100333434374,8535,25579,171,368,49,4790,23,983,38,23
"1613","2020-05-01",166,19,168,482,3299,0.631100333434374,8535,25579,171,368,47,4837,25,1008,41,25
"1614","2020-05-02",185,19,171,488,3299,0.631100333434374,8535,25579,171,368,78,4915,13,1021,66,13
"1615","2020-05-03",161,19,163,482,3299,0.631100333434374,8535,25579,171,368,35,4950,15,1036,27,15
"1616","2020-05-04",159,19,140,476,3299,0.631100333434374,8535,25579,171,368,50,5000,14,1050,43,14
"1617","2020-05-05",152,19,133,479,3299,0.631100333434374,8535,25579,171,368,44,5044,14,1064,32,14
"1618","2020-05-06",150,19,146,460,3299,0.631100333434374,8535,25579,171,368,34,5078,15,1079,28,15
"1619","2020-05-07",150,19,141,454,3299,0.631100333434374,8535,25579,171,368,27,5105,32,1111,20,32
"1620","2020-05-08",173,19,149,446,3299,0.631100333434374,8535,25579,171,368,36,5141,21,1132,27,21
"1621","2020-05-09",161,19,139,437,3299,0.631100333434374,8535,25579,171,368,34,5175,15,1147,28,15
"1622","2020-05-10",156,19,141,433,3299,0.631100333434374,8535,25579,171,368,33,5208,29,1176,26,29
"1623","2020-05-11",143,19,132,421,3299,0.631100333434374,8535,25579,171,368,24,5232,14,1190,18,14
"1624","2020-05-12",148,19,126,409,3299,0.631100333434374,8535,25579,171,368,25,5257,24,1214,20,24
"1625","2020-05-13",137,19,102,396,3299,0.631100333434374,8535,25579,171,368,26,5283,33,1247,17,33
"1626","2020-05-14",138,19,112,384,3299,0.631100333434374,8535,25579,171,368,20,5303,29,1276,16,29
"1627","2020-05-15",128,19,112,373,3299,0.631100333434374,8535,25579,171,368,26,5329,48,1324,22,48
"1628","2020-05-16",118,19,125,357,3299,0.631100333434374,8535,25579,171,368,28,5357,35,1359,20,35
"1629","2020-05-17",110,19,113,356,3299,0.631100333434374,8535,25579,171,368,23,5380,33,1392,16,33
"1630","2020-05-18",113,19,97,349,3299,0.631100333434374,8535,25579,171,368,23,5403,20,1412,13,20
"1631","2020-05-19",114,19,83,340,3299,0.631100333434374,8535,25579,171,368,23,5426,36,1448,18,36
"1632","2020-05-20",121,19,64,337,3299,0.631100333434374,8535,25579,171,368,15,5441,24,1472,9,24
"1633","2020-05-21",117,19,59,326,3299,0.631100333434374,8535,25579,171,368,23,5464,39,1511,16,39
"1634","2020-05-22",119,19,52,302,3299,0.631100333434374,8535,25579,171,368,19,5483,15,1526,16,15
"1635","2020-05-23",133,19,61,303,3299,0.631100333434374,8535,25579,171,368,17,5500,9,1535,12,9
"1636","2020-05-24",124,19,60,292,3299,0.631100333434374,8535,25579,171,368,12,5512,16,1551,7,16
"1637","2020-05-25",119,19,61,301,3299,0.631100333434374,8535,25579,171,368,16,5528,25,1576,11,25
"1638","2020-05-26",115,19,63,308,3299,0.631100333434374,8535,25579,171,368,14,5542,28,1604,11,28
"1639","2020-05-27",109,19,73,299,3299,0.631100333434374,8535,25579,171,368,14,5556,26,1630,12,26
"1640","2020-05-28",105,19,85,289,3299,0.631100333434374,8535,25579,171,368,6,5562,20,1650,3,20
"1641","2020-05-29",104,19,96,296,3299,0.631100333434374,8535,25579,171,368,10,5572,25,1675,6,25
"1642","2020-05-30",108,19,93,308,3299,0.631100333434374,8535,25579,171,368,19,5591,23,1698,14,23
"1643","2020-05-31",97,19,84,293,3299,0.631100333434374,8535,25579,171,368,7,5598,20,1718,6,20
"1644","2020-06-01",97,19,88,301,3299,0.631100333434374,8535,25579,171,368,13,5611,7,1725,5,7
"1645","2020-06-02",89,19,87,271,3299,0.631100333434374,8535,25579,171,368,10,5621,14,1739,5,14
"1646","2020-06-03",97,19,81,255,3299,0.631100333434374,8535,25579,171,368,7,5628,12,1751,5,12
"1647","2020-06-04",102,19,67,259,3299,0.631100333434374,8535,25579,171,368,8,5636,5,1756,5,5
"1648","2020-06-05",108,19,68,256,3299,0.631100333434374,8535,25579,171,368,4,5640,12,1768,3,12
"1649","2020-06-06",98,19,70,242,3299,0.631100333434374,8535,25579,171,368,9,5649,15,1783,4,15
"1650","2020-06-07",90,19,60,219,3299,0.631100333434374,8535,25579,171,368,10,5659,7,1790,7,7
"1651","2020-03-14",1,20,66,18,5094,0.952296819787986,8220,30319,266,473,4,24,3,26,1,3
"1652","2020-03-15",3,20,63,31,5094,0.952296819787986,8220,30319,266,473,11,35,12,38,3,12
"1653","2020-03-16",2,20,58,39,5094,0.952296819787986,8220,30319,266,473,12,47,12,50,6,12
"1654","2020-03-17",2,20,69,58,5094,0.952296819787986,8220,30319,266,473,18,65,10,60,12,10
"1655","2020-03-18",3,20,78,78,5094,0.952296819787986,8220,30319,266,473,9,74,9,69,7,9
"1656","2020-03-19",5,20,87,96,5094,0.952296819787986,8220,30319,266,473,23,97,14,83,16,14
"1657","2020-03-20",10,20,93,116,5094,0.952296819787986,8220,30319,266,473,16,113,16,99,7,16
"1658","2020-03-21",22,20,103,137,5094,0.952296819787986,8220,30319,266,473,16,129,12,111,10,12
"1659","2020-03-22",27,20,112,169,5094,0.952296819787986,8220,30319,266,473,28,157,9,120,21,9
"1660","2020-03-23",29,20,114,199,5094,0.952296819787986,8220,30319,266,473,17,174,10,130,14,10
"1661","2020-03-24",35,20,119,221,5094,0.952296819787986,8220,30319,266,473,27,201,17,147,21,17
"1662","2020-03-25",41,20,113,259,5094,0.952296819787986,8220,30319,266,473,30,231,16,163,22,16
"1663","2020-03-26",47,20,105,294,5094,0.952296819787986,8220,30319,266,473,41,272,22,185,33,22
"1664","2020-03-27",63,20,112,326,5094,0.952296819787986,8220,30319,266,473,58,330,17,202,51,17
"1665","2020-03-28",97,20,106,351,5094,0.952296819787986,8220,30319,266,473,41,371,19,221,35,19
"1666","2020-03-29",107,20,89,410,5094,0.952296819787986,8220,30319,266,473,54,425,15,236,41,15
"1667","2020-03-30",107,20,78,447,5094,0.952296819787986,8220,30319,266,473,63,488,22,258,54,22
"1668","2020-03-31",107,20,70,488,5094,0.952296819787986,8220,30319,266,473,55,543,20,278,52,20
"1669","2020-04-01",119,20,66,532,5094,0.952296819787986,8220,30319,266,473,66,609,16,294,59,16
"1670","2020-04-02",128,20,65,577,5094,0.952296819787986,8220,30319,266,473,71,680,16,310,65,16
"1671","2020-04-03",173,20,53,633,5094,0.952296819787986,8220,30319,266,473,90,770,18,328,86,18
"1672","2020-04-04",181,20,44,717,5094,0.952296819787986,8220,30319,266,473,88,858,29,357,83,29
"1673","2020-04-05",196,20,49,778,5094,0.952296819787986,8220,30319,266,473,115,973,26,383,106,26
"1674","2020-04-06",193,20,48,837,5094,0.952296819787986,8220,30319,266,473,88,1061,17,400,78,17
"1675","2020-04-07",216,20,55,903,5094,0.952296819787986,8220,30319,266,473,136,1197,21,421,131,21
"1676","2020-04-08",231,20,71,973,5094,0.952296819787986,8220,30319,266,473,106,1303,24,445,97,24
"1677","2020-04-09",245,20,68,1031,5094,0.952296819787986,8220,30319,266,473,118,1421,24,469,108,24
"1678","2020-04-10",315,20,64,1065,5094,0.952296819787986,8220,30319,266,473,133,1554,26,495,130,26
"1679","2020-04-11",339,20,75,1109,5094,0.952296819787986,8220,30319,266,473,145,1699,27,522,139,27
"1680","2020-04-12",324,20,88,1167,5094,0.952296819787986,8220,30319,266,473,164,1863,18,540,159,18
"1681","2020-04-13",341,20,101,1173,5094,0.952296819787986,8220,30319,266,473,126,1989,19,559,121,19
"1682","2020-04-14",347,20,126,1243,5094,0.952296819787986,8220,30319,266,473,152,2141,17,576,148,17
"1683","2020-04-15",366,20,121,1300,5094,0.952296819787986,8220,30319,266,473,176,2317,26,602,164,26
"1684","2020-04-16",378,20,114,1309,5094,0.952296819787986,8220,30319,266,473,135,2452,32,634,127,32
"1685","2020-04-17",422,20,121,1323,5094,0.952296819787986,8220,30319,266,473,165,2617,18,652,162,18
"1686","2020-04-18",419,20,126,1335,5094,0.952296819787986,8220,30319,266,473,157,2774,18,670,150,18
"1687","2020-04-19",429,20,125,1357,5094,0.952296819787986,8220,30319,266,473,138,2912,32,702,129,32
"1688","2020-04-20",446,20,146,1362,5094,0.952296819787986,8220,30319,266,473,162,3074,34,736,157,34
"1689","2020-04-21",441,20,136,1356,5094,0.952296819787986,8220,30319,266,473,164,3238,26,762,155,26
"1690","2020-04-22",448,20,126,1359,5094,0.952296819787986,8220,30319,266,473,145,3383,21,783,145,21
"1691","2020-04-23",467,20,143,1338,5094,0.952296819787986,8220,30319,266,473,150,3533,26,809,144,26
"1692","2020-04-24",477,20,150,1350,5094,0.952296819787986,8220,30319,266,473,125,3658,28,837,117,28
"1693","2020-04-25",522,20,186,1343,5094,0.952296819787986,8220,30319,266,473,179,3837,36,873,167,36
"1694","2020-04-26",493,20,170,1315,5094,0.952296819787986,8220,30319,266,473,114,3951,32,905,108,32
"1695","2020-04-27",475,20,149,1274,5094,0.952296819787986,8220,30319,266,473,110,4061,31,936,105,31
"1696","2020-04-28",460,20,149,1232,5094,0.952296819787986,8220,30319,266,473,86,4147,23,959,79,23
"1697","2020-04-29",442,20,144,1210,5094,0.952296819787986,8220,30319,266,473,127,4274,42,1001,125,42
"1698","2020-04-30",426,20,164,1169,5094,0.952296819787986,8220,30319,266,473,93,4367,34,1035,88,34
"1699","2020-05-01",446,20,201,1102,5094,0.952296819787986,8220,30319,266,473,82,4449,22,1057,77,22
"1700","2020-05-02",408,20,211,1021,5094,0.952296819787986,8220,30319,266,473,94,4543,29,1086,90,29
"1701","2020-05-03",382,20,229,977,5094,0.952296819787986,8220,30319,266,473,110,4653,26,1112,103,26
"1702","2020-05-04",352,20,198,912,5094,0.952296819787986,8220,30319,266,473,60,4713,32,1144,55,32
"1703","2020-05-05",337,20,169,912,5094,0.952296819787986,8220,30319,266,473,87,4800,39,1183,79,39
"1704","2020-05-06",331,20,161,876,5094,0.952296819787986,8220,30319,266,473,52,4852,35,1218,48,35
"1705","2020-05-07",312,20,170,811,5094,0.952296819787986,8220,30319,266,473,70,4922,33,1251,65,33
"1706","2020-05-08",300,20,165,765,5094,0.952296819787986,8220,30319,266,473,51,4973,28,1279,47,28
"1707","2020-05-09",298,20,175,717,5094,0.952296819787986,8220,30319,266,473,44,5017,33,1312,41,33
"1708","2020-05-10",258,20,152,681,5094,0.952296819787986,8220,30319,266,473,44,5061,18,1330,43,18
"1709","2020-05-11",256,20,138,624,5094,0.952296819787986,8220,30319,266,473,45,5106,19,1349,44,19
"1710","2020-05-12",250,20,119,580,5094,0.952296819787986,8220,30319,266,473,37,5143,18,1367,36,18
"1711","2020-05-13",245,20,132,528,5094,0.952296819787986,8220,30319,266,473,40,5183,16,1383,35,16
"1712","2020-05-14",235,20,133,500,5094,0.952296819787986,8220,30319,266,473,30,5213,10,1393,24,10
"1713","2020-05-15",212,20,121,467,5094,0.952296819787986,8220,30319,266,473,32,5245,19,1412,28,19
"1714","2020-05-16",197,20,117,444,5094,0.952296819787986,8220,30319,266,473,35,5280,21,1433,31,21
"1715","2020-05-17",184,20,120,409,5094,0.952296819787986,8220,30319,266,473,28,5308,23,1456,25,23
"1716","2020-05-18",165,20,110,374,5094,0.952296819787986,8220,30319,266,473,25,5333,20,1476,22,20
"1717","2020-05-19",149,20,109,343,5094,0.952296819787986,8220,30319,266,473,16,5349,21,1497,14,21
"1718","2020-05-20",127,20,106,320,5094,0.952296819787986,8220,30319,266,473,28,5377,28,1525,24,28
"1719","2020-05-21",123,20,99,287,5094,0.952296819787986,8220,30319,266,473,16,5393,31,1556,15,31
"1720","2020-05-22",107,20,86,261,5094,0.952296819787986,8220,30319,266,473,20,5413,26,1582,20,26
"1721","2020-05-23",108,20,101,247,5094,0.952296819787986,8220,30319,266,473,17,5430,20,1602,16,20
"1722","2020-05-24",101,20,109,230,5094,0.952296819787986,8220,30319,266,473,18,5448,29,1631,15,29
"1723","2020-05-25",97,20,112,219,5094,0.952296819787986,8220,30319,266,473,12,5460,23,1654,10,23
"1724","2020-05-26",98,20,122,200,5094,0.952296819787986,8220,30319,266,473,11,5471,25,1679,9,25
"1725","2020-05-27",95,20,140,187,5094,0.952296819787986,8220,30319,266,473,9,5480,20,1699,7,20
"1726","2020-05-28",87,20,150,179,5094,0.952296819787986,8220,30319,266,473,15,5495,18,1717,14,18
"1727","2020-05-29",78,20,136,168,5094,0.952296819787986,8220,30319,266,473,11,5506,14,1731,9,14
"1728","2020-05-30",73,20,132,163,5094,0.952296819787986,8220,30319,266,473,10,5516,18,1749,9,18
"1729","2020-05-31",60,20,141,155,5094,0.952296819787986,8220,30319,266,473,5,5521,20,1769,5,20
"1730","2020-06-01",55,20,171,137,5094,0.952296819787986,8220,30319,266,473,4,5525,8,1777,4,8
"1731","2020-06-02",50,20,165,127,5094,0.952296819787986,8220,30319,266,473,7,5532,24,1801,6,24
"1732","2020-06-03",49,20,159,114,5094,0.952296819787986,8220,30319,266,473,3,5535,8,1809,3,8
"1733","2020-06-04",50,20,145,108,5094,0.952296819787986,8220,30319,266,473,3,5538,11,1820,1,11
"1734","2020-06-05",42,20,135,108,5094,0.952296819787986,8220,30319,266,473,3,5541,20,1840,2,20
"1735","2020-06-06",43,20,130,99,5094,0.952296819787986,8220,30319,266,473,7,5548,17,1857,6,17
"1736","2020-06-07",38,20,128,99,5094,0.952296819787986,8220,30319,266,473,5,5553,7,1864,2,7
