"","Date","Absents","Paramset","Infections_or_Exposed_per_day_Patient","Infections_or_Exposed_per_day_HCW","total_infections","nosocomial_proportion","PCR_pooled","LFD_pooled","HCW_symp_test","patient_symp_test","new_hcw_infs","cumulative_hcw_infs","new_pat_infs","cumulative_pats_infs","new_nosocomial_hcw_infs","new_nosocomial_pat_infs"
"1","2020-03-14",13,1,76,176,5863,0.392290636193075,1950,7523,652,770,45,177,17,82,10,17
"2","2020-03-15",25,1,77,242,5863,0.392290636193075,1950,7523,652,770,66,243,14,96,18,14
"3","2020-03-16",28,1,90,286,5863,0.392290636193075,1950,7523,652,770,45,288,21,117,14,21
"4","2020-03-17",35,1,99,346,5863,0.392290636193075,1950,7523,652,770,64,352,20,137,28,20
"5","2020-03-18",49,1,107,399,5863,0.392290636193075,1950,7523,652,770,61,413,18,155,30,18
"6","2020-03-19",66,1,107,461,5863,0.392290636193075,1950,7523,652,770,75,488,10,165,32,10
"7","2020-03-20",101,1,86,523,5863,0.392290636193075,1950,7523,652,770,73,561,5,170,30,5
"8","2020-03-21",117,1,85,579,5863,0.392290636193075,1950,7523,652,770,76,637,11,181,39,11
"9","2020-03-22",161,1,75,632,5863,0.392290636193075,1950,7523,652,770,77,714,6,187,33,6
"10","2020-03-23",182,1,75,707,5863,0.392290636193075,1950,7523,652,770,106,820,8,195,52,8
"11","2020-03-24",181,1,90,746,5863,0.392290636193075,1950,7523,652,770,80,900,23,218,40,23
"12","2020-03-25",185,1,82,793,5863,0.392290636193075,1950,7523,652,770,98,998,10,228,43,10
"13","2020-03-26",202,1,78,842,5863,0.392290636193075,1950,7523,652,770,96,1094,13,241,46,13
"14","2020-03-27",254,1,74,894,5863,0.392290636193075,1950,7523,652,770,105,1199,11,252,55,11
"15","2020-03-28",305,1,77,919,5863,0.392290636193075,1950,7523,652,770,84,1283,15,267,34,15
"16","2020-03-29",283,1,94,928,5863,0.392290636193075,1950,7523,652,770,73,1356,25,292,35,25
"17","2020-03-30",279,1,98,947,5863,0.392290636193075,1950,7523,652,770,92,1448,20,312,48,20
"18","2020-03-31",298,1,94,960,5863,0.392290636193075,1950,7523,652,770,84,1532,9,321,49,9
"19","2020-04-01",320,1,85,983,5863,0.392290636193075,1950,7523,652,770,97,1629,8,329,50,8
"20","2020-04-02",327,1,90,1009,5863,0.392290636193075,1950,7523,652,770,102,1731,12,341,51,12
"21","2020-04-03",378,1,92,1004,5863,0.392290636193075,1950,7523,652,770,99,1830,16,357,42,16
"22","2020-04-04",360,1,116,1004,5863,0.392290636193075,1950,7523,652,770,78,1908,32,389,39,32
"23","2020-04-05",346,1,121,1007,5863,0.392290636193075,1950,7523,652,770,90,1998,18,407,48,18
"24","2020-04-06",327,1,124,1007,5863,0.392290636193075,1950,7523,652,770,82,2080,28,435,39,28
"25","2020-04-07",322,1,109,975,5863,0.392290636193075,1950,7523,652,770,77,2157,25,460,38,25
"26","2020-04-08",312,1,121,969,5863,0.392290636193075,1950,7523,652,770,92,2249,21,481,32,21
"27","2020-04-09",312,1,121,975,5863,0.392290636193075,1950,7523,652,770,93,2342,16,497,49,16
"28","2020-04-10",327,1,107,967,5863,0.392290636193075,1950,7523,652,770,75,2417,9,506,31,9
"29","2020-04-11",320,1,110,966,5863,0.392290636193075,1950,7523,652,770,88,2505,12,518,36,12
"30","2020-04-12",310,1,155,980,5863,0.392290636193075,1950,7523,652,770,82,2587,57,575,38,57
"31","2020-04-13",312,1,192,971,5863,0.392290636193075,1950,7523,652,770,86,2673,60,635,38,60
"32","2020-04-14",293,1,196,998,5863,0.392290636193075,1950,7523,652,770,94,2767,38,673,46,38
"33","2020-04-15",292,1,198,983,5863,0.392290636193075,1950,7523,652,770,78,2845,39,712,35,39
"34","2020-04-16",285,1,212,958,5863,0.392290636193075,1950,7523,652,770,72,2917,42,754,34,42
"35","2020-04-17",321,1,211,968,5863,0.392290636193075,1950,7523,652,770,95,3012,33,787,50,33
"36","2020-04-18",336,1,209,928,5863,0.392290636193075,1950,7523,652,770,72,3084,39,826,25,39
"37","2020-04-19",315,1,186,935,5863,0.392290636193075,1950,7523,652,770,77,3161,16,842,37,16
"38","2020-04-20",321,1,158,926,5863,0.392290636193075,1950,7523,652,770,69,3230,12,854,29,12
"39","2020-04-21",316,1,153,924,5863,0.392290636193075,1950,7523,652,770,75,3305,19,873,34,19
"40","2020-04-22",318,1,160,914,5863,0.392290636193075,1950,7523,652,770,77,3382,31,904,37,31
"41","2020-04-23",313,1,164,908,5863,0.392290636193075,1950,7523,652,770,76,3458,18,922,27,18
"42","2020-04-24",306,1,204,865,5863,0.392290636193075,1950,7523,652,770,47,3505,57,979,18,57
"43","2020-04-25",296,1,218,861,5863,0.392290636193075,1950,7523,652,770,65,3570,40,1019,26,40
"44","2020-04-26",285,1,203,876,5863,0.392290636193075,1950,7523,652,770,89,3659,32,1051,39,32
"45","2020-04-27",279,1,203,863,5863,0.392290636193075,1950,7523,652,770,69,3728,34,1085,29,34
"46","2020-04-28",286,1,178,846,5863,0.392290636193075,1950,7523,652,770,56,3784,16,1101,29,16
"47","2020-04-29",280,1,163,826,5863,0.392290636193075,1950,7523,652,770,61,3845,17,1118,28,17
"48","2020-04-30",280,1,148,817,5863,0.392290636193075,1950,7523,652,770,70,3915,13,1131,28,13
"49","2020-05-01",285,1,170,795,5863,0.392290636193075,1950,7523,652,770,61,3976,40,1171,24,40
"50","2020-05-02",283,1,177,798,5863,0.392290636193075,1950,7523,652,770,58,4034,34,1205,19,34
"51","2020-05-03",273,1,178,792,5863,0.392290636193075,1950,7523,652,770,58,4092,26,1231,19,26
"52","2020-05-04",273,1,181,774,5863,0.392290636193075,1950,7523,652,770,55,4147,40,1271,26,40
"53","2020-05-05",246,1,207,750,5863,0.392290636193075,1950,7523,652,770,55,4202,50,1321,19,50
"54","2020-05-06",252,1,193,732,5863,0.392290636193075,1950,7523,652,770,60,4262,31,1352,23,31
"55","2020-05-07",241,1,201,710,5863,0.392290636193075,1950,7523,652,770,52,4314,48,1400,26,48
"56","2020-05-08",243,1,222,700,5863,0.392290636193075,1950,7523,652,770,52,4366,40,1440,22,40
"57","2020-05-09",247,1,231,694,5863,0.392290636193075,1950,7523,652,770,61,4427,48,1488,29,48
"58","2020-05-10",218,1,233,674,5863,0.392290636193075,1950,7523,652,770,55,4482,44,1532,21,44
"59","2020-05-11",204,1,252,662,5863,0.392290636193075,1950,7523,652,770,59,4541,60,1592,25,60
"60","2020-05-12",210,1,255,643,5863,0.392290636193075,1950,7523,652,770,41,4582,45,1637,20,45
"61","2020-05-13",204,1,233,615,5863,0.392290636193075,1950,7523,652,770,45,4627,28,1665,22,28
"62","2020-05-14",206,1,203,586,5863,0.392290636193075,1950,7523,652,770,34,4661,12,1677,13,12
"63","2020-05-15",186,1,191,566,5863,0.392290636193075,1950,7523,652,770,42,4703,25,1702,15,25
"64","2020-05-16",174,1,193,550,5863,0.392290636193075,1950,7523,652,770,39,4742,32,1734,17,32
"65","2020-05-17",173,1,184,548,5863,0.392290636193075,1950,7523,652,770,48,4790,32,1766,12,32
"66","2020-05-18",169,1,182,527,5863,0.392290636193075,1950,7523,652,770,39,4829,32,1798,13,32
"67","2020-05-19",158,1,174,503,5863,0.392290636193075,1950,7523,652,770,37,4866,28,1826,12,28
"68","2020-05-20",147,1,161,478,5863,0.392290636193075,1950,7523,652,770,30,4896,20,1846,14,20
"69","2020-05-21",144,1,162,463,5863,0.392290636193075,1950,7523,652,770,23,4919,25,1871,8,25
"70","2020-05-22",147,1,181,440,5863,0.392290636193075,1950,7523,652,770,29,4948,38,1909,9,38
"71","2020-05-23",156,1,197,412,5863,0.392290636193075,1950,7523,652,770,23,4971,43,1952,6,43
"72","2020-05-24",132,1,211,401,5863,0.392290636193075,1950,7523,652,770,34,5005,45,1997,11,45
"73","2020-05-25",122,1,204,376,5863,0.392290636193075,1950,7523,652,770,36,5041,31,2028,17,31
"74","2020-05-26",115,1,220,370,5863,0.392290636193075,1950,7523,652,770,28,5069,43,2071,14,43
"75","2020-05-27",109,1,204,348,5863,0.392290636193075,1950,7523,652,770,15,5084,27,2098,9,27
"76","2020-05-28",113,1,202,343,5863,0.392290636193075,1950,7523,652,770,28,5112,27,2125,6,27
"77","2020-05-29",113,1,211,347,5863,0.392290636193075,1950,7523,652,770,33,5145,24,2149,17,24
"78","2020-05-30",108,1,210,315,5863,0.392290636193075,1950,7523,652,770,17,5162,37,2186,10,37
"79","2020-05-31",111,1,200,305,5863,0.392290636193075,1950,7523,652,770,22,5184,37,2223,6,37
"80","2020-06-01",113,1,174,289,5863,0.392290636193075,1950,7523,652,770,13,5197,23,2246,3,23
"81","2020-06-02",117,1,162,282,5863,0.392290636193075,1950,7523,652,770,23,5220,23,2269,11,23
"82","2020-06-03",114,1,150,275,5863,0.392290636193075,1950,7523,652,770,20,5240,12,2281,7,12
"83","2020-06-04",103,1,146,260,5863,0.392290636193075,1950,7523,652,770,16,5256,18,2299,4,18
"84","2020-06-05",104,1,127,259,5863,0.392290636193075,1950,7523,652,770,18,5274,14,2313,8,14
"85","2020-06-06",101,1,125,253,5863,0.392290636193075,1950,7523,652,770,23,5297,12,2325,5,12
"86","2020-06-07",91,1,129,245,5863,0.392290636193075,1950,7523,652,770,16,5313,17,2342,5,17
"87","2020-03-07",1,2,0,0,5585,0.704565801253357,2025,7498,606,597,NA,NA,NA,NA,NA,NA
"88","2020-03-08",1,2,0,0,5585,0.704565801253357,2025,7498,606,597,NA,NA,NA,NA,NA,NA
"89","2020-03-09",0,2,0,0,5585,0.704565801253357,2025,7498,606,597,NA,NA,NA,NA,NA,NA
"90","2020-03-10",0,2,0,0,5585,0.704565801253357,2025,7498,606,597,NA,NA,1,1,NA,1
"91","2020-03-11",0,2,0,0,5585,0.704565801253357,2025,7498,606,597,45,45,4,5,NA,4
"92","2020-03-12",0,2,0,0,5585,0.704565801253357,2025,7498,606,597,44,89,4,9,2,4
"93","2020-03-13",5,2,48,76,5585,0.704565801253357,2025,7498,606,597,41,130,13,22,9,13
"94","2020-03-14",14,2,58,99,5585,0.704565801253357,2025,7498,606,597,49,179,19,41,11,19
"95","2020-03-15",16,2,55,136,5585,0.704565801253357,2025,7498,606,597,50,229,19,60,23,19
"96","2020-03-16",14,2,54,168,5585,0.704565801253357,2025,7498,606,597,52,281,17,77,23,17
"97","2020-03-17",22,2,56,204,5585,0.704565801253357,2025,7498,606,597,57,338,19,96,20,19
"98","2020-03-18",27,2,71,242,5585,0.704565801253357,2025,7498,606,597,63,401,13,109,25,13
"99","2020-03-19",33,2,58,279,5585,0.704565801253357,2025,7498,606,597,58,459,17,126,31,17
"100","2020-03-20",48,2,61,322,5585,0.704565801253357,2025,7498,606,597,71,530,21,147,34,21
"101","2020-03-21",78,2,54,376,5585,0.704565801253357,2025,7498,606,597,87,617,27,174,52,27
"102","2020-03-22",89,2,48,412,5585,0.704565801253357,2025,7498,606,597,82,699,38,212,47,38
"103","2020-03-23",85,2,53,473,5585,0.704565801253357,2025,7498,606,597,74,773,36,248,56,36
"104","2020-03-24",91,2,47,537,5585,0.704565801253357,2025,7498,606,597,91,864,22,270,55,22
"105","2020-03-25",110,2,62,588,5585,0.704565801253357,2025,7498,606,597,66,930,21,291,37,21
"106","2020-03-26",126,2,59,684,5585,0.704565801253357,2025,7498,606,597,115,1045,27,318,80,27
"107","2020-03-27",186,2,59,725,5585,0.704565801253357,2025,7498,606,597,107,1152,23,341,63,23
"108","2020-03-28",203,2,58,785,5585,0.704565801253357,2025,7498,606,597,87,1239,12,353,50,12
"109","2020-03-29",216,2,60,868,5585,0.704565801253357,2025,7498,606,597,94,1333,15,368,60,15
"110","2020-03-30",226,2,74,911,5585,0.704565801253357,2025,7498,606,597,96,1429,17,385,62,17
"111","2020-03-31",242,2,83,962,5585,0.704565801253357,2025,7498,606,597,94,1523,15,400,68,15
"112","2020-04-01",241,2,86,1027,5585,0.704565801253357,2025,7498,606,597,98,1621,19,419,66,19
"113","2020-04-02",266,2,94,1042,5585,0.704565801253357,2025,7498,606,597,101,1722,7,426,61,7
"114","2020-04-03",327,2,118,1110,5585,0.704565801253357,2025,7498,606,597,111,1833,14,440,70,14
"115","2020-04-04",349,2,115,1170,5585,0.704565801253357,2025,7498,606,597,88,1921,23,463,57,23
"116","2020-04-05",367,2,115,1224,5585,0.704565801253357,2025,7498,606,597,81,2002,22,485,53,22
"117","2020-04-06",373,2,112,1265,5585,0.704565801253357,2025,7498,606,597,86,2088,29,514,54,29
"118","2020-04-07",378,2,104,1288,5585,0.704565801253357,2025,7498,606,597,97,2185,25,539,63,25
"119","2020-04-08",401,2,124,1325,5585,0.704565801253357,2025,7498,606,597,94,2279,17,556,59,17
"120","2020-04-09",405,2,144,1366,5585,0.704565801253357,2025,7498,606,597,92,2371,24,580,55,24
"121","2020-04-10",477,2,141,1387,5585,0.704565801253357,2025,7498,606,597,79,2450,42,622,39,42
"122","2020-04-11",512,2,144,1401,5585,0.704565801253357,2025,7498,606,597,79,2529,25,647,48,25
"123","2020-04-12",468,2,162,1403,5585,0.704565801253357,2025,7498,606,597,97,2626,51,698,48,51
"124","2020-04-13",452,2,133,1406,5585,0.704565801253357,2025,7498,606,597,89,2715,38,736,53,38
"125","2020-04-14",446,2,136,1401,5585,0.704565801253357,2025,7498,606,597,81,2796,16,752,48,16
"126","2020-04-15",462,2,148,1381,5585,0.704565801253357,2025,7498,606,597,71,2867,18,770,40,18
"127","2020-04-16",453,2,147,1360,5585,0.704565801253357,2025,7498,606,597,82,2949,17,787,49,17
"128","2020-04-17",486,2,136,1335,5585,0.704565801253357,2025,7498,606,597,71,3020,12,799,35,12
"129","2020-04-18",463,2,121,1300,5585,0.704565801253357,2025,7498,606,597,66,3086,39,838,34,39
"130","2020-04-19",429,2,118,1271,5585,0.704565801253357,2025,7498,606,597,72,3158,34,872,39,34
"131","2020-04-20",437,2,116,1221,5585,0.704565801253357,2025,7498,606,597,82,3240,18,890,51,18
"132","2020-04-21",455,2,115,1186,5585,0.704565801253357,2025,7498,606,597,63,3303,31,921,29,31
"133","2020-04-22",439,2,106,1158,5585,0.704565801253357,2025,7498,606,597,57,3360,20,941,30,20
"134","2020-04-23",434,2,98,1091,5585,0.704565801253357,2025,7498,606,597,75,3435,24,965,42,24
"135","2020-04-24",430,2,93,1028,5585,0.704565801253357,2025,7498,606,597,68,3503,44,1009,36,44
"136","2020-04-25",433,2,92,990,5585,0.704565801253357,2025,7498,606,597,78,3581,30,1039,36,30
"137","2020-04-26",398,2,91,957,5585,0.704565801253357,2025,7498,606,597,79,3660,26,1065,50,26
"138","2020-04-27",363,2,100,920,5585,0.704565801253357,2025,7498,606,597,60,3720,21,1086,32,21
"139","2020-04-28",329,2,113,879,5585,0.704565801253357,2025,7498,606,597,74,3794,32,1118,41,32
"140","2020-04-29",325,2,149,813,5585,0.704565801253357,2025,7498,606,597,56,3850,26,1144,30,26
"141","2020-04-30",317,2,192,786,5585,0.704565801253357,2025,7498,606,597,67,3917,29,1173,31,29
"142","2020-05-01",278,2,219,740,5585,0.704565801253357,2025,7498,606,597,61,3978,26,1199,32,26
"143","2020-05-02",282,2,249,703,5585,0.704565801253357,2025,7498,606,597,59,4037,14,1213,27,14
"144","2020-05-03",267,2,218,678,5585,0.704565801253357,2025,7498,606,597,53,4090,14,1227,28,14
"145","2020-05-04",265,2,192,636,5585,0.704565801253357,2025,7498,606,597,60,4150,18,1245,36,18
"146","2020-05-05",249,2,152,607,5585,0.704565801253357,2025,7498,606,597,55,4205,32,1277,28,32
"147","2020-05-06",231,2,132,582,5585,0.704565801253357,2025,7498,606,597,47,4252,52,1329,20,52
"148","2020-05-07",220,2,107,549,5585,0.704565801253357,2025,7498,606,597,59,4311,48,1377,30,48
"149","2020-05-08",211,2,107,540,5585,0.704565801253357,2025,7498,606,597,56,4367,49,1426,25,49
"150","2020-05-09",194,2,125,509,5585,0.704565801253357,2025,7498,606,597,59,4426,41,1467,31,41
"151","2020-05-10",181,2,118,480,5585,0.704565801253357,2025,7498,606,597,32,4458,36,1503,21,36
"152","2020-05-11",177,2,137,450,5585,0.704565801253357,2025,7498,606,597,49,4507,32,1535,23,32
"153","2020-05-12",167,2,129,430,5585,0.704565801253357,2025,7498,606,597,46,4553,37,1572,18,37
"154","2020-05-13",159,2,141,404,5585,0.704565801253357,2025,7498,606,597,54,4607,21,1593,21,21
"155","2020-05-14",157,2,158,392,5585,0.704565801253357,2025,7498,606,597,38,4645,37,1630,17,37
"156","2020-05-15",134,2,140,374,5585,0.704565801253357,2025,7498,606,597,36,4681,31,1661,18,31
"157","2020-05-16",129,2,111,354,5585,0.704565801253357,2025,7498,606,597,40,4721,35,1696,20,35
"158","2020-05-17",126,2,92,348,5585,0.704565801253357,2025,7498,606,597,27,4748,36,1732,14,36
"159","2020-05-18",122,2,97,337,5585,0.704565801253357,2025,7498,606,597,32,4780,35,1767,13,35
"160","2020-05-19",116,2,114,321,5585,0.704565801253357,2025,7498,606,597,23,4803,34,1801,10,34
"161","2020-05-20",116,2,107,317,5585,0.704565801253357,2025,7498,606,597,35,4838,34,1835,14,34
"162","2020-05-21",109,2,113,305,5585,0.704565801253357,2025,7498,606,597,27,4865,31,1866,16,31
"163","2020-05-22",111,2,120,282,5585,0.704565801253357,2025,7498,606,597,31,4896,34,1900,15,34
"164","2020-05-23",106,2,130,283,5585,0.704565801253357,2025,7498,606,597,17,4913,42,1942,5,42
"165","2020-05-24",98,2,127,275,5585,0.704565801253357,2025,7498,606,597,19,4932,34,1976,7,34
"166","2020-05-25",95,2,129,257,5585,0.704565801253357,2025,7498,606,597,27,4959,32,2008,7,32
"167","2020-05-26",97,2,124,251,5585,0.704565801253357,2025,7498,606,597,20,4979,39,2047,8,39
"168","2020-05-27",92,2,123,236,5585,0.704565801253357,2025,7498,606,597,22,5001,26,2073,10,26
"169","2020-05-28",89,2,125,218,5585,0.704565801253357,2025,7498,606,597,20,5021,27,2100,7,27
"170","2020-05-29",82,2,127,206,5585,0.704565801253357,2025,7498,606,597,18,5039,20,2120,7,20
"171","2020-05-30",79,2,124,206,5585,0.704565801253357,2025,7498,606,597,16,5055,27,2147,6,27
"172","2020-05-31",71,2,128,202,5585,0.704565801253357,2025,7498,606,597,15,5070,22,2169,2,22
"173","2020-06-01",66,2,108,195,5585,0.704565801253357,2025,7498,606,597,10,5080,15,2184,1,15
"174","2020-06-02",58,2,92,184,5585,0.704565801253357,2025,7498,606,597,14,5094,20,2204,3,20
"175","2020-06-03",55,2,85,180,5585,0.704565801253357,2025,7498,606,597,20,5114,21,2225,7,21
"176","2020-06-04",59,2,108,167,5585,0.704565801253357,2025,7498,606,597,14,5128,26,2251,2,26
"177","2020-06-05",53,2,107,161,5585,0.704565801253357,2025,7498,606,597,10,5138,20,2271,NA,20
"178","2020-06-06",50,2,114,153,5585,0.704565801253357,2025,7498,606,597,10,5148,15,2286,4,15
"179","2020-06-07",46,2,119,143,5585,0.704565801253357,2025,7498,606,597,13,5161,20,2306,7,20
"180","2020-03-07",1,3,0,0,6465,0.548491879350348,2025,8282,676,1553,NA,NA,NA,NA,NA,NA
"181","2020-03-08",1,3,0,0,6465,0.548491879350348,2025,8282,676,1553,NA,NA,NA,NA,NA,NA
"182","2020-03-09",0,3,0,0,6465,0.548491879350348,2025,8282,676,1553,NA,NA,NA,NA,NA,NA
"183","2020-03-10",0,3,0,0,6465,0.548491879350348,2025,8282,676,1553,NA,NA,NA,NA,NA,NA
"184","2020-03-11",1,3,55,35,6465,0.548491879350348,2025,8282,676,1553,13,13,11,11,3,11
"185","2020-03-12",1,3,111,74,6465,0.548491879350348,2025,8282,676,1553,9,22,9,20,3,9
"186","2020-03-13",4,3,133,120,6465,0.548491879350348,2025,8282,676,1553,24,46,11,31,11,11
"187","2020-03-14",10,3,167,173,6465,0.548491879350348,2025,8282,676,1553,17,63,8,39,9,8
"188","2020-03-15",15,3,184,227,6465,0.548491879350348,2025,8282,676,1553,29,92,7,46,22,7
"189","2020-03-16",22,3,215,301,6465,0.548491879350348,2025,8282,676,1553,48,140,6,52,33,6
"190","2020-03-17",32,3,259,388,6465,0.548491879350348,2025,8282,676,1553,37,177,6,58,27,6
"191","2020-03-18",47,3,262,454,6465,0.548491879350348,2025,8282,676,1553,50,227,5,63,39,5
"192","2020-03-19",61,3,241,546,6465,0.548491879350348,2025,8282,676,1553,70,297,16,79,51,16
"193","2020-03-20",85,3,250,598,6465,0.548491879350348,2025,8282,676,1553,47,344,15,94,33,15
"194","2020-03-21",129,3,254,670,6465,0.548491879350348,2025,8282,676,1553,81,425,18,112,73,18
"195","2020-03-22",165,3,257,749,6465,0.548491879350348,2025,8282,676,1553,77,502,29,141,61,29
"196","2020-03-23",175,3,233,844,6465,0.548491879350348,2025,8282,676,1553,83,585,18,159,74,18
"197","2020-03-24",200,3,232,899,6465,0.548491879350348,2025,8282,676,1553,94,679,14,173,85,14
"198","2020-03-25",214,3,248,976,6465,0.548491879350348,2025,8282,676,1553,91,770,30,203,77,30
"199","2020-03-26",242,3,254,1038,6465,0.548491879350348,2025,8282,676,1553,101,871,24,227,87,24
"200","2020-03-27",321,3,254,1123,6465,0.548491879350348,2025,8282,676,1553,112,983,18,245,96,18
"201","2020-03-28",359,3,229,1140,6465,0.548491879350348,2025,8282,676,1553,121,1104,32,277,113,32
"202","2020-03-29",356,3,216,1202,6465,0.548491879350348,2025,8282,676,1553,162,1266,35,312,147,35
"203","2020-03-30",367,3,223,1265,6465,0.548491879350348,2025,8282,676,1553,115,1381,57,369,105,57
"204","2020-03-31",366,3,244,1310,6465,0.548491879350348,2025,8282,676,1553,126,1507,41,410,118,41
"205","2020-04-01",385,3,282,1318,6465,0.548491879350348,2025,8282,676,1553,147,1654,56,466,138,56
"206","2020-04-02",407,3,273,1327,6465,0.548491879350348,2025,8282,676,1553,168,1822,32,498,160,32
"207","2020-04-03",483,3,265,1375,6465,0.548491879350348,2025,8282,676,1553,132,1954,41,539,122,41
"208","2020-04-04",515,3,261,1371,6465,0.548491879350348,2025,8282,676,1553,177,2131,42,581,165,42
"209","2020-04-05",491,3,260,1391,6465,0.548491879350348,2025,8282,676,1553,120,2251,30,611,105,30
"210","2020-04-06",469,3,268,1381,6465,0.548491879350348,2025,8282,676,1553,167,2418,19,630,156,19
"211","2020-04-07",463,3,281,1389,6465,0.548491879350348,2025,8282,676,1553,175,2593,23,653,164,23
"212","2020-04-08",469,3,268,1375,6465,0.548491879350348,2025,8282,676,1553,141,2734,18,671,133,18
"213","2020-04-09",451,3,279,1378,6465,0.548491879350348,2025,8282,676,1553,164,2898,21,692,151,21
"214","2020-04-10",465,3,260,1383,6465,0.548491879350348,2025,8282,676,1553,163,3061,15,707,142,15
"215","2020-04-11",448,3,281,1376,6465,0.548491879350348,2025,8282,676,1553,167,3228,48,755,152,48
"216","2020-04-12",445,3,287,1368,6465,0.548491879350348,2025,8282,676,1553,147,3375,56,811,141,56
"217","2020-04-13",444,3,294,1354,6465,0.548491879350348,2025,8282,676,1553,92,3467,52,863,84,52
"218","2020-04-14",445,3,288,1365,6465,0.548491879350348,2025,8282,676,1553,125,3592,45,908,119,45
"219","2020-04-15",432,3,282,1355,6465,0.548491879350348,2025,8282,676,1553,146,3738,39,947,139,39
"220","2020-04-16",431,3,281,1301,6465,0.548491879350348,2025,8282,676,1553,156,3894,32,979,146,32
"221","2020-04-17",438,3,274,1276,6465,0.548491879350348,2025,8282,676,1553,127,4021,49,1028,118,49
"222","2020-04-18",425,3,236,1261,6465,0.548491879350348,2025,8282,676,1553,102,4123,51,1079,93,51
"223","2020-04-19",418,3,207,1225,6465,0.548491879350348,2025,8282,676,1553,126,4249,35,1114,115,35
"224","2020-04-20",414,3,202,1216,6465,0.548491879350348,2025,8282,676,1553,71,4320,35,1149,69,35
"225","2020-04-21",399,3,200,1181,6465,0.548491879350348,2025,8282,676,1553,85,4405,34,1183,74,34
"226","2020-04-22",394,3,233,1116,6465,0.548491879350348,2025,8282,676,1553,96,4501,29,1212,91,29
"227","2020-04-23",387,3,235,1096,6465,0.548491879350348,2025,8282,676,1553,84,4585,28,1240,78,28
"228","2020-04-24",415,3,249,1060,6465,0.548491879350348,2025,8282,676,1553,87,4672,27,1267,77,27
"229","2020-04-25",396,3,262,1027,6465,0.548491879350348,2025,8282,676,1553,63,4735,18,1285,54,18
"230","2020-04-26",363,3,270,981,6465,0.548491879350348,2025,8282,676,1553,64,4799,13,1298,57,13
"231","2020-04-27",349,3,273,932,6465,0.548491879350348,2025,8282,676,1553,66,4865,45,1343,62,45
"232","2020-04-28",340,3,271,878,6465,0.548491879350348,2025,8282,676,1553,70,4935,38,1381,57,38
"233","2020-04-29",344,3,271,871,6465,0.548491879350348,2025,8282,676,1553,81,5016,56,1437,67,56
"234","2020-04-30",343,3,297,835,6465,0.548491879350348,2025,8282,676,1553,59,5075,36,1473,54,36
"235","2020-05-01",308,3,287,818,6465,0.548491879350348,2025,8282,676,1553,39,5114,36,1509,33,36
"236","2020-05-02",333,3,302,789,6465,0.548491879350348,2025,8282,676,1553,52,5166,29,1538,43,29
"237","2020-05-03",300,3,296,764,6465,0.548491879350348,2025,8282,676,1553,42,5208,24,1562,36,24
"238","2020-05-04",285,3,302,731,6465,0.548491879350348,2025,8282,676,1553,38,5246,20,1582,32,20
"239","2020-05-05",269,3,291,688,6465,0.548491879350348,2025,8282,676,1553,42,5288,25,1607,37,25
"240","2020-05-06",258,3,281,653,6465,0.548491879350348,2025,8282,676,1553,52,5340,54,1661,46,54
"241","2020-05-07",246,3,291,640,6465,0.548491879350348,2025,8282,676,1553,30,5370,40,1701,23,40
"242","2020-05-08",239,3,280,596,6465,0.548491879350348,2025,8282,676,1553,38,5408,23,1724,37,23
"243","2020-05-09",225,3,282,576,6465,0.548491879350348,2025,8282,676,1553,30,5438,17,1741,22,17
"244","2020-05-10",209,3,303,541,6465,0.548491879350348,2025,8282,676,1553,24,5462,22,1763,18,22
"245","2020-05-11",207,3,348,521,6465,0.548491879350348,2025,8282,676,1553,26,5488,35,1798,20,35
"246","2020-05-12",201,3,374,511,6465,0.548491879350348,2025,8282,676,1553,33,5521,25,1823,25,25
"247","2020-05-13",187,3,365,478,6465,0.548491879350348,2025,8282,676,1553,26,5547,38,1861,23,38
"248","2020-05-14",178,3,335,452,6465,0.548491879350348,2025,8282,676,1553,25,5572,33,1894,21,33
"249","2020-05-15",171,3,346,430,6465,0.548491879350348,2025,8282,676,1553,22,5594,23,1917,17,23
"250","2020-05-16",145,3,339,407,6465,0.548491879350348,2025,8282,676,1553,24,5618,16,1933,19,16
"251","2020-05-17",143,3,339,379,6465,0.548491879350348,2025,8282,676,1553,27,5645,21,1954,23,21
"252","2020-05-18",139,3,336,363,6465,0.548491879350348,2025,8282,676,1553,19,5664,47,2001,9,47
"253","2020-05-19",131,3,315,333,6465,0.548491879350348,2025,8282,676,1553,11,5675,45,2046,9,45
"254","2020-05-20",128,3,320,315,6465,0.548491879350348,2025,8282,676,1553,18,5693,29,2075,16,29
"255","2020-05-21",119,3,340,299,6465,0.548491879350348,2025,8282,676,1553,23,5716,32,2107,18,32
"256","2020-05-22",114,3,327,289,6465,0.548491879350348,2025,8282,676,1553,15,5731,26,2133,10,26
"257","2020-05-23",129,3,327,273,6465,0.548491879350348,2025,8282,676,1553,15,5746,18,2151,11,18
"258","2020-05-24",102,3,309,257,6465,0.548491879350348,2025,8282,676,1553,10,5756,33,2184,9,33
"259","2020-05-25",94,3,308,261,6465,0.548491879350348,2025,8282,676,1553,15,5771,52,2236,13,52
"260","2020-05-26",91,3,299,253,6465,0.548491879350348,2025,8282,676,1553,16,5787,34,2270,15,34
"261","2020-05-27",90,3,270,236,6465,0.548491879350348,2025,8282,676,1553,15,5802,23,2293,13,23
"262","2020-05-28",94,3,263,226,6465,0.548491879350348,2025,8282,676,1553,20,5822,43,2336,19,43
"263","2020-05-29",86,3,253,218,6465,0.548491879350348,2025,8282,676,1553,13,5835,25,2361,10,25
"264","2020-05-30",85,3,257,208,6465,0.548491879350348,2025,8282,676,1553,16,5851,19,2380,12,19
"265","2020-05-31",78,3,257,211,6465,0.548491879350348,2025,8282,676,1553,19,5870,20,2400,14,20
"266","2020-06-01",76,3,270,198,6465,0.548491879350348,2025,8282,676,1553,12,5882,19,2419,8,19
"267","2020-06-02",73,3,290,184,6465,0.548491879350348,2025,8282,676,1553,14,5896,18,2437,10,18
"268","2020-06-03",69,3,287,173,6465,0.548491879350348,2025,8282,676,1553,10,5906,34,2471,7,34
"269","2020-06-04",62,3,294,170,6465,0.548491879350348,2025,8282,676,1553,9,5915,30,2501,5,30
"270","2020-06-05",68,3,290,169,6465,0.548491879350348,2025,8282,676,1553,6,5921,32,2533,5,32
"271","2020-06-06",66,3,303,155,6465,0.548491879350348,2025,8282,676,1553,12,5933,21,2554,9,21
"272","2020-06-07",62,3,329,150,6465,0.548491879350348,2025,8282,676,1553,9,5942,27,2581,7,27
"273","2020-03-13",2,4,37,62,5229,0.724230254350736,1935,6976,529,689,56,164,45,82,14,45
"274","2020-03-14",5,4,61,88,5229,0.724230254350736,1935,6976,529,689,76,240,25,107,29,25
"275","2020-03-15",10,4,76,120,5229,0.724230254350736,1935,6976,529,689,73,313,56,163,34,56
"276","2020-03-16",15,4,95,143,5229,0.724230254350736,1935,6976,529,689,81,394,54,217,51,54
"277","2020-03-17",19,4,119,187,5229,0.724230254350736,1935,6976,529,689,84,478,34,251,52,34
"278","2020-03-18",26,4,119,217,5229,0.724230254350736,1935,6976,529,689,100,578,53,304,51,53
"279","2020-03-19",35,4,117,258,5229,0.724230254350736,1935,6976,529,689,87,665,73,377,51,73
"280","2020-03-20",51,4,110,306,5229,0.724230254350736,1935,6976,529,689,79,744,37,414,46,37
"281","2020-03-21",75,4,103,338,5229,0.724230254350736,1935,6976,529,689,96,840,67,481,63,67
"282","2020-03-22",90,4,103,387,5229,0.724230254350736,1935,6976,529,689,94,934,32,513,57,32
"283","2020-03-23",91,4,93,433,5229,0.724230254350736,1935,6976,529,689,113,1047,31,544,77,31
"284","2020-03-24",102,4,100,457,5229,0.724230254350736,1935,6976,529,689,118,1165,14,558,76,14
"285","2020-03-25",111,4,120,501,5229,0.724230254350736,1935,6976,529,689,106,1271,10,568,64,10
"286","2020-03-26",129,4,150,551,5229,0.724230254350736,1935,6976,529,689,113,1384,13,581,68,13
"287","2020-03-27",164,4,155,602,5229,0.724230254350736,1935,6976,529,689,102,1486,26,607,56,26
"288","2020-03-28",191,4,150,647,5229,0.724230254350736,1935,6976,529,689,115,1601,43,650,72,43
"289","2020-03-29",180,4,133,712,5229,0.724230254350736,1935,6976,529,689,126,1727,53,703,81,53
"290","2020-03-30",181,4,151,733,5229,0.724230254350736,1935,6976,529,689,105,1832,20,723,62,20
"291","2020-03-31",184,4,175,771,5229,0.724230254350736,1935,6976,529,689,89,1921,17,740,49,17
"292","2020-04-01",204,4,146,814,5229,0.724230254350736,1935,6976,529,689,110,2031,12,752,66,12
"293","2020-04-02",203,4,130,844,5229,0.724230254350736,1935,6976,529,689,90,2121,15,767,57,15
"294","2020-04-03",263,4,106,874,5229,0.724230254350736,1935,6976,529,689,94,2215,75,842,60,75
"295","2020-04-04",260,4,116,918,5229,0.724230254350736,1935,6976,529,689,106,2321,36,878,65,36
"296","2020-04-05",258,4,147,969,5229,0.724230254350736,1935,6976,529,689,112,2433,43,921,70,43
"297","2020-04-06",277,4,152,1032,5229,0.724230254350736,1935,6976,529,689,100,2533,53,974,58,53
"298","2020-04-07",293,4,137,1059,5229,0.724230254350736,1935,6976,529,689,88,2621,68,1042,64,68
"299","2020-04-08",282,4,128,1087,5229,0.724230254350736,1935,6976,529,689,107,2728,32,1074,68,32
"300","2020-04-09",288,4,108,1131,5229,0.724230254350736,1935,6976,529,689,80,2808,62,1136,39,62
"301","2020-04-10",324,4,106,1164,5229,0.724230254350736,1935,6976,529,689,100,2908,61,1197,66,61
"302","2020-04-11",380,4,99,1194,5229,0.724230254350736,1935,6976,529,689,81,2989,57,1254,52,57
"303","2020-04-12",398,4,111,1208,5229,0.724230254350736,1935,6976,529,689,86,3075,22,1276,40,22
"304","2020-04-13",379,4,134,1195,5229,0.724230254350736,1935,6976,529,689,84,3159,29,1305,42,29
"305","2020-04-14",375,4,124,1206,5229,0.724230254350736,1935,6976,529,689,98,3257,21,1326,57,21
"306","2020-04-15",386,4,122,1201,5229,0.724230254350736,1935,6976,529,689,100,3357,7,1333,53,7
"307","2020-04-16",398,4,141,1208,5229,0.724230254350736,1935,6976,529,689,73,3430,10,1343,45,10
"308","2020-04-17",457,4,133,1201,5229,0.724230254350736,1935,6976,529,689,88,3518,29,1372,51,29
"309","2020-04-18",425,4,122,1206,5229,0.724230254350736,1935,6976,529,689,85,3603,48,1420,55,48
"310","2020-04-19",385,4,140,1174,5229,0.724230254350736,1935,6976,529,689,93,3696,26,1446,42,26
"311","2020-04-20",386,4,150,1155,5229,0.724230254350736,1935,6976,529,689,80,3776,71,1517,39,71
"312","2020-04-21",381,4,160,1146,5229,0.724230254350736,1935,6976,529,689,69,3845,40,1557,29,40
"313","2020-04-22",380,4,156,1099,5229,0.724230254350736,1935,6976,529,689,78,3923,27,1584,39,27
"314","2020-04-23",377,4,187,1065,5229,0.724230254350736,1935,6976,529,689,74,3997,24,1608,44,24
"315","2020-04-24",340,4,173,1015,5229,0.724230254350736,1935,6976,529,689,64,4061,22,1630,34,22
"316","2020-04-25",344,4,178,996,5229,0.724230254350736,1935,6976,529,689,73,4134,30,1660,40,30
"317","2020-04-26",327,4,204,966,5229,0.724230254350736,1935,6976,529,689,58,4192,75,1735,31,75
"318","2020-04-27",321,4,183,928,5229,0.724230254350736,1935,6976,529,689,64,4256,66,1801,27,66
"319","2020-04-28",306,4,171,900,5229,0.724230254350736,1935,6976,529,689,55,4311,18,1819,32,18
"320","2020-04-29",307,4,167,854,5229,0.724230254350736,1935,6976,529,689,58,4369,36,1855,32,36
"321","2020-04-30",292,4,167,813,5229,0.724230254350736,1935,6976,529,689,54,4423,32,1887,20,32
"322","2020-05-01",296,4,161,766,5229,0.724230254350736,1935,6976,529,689,40,4463,24,1911,22,24
"323","2020-05-02",268,4,148,759,5229,0.724230254350736,1935,6976,529,689,45,4508,19,1930,25,19
"324","2020-05-03",263,4,127,715,5229,0.724230254350736,1935,6976,529,689,61,4569,13,1943,27,13
"325","2020-05-04",252,4,121,667,5229,0.724230254350736,1935,6976,529,689,57,4626,28,1971,26,28
"326","2020-05-05",245,4,150,608,5229,0.724230254350736,1935,6976,529,689,57,4683,47,2018,34,47
"327","2020-05-06",234,4,159,579,5229,0.724230254350736,1935,6976,529,689,49,4732,16,2034,31,16
"328","2020-05-07",230,4,157,558,5229,0.724230254350736,1935,6976,529,689,44,4776,17,2051,23,17
"329","2020-05-08",218,4,144,530,5229,0.724230254350736,1935,6976,529,689,51,4827,39,2090,30,39
"330","2020-05-09",224,4,134,509,5229,0.724230254350736,1935,6976,529,689,48,4875,24,2114,21,24
"331","2020-05-10",202,4,156,486,5229,0.724230254350736,1935,6976,529,689,59,4934,30,2144,28,30
"332","2020-05-11",193,4,148,454,5229,0.724230254350736,1935,6976,529,689,48,4982,51,2195,19,51
"333","2020-05-12",175,4,167,424,5229,0.724230254350736,1935,6976,529,689,46,5028,34,2229,20,34
"334","2020-05-13",168,4,154,421,5229,0.724230254350736,1935,6976,529,689,62,5090,23,2252,29,23
"335","2020-05-14",159,4,141,404,5229,0.724230254350736,1935,6976,529,689,47,5137,14,2266,20,14
"336","2020-05-15",145,4,152,395,5229,0.724230254350736,1935,6976,529,689,35,5172,17,2283,15,17
"337","2020-05-16",146,4,154,378,5229,0.724230254350736,1935,6976,529,689,41,5213,9,2292,18,9
"338","2020-05-17",123,4,147,370,5229,0.724230254350736,1935,6976,529,689,38,5251,18,2310,23,18
"339","2020-05-18",112,4,152,363,5229,0.724230254350736,1935,6976,529,689,32,5283,98,2408,13,98
"340","2020-05-19",102,4,198,343,5229,0.724230254350736,1935,6976,529,689,31,5314,77,2485,20,77
"341","2020-05-20",102,4,207,343,5229,0.724230254350736,1935,6976,529,689,43,5357,85,2570,18,85
"342","2020-05-21",100,4,183,338,5229,0.724230254350736,1935,6976,529,689,41,5398,76,2646,28,76
"343","2020-05-22",107,4,149,328,5229,0.724230254350736,1935,6976,529,689,31,5429,46,2692,14,46
"344","2020-05-23",105,4,155,311,5229,0.724230254350736,1935,6976,529,689,34,5463,36,2728,20,36
"345","2020-05-24",105,4,146,292,5229,0.724230254350736,1935,6976,529,689,37,5500,77,2805,19,77
"346","2020-05-25",108,4,157,283,5229,0.724230254350736,1935,6976,529,689,38,5538,54,2859,24,54
"347","2020-05-26",113,4,171,277,5229,0.724230254350736,1935,6976,529,689,22,5560,68,2927,17,68
"348","2020-05-27",104,4,187,271,5229,0.724230254350736,1935,6976,529,689,24,5584,43,2970,15,43
"349","2020-05-28",101,4,177,262,5229,0.724230254350736,1935,6976,529,689,34,5618,25,2995,22,25
"350","2020-05-29",93,4,154,260,5229,0.724230254350736,1935,6976,529,689,15,5633,60,3055,7,60
"351","2020-05-30",84,4,131,248,5229,0.724230254350736,1935,6976,529,689,30,5663,50,3105,15,50
"352","2020-05-31",80,4,134,232,5229,0.724230254350736,1935,6976,529,689,23,5686,33,3138,9,33
"353","2020-06-01",85,4,121,217,5229,0.724230254350736,1935,6976,529,689,18,5704,53,3191,9,53
"354","2020-06-02",79,4,113,209,5229,0.724230254350736,1935,6976,529,689,20,5724,26,3217,9,26
"355","2020-06-03",76,4,107,203,5229,0.724230254350736,1935,6976,529,689,24,5748,56,3273,11,56
"356","2020-06-04",79,4,120,198,5229,0.724230254350736,1935,6976,529,689,16,5764,31,3304,8,31
"357","2020-06-05",79,4,148,195,5229,0.724230254350736,1935,6976,529,689,17,5781,23,3327,7,23
"358","2020-06-06",84,4,157,179,5229,0.724230254350736,1935,6976,529,689,23,5804,19,3346,9,19
"359","2020-06-07",80,4,148,177,5229,0.724230254350736,1935,6976,529,689,13,5817,21,3367,4,21
"360","2020-03-13",2,5,28,73,5325,0.622535211267606,2115,7855,482,486,13,37,35,68,4,35
"361","2020-03-14",6,5,29,98,5325,0.622535211267606,2115,7855,482,486,12,49,18,86,2,18
"362","2020-03-15",13,5,32,124,5325,0.622535211267606,2115,7855,482,486,27,76,14,100,12,14
"363","2020-03-16",18,5,37,168,5325,0.622535211267606,2115,7855,482,486,32,108,9,109,16,9
"364","2020-03-17",24,5,39,214,5325,0.622535211267606,2115,7855,482,486,30,138,17,126,19,17
"365","2020-03-18",29,5,40,268,5325,0.622535211267606,2115,7855,482,486,32,170,20,146,19,20
"366","2020-03-19",42,5,62,327,5325,0.622535211267606,2115,7855,482,486,43,213,19,165,34,19
"367","2020-03-20",62,5,76,374,5325,0.622535211267606,2115,7855,482,486,42,255,41,206,23,41
"368","2020-03-21",96,5,97,435,5325,0.622535211267606,2115,7855,482,486,48,303,39,245,38,39
"369","2020-03-22",102,5,113,471,5325,0.622535211267606,2115,7855,482,486,51,354,45,290,45,45
"370","2020-03-23",102,5,110,536,5325,0.622535211267606,2115,7855,482,486,64,418,25,315,53,25
"371","2020-03-24",109,5,104,595,5325,0.622535211267606,2115,7855,482,486,64,482,32,347,51,32
"372","2020-03-25",128,5,107,658,5325,0.622535211267606,2115,7855,482,486,87,569,34,381,75,34
"373","2020-03-26",131,5,91,687,5325,0.622535211267606,2115,7855,482,486,76,645,41,422,66,41
"374","2020-03-27",193,5,86,736,5325,0.622535211267606,2115,7855,482,486,86,731,25,447,77,25
"375","2020-03-28",229,5,93,769,5325,0.622535211267606,2115,7855,482,486,87,818,18,465,79,18
"376","2020-03-29",223,5,106,831,5325,0.622535211267606,2115,7855,482,486,110,928,18,483,93,18
"377","2020-03-30",228,5,116,874,5325,0.622535211267606,2115,7855,482,486,109,1037,14,497,97,14
"378","2020-03-31",238,5,112,899,5325,0.622535211267606,2115,7855,482,486,159,1196,31,528,143,31
"379","2020-04-01",241,5,100,917,5325,0.622535211267606,2115,7855,482,486,139,1335,38,566,122,38
"380","2020-04-02",264,5,92,948,5325,0.622535211267606,2115,7855,482,486,129,1464,44,610,118,44
"381","2020-04-03",289,5,87,981,5325,0.622535211267606,2115,7855,482,486,158,1622,23,633,144,23
"382","2020-04-04",319,5,71,1000,5325,0.622535211267606,2115,7855,482,486,145,1767,27,660,137,27
"383","2020-04-05",321,5,70,1050,5325,0.622535211267606,2115,7855,482,486,158,1925,30,690,146,30
"384","2020-04-06",325,5,78,1046,5325,0.622535211267606,2115,7855,482,486,150,2075,36,726,141,36
"385","2020-04-07",334,5,79,1047,5325,0.622535211267606,2115,7855,482,486,174,2249,26,752,153,26
"386","2020-04-08",351,5,87,1041,5325,0.622535211267606,2115,7855,482,486,146,2395,38,790,123,38
"387","2020-04-09",346,5,105,1077,5325,0.622535211267606,2115,7855,482,486,171,2566,45,835,154,45
"388","2020-04-10",417,5,113,1106,5325,0.622535211267606,2115,7855,482,486,201,2767,51,886,188,51
"389","2020-04-11",402,5,116,1096,5325,0.622535211267606,2115,7855,482,486,175,2942,44,930,158,44
"390","2020-04-12",388,5,109,1092,5325,0.622535211267606,2115,7855,482,486,184,3126,27,957,173,27
"391","2020-04-13",380,5,113,1096,5325,0.622535211267606,2115,7855,482,486,147,3273,22,979,137,22
"392","2020-04-14",361,5,104,1122,5325,0.622535211267606,2115,7855,482,486,138,3411,35,1014,126,35
"393","2020-04-15",365,5,115,1097,5325,0.622535211267606,2115,7855,482,486,164,3575,33,1047,153,33
"394","2020-04-16",366,5,128,1079,5325,0.622535211267606,2115,7855,482,486,130,3705,21,1068,114,21
"395","2020-04-17",400,5,122,1098,5325,0.622535211267606,2115,7855,482,486,144,3849,31,1099,134,31
"396","2020-04-18",411,5,131,1073,5325,0.622535211267606,2115,7855,482,486,129,3978,35,1134,114,35
"397","2020-04-19",390,5,128,1071,5325,0.622535211267606,2115,7855,482,486,138,4116,29,1163,127,29
"398","2020-04-20",382,5,150,1054,5325,0.622535211267606,2115,7855,482,486,117,4233,36,1199,109,36
"399","2020-04-21",388,5,152,1033,5325,0.622535211267606,2115,7855,482,486,153,4386,27,1226,142,27
"400","2020-04-22",368,5,169,1002,5325,0.622535211267606,2115,7855,482,486,112,4498,33,1259,104,33
"401","2020-04-23",373,5,166,979,5325,0.622535211267606,2115,7855,482,486,103,4601,53,1312,94,53
"402","2020-04-24",349,5,178,925,5325,0.622535211267606,2115,7855,482,486,93,4694,24,1336,87,24
"403","2020-04-25",346,5,184,860,5325,0.622535211267606,2115,7855,482,486,85,4779,36,1372,78,36
"404","2020-04-26",316,5,168,839,5325,0.622535211267606,2115,7855,482,486,84,4863,25,1397,76,25
"405","2020-04-27",292,5,176,814,5325,0.622535211267606,2115,7855,482,486,83,4946,43,1440,75,43
"406","2020-04-28",283,5,163,773,5325,0.622535211267606,2115,7855,482,486,56,5002,21,1461,48,21
"407","2020-04-29",286,5,162,747,5325,0.622535211267606,2115,7855,482,486,62,5064,45,1506,52,45
"408","2020-04-30",278,5,151,736,5325,0.622535211267606,2115,7855,482,486,58,5122,32,1538,47,32
"409","2020-05-01",287,5,141,735,5325,0.622535211267606,2115,7855,482,486,47,5169,34,1572,33,34
"410","2020-05-02",259,5,150,725,5325,0.622535211267606,2115,7855,482,486,48,5217,46,1618,42,46
"411","2020-05-03",239,5,177,697,5325,0.622535211267606,2115,7855,482,486,57,5274,56,1674,48,56
"412","2020-05-04",232,5,185,677,5325,0.622535211267606,2115,7855,482,486,45,5319,33,1707,38,33
"413","2020-05-05",224,5,171,644,5325,0.622535211267606,2115,7855,482,486,49,5368,23,1730,40,23
"414","2020-05-06",212,5,150,632,5325,0.622535211267606,2115,7855,482,486,39,5407,26,1756,27,26
"415","2020-05-07",203,5,141,613,5325,0.622535211267606,2115,7855,482,486,51,5458,56,1812,39,56
"416","2020-05-08",187,5,148,603,5325,0.622535211267606,2115,7855,482,486,33,5491,74,1886,31,74
"417","2020-05-09",202,5,138,593,5325,0.622535211267606,2115,7855,482,486,30,5521,53,1939,25,53
"418","2020-05-10",192,5,151,577,5325,0.622535211267606,2115,7855,482,486,21,5542,51,1990,19,51
"419","2020-05-11",190,5,131,562,5325,0.622535211267606,2115,7855,482,486,21,5563,34,2024,13,34
"420","2020-05-12",186,5,137,530,5325,0.622535211267606,2115,7855,482,486,23,5586,49,2073,20,49
"421","2020-05-13",182,5,133,511,5325,0.622535211267606,2115,7855,482,486,23,5609,48,2121,19,48
"422","2020-05-14",183,5,122,502,5325,0.622535211267606,2115,7855,482,486,21,5630,34,2155,14,34
"423","2020-05-15",204,5,109,487,5325,0.622535211267606,2115,7855,482,486,14,5644,48,2203,11,48
"424","2020-05-16",201,5,98,454,5325,0.622535211267606,2115,7855,482,486,22,5666,32,2235,18,32
"425","2020-05-17",183,5,114,436,5325,0.622535211267606,2115,7855,482,486,25,5691,25,2260,20,25
"426","2020-05-18",174,5,131,423,5325,0.622535211267606,2115,7855,482,486,20,5711,32,2292,15,32
"427","2020-05-19",162,5,143,407,5325,0.622535211267606,2115,7855,482,486,22,5733,29,2321,16,29
"428","2020-05-20",160,5,141,392,5325,0.622535211267606,2115,7855,482,486,18,5751,33,2354,12,33
"429","2020-05-21",153,5,143,392,5325,0.622535211267606,2115,7855,482,486,16,5767,22,2376,13,22
"430","2020-05-22",135,5,157,362,5325,0.622535211267606,2115,7855,482,486,12,5779,20,2396,8,20
"431","2020-05-23",130,5,150,361,5325,0.622535211267606,2115,7855,482,486,11,5790,19,2415,8,19
"432","2020-05-24",119,5,175,350,5325,0.622535211267606,2115,7855,482,486,13,5803,35,2450,10,35
"433","2020-05-25",118,5,162,326,5325,0.622535211267606,2115,7855,482,486,15,5818,42,2492,11,42
"434","2020-05-26",110,5,161,311,5325,0.622535211267606,2115,7855,482,486,9,5827,33,2525,6,33
"435","2020-05-27",106,5,157,280,5325,0.622535211267606,2115,7855,482,486,9,5836,51,2576,7,51
"436","2020-05-28",108,5,145,289,5325,0.622535211267606,2115,7855,482,486,12,5848,37,2613,10,37
"437","2020-05-29",99,5,136,292,5325,0.622535211267606,2115,7855,482,486,10,5858,22,2635,3,22
"438","2020-05-30",97,5,138,261,5325,0.622535211267606,2115,7855,482,486,14,5872,29,2664,7,29
"439","2020-05-31",89,5,132,244,5325,0.622535211267606,2115,7855,482,486,6,5878,24,2688,5,24
"440","2020-06-01",85,5,109,248,5325,0.622535211267606,2115,7855,482,486,8,5886,21,2709,8,21
"441","2020-06-02",83,5,102,237,5325,0.622535211267606,2115,7855,482,486,8,5894,20,2729,3,20
"442","2020-06-03",80,5,99,218,5325,0.622535211267606,2115,7855,482,486,3,5897,24,2753,2,24
"443","2020-06-04",68,5,96,208,5325,0.622535211267606,2115,7855,482,486,7,5904,26,2779,3,26
"444","2020-06-05",69,5,94,190,5325,0.622535211267606,2115,7855,482,486,12,5916,42,2821,9,42
"445","2020-06-06",70,5,86,174,5325,0.622535211267606,2115,7855,482,486,5,5921,30,2851,2,30
"446","2020-06-07",66,5,87,169,5325,0.622535211267606,2115,7855,482,486,4,5925,38,2889,2,38
"447","2020-03-12",1,6,32,46,5411,0.710404731103308,2055,7531,590,1172,20,45,11,14,2,11
"448","2020-03-13",5,6,49,66,5411,0.710404731103308,2055,7531,590,1172,25,70,2,16,2,2
"449","2020-03-14",6,6,74,93,5411,0.710404731103308,2055,7531,590,1172,29,99,7,23,6,7
"450","2020-03-15",11,6,85,134,5411,0.710404731103308,2055,7531,590,1172,49,148,18,41,24,18
"451","2020-03-16",14,6,83,179,5411,0.710404731103308,2055,7531,590,1172,39,187,37,78,23,37
"452","2020-03-17",18,6,102,221,5411,0.710404731103308,2055,7531,590,1172,43,230,29,107,25,29
"453","2020-03-18",25,6,111,270,5411,0.710404731103308,2055,7531,590,1172,47,277,18,125,28,18
"454","2020-03-19",35,6,102,326,5411,0.710404731103308,2055,7531,590,1172,59,336,18,143,34,18
"455","2020-03-20",56,6,83,381,5411,0.710404731103308,2055,7531,590,1172,64,400,6,149,40,6
"456","2020-03-21",100,6,92,439,5411,0.710404731103308,2055,7531,590,1172,67,467,12,161,37,12
"457","2020-03-22",114,6,106,482,5411,0.710404731103308,2055,7531,590,1172,54,521,5,166,41,5
"458","2020-03-23",122,6,142,520,5411,0.710404731103308,2055,7531,590,1172,77,598,7,173,54,7
"459","2020-03-24",128,6,144,565,5411,0.710404731103308,2055,7531,590,1172,64,662,8,181,41,8
"460","2020-03-25",144,6,130,620,5411,0.710404731103308,2055,7531,590,1172,74,736,31,212,53,31
"461","2020-03-26",165,6,168,641,5411,0.710404731103308,2055,7531,590,1172,86,822,27,239,51,27
"462","2020-03-27",201,6,176,691,5411,0.710404731103308,2055,7531,590,1172,92,914,40,279,60,40
"463","2020-03-28",237,6,166,731,5411,0.710404731103308,2055,7531,590,1172,109,1023,17,296,76,17
"464","2020-03-29",232,6,141,794,5411,0.710404731103308,2055,7531,590,1172,107,1130,20,316,70,20
"465","2020-03-30",226,6,133,821,5411,0.710404731103308,2055,7531,590,1172,105,1235,45,361,78,45
"466","2020-03-31",242,6,125,856,5411,0.710404731103308,2055,7531,590,1172,91,1326,19,380,64,19
"467","2020-04-01",256,6,125,890,5411,0.710404731103308,2055,7531,590,1172,110,1436,18,398,89,18
"468","2020-04-02",261,6,99,921,5411,0.710404731103308,2055,7531,590,1172,126,1562,29,427,91,29
"469","2020-04-03",318,6,99,960,5411,0.710404731103308,2055,7531,590,1172,119,1681,17,444,88,17
"470","2020-04-04",297,6,86,977,5411,0.710404731103308,2055,7531,590,1172,132,1813,19,463,108,19
"471","2020-04-05",320,6,79,1004,5411,0.710404731103308,2055,7531,590,1172,108,1921,17,480,75,17
"472","2020-04-06",328,6,92,1011,5411,0.710404731103308,2055,7531,590,1172,129,2050,43,523,102,43
"473","2020-04-07",319,6,153,1009,5411,0.710404731103308,2055,7531,590,1172,142,2192,46,569,118,46
"474","2020-04-08",327,6,197,1027,5411,0.710404731103308,2055,7531,590,1172,127,2319,32,601,99,32
"475","2020-04-09",321,6,202,1033,5411,0.710404731103308,2055,7531,590,1172,99,2418,18,619,72,18
"476","2020-04-10",348,6,213,1038,5411,0.710404731103308,2055,7531,590,1172,138,2556,32,651,108,32
"477","2020-04-11",357,6,198,1048,5411,0.710404731103308,2055,7531,590,1172,136,2692,30,681,94,30
"478","2020-04-12",342,6,193,1027,5411,0.710404731103308,2055,7531,590,1172,85,2777,30,711,68,30
"479","2020-04-13",324,6,220,1050,5411,0.710404731103308,2055,7531,590,1172,131,2908,23,734,113,23
"480","2020-04-14",314,6,219,1042,5411,0.710404731103308,2055,7531,590,1172,94,3002,17,751,71,17
"481","2020-04-15",307,6,203,1043,5411,0.710404731103308,2055,7531,590,1172,111,3113,15,766,86,15
"482","2020-04-16",306,6,181,1045,5411,0.710404731103308,2055,7531,590,1172,122,3235,21,787,102,21
"483","2020-04-17",345,6,230,1014,5411,0.710404731103308,2055,7531,590,1172,98,3333,55,842,75,55
"484","2020-04-18",350,6,266,1006,5411,0.710404731103308,2055,7531,590,1172,107,3440,47,889,82,47
"485","2020-04-19",343,6,230,992,5411,0.710404731103308,2055,7531,590,1172,99,3539,60,949,72,60
"486","2020-04-20",354,6,202,958,5411,0.710404731103308,2055,7531,590,1172,98,3637,67,1016,84,67
"487","2020-04-21",351,6,189,956,5411,0.710404731103308,2055,7531,590,1172,94,3731,31,1047,77,31
"488","2020-04-22",345,6,178,948,5411,0.710404731103308,2055,7531,590,1172,76,3807,29,1076,51,29
"489","2020-04-23",344,6,176,931,5411,0.710404731103308,2055,7531,590,1172,77,3884,26,1102,55,26
"490","2020-04-24",329,6,162,909,5411,0.710404731103308,2055,7531,590,1172,92,3976,46,1148,64,46
"491","2020-04-25",316,6,186,884,5411,0.710404731103308,2055,7531,590,1172,78,4054,24,1172,57,24
"492","2020-04-26",296,6,217,872,5411,0.710404731103308,2055,7531,590,1172,62,4116,21,1193,44,21
"493","2020-04-27",290,6,216,877,5411,0.710404731103308,2055,7531,590,1172,73,4189,27,1220,48,27
"494","2020-04-28",282,6,249,858,5411,0.710404731103308,2055,7531,590,1172,59,4248,28,1248,43,28
"495","2020-04-29",283,6,260,803,5411,0.710404731103308,2055,7531,590,1172,59,4307,29,1277,44,29
"496","2020-04-30",283,6,236,788,5411,0.710404731103308,2055,7531,590,1172,61,4368,34,1311,42,34
"497","2020-05-01",263,6,222,778,5411,0.710404731103308,2055,7531,590,1172,65,4433,13,1324,43,13
"498","2020-05-02",269,6,216,763,5411,0.710404731103308,2055,7531,590,1172,44,4477,12,1336,28,12
"499","2020-05-03",264,6,265,737,5411,0.710404731103308,2055,7531,590,1172,51,4528,22,1358,33,22
"500","2020-05-04",258,6,298,726,5411,0.710404731103308,2055,7531,590,1172,52,4580,40,1398,35,40
"501","2020-05-05",253,6,266,750,5411,0.710404731103308,2055,7531,590,1172,43,4623,32,1430,26,32
"502","2020-05-06",242,6,262,736,5411,0.710404731103308,2055,7531,590,1172,47,4670,24,1454,32,24
"503","2020-05-07",239,6,218,737,5411,0.710404731103308,2055,7531,590,1172,39,4709,17,1471,17,17
"504","2020-05-08",251,6,194,723,5411,0.710404731103308,2055,7531,590,1172,39,4748,7,1478,26,7
"505","2020-05-09",266,6,159,713,5411,0.710404731103308,2055,7531,590,1172,41,4789,12,1490,23,12
"506","2020-05-10",255,6,133,695,5411,0.710404731103308,2055,7531,590,1172,53,4842,17,1507,41,17
"507","2020-05-11",246,6,114,684,5411,0.710404731103308,2055,7531,590,1172,30,4872,13,1520,18,13
"508","2020-05-12",234,6,100,654,5411,0.710404731103308,2055,7531,590,1172,37,4909,8,1528,23,8
"509","2020-05-13",236,6,96,631,5411,0.710404731103308,2055,7531,590,1172,33,4942,5,1533,21,5
"510","2020-05-14",232,6,106,588,5411,0.710404731103308,2055,7531,590,1172,32,4974,10,1543,20,10
"511","2020-05-15",237,6,148,568,5411,0.710404731103308,2055,7531,590,1172,27,5001,10,1553,18,10
"512","2020-05-16",223,6,149,546,5411,0.710404731103308,2055,7531,590,1172,27,5028,32,1585,15,32
"513","2020-05-17",204,6,148,505,5411,0.710404731103308,2055,7531,590,1172,17,5045,59,1644,8,59
"514","2020-05-18",194,6,149,470,5411,0.710404731103308,2055,7531,590,1172,32,5077,26,1670,17,26
"515","2020-05-19",188,6,142,445,5411,0.710404731103308,2055,7531,590,1172,25,5102,13,1683,13,13
"516","2020-05-20",181,6,129,435,5411,0.710404731103308,2055,7531,590,1172,24,5126,23,1706,13,23
"517","2020-05-21",181,6,114,408,5411,0.710404731103308,2055,7531,590,1172,21,5147,14,1720,10,14
"518","2020-05-22",167,6,108,362,5411,0.710404731103308,2055,7531,590,1172,25,5172,10,1730,16,10
"519","2020-05-23",159,6,105,335,5411,0.710404731103308,2055,7531,590,1172,23,5195,47,1777,11,47
"520","2020-05-24",144,6,141,312,5411,0.710404731103308,2055,7531,590,1172,13,5208,24,1801,8,24
"521","2020-05-25",138,6,135,294,5411,0.710404731103308,2055,7531,590,1172,26,5234,17,1818,13,17
"522","2020-05-26",125,6,166,288,5411,0.710404731103308,2055,7531,590,1172,26,5260,30,1848,14,30
"523","2020-05-27",116,6,190,279,5411,0.710404731103308,2055,7531,590,1172,22,5282,19,1867,14,19
"524","2020-05-28",99,6,217,273,5411,0.710404731103308,2055,7531,590,1172,11,5293,28,1895,6,28
"525","2020-05-29",90,6,204,264,5411,0.710404731103308,2055,7531,590,1172,10,5303,16,1911,5,16
"526","2020-05-30",101,6,194,246,5411,0.710404731103308,2055,7531,590,1172,9,5312,9,1920,4,9
"527","2020-05-31",86,6,189,251,5411,0.710404731103308,2055,7531,590,1172,15,5327,10,1930,7,10
"528","2020-06-01",79,6,167,240,5411,0.710404731103308,2055,7531,590,1172,13,5340,12,1942,7,12
"529","2020-06-02",81,6,157,230,5411,0.710404731103308,2055,7531,590,1172,17,5357,21,1963,7,21
"530","2020-06-03",77,6,176,218,5411,0.710404731103308,2055,7531,590,1172,16,5373,6,1969,10,6
"531","2020-06-04",78,6,157,223,5411,0.710404731103308,2055,7531,590,1172,9,5382,4,1973,4,4
"532","2020-06-05",87,6,161,222,5411,0.710404731103308,2055,7531,590,1172,7,5389,7,1980,4,7
"533","2020-06-06",75,6,145,213,5411,0.710404731103308,2055,7531,590,1172,12,5401,1,1981,7,1
"534","2020-06-07",77,6,154,199,5411,0.710404731103308,2055,7531,590,1172,7,5408,3,1984,2,3
"535","2020-03-13",6,7,23,141,5934,0.387933940006741,1965,7969,656,602,15,46,25,55,4,25
"536","2020-03-14",13,7,29,194,5934,0.387933940006741,1965,7969,656,602,26,72,22,77,8,22
"537","2020-03-15",21,7,30,266,5934,0.387933940006741,1965,7969,656,602,32,104,7,84,18,7
"538","2020-03-16",36,7,36,327,5934,0.387933940006741,1965,7969,656,602,33,137,17,101,19,17
"539","2020-03-17",43,7,37,385,5934,0.387933940006741,1965,7969,656,602,39,176,37,138,25,37
"540","2020-03-18",58,7,36,446,5934,0.387933940006741,1965,7969,656,602,43,219,48,186,32,48
"541","2020-03-19",78,7,43,514,5934,0.387933940006741,1965,7969,656,602,56,275,20,206,45,20
"542","2020-03-20",106,7,49,577,5934,0.387933940006741,1965,7969,656,602,64,339,41,247,48,41
"543","2020-03-21",174,7,55,645,5934,0.387933940006741,1965,7969,656,602,66,405,33,280,54,33
"544","2020-03-22",179,7,64,713,5934,0.387933940006741,1965,7969,656,602,74,479,49,329,61,49
"545","2020-03-23",171,7,69,745,5934,0.387933940006741,1965,7969,656,602,87,566,39,368,70,39
"546","2020-03-24",193,7,77,789,5934,0.387933940006741,1965,7969,656,602,114,680,48,416,105,48
"547","2020-03-25",206,7,87,820,5934,0.387933940006741,1965,7969,656,602,107,787,55,471,95,55
"548","2020-03-26",215,7,89,873,5934,0.387933940006741,1965,7969,656,602,94,881,58,529,85,58
"549","2020-03-27",271,7,87,886,5934,0.387933940006741,1965,7969,656,602,125,1006,50,579,114,50
"550","2020-03-28",268,7,100,925,5934,0.387933940006741,1965,7969,656,602,112,1118,22,601,99,22
"551","2020-03-29",288,7,94,947,5934,0.387933940006741,1965,7969,656,602,133,1251,18,619,115,18
"552","2020-03-30",292,7,112,980,5934,0.387933940006741,1965,7969,656,602,172,1423,14,633,154,14
"553","2020-03-31",287,7,102,1000,5934,0.387933940006741,1965,7969,656,602,121,1544,57,690,106,57
"554","2020-04-01",291,7,107,1011,5934,0.387933940006741,1965,7969,656,602,122,1666,14,704,117,14
"555","2020-04-02",307,7,105,1046,5934,0.387933940006741,1965,7969,656,602,146,1812,17,721,129,17
"556","2020-04-03",331,7,94,1053,5934,0.387933940006741,1965,7969,656,602,115,1927,9,730,101,9
"557","2020-04-04",311,7,100,1067,5934,0.387933940006741,1965,7969,656,602,172,2099,3,733,160,3
"558","2020-04-05",317,7,112,1052,5934,0.387933940006741,1965,7969,656,602,147,2246,16,749,131,16
"559","2020-04-06",318,7,98,1069,5934,0.387933940006741,1965,7969,656,602,168,2414,45,794,159,45
"560","2020-04-07",322,7,116,1084,5934,0.387933940006741,1965,7969,656,602,129,2543,28,822,113,28
"561","2020-04-08",328,7,130,1077,5934,0.387933940006741,1965,7969,656,602,126,2669,52,874,111,52
"562","2020-04-09",328,7,126,1064,5934,0.387933940006741,1965,7969,656,602,122,2791,35,909,110,35
"563","2020-04-10",374,7,117,1051,5934,0.387933940006741,1965,7969,656,602,179,2970,10,919,167,10
"564","2020-04-11",410,7,114,1037,5934,0.387933940006741,1965,7969,656,602,158,3128,10,929,140,10
"565","2020-04-12",371,7,132,1017,5934,0.387933940006741,1965,7969,656,602,127,3255,55,984,111,55
"566","2020-04-13",360,7,124,998,5934,0.387933940006741,1965,7969,656,602,141,3396,54,1038,133,54
"567","2020-04-14",351,7,124,1001,5934,0.387933940006741,1965,7969,656,602,151,3547,24,1062,138,24
"568","2020-04-15",347,7,115,991,5934,0.387933940006741,1965,7969,656,602,116,3663,15,1077,108,15
"569","2020-04-16",341,7,105,959,5934,0.387933940006741,1965,7969,656,602,128,3791,27,1104,117,27
"570","2020-04-17",334,7,99,959,5934,0.387933940006741,1965,7969,656,602,101,3892,35,1139,92,35
"571","2020-04-18",336,7,99,948,5934,0.387933940006741,1965,7969,656,602,97,3989,26,1165,89,26
"572","2020-04-19",310,7,112,968,5934,0.387933940006741,1965,7969,656,602,105,4094,21,1186,91,21
"573","2020-04-20",310,7,128,955,5934,0.387933940006741,1965,7969,656,602,88,4182,32,1218,75,32
"574","2020-04-21",296,7,126,949,5934,0.387933940006741,1965,7969,656,602,96,4278,20,1238,81,20
"575","2020-04-22",290,7,123,942,5934,0.387933940006741,1965,7969,656,602,80,4358,16,1254,69,16
"576","2020-04-23",280,7,156,936,5934,0.387933940006741,1965,7969,656,602,65,4423,58,1312,59,58
"577","2020-04-24",284,7,156,923,5934,0.387933940006741,1965,7969,656,602,73,4496,47,1359,63,47
"578","2020-04-25",304,7,162,929,5934,0.387933940006741,1965,7969,656,602,52,4548,20,1379,40,20
"579","2020-04-26",301,7,158,906,5934,0.387933940006741,1965,7969,656,602,51,4599,30,1409,39,30
"580","2020-04-27",286,7,147,884,5934,0.387933940006741,1965,7969,656,602,61,4660,31,1440,50,31
"581","2020-04-28",297,7,145,862,5934,0.387933940006741,1965,7969,656,602,58,4718,31,1471,53,31
"582","2020-04-29",303,7,138,868,5934,0.387933940006741,1965,7969,656,602,42,4760,35,1506,31,35
"583","2020-04-30",313,7,156,848,5934,0.387933940006741,1965,7969,656,602,53,4813,18,1524,42,18
"584","2020-05-01",317,7,151,830,5934,0.387933940006741,1965,7969,656,602,34,4847,16,1540,28,16
"585","2020-05-02",310,7,158,796,5934,0.387933940006741,1965,7969,656,602,36,4883,13,1553,28,13
"586","2020-05-03",294,7,161,791,5934,0.387933940006741,1965,7969,656,602,44,4927,8,1561,31,8
"587","2020-05-04",268,7,179,761,5934,0.387933940006741,1965,7969,656,602,31,4958,16,1577,23,16
"588","2020-05-05",264,7,183,742,5934,0.387933940006741,1965,7969,656,602,38,4996,18,1595,27,18
"589","2020-05-06",250,7,184,726,5934,0.387933940006741,1965,7969,656,602,26,5022,18,1613,18,18
"590","2020-05-07",238,7,183,710,5934,0.387933940006741,1965,7969,656,602,36,5058,14,1627,29,14
"591","2020-05-08",242,7,200,688,5934,0.387933940006741,1965,7969,656,602,29,5087,14,1641,24,14
"592","2020-05-09",228,7,193,667,5934,0.387933940006741,1965,7969,656,602,21,5108,43,1684,16,43
"593","2020-05-10",215,7,170,646,5934,0.387933940006741,1965,7969,656,602,33,5141,65,1749,28,65
"594","2020-05-11",224,7,161,640,5934,0.387933940006741,1965,7969,656,602,30,5171,34,1783,25,34
"595","2020-05-12",215,7,147,613,5934,0.387933940006741,1965,7969,656,602,29,5200,23,1806,19,23
"596","2020-05-13",209,7,166,600,5934,0.387933940006741,1965,7969,656,602,15,5215,11,1817,11,11
"597","2020-05-14",209,7,194,585,5934,0.387933940006741,1965,7969,656,602,13,5228,47,1864,9,47
"598","2020-05-15",208,7,173,548,5934,0.387933940006741,1965,7969,656,602,21,5249,32,1896,15,32
"599","2020-05-16",195,7,166,541,5934,0.387933940006741,1965,7969,656,602,14,5263,20,1916,8,20
"600","2020-05-17",181,7,148,526,5934,0.387933940006741,1965,7969,656,602,7,5270,40,1956,6,40
"601","2020-05-18",180,7,134,507,5934,0.387933940006741,1965,7969,656,602,19,5289,20,1976,9,20
"602","2020-05-19",169,7,124,484,5934,0.387933940006741,1965,7969,656,602,17,5306,21,1997,12,21
"603","2020-05-20",168,7,131,450,5934,0.387933940006741,1965,7969,656,602,15,5321,16,2013,11,16
"604","2020-05-21",166,7,141,452,5934,0.387933940006741,1965,7969,656,602,18,5339,28,2041,13,28
"605","2020-05-22",163,7,141,434,5934,0.387933940006741,1965,7969,656,602,10,5349,14,2055,8,14
"606","2020-05-23",165,7,148,410,5934,0.387933940006741,1965,7969,656,602,14,5363,26,2081,12,26
"607","2020-05-24",151,7,150,387,5934,0.387933940006741,1965,7969,656,602,6,5369,15,2096,3,15
"608","2020-05-25",142,7,149,372,5934,0.387933940006741,1965,7969,656,602,11,5380,8,2104,8,8
"609","2020-05-26",135,7,154,337,5934,0.387933940006741,1965,7969,656,602,13,5393,7,2111,10,7
"610","2020-05-27",132,7,162,327,5934,0.387933940006741,1965,7969,656,602,12,5405,14,2125,8,14
"611","2020-05-28",111,7,152,310,5934,0.387933940006741,1965,7969,656,602,8,5413,31,2156,4,31
"612","2020-05-29",102,7,148,301,5934,0.387933940006741,1965,7969,656,602,9,5422,66,2222,8,66
"613","2020-05-30",99,7,143,286,5934,0.387933940006741,1965,7969,656,602,8,5430,55,2277,6,55
"614","2020-05-31",86,7,150,275,5934,0.387933940006741,1965,7969,656,602,10,5440,41,2318,4,41
"615","2020-06-01",78,7,149,262,5934,0.387933940006741,1965,7969,656,602,10,5450,32,2350,4,32
"616","2020-06-02",71,7,140,262,5934,0.387933940006741,1965,7969,656,602,7,5457,13,2363,4,13
"617","2020-06-03",71,7,128,234,5934,0.387933940006741,1965,7969,656,602,12,5469,25,2388,8,25
"618","2020-06-04",74,7,115,232,5934,0.387933940006741,1965,7969,656,602,6,5475,19,2407,4,19
"619","2020-06-05",73,7,119,218,5934,0.387933940006741,1965,7969,656,602,1,5476,31,2438,NA,31
"620","2020-06-06",72,7,119,215,5934,0.387933940006741,1965,7969,656,602,7,5483,34,2472,5,34
"621","2020-06-07",69,7,110,211,5934,0.387933940006741,1965,7969,656,602,4,5487,35,2507,3,35
"622","2020-03-12",1,8,74,61,5850,0.591282051282051,2085,7832,571,1214,22,42,10,14,2,10
"623","2020-03-13",4,8,78,104,5850,0.591282051282051,2085,7832,571,1214,23,65,22,36,2,22
"624","2020-03-14",13,8,82,145,5850,0.591282051282051,2085,7832,571,1214,34,99,8,44,4,8
"625","2020-03-15",21,8,92,183,5850,0.591282051282051,2085,7832,571,1214,31,130,21,65,7,21
"626","2020-03-16",25,8,128,238,5850,0.591282051282051,2085,7832,571,1214,38,168,16,81,12,16
"627","2020-03-17",34,8,164,291,5850,0.591282051282051,2085,7832,571,1214,41,209,18,99,13,18
"628","2020-03-18",49,8,168,361,5850,0.591282051282051,2085,7832,571,1214,49,258,13,112,20,13
"629","2020-03-19",64,8,165,427,5850,0.591282051282051,2085,7832,571,1214,40,298,29,141,18,29
"630","2020-03-20",89,8,158,483,5850,0.591282051282051,2085,7832,571,1214,56,354,28,169,30,28
"631","2020-03-21",124,8,162,548,5850,0.591282051282051,2085,7832,571,1214,54,408,17,186,32,17
"632","2020-03-22",136,8,179,607,5850,0.591282051282051,2085,7832,571,1214,51,459,11,197,25,11
"633","2020-03-23",151,8,207,652,5850,0.591282051282051,2085,7832,571,1214,58,517,8,205,29,8
"634","2020-03-24",161,8,225,721,5850,0.591282051282051,2085,7832,571,1214,55,572,21,226,31,21
"635","2020-03-25",166,8,232,776,5850,0.591282051282051,2085,7832,571,1214,80,652,8,234,54,8
"636","2020-03-26",175,8,227,848,5850,0.591282051282051,2085,7832,571,1214,64,716,27,261,31,27
"637","2020-03-27",238,8,221,871,5850,0.591282051282051,2085,7832,571,1214,48,764,25,286,30,25
"638","2020-03-28",260,8,213,923,5850,0.591282051282051,2085,7832,571,1214,77,841,28,314,52,28
"639","2020-03-29",284,8,241,954,5850,0.591282051282051,2085,7832,571,1214,63,904,37,351,31,37
"640","2020-03-30",292,8,242,1015,5850,0.591282051282051,2085,7832,571,1214,95,999,47,398,65,47
"641","2020-03-31",294,8,241,1053,5850,0.591282051282051,2085,7832,571,1214,73,1072,54,452,44,54
"642","2020-04-01",314,8,227,1107,5850,0.591282051282051,2085,7832,571,1214,65,1137,30,482,38,30
"643","2020-04-02",331,8,229,1139,5850,0.591282051282051,2085,7832,571,1214,69,1206,16,498,45,16
"644","2020-04-03",407,8,241,1180,5850,0.591282051282051,2085,7832,571,1214,92,1298,21,519,61,21
"645","2020-04-04",422,8,240,1199,5850,0.591282051282051,2085,7832,571,1214,66,1364,39,558,37,39
"646","2020-04-05",382,8,264,1203,5850,0.591282051282051,2085,7832,571,1214,86,1450,29,587,53,29
"647","2020-04-06",366,8,272,1219,5850,0.591282051282051,2085,7832,571,1214,78,1528,54,641,53,54
"648","2020-04-07",373,8,282,1247,5850,0.591282051282051,2085,7832,571,1214,83,1611,40,681,52,40
"649","2020-04-08",373,8,277,1220,5850,0.591282051282051,2085,7832,571,1214,79,1690,31,712,42,31
"650","2020-04-09",375,8,260,1212,5850,0.591282051282051,2085,7832,571,1214,80,1770,18,730,49,18
"651","2020-04-10",423,8,256,1239,5850,0.591282051282051,2085,7832,571,1214,75,1845,10,740,47,10
"652","2020-04-11",424,8,246,1200,5850,0.591282051282051,2085,7832,571,1214,67,1912,13,753,38,13
"653","2020-04-12",404,8,231,1183,5850,0.591282051282051,2085,7832,571,1214,60,1972,12,765,38,12
"654","2020-04-13",403,8,262,1184,5850,0.591282051282051,2085,7832,571,1214,83,2055,7,772,52,7
"655","2020-04-14",395,8,266,1197,5850,0.591282051282051,2085,7832,571,1214,72,2127,9,781,40,9
"656","2020-04-15",398,8,279,1167,5850,0.591282051282051,2085,7832,571,1214,78,2205,15,796,51,15
"657","2020-04-16",401,8,251,1143,5850,0.591282051282051,2085,7832,571,1214,67,2272,36,832,39,36
"658","2020-04-17",417,8,264,1132,5850,0.591282051282051,2085,7832,571,1214,61,2333,22,854,39,22
"659","2020-04-18",393,8,267,1110,5850,0.591282051282051,2085,7832,571,1214,76,2409,40,894,43,40
"660","2020-04-19",370,8,306,1081,5850,0.591282051282051,2085,7832,571,1214,80,2489,48,942,54,48
"661","2020-04-20",362,8,305,1058,5850,0.591282051282051,2085,7832,571,1214,66,2555,25,967,34,25
"662","2020-04-21",353,8,295,1039,5850,0.591282051282051,2085,7832,571,1214,75,2630,37,1004,37,37
"663","2020-04-22",357,8,284,1021,5850,0.591282051282051,2085,7832,571,1214,68,2698,23,1027,43,23
"664","2020-04-23",345,8,259,1002,5850,0.591282051282051,2085,7832,571,1214,69,2767,28,1055,38,28
"665","2020-04-24",341,8,256,978,5850,0.591282051282051,2085,7832,571,1214,70,2837,40,1095,35,40
"666","2020-04-25",367,8,244,942,5850,0.591282051282051,2085,7832,571,1214,61,2898,31,1126,37,31
"667","2020-04-26",346,8,238,886,5850,0.591282051282051,2085,7832,571,1214,66,2964,40,1166,36,40
"668","2020-04-27",333,8,229,848,5850,0.591282051282051,2085,7832,571,1214,50,3014,47,1213,27,47
"669","2020-04-28",319,8,229,815,5850,0.591282051282051,2085,7832,571,1214,63,3077,30,1243,38,30
"670","2020-04-29",302,8,238,794,5850,0.591282051282051,2085,7832,571,1214,69,3146,31,1274,40,31
"671","2020-04-30",293,8,239,754,5850,0.591282051282051,2085,7832,571,1214,55,3201,27,1301,30,27
"672","2020-05-01",291,8,231,755,5850,0.591282051282051,2085,7832,571,1214,70,3271,47,1348,39,47
"673","2020-05-02",286,8,220,754,5850,0.591282051282051,2085,7832,571,1214,52,3323,40,1388,26,40
"674","2020-05-03",253,8,229,737,5850,0.591282051282051,2085,7832,571,1214,47,3370,35,1423,26,35
"675","2020-05-04",239,8,245,715,5850,0.591282051282051,2085,7832,571,1214,57,3427,40,1463,31,40
"676","2020-05-05",228,8,263,691,5850,0.591282051282051,2085,7832,571,1214,62,3489,26,1489,30,26
"677","2020-05-06",227,8,295,650,5850,0.591282051282051,2085,7832,571,1214,45,3534,24,1513,25,24
"678","2020-05-07",222,8,315,637,5850,0.591282051282051,2085,7832,571,1214,45,3579,41,1554,22,41
"679","2020-05-08",223,8,299,627,5850,0.591282051282051,2085,7832,571,1214,45,3624,24,1578,23,24
"680","2020-05-09",213,8,293,604,5850,0.591282051282051,2085,7832,571,1214,44,3668,51,1629,20,51
"681","2020-05-10",199,8,288,593,5850,0.591282051282051,2085,7832,571,1214,45,3713,60,1689,29,60
"682","2020-05-11",203,8,287,560,5850,0.591282051282051,2085,7832,571,1214,44,3757,25,1714,28,25
"683","2020-05-12",198,8,288,530,5850,0.591282051282051,2085,7832,571,1214,42,3799,17,1731,22,17
"684","2020-05-13",182,8,282,510,5850,0.591282051282051,2085,7832,571,1214,43,3842,17,1748,26,17
"685","2020-05-14",179,8,297,484,5850,0.591282051282051,2085,7832,571,1214,37,3879,18,1766,13,18
"686","2020-05-15",159,8,272,463,5850,0.591282051282051,2085,7832,571,1214,33,3912,24,1790,20,24
"687","2020-05-16",156,8,260,449,5850,0.591282051282051,2085,7832,571,1214,28,3940,53,1843,21,53
"688","2020-05-17",143,8,269,427,5850,0.591282051282051,2085,7832,571,1214,28,3968,40,1883,14,40
"689","2020-05-18",138,8,270,426,5850,0.591282051282051,2085,7832,571,1214,29,3997,49,1932,18,49
"690","2020-05-19",137,8,273,413,5850,0.591282051282051,2085,7832,571,1214,28,4025,31,1963,16,31
"691","2020-05-20",137,8,274,397,5850,0.591282051282051,2085,7832,571,1214,34,4059,15,1978,14,15
"692","2020-05-21",135,8,272,380,5850,0.591282051282051,2085,7832,571,1214,26,4085,14,1992,14,14
"693","2020-05-22",134,8,289,356,5850,0.591282051282051,2085,7832,571,1214,31,4116,31,2023,19,31
"694","2020-05-23",146,8,293,339,5850,0.591282051282051,2085,7832,571,1214,19,4135,35,2058,10,35
"695","2020-05-24",145,8,285,326,5850,0.591282051282051,2085,7832,571,1214,26,4161,24,2082,15,24
"696","2020-05-25",132,8,275,317,5850,0.591282051282051,2085,7832,571,1214,17,4178,21,2103,7,21
"697","2020-05-26",126,8,287,298,5850,0.591282051282051,2085,7832,571,1214,26,4204,8,2111,8,8
"698","2020-05-27",125,8,281,298,5850,0.591282051282051,2085,7832,571,1214,25,4229,12,2123,11,12
"699","2020-05-28",116,8,284,273,5850,0.591282051282051,2085,7832,571,1214,19,4248,8,2131,8,8
"700","2020-05-29",108,8,284,259,5850,0.591282051282051,2085,7832,571,1214,20,4268,26,2157,7,26
"701","2020-05-30",96,8,272,249,5850,0.591282051282051,2085,7832,571,1214,19,4287,39,2196,9,39
"702","2020-05-31",82,8,268,225,5850,0.591282051282051,2085,7832,571,1214,20,4307,20,2216,9,20
"703","2020-06-01",79,8,270,217,5850,0.591282051282051,2085,7832,571,1214,18,4325,18,2234,8,18
"704","2020-06-02",75,8,266,212,5850,0.591282051282051,2085,7832,571,1214,16,4341,23,2257,8,23
"705","2020-06-03",73,8,271,205,5850,0.591282051282051,2085,7832,571,1214,18,4359,11,2268,9,11
"706","2020-06-04",72,8,254,191,5850,0.591282051282051,2085,7832,571,1214,16,4375,9,2277,5,9
"707","2020-06-05",69,8,255,189,5850,0.591282051282051,2085,7832,571,1214,10,4385,7,2284,4,7
"708","2020-06-06",65,8,242,178,5850,0.591282051282051,2085,7832,571,1214,12,4397,17,2301,4,17
"709","2020-06-07",60,8,253,175,5850,0.591282051282051,2085,7832,571,1214,14,4411,6,2307,7,6
"710","2020-03-14",3,9,84,45,6081,0.935865811544154,2025,6817,594,755,16,44,41,101,9,41
"711","2020-03-15",6,9,92,66,6081,0.935865811544154,2025,6817,594,755,24,68,17,118,18,17
"712","2020-03-16",6,9,114,92,6081,0.935865811544154,2025,6817,594,755,20,88,47,165,13,47
"713","2020-03-17",6,9,110,120,6081,0.935865811544154,2025,6817,594,755,23,111,51,216,20,51
"714","2020-03-18",8,9,125,170,6081,0.935865811544154,2025,6817,594,755,28,139,22,238,22,22
"715","2020-03-19",13,9,113,214,6081,0.935865811544154,2025,6817,594,755,31,170,18,256,25,18
"716","2020-03-20",26,9,118,262,6081,0.935865811544154,2025,6817,594,755,40,210,12,268,35,12
"717","2020-03-21",41,9,119,308,6081,0.935865811544154,2025,6817,594,755,31,241,34,302,30,34
"718","2020-03-22",71,9,131,366,6081,0.935865811544154,2025,6817,594,755,68,309,28,330,59,28
"719","2020-03-23",88,9,137,430,6081,0.935865811544154,2025,6817,594,755,52,361,18,348,44,18
"720","2020-03-24",101,9,165,507,6081,0.935865811544154,2025,6817,594,755,65,426,47,395,60,47
"721","2020-03-25",117,9,162,586,6081,0.935865811544154,2025,6817,594,755,68,494,28,423,64,28
"722","2020-03-26",136,9,157,651,6081,0.935865811544154,2025,6817,594,755,64,558,17,440,58,17
"723","2020-03-27",173,9,174,744,6081,0.935865811544154,2025,6817,594,755,81,639,10,450,74,10
"724","2020-03-28",233,9,185,792,6081,0.935865811544154,2025,6817,594,755,78,717,11,461,73,11
"725","2020-03-29",227,9,178,878,6081,0.935865811544154,2025,6817,594,755,70,787,55,516,65,55
"726","2020-03-30",226,9,187,952,6081,0.935865811544154,2025,6817,594,755,130,917,58,574,122,58
"727","2020-03-31",236,9,178,1019,6081,0.935865811544154,2025,6817,594,755,111,1028,35,609,105,35
"728","2020-04-01",256,9,163,1078,6081,0.935865811544154,2025,6817,594,755,152,1180,27,636,141,27
"729","2020-04-02",269,9,164,1112,6081,0.935865811544154,2025,6817,594,755,115,1295,41,677,107,41
"730","2020-04-03",328,9,143,1188,6081,0.935865811544154,2025,6817,594,755,130,1425,61,738,122,61
"731","2020-04-04",352,9,142,1263,6081,0.935865811544154,2025,6817,594,755,173,1598,53,791,165,53
"732","2020-04-05",379,9,163,1343,6081,0.935865811544154,2025,6817,594,755,124,1722,39,830,114,39
"733","2020-04-06",400,9,177,1387,6081,0.935865811544154,2025,6817,594,755,144,1866,30,860,138,30
"734","2020-04-07",410,9,179,1479,6081,0.935865811544154,2025,6817,594,755,178,2044,20,880,165,20
"735","2020-04-08",427,9,200,1556,6081,0.935865811544154,2025,6817,594,755,176,2220,11,891,173,11
"736","2020-04-09",443,9,216,1642,6081,0.935865811544154,2025,6817,594,755,188,2408,13,904,180,13
"737","2020-04-10",562,9,220,1683,6081,0.935865811544154,2025,6817,594,755,169,2577,15,919,164,15
"738","2020-04-11",579,9,226,1735,6081,0.935865811544154,2025,6817,594,755,154,2731,11,930,149,11
"739","2020-04-12",578,9,260,1778,6081,0.935865811544154,2025,6817,594,755,152,2883,57,987,145,57
"740","2020-04-13",575,9,257,1782,6081,0.935865811544154,2025,6817,594,755,170,3053,22,1009,168,22
"741","2020-04-14",583,9,239,1739,6081,0.935865811544154,2025,6817,594,755,156,3209,13,1022,153,13
"742","2020-04-15",591,9,187,1742,6081,0.935865811544154,2025,6817,594,755,192,3401,11,1033,186,11
"743","2020-04-16",603,9,188,1713,6081,0.935865811544154,2025,6817,594,755,149,3550,15,1048,143,15
"744","2020-04-17",669,9,188,1705,6081,0.935865811544154,2025,6817,594,755,135,3685,72,1120,125,72
"745","2020-04-18",646,9,174,1687,6081,0.935865811544154,2025,6817,594,755,142,3827,63,1183,134,63
"746","2020-04-19",580,9,173,1652,6081,0.935865811544154,2025,6817,594,755,143,3970,23,1206,141,23
"747","2020-04-20",559,9,154,1604,6081,0.935865811544154,2025,6817,594,755,149,4119,21,1227,147,21
"748","2020-04-21",539,9,126,1502,6081,0.935865811544154,2025,6817,594,755,99,4218,22,1249,95,22
"749","2020-04-22",532,9,111,1451,6081,0.935865811544154,2025,6817,594,755,116,4334,19,1268,111,19
"750","2020-04-23",521,9,107,1393,6081,0.935865811544154,2025,6817,594,755,125,4459,60,1328,120,60
"751","2020-04-24",481,9,112,1340,6081,0.935865811544154,2025,6817,594,755,82,4541,25,1353,77,25
"752","2020-04-25",476,9,127,1293,6081,0.935865811544154,2025,6817,594,755,75,4616,11,1364,72,11
"753","2020-04-26",455,9,146,1193,6081,0.935865811544154,2025,6817,594,755,74,4690,15,1379,70,15
"754","2020-04-27",448,9,188,1134,6081,0.935865811544154,2025,6817,594,755,74,4764,13,1392,70,13
"755","2020-04-28",430,9,213,1076,6081,0.935865811544154,2025,6817,594,755,76,4840,6,1398,70,6
"756","2020-04-29",418,9,245,1017,6081,0.935865811544154,2025,6817,594,755,67,4907,8,1406,59,8
"757","2020-04-30",395,9,245,942,6081,0.935865811544154,2025,6817,594,755,68,4975,13,1419,64,13
"758","2020-05-01",368,9,262,889,6081,0.935865811544154,2025,6817,594,755,47,5022,5,1424,41,5
"759","2020-05-02",352,9,253,828,6081,0.935865811544154,2025,6817,594,755,55,5077,4,1428,50,4
"760","2020-05-03",306,9,217,773,6081,0.935865811544154,2025,6817,594,755,54,5131,7,1435,51,7
"761","2020-05-04",287,9,211,721,6081,0.935865811544154,2025,6817,594,755,35,5166,11,1446,32,11
"762","2020-05-05",285,9,239,679,6081,0.935865811544154,2025,6817,594,755,39,5205,12,1458,39,12
"763","2020-05-06",278,9,240,643,6081,0.935865811544154,2025,6817,594,755,24,5229,5,1463,20,5
"764","2020-05-07",276,9,219,580,6081,0.935865811544154,2025,6817,594,755,30,5259,11,1474,27,11
"765","2020-05-08",244,9,194,531,6081,0.935865811544154,2025,6817,594,755,38,5297,18,1492,34,18
"766","2020-05-09",236,9,164,503,6081,0.935865811544154,2025,6817,594,755,31,5328,65,1557,29,65
"767","2020-05-10",206,9,142,460,6081,0.935865811544154,2025,6817,594,755,36,5364,61,1618,34,61
"768","2020-05-11",190,9,126,435,6081,0.935865811544154,2025,6817,594,755,26,5390,40,1658,21,40
"769","2020-05-12",177,9,120,426,6081,0.935865811544154,2025,6817,594,755,25,5415,52,1710,21,52
"770","2020-05-13",151,9,151,389,6081,0.935865811544154,2025,6817,594,755,22,5437,35,1745,21,35
"771","2020-05-14",135,9,170,362,6081,0.935865811544154,2025,6817,594,755,22,5459,26,1771,18,26
"772","2020-05-15",123,9,173,318,6081,0.935865811544154,2025,6817,594,755,31,5490,41,1812,31,41
"773","2020-05-16",112,9,199,289,6081,0.935865811544154,2025,6817,594,755,20,5510,31,1843,20,31
"774","2020-05-17",111,9,222,267,6081,0.935865811544154,2025,6817,594,755,17,5527,58,1901,13,58
"775","2020-05-18",106,9,237,249,6081,0.935865811544154,2025,6817,594,755,15,5542,74,1975,15,74
"776","2020-05-19",88,9,249,237,6081,0.935865811544154,2025,6817,594,755,17,5559,63,2038,13,63
"777","2020-05-20",82,9,255,224,6081,0.935865811544154,2025,6817,594,755,22,5581,51,2089,20,51
"778","2020-05-21",78,9,224,205,6081,0.935865811544154,2025,6817,594,755,19,5600,32,2121,18,32
"779","2020-05-22",72,9,225,196,6081,0.935865811544154,2025,6817,594,755,14,5614,14,2135,10,14
"780","2020-05-23",70,9,229,176,6081,0.935865811544154,2025,6817,594,755,24,5638,5,2140,22,5
"781","2020-05-24",65,9,218,165,6081,0.935865811544154,2025,6817,594,755,10,5648,13,2153,10,13
"782","2020-05-25",65,9,220,155,6081,0.935865811544154,2025,6817,594,755,12,5660,6,2159,11,6
"783","2020-05-26",65,9,218,156,6081,0.935865811544154,2025,6817,594,755,13,5673,17,2176,10,17
"784","2020-05-27",69,9,208,153,6081,0.935865811544154,2025,6817,594,755,13,5686,15,2191,10,15
"785","2020-05-28",65,9,204,150,6081,0.935865811544154,2025,6817,594,755,12,5698,7,2198,10,7
"786","2020-05-29",60,9,179,143,6081,0.935865811544154,2025,6817,594,755,11,5709,7,2205,11,7
"787","2020-05-30",55,9,164,136,6081,0.935865811544154,2025,6817,594,755,7,5716,33,2238,5,33
"788","2020-05-31",45,9,128,132,6081,0.935865811544154,2025,6817,594,755,14,5730,40,2278,12,40
"789","2020-06-01",41,9,121,121,6081,0.935865811544154,2025,6817,594,755,3,5733,48,2326,3,48
"790","2020-06-02",37,9,120,124,6081,0.935865811544154,2025,6817,594,755,10,5743,52,2378,8,52
"791","2020-06-03",32,9,126,120,6081,0.935865811544154,2025,6817,594,755,5,5748,23,2401,5,23
"792","2020-06-04",31,9,145,116,6081,0.935865811544154,2025,6817,594,755,4,5752,48,2449,4,48
"793","2020-06-05",41,9,163,109,6081,0.935865811544154,2025,6817,594,755,2,5754,36,2485,1,36
"794","2020-06-06",45,9,162,108,6081,0.935865811544154,2025,6817,594,755,7,5761,38,2523,7,38
"795","2020-06-07",49,9,140,109,6081,0.935865811544154,2025,6817,594,755,4,5765,24,2547,4,24
"796","2020-03-08",1,10,0,0,5793,0.899533920248576,1995,7108,558,849,NA,NA,NA,NA,NA,NA
"797","2020-03-09",1,10,0,0,5793,0.899533920248576,1995,7108,558,849,NA,NA,NA,NA,NA,NA
"798","2020-03-10",0,10,0,0,5793,0.899533920248576,1995,7108,558,849,NA,NA,1,1,NA,1
"799","2020-03-11",0,10,0,0,5793,0.899533920248576,1995,7108,558,849,20,20,17,18,1,17
"800","2020-03-12",0,10,0,0,5793,0.899533920248576,1995,7108,558,849,24,44,10,28,3,10
"801","2020-03-13",1,10,45,23,5793,0.899533920248576,1995,7108,558,849,32,76,16,44,10,16
"802","2020-03-14",5,10,41,37,5793,0.899533920248576,1995,7108,558,849,23,99,17,61,8,17
"803","2020-03-15",9,10,52,54,5793,0.899533920248576,1995,7108,558,849,37,136,6,67,11,6
"804","2020-03-16",9,10,94,64,5793,0.899533920248576,1995,7108,558,849,32,168,11,78,18,11
"805","2020-03-17",12,10,110,86,5793,0.899533920248576,1995,7108,558,849,36,204,7,85,24,7
"806","2020-03-18",14,10,108,115,5793,0.899533920248576,1995,7108,558,849,42,246,17,102,21,17
"807","2020-03-19",17,10,121,131,5793,0.899533920248576,1995,7108,558,849,42,288,5,107,24,5
"808","2020-03-20",19,10,138,156,5793,0.899533920248576,1995,7108,558,849,58,346,14,121,43,14
"809","2020-03-21",30,10,152,178,5793,0.899533920248576,1995,7108,558,849,67,413,10,131,47,10
"810","2020-03-22",32,10,138,235,5793,0.899533920248576,1995,7108,558,849,58,471,4,135,41,4
"811","2020-03-23",38,10,129,266,5793,0.899533920248576,1995,7108,558,849,78,549,9,144,57,9
"812","2020-03-24",46,10,117,300,5793,0.899533920248576,1995,7108,558,849,90,639,7,151,68,7
"813","2020-03-25",53,10,107,335,5793,0.899533920248576,1995,7108,558,849,80,719,20,171,58,20
"814","2020-03-26",71,10,93,371,5793,0.899533920248576,1995,7108,558,849,125,844,5,176,99,5
"815","2020-03-27",90,10,89,427,5793,0.899533920248576,1995,7108,558,849,71,915,8,184,51,8
"816","2020-03-28",116,10,106,465,5793,0.899533920248576,1995,7108,558,849,98,1013,12,196,75,12
"817","2020-03-29",136,10,105,519,5793,0.899533920248576,1995,7108,558,849,119,1132,9,205,91,9
"818","2020-03-30",130,10,106,582,5793,0.899533920248576,1995,7108,558,849,101,1233,10,215,81,10
"819","2020-03-31",143,10,140,639,5793,0.899533920248576,1995,7108,558,849,109,1342,17,232,83,17
"820","2020-04-01",161,10,158,737,5793,0.899533920248576,1995,7108,558,849,127,1469,11,243,105,11
"821","2020-04-02",162,10,160,819,5793,0.899533920248576,1995,7108,558,849,90,1559,26,269,70,26
"822","2020-04-03",227,10,149,905,5793,0.899533920248576,1995,7108,558,849,144,1703,40,309,114,40
"823","2020-04-04",251,10,139,993,5793,0.899533920248576,1995,7108,558,849,135,1838,18,327,121,18
"824","2020-04-05",251,10,134,1061,5793,0.899533920248576,1995,7108,558,849,128,1966,17,344,107,17
"825","2020-04-06",269,10,140,1140,5793,0.899533920248576,1995,7108,558,849,138,2104,17,361,114,17
"826","2020-04-07",280,10,132,1226,5793,0.899533920248576,1995,7108,558,849,119,2223,15,376,95,15
"827","2020-04-08",302,10,112,1286,5793,0.899533920248576,1995,7108,558,849,145,2368,27,403,115,27
"828","2020-04-09",317,10,114,1379,5793,0.899533920248576,1995,7108,558,849,140,2508,37,440,119,37
"829","2020-04-10",412,10,109,1441,5793,0.899533920248576,1995,7108,558,849,124,2632,19,459,103,19
"830","2020-04-11",493,10,120,1524,5793,0.899533920248576,1995,7108,558,849,132,2764,22,481,109,22
"831","2020-04-12",463,10,140,1596,5793,0.899533920248576,1995,7108,558,849,115,2879,40,521,92,40
"832","2020-04-13",456,10,148,1671,5793,0.899533920248576,1995,7108,558,849,123,3002,16,537,108,16
"833","2020-04-14",475,10,177,1729,5793,0.899533920248576,1995,7108,558,849,128,3130,23,560,106,23
"834","2020-04-15",508,10,164,1761,5793,0.899533920248576,1995,7108,558,849,99,3229,36,596,82,36
"835","2020-04-16",538,10,176,1746,5793,0.899533920248576,1995,7108,558,849,117,3346,26,622,99,26
"836","2020-04-17",672,10,192,1792,5793,0.899533920248576,1995,7108,558,849,101,3447,25,647,75,25
"837","2020-04-18",641,10,209,1795,5793,0.899533920248576,1995,7108,558,849,93,3540,12,659,72,12
"838","2020-04-19",633,10,197,1769,5793,0.899533920248576,1995,7108,558,849,104,3644,19,678,78,19
"839","2020-04-20",654,10,193,1769,5793,0.899533920248576,1995,7108,558,849,87,3731,13,691,66,13
"840","2020-04-21",646,10,172,1754,5793,0.899533920248576,1995,7108,558,849,86,3817,15,706,61,15
"841","2020-04-22",627,10,167,1686,5793,0.899533920248576,1995,7108,558,849,71,3888,14,720,56,14
"842","2020-04-23",628,10,186,1624,5793,0.899533920248576,1995,7108,558,849,55,3943,10,730,41,10
"843","2020-04-24",608,10,216,1562,5793,0.899533920248576,1995,7108,558,849,61,4004,12,742,46,12
"844","2020-04-25",599,10,247,1482,5793,0.899533920248576,1995,7108,558,849,71,4075,14,756,50,14
"845","2020-04-26",536,10,267,1402,5793,0.899533920248576,1995,7108,558,849,72,4147,16,772,53,16
"846","2020-04-27",505,10,280,1361,5793,0.899533920248576,1995,7108,558,849,69,4216,20,792,51,20
"847","2020-04-28",486,10,274,1280,5793,0.899533920248576,1995,7108,558,849,64,4280,18,810,48,18
"848","2020-04-29",471,10,261,1245,5793,0.899533920248576,1995,7108,558,849,38,4318,40,850,26,40
"849","2020-04-30",450,10,234,1174,5793,0.899533920248576,1995,7108,558,849,57,4375,57,907,37,57
"850","2020-05-01",425,10,200,1102,5793,0.899533920248576,1995,7108,558,849,42,4417,60,967,27,60
"851","2020-05-02",413,10,185,1012,5793,0.899533920248576,1995,7108,558,849,49,4466,57,1024,31,57
"852","2020-05-03",389,10,176,958,5793,0.899533920248576,1995,7108,558,849,54,4520,23,1047,35,23
"853","2020-05-04",371,10,160,897,5793,0.899533920248576,1995,7108,558,849,48,4568,9,1056,38,9
"854","2020-05-05",360,10,184,839,5793,0.899533920248576,1995,7108,558,849,47,4615,11,1067,32,11
"855","2020-05-06",339,10,198,788,5793,0.899533920248576,1995,7108,558,849,27,4642,4,1071,18,4
"856","2020-05-07",322,10,228,721,5793,0.899533920248576,1995,7108,558,849,38,4680,5,1076,24,5
"857","2020-05-08",285,10,222,669,5793,0.899533920248576,1995,7108,558,849,37,4717,13,1089,23,13
"858","2020-05-09",261,10,191,643,5793,0.899533920248576,1995,7108,558,849,31,4748,41,1130,19,41
"859","2020-05-10",239,10,212,603,5793,0.899533920248576,1995,7108,558,849,32,4780,12,1142,18,12
"860","2020-05-11",229,10,200,552,5793,0.899533920248576,1995,7108,558,849,25,4805,29,1171,20,29
"861","2020-05-12",199,10,179,507,5793,0.899533920248576,1995,7108,558,849,34,4839,24,1195,23,24
"862","2020-05-13",195,10,153,470,5793,0.899533920248576,1995,7108,558,849,27,4866,27,1222,16,27
"863","2020-05-14",186,10,141,431,5793,0.899533920248576,1995,7108,558,849,33,4899,37,1259,16,37
"864","2020-05-15",162,10,137,383,5793,0.899533920248576,1995,7108,558,849,27,4926,13,1272,14,13
"865","2020-05-16",148,10,129,349,5793,0.899533920248576,1995,7108,558,849,29,4955,8,1280,14,8
"866","2020-05-17",134,10,112,323,5793,0.899533920248576,1995,7108,558,849,25,4980,11,1291,14,11
"867","2020-05-18",130,10,103,291,5793,0.899533920248576,1995,7108,558,849,25,5005,17,1308,18,17
"868","2020-05-19",129,10,136,260,5793,0.899533920248576,1995,7108,558,849,17,5022,34,1342,9,34
"869","2020-05-20",114,10,161,241,5793,0.899533920248576,1995,7108,558,849,25,5047,13,1355,16,13
"870","2020-05-21",105,10,144,213,5793,0.899533920248576,1995,7108,558,849,32,5079,23,1378,18,23
"871","2020-05-22",95,10,144,200,5793,0.899533920248576,1995,7108,558,849,18,5097,16,1394,10,16
"872","2020-05-23",98,10,166,178,5793,0.899533920248576,1995,7108,558,849,17,5114,31,1425,11,31
"873","2020-05-24",85,10,167,161,5793,0.899533920248576,1995,7108,558,849,20,5134,16,1441,14,16
"874","2020-05-25",74,10,158,149,5793,0.899533920248576,1995,7108,558,849,14,5148,22,1463,12,22
"875","2020-05-26",60,10,152,133,5793,0.899533920248576,1995,7108,558,849,14,5162,13,1476,10,13
"876","2020-05-27",61,10,156,129,5793,0.899533920248576,1995,7108,558,849,11,5173,18,1494,5,18
"877","2020-05-28",52,10,146,120,5793,0.899533920248576,1995,7108,558,849,15,5188,26,1520,7,26
"878","2020-05-29",45,10,133,113,5793,0.899533920248576,1995,7108,558,849,15,5203,17,1537,6,17
"879","2020-05-30",36,10,116,102,5793,0.899533920248576,1995,7108,558,849,20,5223,26,1563,12,26
"880","2020-05-31",30,10,116,96,5793,0.899533920248576,1995,7108,558,849,20,5243,13,1576,9,13
"881","2020-06-01",28,10,135,91,5793,0.899533920248576,1995,7108,558,849,12,5255,7,1583,6,7
"882","2020-06-02",32,10,139,82,5793,0.899533920248576,1995,7108,558,849,14,5269,10,1593,10,10
"883","2020-06-03",28,10,128,74,5793,0.899533920248576,1995,7108,558,849,14,5283,18,1611,5,18
"884","2020-06-04",29,10,138,69,5793,0.899533920248576,1995,7108,558,849,7,5290,25,1636,6,25
"885","2020-06-05",25,10,142,65,5793,0.899533920248576,1995,7108,558,849,14,5304,25,1661,10,25
"886","2020-06-06",23,10,134,59,5793,0.899533920248576,1995,7108,558,849,13,5317,19,1680,6,19
"887","2020-06-07",25,10,132,56,5793,0.899533920248576,1995,7108,558,849,8,5325,19,1699,6,19
"888","2020-03-14",9,11,93,153,6784,0.714770047169811,1980,7655,691,795,53,174,46,156,16,46
"889","2020-03-15",19,11,104,188,6784,0.714770047169811,1980,7655,691,795,54,228,44,200,13,44
"890","2020-03-16",17,11,100,247,6784,0.714770047169811,1980,7655,691,795,74,302,60,260,35,60
"891","2020-03-17",25,11,121,299,6784,0.714770047169811,1980,7655,691,795,87,389,69,329,44,69
"892","2020-03-18",34,11,135,365,6784,0.714770047169811,1980,7655,691,795,69,458,50,379,38,50
"893","2020-03-19",46,11,135,436,6784,0.714770047169811,1980,7655,691,795,99,557,30,409,56,30
"894","2020-03-20",68,11,154,509,6784,0.714770047169811,1980,7655,691,795,72,629,49,458,41,49
"895","2020-03-21",94,11,161,576,6784,0.714770047169811,1980,7655,691,795,96,725,43,501,61,43
"896","2020-03-22",137,11,142,668,6784,0.714770047169811,1980,7655,691,795,102,827,48,549,70,48
"897","2020-03-23",150,11,179,755,6784,0.714770047169811,1980,7655,691,795,125,952,35,584,85,35
"898","2020-03-24",155,11,163,832,6784,0.714770047169811,1980,7655,691,795,109,1061,43,627,70,43
"899","2020-03-25",171,11,149,878,6784,0.714770047169811,1980,7655,691,795,131,1192,50,677,89,50
"900","2020-03-26",185,11,141,1010,6784,0.714770047169811,1980,7655,691,795,107,1299,42,719,74,42
"901","2020-03-27",265,11,137,1140,6784,0.714770047169811,1980,7655,691,795,139,1438,39,758,98,39
"902","2020-03-28",293,11,166,1223,6784,0.714770047169811,1980,7655,691,795,88,1526,33,791,68,33
"903","2020-03-29",333,11,165,1298,6784,0.714770047169811,1980,7655,691,795,149,1675,25,816,102,25
"904","2020-03-30",350,11,167,1365,6784,0.714770047169811,1980,7655,691,795,137,1812,39,855,90,39
"905","2020-03-31",362,11,187,1445,6784,0.714770047169811,1980,7655,691,795,119,1931,55,910,78,55
"906","2020-04-01",388,11,174,1541,6784,0.714770047169811,1980,7655,691,795,117,2048,57,967,77,57
"907","2020-04-02",414,11,198,1607,6784,0.714770047169811,1980,7655,691,795,114,2162,45,1012,82,45
"908","2020-04-03",532,11,175,1676,6784,0.714770047169811,1980,7655,691,795,141,2303,43,1055,105,43
"909","2020-04-04",587,11,167,1703,6784,0.714770047169811,1980,7655,691,795,124,2427,33,1088,86,33
"910","2020-04-05",541,11,195,1757,6784,0.714770047169811,1980,7655,691,795,129,2556,47,1135,93,47
"911","2020-04-06",539,11,215,1811,6784,0.714770047169811,1980,7655,691,795,112,2668,39,1174,76,39
"912","2020-04-07",545,11,197,1837,6784,0.714770047169811,1980,7655,691,795,129,2797,39,1213,96,39
"913","2020-04-08",559,11,187,1849,6784,0.714770047169811,1980,7655,691,795,119,2916,32,1245,80,32
"914","2020-04-09",573,11,178,1860,6784,0.714770047169811,1980,7655,691,795,119,3035,53,1298,84,53
"915","2020-04-10",654,11,156,1874,6784,0.714770047169811,1980,7655,691,795,102,3137,35,1333,71,35
"916","2020-04-11",627,11,159,1843,6784,0.714770047169811,1980,7655,691,795,122,3259,49,1382,83,49
"917","2020-04-12",589,11,195,1845,6784,0.714770047169811,1980,7655,691,795,116,3375,50,1432,74,50
"918","2020-04-13",596,11,235,1817,6784,0.714770047169811,1980,7655,691,795,114,3489,44,1476,81,44
"919","2020-04-14",588,11,257,1779,6784,0.714770047169811,1980,7655,691,795,124,3613,44,1520,81,44
"920","2020-04-15",601,11,256,1776,6784,0.714770047169811,1980,7655,691,795,114,3727,33,1553,88,33
"921","2020-04-16",605,11,249,1728,6784,0.714770047169811,1980,7655,691,795,82,3809,40,1593,55,40
"922","2020-04-17",637,11,224,1634,6784,0.714770047169811,1980,7655,691,795,93,3902,32,1625,63,32
"923","2020-04-18",660,11,200,1568,6784,0.714770047169811,1980,7655,691,795,100,4002,25,1650,58,25
"924","2020-04-19",597,11,204,1507,6784,0.714770047169811,1980,7655,691,795,83,4085,15,1665,52,15
"925","2020-04-20",585,11,199,1468,6784,0.714770047169811,1980,7655,691,795,89,4174,30,1695,60,30
"926","2020-04-21",564,11,168,1411,6784,0.714770047169811,1980,7655,691,795,91,4265,22,1717,59,22
"927","2020-04-22",516,11,162,1351,6784,0.714770047169811,1980,7655,691,795,63,4328,45,1762,34,45
"928","2020-04-23",498,11,202,1275,6784,0.714770047169811,1980,7655,691,795,74,4402,36,1798,48,36
"929","2020-04-24",413,11,249,1215,6784,0.714770047169811,1980,7655,691,795,82,4484,47,1845,55,47
"930","2020-04-25",379,11,230,1128,6784,0.714770047169811,1980,7655,691,795,92,4576,36,1881,45,36
"931","2020-04-26",372,11,260,1055,6784,0.714770047169811,1980,7655,691,795,56,4632,40,1921,31,40
"932","2020-04-27",352,11,225,993,6784,0.714770047169811,1980,7655,691,795,63,4695,40,1961,38,40
"933","2020-04-28",350,11,203,945,6784,0.714770047169811,1980,7655,691,795,54,4749,29,1990,32,29
"934","2020-04-29",346,11,180,891,6784,0.714770047169811,1980,7655,691,795,60,4809,27,2017,25,27
"935","2020-04-30",326,11,170,815,6784,0.714770047169811,1980,7655,691,795,52,4861,53,2070,27,53
"936","2020-05-01",322,11,162,769,6784,0.714770047169811,1980,7655,691,795,68,4929,27,2097,37,27
"937","2020-05-02",315,11,169,707,6784,0.714770047169811,1980,7655,691,795,56,4985,48,2145,34,48
"938","2020-05-03",264,11,188,657,6784,0.714770047169811,1980,7655,691,795,57,5042,40,2185,32,40
"939","2020-05-04",250,11,196,608,6784,0.714770047169811,1980,7655,691,795,37,5079,43,2228,11,43
"940","2020-05-05",235,11,189,566,6784,0.714770047169811,1980,7655,691,795,37,5116,46,2274,18,46
"941","2020-05-06",234,11,232,540,6784,0.714770047169811,1980,7655,691,795,37,5153,38,2312,16,38
"942","2020-05-07",220,11,218,488,6784,0.714770047169811,1980,7655,691,795,54,5207,31,2343,25,31
"943","2020-05-08",211,11,208,458,6784,0.714770047169811,1980,7655,691,795,34,5241,31,2374,14,31
"944","2020-05-09",185,11,221,439,6784,0.714770047169811,1980,7655,691,795,38,5279,40,2414,15,40
"945","2020-05-10",182,11,199,389,6784,0.714770047169811,1980,7655,691,795,35,5314,38,2452,13,38
"946","2020-05-11",172,11,190,365,6784,0.714770047169811,1980,7655,691,795,30,5344,76,2528,14,76
"947","2020-05-12",151,11,214,350,6784,0.714770047169811,1980,7655,691,795,32,5376,60,2588,16,60
"948","2020-05-13",133,11,245,325,6784,0.714770047169811,1980,7655,691,795,32,5408,48,2636,11,48
"949","2020-05-14",129,11,252,318,6784,0.714770047169811,1980,7655,691,795,33,5441,36,2672,14,36
"950","2020-05-15",114,11,270,310,6784,0.714770047169811,1980,7655,691,795,33,5474,48,2720,7,48
"951","2020-05-16",119,11,273,294,6784,0.714770047169811,1980,7655,691,795,26,5500,37,2757,12,37
"952","2020-05-17",105,11,273,289,6784,0.714770047169811,1980,7655,691,795,16,5516,35,2792,5,35
"953","2020-05-18",100,11,241,267,6784,0.714770047169811,1980,7655,691,795,20,5536,37,2829,11,37
"954","2020-05-19",89,11,272,260,6784,0.714770047169811,1980,7655,691,795,20,5556,35,2864,4,35
"955","2020-05-20",92,11,238,250,6784,0.714770047169811,1980,7655,691,795,26,5582,38,2902,14,38
"956","2020-05-21",94,11,226,245,6784,0.714770047169811,1980,7655,691,795,24,5606,50,2952,8,50
"957","2020-05-22",98,11,226,226,6784,0.714770047169811,1980,7655,691,795,23,5629,43,2995,11,43
"958","2020-05-23",95,11,203,204,6784,0.714770047169811,1980,7655,691,795,15,5644,51,3046,5,51
"959","2020-05-24",85,11,186,195,6784,0.714770047169811,1980,7655,691,795,18,5662,30,3076,3,30
"960","2020-05-25",80,11,162,183,6784,0.714770047169811,1980,7655,691,795,22,5684,38,3114,10,38
"961","2020-05-26",78,11,170,175,6784,0.714770047169811,1980,7655,691,795,23,5707,32,3146,9,32
"962","2020-05-27",72,11,148,161,6784,0.714770047169811,1980,7655,691,795,19,5726,18,3164,9,18
"963","2020-05-28",61,11,189,164,6784,0.714770047169811,1980,7655,691,795,11,5737,27,3191,4,27
"964","2020-05-29",46,11,210,148,6784,0.714770047169811,1980,7655,691,795,14,5751,26,3217,3,26
"965","2020-05-30",47,11,208,136,6784,0.714770047169811,1980,7655,691,795,16,5767,33,3250,8,33
"966","2020-05-31",45,11,216,126,6784,0.714770047169811,1980,7655,691,795,20,5787,31,3281,9,31
"967","2020-06-01",42,11,193,118,6784,0.714770047169811,1980,7655,691,795,10,5797,40,3321,5,40
"968","2020-06-02",44,11,173,110,6784,0.714770047169811,1980,7655,691,795,10,5807,47,3368,4,47
"969","2020-06-03",43,11,161,104,6784,0.714770047169811,1980,7655,691,795,15,5822,40,3408,8,40
"970","2020-06-04",40,11,140,95,6784,0.714770047169811,1980,7655,691,795,15,5837,34,3442,7,34
"971","2020-06-05",40,11,115,95,6784,0.714770047169811,1980,7655,691,795,10,5847,47,3489,8,47
"972","2020-06-06",29,11,96,84,6784,0.714770047169811,1980,7655,691,795,4,5851,45,3534,1,45
"973","2020-06-07",27,11,85,81,6784,0.714770047169811,1980,7655,691,795,13,5864,60,3594,8,60
"974","2020-03-12",1,12,22,89,5574,0.493003229278794,1995,7485,652,795,18,36,8,24,4,8
"975","2020-03-13",3,12,37,129,5574,0.493003229278794,1995,7485,652,795,26,62,6,30,7,6
"976","2020-03-14",6,12,52,178,5574,0.493003229278794,1995,7485,652,795,26,88,21,51,7,21
"977","2020-03-15",19,12,70,228,5574,0.493003229278794,1995,7485,652,795,32,120,18,69,11,18
"978","2020-03-16",27,12,83,280,5574,0.493003229278794,1995,7485,652,795,23,143,28,97,13,28
"979","2020-03-17",30,12,96,331,5574,0.493003229278794,1995,7485,652,795,45,188,36,133,29,36
"980","2020-03-18",46,12,93,389,5574,0.493003229278794,1995,7485,652,795,31,219,19,152,22,19
"981","2020-03-19",58,12,99,429,5574,0.493003229278794,1995,7485,652,795,49,268,10,162,30,10
"982","2020-03-20",85,12,96,484,5574,0.493003229278794,1995,7485,652,795,60,328,23,185,39,23
"983","2020-03-21",150,12,113,556,5574,0.493003229278794,1995,7485,652,795,40,368,13,198,33,13
"984","2020-03-22",163,12,132,617,5574,0.493003229278794,1995,7485,652,795,62,430,15,213,52,15
"985","2020-03-23",161,12,147,661,5574,0.493003229278794,1995,7485,652,795,61,491,16,229,41,16
"986","2020-03-24",172,12,130,719,5574,0.493003229278794,1995,7485,652,795,48,539,18,247,25,18
"987","2020-03-25",174,12,137,739,5574,0.493003229278794,1995,7485,652,795,69,608,26,273,53,26
"988","2020-03-26",193,12,129,802,5574,0.493003229278794,1995,7485,652,795,69,677,50,323,50,50
"989","2020-03-27",254,12,128,859,5574,0.493003229278794,1995,7485,652,795,85,762,36,359,63,36
"990","2020-03-28",253,12,107,885,5574,0.493003229278794,1995,7485,652,795,79,841,26,385,60,26
"991","2020-03-29",269,12,101,927,5574,0.493003229278794,1995,7485,652,795,100,941,13,398,82,13
"992","2020-03-30",280,12,94,940,5574,0.493003229278794,1995,7485,652,795,74,1015,39,437,53,39
"993","2020-03-31",286,12,98,959,5574,0.493003229278794,1995,7485,652,795,90,1105,43,480,72,43
"994","2020-04-01",305,12,100,994,5574,0.493003229278794,1995,7485,652,795,95,1200,18,498,73,18
"995","2020-04-02",306,12,84,1019,5574,0.493003229278794,1995,7485,652,795,85,1285,15,513,70,15
"996","2020-04-03",346,12,87,1048,5574,0.493003229278794,1995,7485,652,795,95,1380,4,517,82,4
"997","2020-04-04",347,12,95,1043,5574,0.493003229278794,1995,7485,652,795,117,1497,19,536,89,19
"998","2020-04-05",336,12,108,1051,5574,0.493003229278794,1995,7485,652,795,114,1611,44,580,99,44
"999","2020-04-06",335,12,127,1043,5574,0.493003229278794,1995,7485,652,795,139,1750,28,608,120,28
"1000","2020-04-07",331,12,133,1047,5574,0.493003229278794,1995,7485,652,795,114,1864,21,629,96,21
"1001","2020-04-08",318,12,136,1048,5574,0.493003229278794,1995,7485,652,795,97,1961,11,640,80,11
"1002","2020-04-09",317,12,142,1041,5574,0.493003229278794,1995,7485,652,795,115,2076,4,644,104,4
"1003","2020-04-10",352,12,165,1028,5574,0.493003229278794,1995,7485,652,795,129,2205,13,657,102,13
"1004","2020-04-11",374,12,164,1027,5574,0.493003229278794,1995,7485,652,795,107,2312,8,665,88,8
"1005","2020-04-12",336,12,184,991,5574,0.493003229278794,1995,7485,652,795,119,2431,9,674,102,9
"1006","2020-04-13",322,12,193,990,5574,0.493003229278794,1995,7485,652,795,97,2528,40,714,84,40
"1007","2020-04-14",319,12,177,982,5574,0.493003229278794,1995,7485,652,795,108,2636,18,732,92,18
"1008","2020-04-15",326,12,157,956,5574,0.493003229278794,1995,7485,652,795,96,2732,20,752,74,20
"1009","2020-04-16",334,12,151,943,5574,0.493003229278794,1995,7485,652,795,109,2841,38,790,86,38
"1010","2020-04-17",334,12,138,926,5574,0.493003229278794,1995,7485,652,795,103,2944,26,816,86,26
"1011","2020-04-18",329,12,167,917,5574,0.493003229278794,1995,7485,652,795,101,3045,23,839,85,23
"1012","2020-04-19",320,12,178,915,5574,0.493003229278794,1995,7485,652,795,80,3125,24,863,61,24
"1013","2020-04-20",305,12,170,908,5574,0.493003229278794,1995,7485,652,795,88,3213,37,900,68,37
"1014","2020-04-21",301,12,173,896,5574,0.493003229278794,1995,7485,652,795,111,3324,24,924,91,24
"1015","2020-04-22",298,12,162,857,5574,0.493003229278794,1995,7485,652,795,66,3390,20,944,47,20
"1016","2020-04-23",288,12,170,842,5574,0.493003229278794,1995,7485,652,795,88,3478,58,1002,76,58
"1017","2020-04-24",285,12,199,812,5574,0.493003229278794,1995,7485,652,795,70,3548,18,1020,55,18
"1018","2020-04-25",282,12,201,814,5574,0.493003229278794,1995,7485,652,795,70,3618,23,1043,60,23
"1019","2020-04-26",255,12,186,799,5574,0.493003229278794,1995,7485,652,795,83,3701,52,1095,63,52
"1020","2020-04-27",251,12,183,794,5574,0.493003229278794,1995,7485,652,795,57,3758,17,1112,40,17
"1021","2020-04-28",255,12,185,795,5574,0.493003229278794,1995,7485,652,795,71,3829,21,1133,54,21
"1022","2020-04-29",253,12,175,774,5574,0.493003229278794,1995,7485,652,795,53,3882,18,1151,37,18
"1023","2020-04-30",248,12,192,790,5574,0.493003229278794,1995,7485,652,795,53,3935,23,1174,40,23
"1024","2020-05-01",261,12,180,787,5574,0.493003229278794,1995,7485,652,795,45,3980,18,1192,34,18
"1025","2020-05-02",262,12,170,771,5574,0.493003229278794,1995,7485,652,795,60,4040,21,1213,45,21
"1026","2020-05-03",274,12,153,757,5574,0.493003229278794,1995,7485,652,795,39,4079,10,1223,24,10
"1027","2020-05-04",262,12,144,751,5574,0.493003229278794,1995,7485,652,795,44,4123,13,1236,31,13
"1028","2020-05-05",237,12,166,731,5574,0.493003229278794,1995,7485,652,795,38,4161,43,1279,31,43
"1029","2020-05-06",237,12,205,713,5574,0.493003229278794,1995,7485,652,795,36,4197,28,1307,24,28
"1030","2020-05-07",246,12,223,699,5574,0.493003229278794,1995,7485,652,795,36,4233,22,1329,24,22
"1031","2020-05-08",274,12,238,683,5574,0.493003229278794,1995,7485,652,795,36,4269,14,1343,25,14
"1032","2020-05-09",256,12,234,665,5574,0.493003229278794,1995,7485,652,795,36,4305,13,1356,23,13
"1033","2020-05-10",220,12,239,643,5574,0.493003229278794,1995,7485,652,795,35,4340,41,1397,22,41
"1034","2020-05-11",232,12,232,634,5574,0.493003229278794,1995,7485,652,795,33,4373,18,1415,18,18
"1035","2020-05-12",233,12,230,619,5574,0.493003229278794,1995,7485,652,795,30,4403,30,1445,15,30
"1036","2020-05-13",224,12,222,610,5574,0.493003229278794,1995,7485,652,795,38,4441,23,1468,27,23
"1037","2020-05-14",210,12,228,592,5574,0.493003229278794,1995,7485,652,795,27,4468,22,1490,17,22
"1038","2020-05-15",191,12,212,566,5574,0.493003229278794,1995,7485,652,795,38,4506,40,1530,28,40
"1039","2020-05-16",205,12,203,536,5574,0.493003229278794,1995,7485,652,795,24,4530,17,1547,14,17
"1040","2020-05-17",201,12,206,515,5574,0.493003229278794,1995,7485,652,795,21,4551,17,1564,14,17
"1041","2020-05-18",187,12,209,501,5574,0.493003229278794,1995,7485,652,795,29,4580,34,1598,21,34
"1042","2020-05-19",176,12,204,469,5574,0.493003229278794,1995,7485,652,795,32,4612,62,1660,20,62
"1043","2020-05-20",181,12,219,450,5574,0.493003229278794,1995,7485,652,795,25,4637,44,1704,18,44
"1044","2020-05-21",176,12,214,427,5574,0.493003229278794,1995,7485,652,795,27,4664,22,1726,17,22
"1045","2020-05-22",167,12,209,410,5574,0.493003229278794,1995,7485,652,795,31,4695,10,1736,24,10
"1046","2020-05-23",155,12,222,381,5574,0.493003229278794,1995,7485,652,795,19,4714,27,1763,14,27
"1047","2020-05-24",138,12,216,358,5574,0.493003229278794,1995,7485,652,795,19,4733,15,1778,13,15
"1048","2020-05-25",134,12,229,349,5574,0.493003229278794,1995,7485,652,795,21,4754,36,1814,11,36
"1049","2020-05-26",126,12,235,317,5574,0.493003229278794,1995,7485,652,795,19,4773,34,1848,8,34
"1050","2020-05-27",116,12,208,299,5574,0.493003229278794,1995,7485,652,795,24,4797,50,1898,17,50
"1051","2020-05-28",113,12,195,274,5574,0.493003229278794,1995,7485,652,795,19,4816,28,1926,11,28
"1052","2020-05-29",109,12,183,264,5574,0.493003229278794,1995,7485,652,795,25,4841,13,1939,18,13
"1053","2020-05-30",108,12,184,252,5574,0.493003229278794,1995,7485,652,795,19,4860,13,1952,13,13
"1054","2020-05-31",93,12,178,234,5574,0.493003229278794,1995,7485,652,795,15,4875,23,1975,10,23
"1055","2020-06-01",86,12,160,212,5574,0.493003229278794,1995,7485,652,795,9,4884,19,1994,5,19
"1056","2020-06-02",79,12,162,200,5574,0.493003229278794,1995,7485,652,795,16,4900,8,2002,8,8
"1057","2020-06-03",75,12,161,198,5574,0.493003229278794,1995,7485,652,795,18,4918,19,2021,14,19
"1058","2020-06-04",72,12,161,193,5574,0.493003229278794,1995,7485,652,795,16,4934,21,2042,10,21
"1059","2020-06-05",67,12,160,176,5574,0.493003229278794,1995,7485,652,795,19,4953,46,2088,14,46
"1060","2020-06-06",62,12,151,173,5574,0.493003229278794,1995,7485,652,795,10,4963,34,2122,8,34
"1061","2020-06-07",60,12,147,165,5574,0.493003229278794,1995,7485,652,795,19,4982,24,2146,14,24
"1062","2020-03-13",1,13,53,36,5950,0.86436974789916,2055,7404,695,715,31,73,3,22,4,3
"1063","2020-03-14",3,13,64,56,5950,0.86436974789916,2055,7404,695,715,25,98,6,28,8,6
"1064","2020-03-15",3,13,82,74,5950,0.86436974789916,2055,7404,695,715,26,124,4,32,11,4
"1065","2020-03-16",4,13,88,99,5950,0.86436974789916,2055,7404,695,715,44,168,3,35,18,3
"1066","2020-03-17",6,13,91,131,5950,0.86436974789916,2055,7404,695,715,46,214,5,40,18,5
"1067","2020-03-18",10,13,91,169,5950,0.86436974789916,2055,7404,695,715,56,270,9,49,31,9
"1068","2020-03-19",18,13,100,217,5950,0.86436974789916,2055,7404,695,715,65,335,22,71,36,22
"1069","2020-03-20",29,13,108,251,5950,0.86436974789916,2055,7404,695,715,60,395,21,92,32,21
"1070","2020-03-21",48,13,103,307,5950,0.86436974789916,2055,7404,695,715,72,467,29,121,49,29
"1071","2020-03-22",62,13,103,340,5950,0.86436974789916,2055,7404,695,715,52,519,24,145,33,24
"1072","2020-03-23",73,13,108,409,5950,0.86436974789916,2055,7404,695,715,80,599,20,165,59,20
"1073","2020-03-24",80,13,105,455,5950,0.86436974789916,2055,7404,695,715,80,679,11,176,48,11
"1074","2020-03-25",85,13,110,506,5950,0.86436974789916,2055,7404,695,715,95,774,18,194,67,18
"1075","2020-03-26",89,13,108,550,5950,0.86436974789916,2055,7404,695,715,69,843,8,202,53,8
"1076","2020-03-27",117,13,121,613,5950,0.86436974789916,2055,7404,695,715,92,935,9,211,62,9
"1077","2020-03-28",173,13,110,657,5950,0.86436974789916,2055,7404,695,715,86,1021,18,229,56,18
"1078","2020-03-29",178,13,112,746,5950,0.86436974789916,2055,7404,695,715,113,1134,26,255,82,26
"1079","2020-03-30",175,13,109,840,5950,0.86436974789916,2055,7404,695,715,94,1228,26,281,71,26
"1080","2020-03-31",191,13,129,936,5950,0.86436974789916,2055,7404,695,715,85,1313,15,296,63,15
"1081","2020-04-01",220,13,145,1044,5950,0.86436974789916,2055,7404,695,715,90,1403,10,306,69,10
"1082","2020-04-02",239,13,132,1083,5950,0.86436974789916,2055,7404,695,715,95,1498,10,316,73,10
"1083","2020-04-03",345,13,149,1199,5950,0.86436974789916,2055,7404,695,715,100,1598,4,320,70,4
"1084","2020-04-04",339,13,163,1265,5950,0.86436974789916,2055,7404,695,715,87,1685,6,326,70,6
"1085","2020-04-05",401,13,167,1309,5950,0.86436974789916,2055,7404,695,715,122,1807,9,335,90,9
"1086","2020-04-06",406,13,158,1371,5950,0.86436974789916,2055,7404,695,715,92,1899,13,348,68,13
"1087","2020-04-07",405,13,149,1450,5950,0.86436974789916,2055,7404,695,715,96,1995,10,358,74,10
"1088","2020-04-08",427,13,152,1527,5950,0.86436974789916,2055,7404,695,715,88,2083,16,374,67,16
"1089","2020-04-09",453,13,149,1572,5950,0.86436974789916,2055,7404,695,715,110,2193,32,406,80,32
"1090","2020-04-10",551,13,137,1599,5950,0.86436974789916,2055,7404,695,715,116,2309,19,425,88,19
"1091","2020-04-11",582,13,138,1627,5950,0.86436974789916,2055,7404,695,715,93,2402,13,438,62,13
"1092","2020-04-12",517,13,137,1653,5950,0.86436974789916,2055,7404,695,715,94,2496,16,454,67,16
"1093","2020-04-13",537,13,125,1677,5950,0.86436974789916,2055,7404,695,715,92,2588,17,471,66,17
"1094","2020-04-14",529,13,128,1692,5950,0.86436974789916,2055,7404,695,715,121,2709,7,478,90,7
"1095","2020-04-15",528,13,136,1737,5950,0.86436974789916,2055,7404,695,715,80,2789,16,494,61,16
"1096","2020-04-16",538,13,145,1733,5950,0.86436974789916,2055,7404,695,715,75,2864,35,529,55,35
"1097","2020-04-17",582,13,156,1720,5950,0.86436974789916,2055,7404,695,715,111,2975,15,544,88,15
"1098","2020-04-18",607,13,153,1709,5950,0.86436974789916,2055,7404,695,715,82,3057,33,577,53,33
"1099","2020-04-19",581,13,161,1669,5950,0.86436974789916,2055,7404,695,715,96,3153,19,596,73,19
"1100","2020-04-20",576,13,145,1638,5950,0.86436974789916,2055,7404,695,715,84,3237,38,634,62,38
"1101","2020-04-21",577,13,144,1595,5950,0.86436974789916,2055,7404,695,715,77,3314,25,659,53,25
"1102","2020-04-22",565,13,161,1536,5950,0.86436974789916,2055,7404,695,715,61,3375,37,696,40,37
"1103","2020-04-23",544,13,173,1459,5950,0.86436974789916,2055,7404,695,715,65,3440,33,729,49,33
"1104","2020-04-24",555,13,173,1406,5950,0.86436974789916,2055,7404,695,715,59,3499,39,768,35,39
"1105","2020-04-25",509,13,171,1355,5950,0.86436974789916,2055,7404,695,715,44,3543,26,794,26,26
"1106","2020-04-26",473,13,166,1237,5950,0.86436974789916,2055,7404,695,715,81,3624,17,811,50,17
"1107","2020-04-27",451,13,167,1184,5950,0.86436974789916,2055,7404,695,715,53,3677,31,842,35,31
"1108","2020-04-28",429,13,203,1108,5950,0.86436974789916,2055,7404,695,715,39,3716,20,862,23,20
"1109","2020-04-29",418,13,187,1054,5950,0.86436974789916,2055,7404,695,715,63,3779,25,887,39,25
"1110","2020-04-30",408,13,199,1012,5950,0.86436974789916,2055,7404,695,715,68,3847,18,905,40,18
"1111","2020-05-01",353,13,212,935,5950,0.86436974789916,2055,7404,695,715,66,3913,28,933,40,28
"1112","2020-05-02",341,13,200,864,5950,0.86436974789916,2055,7404,695,715,64,3977,25,958,36,25
"1113","2020-05-03",312,13,190,798,5950,0.86436974789916,2055,7404,695,715,59,4036,38,996,35,38
"1114","2020-05-04",300,13,177,739,5950,0.86436974789916,2055,7404,695,715,46,4082,30,1026,29,30
"1115","2020-05-05",280,13,170,671,5950,0.86436974789916,2055,7404,695,715,49,4131,14,1040,27,14
"1116","2020-05-06",261,13,179,638,5950,0.86436974789916,2055,7404,695,715,42,4173,19,1059,29,19
"1117","2020-05-07",251,13,188,593,5950,0.86436974789916,2055,7404,695,715,46,4219,17,1076,28,17
"1118","2020-05-08",232,13,188,561,5950,0.86436974789916,2055,7404,695,715,54,4273,31,1107,28,31
"1119","2020-05-09",227,13,217,514,5950,0.86436974789916,2055,7404,695,715,49,4322,23,1130,28,23
"1120","2020-05-10",200,13,239,481,5950,0.86436974789916,2055,7404,695,715,42,4364,27,1157,29,27
"1121","2020-05-11",181,13,249,442,5950,0.86436974789916,2055,7404,695,715,43,4407,21,1178,27,21
"1122","2020-05-12",168,13,256,417,5950,0.86436974789916,2055,7404,695,715,32,4439,26,1204,19,26
"1123","2020-05-13",167,13,257,379,5950,0.86436974789916,2055,7404,695,715,42,4481,16,1220,32,16
"1124","2020-05-14",155,13,264,340,5950,0.86436974789916,2055,7404,695,715,41,4522,13,1233,27,13
"1125","2020-05-15",135,13,270,317,5950,0.86436974789916,2055,7404,695,715,37,4559,14,1247,21,14
"1126","2020-05-16",121,13,252,291,5950,0.86436974789916,2055,7404,695,715,21,4580,12,1259,11,12
"1127","2020-05-17",117,13,233,264,5950,0.86436974789916,2055,7404,695,715,35,4615,25,1284,20,25
"1128","2020-05-18",114,13,233,240,5950,0.86436974789916,2055,7404,695,715,29,4644,29,1313,13,29
"1129","2020-05-19",109,13,238,222,5950,0.86436974789916,2055,7404,695,715,32,4676,29,1342,16,29
"1130","2020-05-20",106,13,220,204,5950,0.86436974789916,2055,7404,695,715,26,4702,21,1363,16,21
"1131","2020-05-21",99,13,216,192,5950,0.86436974789916,2055,7404,695,715,35,4737,18,1381,22,18
"1132","2020-05-22",80,13,246,185,5950,0.86436974789916,2055,7404,695,715,24,4761,24,1405,15,24
"1133","2020-05-23",80,13,244,170,5950,0.86436974789916,2055,7404,695,715,30,4791,19,1424,10,19
"1134","2020-05-24",72,13,255,152,5950,0.86436974789916,2055,7404,695,715,24,4815,37,1461,19,37
"1135","2020-05-25",66,13,256,137,5950,0.86436974789916,2055,7404,695,715,15,4830,23,1484,8,23
"1136","2020-05-26",62,13,252,131,5950,0.86436974789916,2055,7404,695,715,22,4852,26,1510,12,26
"1137","2020-05-27",53,13,252,132,5950,0.86436974789916,2055,7404,695,715,17,4869,27,1537,13,27
"1138","2020-05-28",53,13,253,122,5950,0.86436974789916,2055,7404,695,715,30,4899,19,1556,16,19
"1139","2020-05-29",49,13,250,113,5950,0.86436974789916,2055,7404,695,715,27,4926,16,1572,15,16
"1140","2020-05-30",39,13,232,110,5950,0.86436974789916,2055,7404,695,715,13,4939,20,1592,4,20
"1141","2020-05-31",36,13,220,99,5950,0.86436974789916,2055,7404,695,715,12,4951,18,1610,7,18
"1142","2020-06-01",37,13,218,92,5950,0.86436974789916,2055,7404,695,715,18,4969,11,1621,6,11
"1143","2020-06-02",31,13,214,96,5950,0.86436974789916,2055,7404,695,715,19,4988,9,1630,6,9
"1144","2020-06-03",29,13,201,93,5950,0.86436974789916,2055,7404,695,715,16,5004,13,1643,6,13
"1145","2020-06-04",25,13,190,85,5950,0.86436974789916,2055,7404,695,715,15,5019,12,1655,6,12
"1146","2020-06-05",27,13,186,80,5950,0.86436974789916,2055,7404,695,715,9,5028,8,1663,5,8
"1147","2020-06-06",28,13,187,75,5950,0.86436974789916,2055,7404,695,715,9,5037,5,1668,6,5
"1148","2020-06-07",27,13,176,69,5950,0.86436974789916,2055,7404,695,715,13,5050,14,1682,9,14
"1149","2020-03-14",4,14,48,63,6179,0.864541187894481,2070,7634,536,892,27,93,25,54,13,25
"1150","2020-03-15",11,14,48,92,6179,0.864541187894481,2070,7634,536,892,41,134,13,67,21,13
"1151","2020-03-16",10,14,53,140,6179,0.864541187894481,2070,7634,536,892,45,179,11,78,30,11
"1152","2020-03-17",10,14,53,177,6179,0.864541187894481,2070,7634,536,892,43,222,28,106,28,28
"1153","2020-03-18",12,14,59,227,6179,0.864541187894481,2070,7634,536,892,54,276,13,119,33,13
"1154","2020-03-19",21,14,69,291,6179,0.864541187894481,2070,7634,536,892,59,335,12,131,35,12
"1155","2020-03-20",45,14,72,329,6179,0.864541187894481,2070,7634,536,892,66,401,3,134,47,3
"1156","2020-03-21",59,14,95,399,6179,0.864541187894481,2070,7634,536,892,68,469,11,145,48,11
"1157","2020-03-22",71,14,114,463,6179,0.864541187894481,2070,7634,536,892,59,528,27,172,44,27
"1158","2020-03-23",76,14,119,520,6179,0.864541187894481,2070,7634,536,892,62,590,51,223,40,51
"1159","2020-03-24",88,14,111,591,6179,0.864541187894481,2070,7634,536,892,66,656,20,243,52,20
"1160","2020-03-25",106,14,117,649,6179,0.864541187894481,2070,7634,536,892,83,739,16,259,63,16
"1161","2020-03-26",128,14,131,728,6179,0.864541187894481,2070,7634,536,892,62,801,48,307,50,48
"1162","2020-03-27",159,14,114,789,6179,0.864541187894481,2070,7634,536,892,94,895,34,341,74,34
"1163","2020-03-28",251,14,135,877,6179,0.864541187894481,2070,7634,536,892,88,983,21,362,64,21
"1164","2020-03-29",260,14,153,987,6179,0.864541187894481,2070,7634,536,892,115,1098,10,372,91,10
"1165","2020-03-30",266,14,186,1057,6179,0.864541187894481,2070,7634,536,892,83,1181,13,385,59,13
"1166","2020-03-31",281,14,209,1129,6179,0.864541187894481,2070,7634,536,892,85,1266,5,390,68,5
"1167","2020-04-01",308,14,224,1207,6179,0.864541187894481,2070,7634,536,892,94,1360,7,397,75,7
"1168","2020-04-02",325,14,230,1290,6179,0.864541187894481,2070,7634,536,892,103,1463,1,398,76,1
"1169","2020-04-03",447,14,240,1334,6179,0.864541187894481,2070,7634,536,892,111,1574,5,403,87,5
"1170","2020-04-04",435,14,249,1414,6179,0.864541187894481,2070,7634,536,892,90,1664,2,405,68,2
"1171","2020-04-05",439,14,232,1437,6179,0.864541187894481,2070,7634,536,892,93,1757,3,408,68,3
"1172","2020-04-06",458,14,211,1484,6179,0.864541187894481,2070,7634,536,892,90,1847,14,422,68,14
"1173","2020-04-07",454,14,186,1559,6179,0.864541187894481,2070,7634,536,892,85,1932,50,472,67,50
"1174","2020-04-08",461,14,173,1586,6179,0.864541187894481,2070,7634,536,892,99,2031,61,533,84,61
"1175","2020-04-09",471,14,166,1621,6179,0.864541187894481,2070,7634,536,892,88,2119,29,562,69,29
"1176","2020-04-10",512,14,151,1650,6179,0.864541187894481,2070,7634,536,892,92,2211,44,606,67,44
"1177","2020-04-11",525,14,176,1668,6179,0.864541187894481,2070,7634,536,892,114,2325,23,629,100,23
"1178","2020-04-12",525,14,212,1666,6179,0.864541187894481,2070,7634,536,892,85,2410,27,656,71,27
"1179","2020-04-13",514,14,241,1634,6179,0.864541187894481,2070,7634,536,892,97,2507,48,704,82,48
"1180","2020-04-14",512,14,246,1600,6179,0.864541187894481,2070,7634,536,892,88,2595,25,729,62,25
"1181","2020-04-15",523,14,249,1600,6179,0.864541187894481,2070,7634,536,892,94,2689,24,753,68,24
"1182","2020-04-16",534,14,223,1606,6179,0.864541187894481,2070,7634,536,892,93,2782,15,768,69,15
"1183","2020-04-17",616,14,252,1570,6179,0.864541187894481,2070,7634,536,892,67,2849,63,831,56,63
"1184","2020-04-18",591,14,256,1525,6179,0.864541187894481,2070,7634,536,892,79,2928,50,881,69,50
"1185","2020-04-19",538,14,250,1490,6179,0.864541187894481,2070,7634,536,892,73,3001,31,912,56,31
"1186","2020-04-20",538,14,252,1404,6179,0.864541187894481,2070,7634,536,892,73,3074,15,927,58,15
"1187","2020-04-21",539,14,241,1346,6179,0.864541187894481,2070,7634,536,892,89,3163,20,947,64,20
"1188","2020-04-22",523,14,227,1307,6179,0.864541187894481,2070,7634,536,892,69,3232,25,972,48,25
"1189","2020-04-23",495,14,228,1234,6179,0.864541187894481,2070,7634,536,892,85,3317,13,985,65,13
"1190","2020-04-24",451,14,220,1182,6179,0.864541187894481,2070,7634,536,892,54,3371,14,999,40,14
"1191","2020-04-25",440,14,193,1120,6179,0.864541187894481,2070,7634,536,892,75,3446,42,1041,58,42
"1192","2020-04-26",397,14,170,1073,6179,0.864541187894481,2070,7634,536,892,72,3518,47,1088,50,47
"1193","2020-04-27",375,14,197,1011,6179,0.864541187894481,2070,7634,536,892,79,3597,32,1120,65,32
"1194","2020-04-28",347,14,219,967,6179,0.864541187894481,2070,7634,536,892,70,3667,48,1168,52,48
"1195","2020-04-29",331,14,258,927,6179,0.864541187894481,2070,7634,536,892,56,3723,55,1223,37,55
"1196","2020-04-30",323,14,253,887,6179,0.864541187894481,2070,7634,536,892,63,3786,30,1253,48,30
"1197","2020-05-01",315,14,236,843,6179,0.864541187894481,2070,7634,536,892,75,3861,24,1277,55,24
"1198","2020-05-02",315,14,223,793,6179,0.864541187894481,2070,7634,536,892,60,3921,29,1306,44,29
"1199","2020-05-03",288,14,208,746,6179,0.864541187894481,2070,7634,536,892,52,3973,72,1378,42,72
"1200","2020-05-04",287,14,187,712,6179,0.864541187894481,2070,7634,536,892,62,4035,64,1442,50,64
"1201","2020-05-05",274,14,186,662,6179,0.864541187894481,2070,7634,536,892,87,4122,35,1477,68,35
"1202","2020-05-06",274,14,215,632,6179,0.864541187894481,2070,7634,536,892,60,4182,37,1514,43,37
"1203","2020-05-07",270,14,229,601,6179,0.864541187894481,2070,7634,536,892,61,4243,13,1527,45,13
"1204","2020-05-08",241,14,209,560,6179,0.864541187894481,2070,7634,536,892,64,4307,14,1541,46,14
"1205","2020-05-09",235,14,193,521,6179,0.864541187894481,2070,7634,536,892,55,4362,4,1545,42,4
"1206","2020-05-10",221,14,189,480,6179,0.864541187894481,2070,7634,536,892,55,4417,3,1548,34,3
"1207","2020-05-11",202,14,210,439,6179,0.864541187894481,2070,7634,536,892,45,4462,5,1553,26,5
"1208","2020-05-12",192,14,201,416,6179,0.864541187894481,2070,7634,536,892,39,4501,2,1555,30,2
"1209","2020-05-13",173,14,216,390,6179,0.864541187894481,2070,7634,536,892,51,4552,5,1560,34,5
"1210","2020-05-14",152,14,218,371,6179,0.864541187894481,2070,7634,536,892,30,4582,12,1572,20,12
"1211","2020-05-15",145,14,201,350,6179,0.864541187894481,2070,7634,536,892,34,4616,49,1621,21,49
"1212","2020-05-16",126,14,172,332,6179,0.864541187894481,2070,7634,536,892,43,4659,28,1649,31,28
"1213","2020-05-17",113,14,171,318,6179,0.864541187894481,2070,7634,536,892,20,4679,22,1671,14,22
"1214","2020-05-18",107,14,200,294,6179,0.864541187894481,2070,7634,536,892,34,4713,20,1691,25,20
"1215","2020-05-19",105,14,221,268,6179,0.864541187894481,2070,7634,536,892,27,4740,12,1703,19,12
"1216","2020-05-20",101,14,205,248,6179,0.864541187894481,2070,7634,536,892,33,4773,8,1711,23,8
"1217","2020-05-21",102,14,212,236,6179,0.864541187894481,2070,7634,536,892,26,4799,8,1719,21,8
"1218","2020-05-22",84,14,206,235,6179,0.864541187894481,2070,7634,536,892,17,4816,6,1725,10,6
"1219","2020-05-23",85,14,177,228,6179,0.864541187894481,2070,7634,536,892,14,4830,11,1736,9,11
"1220","2020-05-24",78,14,189,218,6179,0.864541187894481,2070,7634,536,892,19,4849,36,1772,13,36
"1221","2020-05-25",78,14,225,207,6179,0.864541187894481,2070,7634,536,892,26,4875,23,1795,19,23
"1222","2020-05-26",70,14,208,202,6179,0.864541187894481,2070,7634,536,892,27,4902,35,1830,19,35
"1223","2020-05-27",66,14,200,194,6179,0.864541187894481,2070,7634,536,892,22,4924,44,1874,12,44
"1224","2020-05-28",63,14,213,196,6179,0.864541187894481,2070,7634,536,892,27,4951,53,1927,22,53
"1225","2020-05-29",72,14,208,182,6179,0.864541187894481,2070,7634,536,892,21,4972,20,1947,12,20
"1226","2020-05-30",74,14,180,178,6179,0.864541187894481,2070,7634,536,892,17,4989,25,1972,12,25
"1227","2020-05-31",62,14,178,177,6179,0.864541187894481,2070,7634,536,892,17,5006,28,2000,13,28
"1228","2020-06-01",57,14,162,172,6179,0.864541187894481,2070,7634,536,892,12,5018,25,2025,9,25
"1229","2020-06-02",59,14,151,164,6179,0.864541187894481,2070,7634,536,892,20,5038,23,2048,11,23
"1230","2020-06-03",61,14,156,160,6179,0.864541187894481,2070,7634,536,892,15,5053,30,2078,10,30
"1231","2020-06-04",59,14,168,155,6179,0.864541187894481,2070,7634,536,892,21,5074,22,2100,14,22
"1232","2020-06-05",55,14,170,146,6179,0.864541187894481,2070,7634,536,892,19,5093,36,2136,14,36
"1233","2020-06-06",62,14,163,146,6179,0.864541187894481,2070,7634,536,892,10,5103,11,2147,4,11
"1234","2020-06-07",58,14,165,139,6179,0.864541187894481,2070,7634,536,892,12,5115,30,2177,11,30
"1235","2020-03-12",1,15,71,108,6496,0.50923645320197,2175,8803,676,1333,50,90,2,8,1,2
"1236","2020-03-13",4,15,124,164,6496,0.50923645320197,2175,8803,676,1333,51,141,5,13,3,5
"1237","2020-03-14",15,15,129,240,6496,0.50923645320197,2175,8803,676,1333,53,194,4,17,9,4
"1238","2020-03-15",31,15,168,313,6496,0.50923645320197,2175,8803,676,1333,72,266,2,19,16,2
"1239","2020-03-16",33,15,202,394,6496,0.50923645320197,2175,8803,676,1333,62,328,5,24,12,5
"1240","2020-03-17",41,15,207,477,6496,0.50923645320197,2175,8803,676,1333,61,389,8,32,29,8
"1241","2020-03-18",53,15,232,568,6496,0.50923645320197,2175,8803,676,1333,63,452,7,39,23,7
"1242","2020-03-19",68,15,261,636,6496,0.50923645320197,2175,8803,676,1333,80,532,7,46,44,7
"1243","2020-03-20",127,15,259,698,6496,0.50923645320197,2175,8803,676,1333,85,617,9,55,31,9
"1244","2020-03-21",154,15,278,766,6496,0.50923645320197,2175,8803,676,1333,80,697,12,67,42,12
"1245","2020-03-22",208,15,277,825,6496,0.50923645320197,2175,8803,676,1333,93,790,14,81,39,14
"1246","2020-03-23",224,15,256,899,6496,0.50923645320197,2175,8803,676,1333,70,860,11,92,40,11
"1247","2020-03-24",236,15,227,970,6496,0.50923645320197,2175,8803,676,1333,75,935,19,111,39,19
"1248","2020-03-25",265,15,197,1002,6496,0.50923645320197,2175,8803,676,1333,87,1022,23,134,46,23
"1249","2020-03-26",287,15,176,1034,6496,0.50923645320197,2175,8803,676,1333,111,1133,23,157,60,23
"1250","2020-03-27",368,15,178,1054,6496,0.50923645320197,2175,8803,676,1333,87,1220,16,173,41,16
"1251","2020-03-28",378,15,207,1094,6496,0.50923645320197,2175,8803,676,1333,108,1328,18,191,55,18
"1252","2020-03-29",375,15,220,1153,6496,0.50923645320197,2175,8803,676,1333,95,1423,18,209,49,18
"1253","2020-03-30",402,15,199,1183,6496,0.50923645320197,2175,8803,676,1333,101,1524,25,234,59,25
"1254","2020-03-31",400,15,185,1182,6496,0.50923645320197,2175,8803,676,1333,91,1615,17,251,46,17
"1255","2020-04-01",408,15,171,1212,6496,0.50923645320197,2175,8803,676,1333,85,1700,11,262,53,11
"1256","2020-04-02",406,15,156,1206,6496,0.50923645320197,2175,8803,676,1333,117,1817,16,278,54,16
"1257","2020-04-03",455,15,220,1218,6496,0.50923645320197,2175,8803,676,1333,101,1918,16,294,38,16
"1258","2020-04-04",475,15,227,1207,6496,0.50923645320197,2175,8803,676,1333,102,2020,14,308,49,14
"1259","2020-04-05",402,15,246,1206,6496,0.50923645320197,2175,8803,676,1333,77,2097,32,340,34,32
"1260","2020-04-06",381,15,245,1192,6496,0.50923645320197,2175,8803,676,1333,106,2203,7,347,48,7
"1261","2020-04-07",364,15,277,1158,6496,0.50923645320197,2175,8803,676,1333,101,2304,33,380,49,33
"1262","2020-04-08",365,15,273,1147,6496,0.50923645320197,2175,8803,676,1333,78,2382,29,409,46,29
"1263","2020-04-09",368,15,303,1113,6496,0.50923645320197,2175,8803,676,1333,87,2469,23,432,36,23
"1264","2020-04-10",382,15,314,1104,6496,0.50923645320197,2175,8803,676,1333,91,2560,22,454,54,22
"1265","2020-04-11",391,15,313,1086,6496,0.50923645320197,2175,8803,676,1333,87,2647,16,470,52,16
"1266","2020-04-12",391,15,273,1064,6496,0.50923645320197,2175,8803,676,1333,72,2719,26,496,35,26
"1267","2020-04-13",394,15,242,1051,6496,0.50923645320197,2175,8803,676,1333,78,2797,16,512,34,16
"1268","2020-04-14",395,15,222,1057,6496,0.50923645320197,2175,8803,676,1333,95,2892,32,544,45,32
"1269","2020-04-15",376,15,185,1063,6496,0.50923645320197,2175,8803,676,1333,91,2983,16,560,46,16
"1270","2020-04-16",368,15,168,1046,6496,0.50923645320197,2175,8803,676,1333,72,3055,6,566,28,6
"1271","2020-04-17",398,15,178,1053,6496,0.50923645320197,2175,8803,676,1333,81,3136,6,572,29,6
"1272","2020-04-18",384,15,197,1022,6496,0.50923645320197,2175,8803,676,1333,70,3206,15,587,30,15
"1273","2020-04-19",356,15,193,1033,6496,0.50923645320197,2175,8803,676,1333,111,3317,27,614,64,27
"1274","2020-04-20",339,15,236,1015,6496,0.50923645320197,2175,8803,676,1333,77,3394,30,644,43,30
"1275","2020-04-21",339,15,247,991,6496,0.50923645320197,2175,8803,676,1333,87,3481,23,667,38,23
"1276","2020-04-22",349,15,225,980,6496,0.50923645320197,2175,8803,676,1333,79,3560,16,683,30,16
"1277","2020-04-23",347,15,215,965,6496,0.50923645320197,2175,8803,676,1333,74,3634,47,730,42,47
"1278","2020-04-24",329,15,209,934,6496,0.50923645320197,2175,8803,676,1333,57,3691,32,762,24,32
"1279","2020-04-25",325,15,229,923,6496,0.50923645320197,2175,8803,676,1333,85,3776,24,786,31,24
"1280","2020-04-26",336,15,287,899,6496,0.50923645320197,2175,8803,676,1333,58,3834,31,817,28,31
"1281","2020-04-27",327,15,301,860,6496,0.50923645320197,2175,8803,676,1333,61,3895,18,835,25,18
"1282","2020-04-28",302,15,262,833,6496,0.50923645320197,2175,8803,676,1333,57,3952,22,857,26,22
"1283","2020-04-29",289,15,256,814,6496,0.50923645320197,2175,8803,676,1333,79,4031,23,880,29,23
"1284","2020-04-30",283,15,258,804,6496,0.50923645320197,2175,8803,676,1333,72,4103,33,913,19,33
"1285","2020-05-01",282,15,228,760,6496,0.50923645320197,2175,8803,676,1333,63,4166,29,942,29,29
"1286","2020-05-02",276,15,222,714,6496,0.50923645320197,2175,8803,676,1333,50,4216,23,965,14,23
"1287","2020-05-03",219,15,204,698,6496,0.50923645320197,2175,8803,676,1333,65,4281,32,997,26,32
"1288","2020-05-04",211,15,213,677,6496,0.50923645320197,2175,8803,676,1333,44,4325,39,1036,19,39
"1289","2020-05-05",209,15,233,664,6496,0.50923645320197,2175,8803,676,1333,50,4375,42,1078,16,42
"1290","2020-05-06",214,15,214,650,6496,0.50923645320197,2175,8803,676,1333,54,4429,34,1112,19,34
"1291","2020-05-07",217,15,206,628,6496,0.50923645320197,2175,8803,676,1333,57,4486,35,1147,22,35
"1292","2020-05-08",209,15,223,618,6496,0.50923645320197,2175,8803,676,1333,47,4533,47,1194,18,47
"1293","2020-05-09",211,15,202,620,6496,0.50923645320197,2175,8803,676,1333,46,4579,22,1216,16,22
"1294","2020-05-10",210,15,218,618,6496,0.50923645320197,2175,8803,676,1333,50,4629,14,1230,21,14
"1295","2020-05-11",211,15,239,612,6496,0.50923645320197,2175,8803,676,1333,51,4680,17,1247,21,17
"1296","2020-05-12",204,15,234,610,6496,0.50923645320197,2175,8803,676,1333,35,4715,20,1267,7,20
"1297","2020-05-13",194,15,231,622,6496,0.50923645320197,2175,8803,676,1333,43,4758,36,1303,14,36
"1298","2020-05-14",195,15,204,611,6496,0.50923645320197,2175,8803,676,1333,42,4800,54,1357,20,54
"1299","2020-05-15",196,15,197,591,6496,0.50923645320197,2175,8803,676,1333,30,4830,16,1373,11,16
"1300","2020-05-16",216,15,163,584,6496,0.50923645320197,2175,8803,676,1333,44,4874,28,1401,18,28
"1301","2020-05-17",198,15,172,562,6496,0.50923645320197,2175,8803,676,1333,36,4910,14,1415,15,14
"1302","2020-05-18",185,15,243,545,6496,0.50923645320197,2175,8803,676,1333,32,4942,17,1432,10,17
"1303","2020-05-19",175,15,287,523,6496,0.50923645320197,2175,8803,676,1333,28,4970,14,1446,12,14
"1304","2020-05-20",171,15,325,495,6496,0.50923645320197,2175,8803,676,1333,27,4997,27,1473,10,27
"1305","2020-05-21",167,15,343,477,6496,0.50923645320197,2175,8803,676,1333,29,5026,28,1501,7,28
"1306","2020-05-22",164,15,330,461,6496,0.50923645320197,2175,8803,676,1333,30,5056,18,1519,8,18
"1307","2020-05-23",152,15,298,442,6496,0.50923645320197,2175,8803,676,1333,29,5085,27,1546,10,27
"1308","2020-05-24",150,15,320,433,6496,0.50923645320197,2175,8803,676,1333,23,5108,30,1576,7,30
"1309","2020-05-25",151,15,316,433,6496,0.50923645320197,2175,8803,676,1333,25,5133,15,1591,7,15
"1310","2020-05-26",150,15,337,424,6496,0.50923645320197,2175,8803,676,1333,10,5143,27,1618,3,27
"1311","2020-05-27",150,15,321,396,6496,0.50923645320197,2175,8803,676,1333,24,5167,26,1644,10,26
"1312","2020-05-28",136,15,285,393,6496,0.50923645320197,2175,8803,676,1333,21,5188,18,1662,6,18
"1313","2020-05-29",146,15,301,360,6496,0.50923645320197,2175,8803,676,1333,24,5212,14,1676,7,14
"1314","2020-05-30",144,15,300,362,6496,0.50923645320197,2175,8803,676,1333,18,5230,17,1693,8,17
"1315","2020-05-31",141,15,279,345,6496,0.50923645320197,2175,8803,676,1333,27,5257,34,1727,8,34
"1316","2020-06-01",128,15,275,329,6496,0.50923645320197,2175,8803,676,1333,16,5273,31,1758,5,31
"1317","2020-06-02",120,15,251,317,6496,0.50923645320197,2175,8803,676,1333,24,5297,18,1776,6,18
"1318","2020-06-03",108,15,261,296,6496,0.50923645320197,2175,8803,676,1333,13,5310,11,1787,3,11
"1319","2020-06-04",112,15,248,285,6496,0.50923645320197,2175,8803,676,1333,17,5327,15,1802,6,15
"1320","2020-06-05",97,15,227,270,6496,0.50923645320197,2175,8803,676,1333,12,5339,15,1817,5,15
"1321","2020-06-06",91,15,196,261,6496,0.50923645320197,2175,8803,676,1333,20,5359,17,1834,5,17
"1322","2020-06-07",78,15,178,235,6496,0.50923645320197,2175,8803,676,1333,13,5372,17,1851,5,17
"1323","2020-03-13",1,16,96,37,6102,0.842838413634874,2100,7329,588,986,43,104,17,69,9,17
"1324","2020-03-14",2,16,106,49,6102,0.842838413634874,2100,7329,588,986,41,145,13,82,10,13
"1325","2020-03-15",10,16,102,76,6102,0.842838413634874,2100,7329,588,986,38,183,16,98,15,16
"1326","2020-03-16",13,16,105,106,6102,0.842838413634874,2100,7329,588,986,56,239,37,135,18,37
"1327","2020-03-17",11,16,105,134,6102,0.842838413634874,2100,7329,588,986,53,292,47,182,24,47
"1328","2020-03-18",17,16,107,166,6102,0.842838413634874,2100,7329,588,986,74,366,35,217,44,35
"1329","2020-03-19",19,16,113,208,6102,0.842838413634874,2100,7329,588,986,72,438,22,239,47,22
"1330","2020-03-20",25,16,146,238,6102,0.842838413634874,2100,7329,588,986,73,511,28,267,39,28
"1331","2020-03-21",46,16,158,280,6102,0.842838413634874,2100,7329,588,986,81,592,28,295,53,28
"1332","2020-03-22",54,16,176,322,6102,0.842838413634874,2100,7329,588,986,76,668,31,326,47,31
"1333","2020-03-23",60,16,171,373,6102,0.842838413634874,2100,7329,588,986,73,741,48,374,45,48
"1334","2020-03-24",66,16,192,426,6102,0.842838413634874,2100,7329,588,986,107,848,57,431,71,57
"1335","2020-03-25",78,16,181,490,6102,0.842838413634874,2100,7329,588,986,91,939,40,471,60,40
"1336","2020-03-26",90,16,191,535,6102,0.842838413634874,2100,7329,588,986,129,1068,45,516,98,45
"1337","2020-03-27",138,16,187,600,6102,0.842838413634874,2100,7329,588,986,84,1152,33,549,55,33
"1338","2020-03-28",185,16,151,663,6102,0.842838413634874,2100,7329,588,986,106,1258,29,578,69,29
"1339","2020-03-29",189,16,147,742,6102,0.842838413634874,2100,7329,588,986,95,1353,52,630,70,52
"1340","2020-03-30",184,16,141,810,6102,0.842838413634874,2100,7329,588,986,119,1472,51,681,91,51
"1341","2020-03-31",197,16,157,930,6102,0.842838413634874,2100,7329,588,986,100,1572,41,722,77,41
"1342","2020-04-01",211,16,178,1005,6102,0.842838413634874,2100,7329,588,986,132,1704,31,753,106,31
"1343","2020-04-02",237,16,183,1077,6102,0.842838413634874,2100,7329,588,986,114,1818,33,786,84,33
"1344","2020-04-03",310,16,174,1172,6102,0.842838413634874,2100,7329,588,986,116,1934,44,830,80,44
"1345","2020-04-04",369,16,155,1234,6102,0.842838413634874,2100,7329,588,986,116,2050,44,874,89,44
"1346","2020-04-05",368,16,162,1319,6102,0.842838413634874,2100,7329,588,986,101,2151,58,932,76,58
"1347","2020-04-06",372,16,182,1384,6102,0.842838413634874,2100,7329,588,986,109,2260,54,986,76,54
"1348","2020-04-07",408,16,181,1470,6102,0.842838413634874,2100,7329,588,986,133,2393,47,1033,101,47
"1349","2020-04-08",422,16,199,1522,6102,0.842838413634874,2100,7329,588,986,87,2480,42,1075,54,42
"1350","2020-04-09",430,16,224,1581,6102,0.842838413634874,2100,7329,588,986,113,2593,35,1110,85,35
"1351","2020-04-10",568,16,250,1666,6102,0.842838413634874,2100,7329,588,986,123,2716,34,1144,88,34
"1352","2020-04-11",554,16,238,1726,6102,0.842838413634874,2100,7329,588,986,77,2793,37,1181,60,37
"1353","2020-04-12",546,16,227,1776,6102,0.842838413634874,2100,7329,588,986,90,2883,28,1209,64,28
"1354","2020-04-13",547,16,199,1771,6102,0.842838413634874,2100,7329,588,986,107,2990,54,1263,83,54
"1355","2020-04-14",548,16,213,1747,6102,0.842838413634874,2100,7329,588,986,113,3103,44,1307,79,44
"1356","2020-04-15",555,16,210,1759,6102,0.842838413634874,2100,7329,588,986,92,3195,52,1359,61,52
"1357","2020-04-16",574,16,193,1735,6102,0.842838413634874,2100,7329,588,986,95,3290,27,1386,67,27
"1358","2020-04-17",611,16,198,1729,6102,0.842838413634874,2100,7329,588,986,91,3381,43,1429,49,43
"1359","2020-04-18",596,16,216,1685,6102,0.842838413634874,2100,7329,588,986,82,3463,52,1481,56,52
"1360","2020-04-19",553,16,207,1656,6102,0.842838413634874,2100,7329,588,986,78,3541,59,1540,64,59
"1361","2020-04-20",554,16,227,1592,6102,0.842838413634874,2100,7329,588,986,77,3618,40,1580,42,40
"1362","2020-04-21",525,16,210,1606,6102,0.842838413634874,2100,7329,588,986,74,3692,40,1620,47,40
"1363","2020-04-22",540,16,217,1557,6102,0.842838413634874,2100,7329,588,986,83,3775,43,1663,59,43
"1364","2020-04-23",542,16,242,1500,6102,0.842838413634874,2100,7329,588,986,86,3861,26,1689,58,26
"1365","2020-04-24",566,16,229,1434,6102,0.842838413634874,2100,7329,588,986,66,3927,31,1720,44,31
"1366","2020-04-25",585,16,221,1375,6102,0.842838413634874,2100,7329,588,986,58,3985,28,1748,41,28
"1367","2020-04-26",525,16,207,1296,6102,0.842838413634874,2100,7329,588,986,54,4039,37,1785,33,37
"1368","2020-04-27",499,16,220,1241,6102,0.842838413634874,2100,7329,588,986,67,4106,39,1824,38,39
"1369","2020-04-28",478,16,197,1151,6102,0.842838413634874,2100,7329,588,986,62,4168,32,1856,31,32
"1370","2020-04-29",454,16,214,1072,6102,0.842838413634874,2100,7329,588,986,64,4232,38,1894,42,38
"1371","2020-04-30",423,16,210,1015,6102,0.842838413634874,2100,7329,588,986,57,4289,34,1928,29,34
"1372","2020-05-01",362,16,220,953,6102,0.842838413634874,2100,7329,588,986,68,4357,30,1958,42,30
"1373","2020-05-02",343,16,238,874,6102,0.842838413634874,2100,7329,588,986,57,4414,32,1990,26,32
"1374","2020-05-03",317,16,256,812,6102,0.842838413634874,2100,7329,588,986,51,4465,37,2027,29,37
"1375","2020-05-04",295,16,254,745,6102,0.842838413634874,2100,7329,588,986,48,4513,45,2072,26,45
"1376","2020-05-05",286,16,230,688,6102,0.842838413634874,2100,7329,588,986,44,4557,42,2114,25,42
"1377","2020-05-06",258,16,225,645,6102,0.842838413634874,2100,7329,588,986,45,4602,61,2175,24,61
"1378","2020-05-07",241,16,251,612,6102,0.842838413634874,2100,7329,588,986,52,4654,64,2239,28,64
"1379","2020-05-08",230,16,297,572,6102,0.842838413634874,2100,7329,588,986,45,4699,30,2269,27,30
"1380","2020-05-09",229,16,320,533,6102,0.842838413634874,2100,7329,588,986,45,4744,51,2320,23,51
"1381","2020-05-10",211,16,307,486,6102,0.842838413634874,2100,7329,588,986,41,4785,34,2354,25,34
"1382","2020-05-11",198,16,284,446,6102,0.842838413634874,2100,7329,588,986,38,4823,37,2391,22,37
"1383","2020-05-12",183,16,283,416,6102,0.842838413634874,2100,7329,588,986,36,4859,28,2419,28,28
"1384","2020-05-13",182,16,293,388,6102,0.842838413634874,2100,7329,588,986,39,4898,44,2463,19,44
"1385","2020-05-14",178,16,290,363,6102,0.842838413634874,2100,7329,588,986,32,4930,39,2502,20,39
"1386","2020-05-15",152,16,295,334,6102,0.842838413634874,2100,7329,588,986,40,4970,35,2537,28,35
"1387","2020-05-16",136,16,263,315,6102,0.842838413634874,2100,7329,588,986,36,5006,23,2560,13,23
"1388","2020-05-17",118,16,241,301,6102,0.842838413634874,2100,7329,588,986,29,5035,42,2602,13,42
"1389","2020-05-18",116,16,240,279,6102,0.842838413634874,2100,7329,588,986,34,5069,39,2641,16,39
"1390","2020-05-19",114,16,225,253,6102,0.842838413634874,2100,7329,588,986,28,5097,33,2674,12,33
"1391","2020-05-20",108,16,234,241,6102,0.842838413634874,2100,7329,588,986,23,5120,37,2711,11,37
"1392","2020-05-21",98,16,207,220,6102,0.842838413634874,2100,7329,588,986,32,5152,42,2753,17,42
"1393","2020-05-22",86,16,207,213,6102,0.842838413634874,2100,7329,588,986,21,5173,51,2804,10,51
"1394","2020-05-23",81,16,183,211,6102,0.842838413634874,2100,7329,588,986,20,5193,32,2836,11,32
"1395","2020-05-24",74,16,200,202,6102,0.842838413634874,2100,7329,588,986,25,5218,31,2867,11,31
"1396","2020-05-25",71,16,218,195,6102,0.842838413634874,2100,7329,588,986,26,5244,34,2901,15,34
"1397","2020-05-26",59,16,231,181,6102,0.842838413634874,2100,7329,588,986,19,5263,44,2945,10,44
"1398","2020-05-27",57,16,245,159,6102,0.842838413634874,2100,7329,588,986,26,5289,43,2988,14,43
"1399","2020-05-28",57,16,239,147,6102,0.842838413634874,2100,7329,588,986,18,5307,48,3036,11,48
"1400","2020-05-29",60,16,211,143,6102,0.842838413634874,2100,7329,588,986,18,5325,40,3076,7,40
"1401","2020-05-30",57,16,205,137,6102,0.842838413634874,2100,7329,588,986,19,5344,33,3109,8,33
"1402","2020-05-31",49,16,193,127,6102,0.842838413634874,2100,7329,588,986,11,5355,31,3140,6,31
"1403","2020-06-01",42,16,195,122,6102,0.842838413634874,2100,7329,588,986,15,5370,39,3179,5,39
"1404","2020-06-02",44,16,189,111,6102,0.842838413634874,2100,7329,588,986,14,5384,41,3220,5,41
"1405","2020-06-03",42,16,178,104,6102,0.842838413634874,2100,7329,588,986,11,5395,42,3262,6,42
"1406","2020-06-04",40,16,185,101,6102,0.842838413634874,2100,7329,588,986,11,5406,31,3293,6,31
"1407","2020-06-05",31,16,195,100,6102,0.842838413634874,2100,7329,588,986,12,5418,32,3325,6,32
"1408","2020-06-06",29,16,198,86,6102,0.842838413634874,2100,7329,588,986,10,5428,40,3365,6,40
"1409","2020-06-07",32,16,213,79,6102,0.842838413634874,2100,7329,588,986,14,5442,47,3412,6,47
"1410","2020-03-13",2,17,36,70,5709,0.656857593273778,2025,7630,659,921,11,25,18,55,9,18
"1411","2020-03-14",5,17,50,98,5709,0.656857593273778,2025,7630,659,921,20,45,16,71,18,16
"1412","2020-03-15",11,17,66,147,5709,0.656857593273778,2025,7630,659,921,21,66,23,94,15,23
"1413","2020-03-16",16,17,104,186,5709,0.656857593273778,2025,7630,659,921,26,92,28,122,23,28
"1414","2020-03-17",22,17,122,228,5709,0.656857593273778,2025,7630,659,921,28,120,22,144,23,22
"1415","2020-03-18",28,17,121,272,5709,0.656857593273778,2025,7630,659,921,50,170,31,175,40,31
"1416","2020-03-19",36,17,116,322,5709,0.656857593273778,2025,7630,659,921,45,215,10,185,40,10
"1417","2020-03-20",53,17,100,377,5709,0.656857593273778,2025,7630,659,921,51,266,10,195,47,10
"1418","2020-03-21",83,17,97,436,5709,0.656857593273778,2025,7630,659,921,54,320,18,213,48,18
"1419","2020-03-22",105,17,91,466,5709,0.656857593273778,2025,7630,659,921,63,383,32,245,57,32
"1420","2020-03-23",114,17,86,521,5709,0.656857593273778,2025,7630,659,921,77,460,25,270,70,25
"1421","2020-03-24",125,17,79,555,5709,0.656857593273778,2025,7630,659,921,88,548,44,314,79,44
"1422","2020-03-25",137,17,115,598,5709,0.656857593273778,2025,7630,659,921,100,648,39,353,95,39
"1423","2020-03-26",147,17,128,648,5709,0.656857593273778,2025,7630,659,921,86,734,29,382,81,29
"1424","2020-03-27",196,17,135,701,5709,0.656857593273778,2025,7630,659,921,123,857,32,414,116,32
"1425","2020-03-28",223,17,129,773,5709,0.656857593273778,2025,7630,659,921,96,953,40,454,91,40
"1426","2020-03-29",216,17,134,820,5709,0.656857593273778,2025,7630,659,921,128,1081,32,486,121,32
"1427","2020-03-30",223,17,157,874,5709,0.656857593273778,2025,7630,659,921,127,1208,36,522,124,36
"1428","2020-03-31",224,17,154,909,5709,0.656857593273778,2025,7630,659,921,122,1330,23,545,115,23
"1429","2020-04-01",228,17,153,969,5709,0.656857593273778,2025,7630,659,921,123,1453,15,560,120,15
"1430","2020-04-02",242,17,154,1012,5709,0.656857593273778,2025,7630,659,921,104,1557,40,600,100,40
"1431","2020-04-03",314,17,147,1057,5709,0.656857593273778,2025,7630,659,921,144,1701,15,615,139,15
"1432","2020-04-04",319,17,145,1125,5709,0.656857593273778,2025,7630,659,921,169,1870,19,634,163,19
"1433","2020-04-05",354,17,141,1144,5709,0.656857593273778,2025,7630,659,921,169,2039,35,669,165,35
"1434","2020-04-06",354,17,188,1196,5709,0.656857593273778,2025,7630,659,921,145,2184,47,716,137,47
"1435","2020-04-07",368,17,212,1251,5709,0.656857593273778,2025,7630,659,921,191,2375,32,748,185,32
"1436","2020-04-08",390,17,211,1288,5709,0.656857593273778,2025,7630,659,921,188,2563,48,796,180,48
"1437","2020-04-09",402,17,188,1273,5709,0.656857593273778,2025,7630,659,921,192,2755,52,848,190,52
"1438","2020-04-10",482,17,188,1320,5709,0.656857593273778,2025,7630,659,921,162,2917,43,891,157,43
"1439","2020-04-11",474,17,195,1350,5709,0.656857593273778,2025,7630,659,921,174,3091,47,938,167,47
"1440","2020-04-12",405,17,188,1343,5709,0.656857593273778,2025,7630,659,921,173,3264,77,1015,168,77
"1441","2020-04-13",422,17,176,1363,5709,0.656857593273778,2025,7630,659,921,157,3421,36,1051,154,36
"1442","2020-04-14",427,17,163,1356,5709,0.656857593273778,2025,7630,659,921,113,3534,38,1089,112,38
"1443","2020-04-15",433,17,158,1319,5709,0.656857593273778,2025,7630,659,921,146,3680,9,1098,144,9
"1444","2020-04-16",434,17,155,1328,5709,0.656857593273778,2025,7630,659,921,120,3800,28,1126,113,28
"1445","2020-04-17",429,17,201,1293,5709,0.656857593273778,2025,7630,659,921,162,3962,22,1148,157,22
"1446","2020-04-18",448,17,224,1266,5709,0.656857593273778,2025,7630,659,921,140,4102,18,1166,135,18
"1447","2020-04-19",422,17,260,1227,5709,0.656857593273778,2025,7630,659,921,125,4227,24,1190,123,24
"1448","2020-04-20",407,17,282,1227,5709,0.656857593273778,2025,7630,659,921,111,4338,12,1202,109,12
"1449","2020-04-21",400,17,253,1214,5709,0.656857593273778,2025,7630,659,921,90,4428,7,1209,88,7
"1450","2020-04-22",408,17,242,1166,5709,0.656857593273778,2025,7630,659,921,101,4529,9,1218,98,9
"1451","2020-04-23",399,17,237,1113,5709,0.656857593273778,2025,7630,659,921,105,4634,8,1226,100,8
"1452","2020-04-24",419,17,253,1083,5709,0.656857593273778,2025,7630,659,921,97,4731,14,1240,94,14
"1453","2020-04-25",416,17,232,1046,5709,0.656857593273778,2025,7630,659,921,99,4830,37,1277,94,37
"1454","2020-04-26",395,17,202,993,5709,0.656857593273778,2025,7630,659,921,60,4890,32,1309,57,32
"1455","2020-04-27",391,17,190,959,5709,0.656857593273778,2025,7630,659,921,76,4966,51,1360,73,51
"1456","2020-04-28",371,17,192,934,5709,0.656857593273778,2025,7630,659,921,62,5028,52,1412,58,52
"1457","2020-04-29",339,17,187,875,5709,0.656857593273778,2025,7630,659,921,52,5080,57,1469,49,57
"1458","2020-04-30",322,17,208,844,5709,0.656857593273778,2025,7630,659,921,64,5144,33,1502,60,33
"1459","2020-05-01",299,17,177,807,5709,0.656857593273778,2025,7630,659,921,57,5201,47,1549,54,47
"1460","2020-05-02",301,17,155,768,5709,0.656857593273778,2025,7630,659,921,62,5263,46,1595,58,46
"1461","2020-05-03",273,17,156,724,5709,0.656857593273778,2025,7630,659,921,48,5311,28,1623,45,28
"1462","2020-05-04",254,17,177,700,5709,0.656857593273778,2025,7630,659,921,42,5353,21,1644,41,21
"1463","2020-05-05",236,17,183,662,5709,0.656857593273778,2025,7630,659,921,37,5390,58,1702,35,58
"1464","2020-05-06",234,17,179,629,5709,0.656857593273778,2025,7630,659,921,35,5425,42,1744,32,42
"1465","2020-05-07",235,17,161,604,5709,0.656857593273778,2025,7630,659,921,32,5457,30,1774,30,30
"1466","2020-05-08",220,17,146,574,5709,0.656857593273778,2025,7630,659,921,27,5484,15,1789,24,15
"1467","2020-05-09",194,17,144,553,5709,0.656857593273778,2025,7630,659,921,37,5521,11,1800,34,11
"1468","2020-05-10",184,17,144,546,5709,0.656857593273778,2025,7630,659,921,21,5542,8,1808,19,8
"1469","2020-05-11",177,17,125,519,5709,0.656857593273778,2025,7630,659,921,20,5562,9,1817,16,9
"1470","2020-05-12",180,17,120,510,5709,0.656857593273778,2025,7630,659,921,44,5606,9,1826,41,9
"1471","2020-05-13",176,17,112,491,5709,0.656857593273778,2025,7630,659,921,14,5620,47,1873,13,47
"1472","2020-05-14",176,17,98,480,5709,0.656857593273778,2025,7630,659,921,21,5641,36,1909,16,36
"1473","2020-05-15",163,17,115,454,5709,0.656857593273778,2025,7630,659,921,14,5655,29,1938,13,29
"1474","2020-05-16",155,17,130,434,5709,0.656857593273778,2025,7630,659,921,20,5675,47,1985,19,47
"1475","2020-05-17",172,17,182,405,5709,0.656857593273778,2025,7630,659,921,18,5693,45,2030,17,45
"1476","2020-05-18",165,17,175,390,5709,0.656857593273778,2025,7630,659,921,14,5707,52,2082,14,52
"1477","2020-05-19",148,17,155,373,5709,0.656857593273778,2025,7630,659,921,13,5720,44,2126,12,44
"1478","2020-05-20",142,17,153,343,5709,0.656857593273778,2025,7630,659,921,21,5741,42,2168,19,42
"1479","2020-05-21",134,17,143,315,5709,0.656857593273778,2025,7630,659,921,12,5753,28,2196,12,28
"1480","2020-05-22",133,17,136,298,5709,0.656857593273778,2025,7630,659,921,14,5767,37,2233,12,37
"1481","2020-05-23",134,17,165,284,5709,0.656857593273778,2025,7630,659,921,4,5771,39,2272,2,39
"1482","2020-05-24",111,17,152,273,5709,0.656857593273778,2025,7630,659,921,14,5785,27,2299,12,27
"1483","2020-05-25",105,17,147,271,5709,0.656857593273778,2025,7630,659,921,10,5795,48,2347,6,48
"1484","2020-05-26",98,17,144,266,5709,0.656857593273778,2025,7630,659,921,17,5812,43,2390,13,43
"1485","2020-05-27",96,17,138,265,5709,0.656857593273778,2025,7630,659,921,13,5825,29,2419,12,29
"1486","2020-05-28",96,17,145,251,5709,0.656857593273778,2025,7630,659,921,13,5838,23,2442,11,23
"1487","2020-05-29",100,17,134,235,5709,0.656857593273778,2025,7630,659,921,7,5845,19,2461,5,19
"1488","2020-05-30",98,17,128,223,5709,0.656857593273778,2025,7630,659,921,12,5857,14,2475,11,14
"1489","2020-05-31",92,17,113,216,5709,0.656857593273778,2025,7630,659,921,9,5866,13,2488,8,13
"1490","2020-06-01",93,17,115,199,5709,0.656857593273778,2025,7630,659,921,5,5871,7,2495,3,7
"1491","2020-06-02",86,17,114,190,5709,0.656857593273778,2025,7630,659,921,12,5883,24,2519,10,24
"1492","2020-06-03",81,17,104,185,5709,0.656857593273778,2025,7630,659,921,13,5896,23,2542,12,23
"1493","2020-06-04",74,17,99,168,5709,0.656857593273778,2025,7630,659,921,10,5906,43,2585,8,43
"1494","2020-06-05",64,17,83,152,5709,0.656857593273778,2025,7630,659,921,8,5914,40,2625,8,40
"1495","2020-06-06",58,17,70,146,5709,0.656857593273778,2025,7630,659,921,9,5923,22,2647,8,22
"1496","2020-06-07",45,17,69,138,5709,0.656857593273778,2025,7630,659,921,8,5931,11,2658,7,11
"1497","2020-03-08",1,18,0,0,5681,0.825558880478789,2055,7146,665,1167,NA,NA,NA,NA,NA,NA
"1498","2020-03-09",1,18,0,0,5681,0.825558880478789,2055,7146,665,1167,NA,NA,NA,NA,NA,NA
"1499","2020-03-10",0,18,0,0,5681,0.825558880478789,2055,7146,665,1167,NA,NA,1,1,NA,1
"1500","2020-03-11",0,18,0,0,5681,0.825558880478789,2055,7146,665,1167,10,10,5,6,NA,5
"1501","2020-03-12",1,18,59,31,5681,0.825558880478789,2055,7146,665,1167,6,16,10,16,NA,10
"1502","2020-03-13",2,18,91,46,5681,0.825558880478789,2055,7146,665,1167,7,23,7,23,3,7
"1503","2020-03-14",2,18,96,72,5681,0.825558880478789,2055,7146,665,1167,14,37,1,24,4,1
"1504","2020-03-15",5,18,93,104,5681,0.825558880478789,2055,7146,665,1167,17,54,9,33,11,9
"1505","2020-03-16",10,18,115,137,5681,0.825558880478789,2055,7146,665,1167,10,64,33,66,3,33
"1506","2020-03-17",18,18,129,176,5681,0.825558880478789,2055,7146,665,1167,22,86,24,90,15,24
"1507","2020-03-18",27,18,179,217,5681,0.825558880478789,2055,7146,665,1167,29,115,20,110,17,20
"1508","2020-03-19",33,18,166,271,5681,0.825558880478789,2055,7146,665,1167,16,131,27,137,7,27
"1509","2020-03-20",43,18,175,331,5681,0.825558880478789,2055,7146,665,1167,31,162,37,174,25,37
"1510","2020-03-21",82,18,176,389,5681,0.825558880478789,2055,7146,665,1167,26,188,35,209,16,35
"1511","2020-03-22",106,18,198,452,5681,0.825558880478789,2055,7146,665,1167,61,249,20,229,47,20
"1512","2020-03-23",117,18,208,526,5681,0.825558880478789,2055,7146,665,1167,39,288,11,240,35,11
"1513","2020-03-24",122,18,223,622,5681,0.825558880478789,2055,7146,665,1167,43,331,8,248,36,8
"1514","2020-03-25",128,18,244,703,5681,0.825558880478789,2055,7146,665,1167,49,380,9,257,38,9
"1515","2020-03-26",145,18,268,763,5681,0.825558880478789,2055,7146,665,1167,59,439,3,260,48,3
"1516","2020-03-27",214,18,259,857,5681,0.825558880478789,2055,7146,665,1167,68,507,12,272,57,12
"1517","2020-03-28",212,18,228,912,5681,0.825558880478789,2055,7146,665,1167,60,567,22,294,52,22
"1518","2020-03-29",255,18,218,999,5681,0.825558880478789,2055,7146,665,1167,78,645,17,311,69,17
"1519","2020-03-30",272,18,201,1109,5681,0.825558880478789,2055,7146,665,1167,95,740,16,327,89,16
"1520","2020-03-31",287,18,226,1174,5681,0.825558880478789,2055,7146,665,1167,81,821,45,372,75,45
"1521","2020-04-01",306,18,210,1216,5681,0.825558880478789,2055,7146,665,1167,124,945,37,409,117,37
"1522","2020-04-02",323,18,174,1281,5681,0.825558880478789,2055,7146,665,1167,120,1065,32,441,115,32
"1523","2020-04-03",442,18,158,1311,5681,0.825558880478789,2055,7146,665,1167,130,1195,20,461,119,20
"1524","2020-04-04",473,18,121,1394,5681,0.825558880478789,2055,7146,665,1167,135,1330,14,475,129,14
"1525","2020-04-05",424,18,118,1445,5681,0.825558880478789,2055,7146,665,1167,129,1459,21,496,122,21
"1526","2020-04-06",434,18,150,1495,5681,0.825558880478789,2055,7146,665,1167,131,1590,20,516,126,20
"1527","2020-04-07",434,18,173,1508,5681,0.825558880478789,2055,7146,665,1167,146,1736,12,528,142,12
"1528","2020-04-08",457,18,216,1514,5681,0.825558880478789,2055,7146,665,1167,138,1874,9,537,132,9
"1529","2020-04-09",465,18,208,1519,5681,0.825558880478789,2055,7146,665,1167,189,2063,14,551,178,14
"1530","2020-04-10",544,18,183,1581,5681,0.825558880478789,2055,7146,665,1167,154,2217,14,565,144,14
"1531","2020-04-11",555,18,184,1607,5681,0.825558880478789,2055,7146,665,1167,169,2386,19,584,163,19
"1532","2020-04-12",528,18,229,1576,5681,0.825558880478789,2055,7146,665,1167,190,2576,35,619,182,35
"1533","2020-04-13",512,18,237,1566,5681,0.825558880478789,2055,7146,665,1167,167,2743,25,644,161,25
"1534","2020-04-14",526,18,208,1575,5681,0.825558880478789,2055,7146,665,1167,175,2918,32,676,167,32
"1535","2020-04-15",525,18,187,1549,5681,0.825558880478789,2055,7146,665,1167,172,3090,20,696,170,20
"1536","2020-04-16",539,18,191,1540,5681,0.825558880478789,2055,7146,665,1167,149,3239,40,736,144,40
"1537","2020-04-17",577,18,192,1509,5681,0.825558880478789,2055,7146,665,1167,181,3420,31,767,171,31
"1538","2020-04-18",575,18,198,1481,5681,0.825558880478789,2055,7146,665,1167,154,3574,41,808,149,41
"1539","2020-04-19",512,18,187,1423,5681,0.825558880478789,2055,7146,665,1167,129,3703,31,839,127,31
"1540","2020-04-20",508,18,205,1352,5681,0.825558880478789,2055,7146,665,1167,138,3841,26,865,131,26
"1541","2020-04-21",492,18,181,1316,5681,0.825558880478789,2055,7146,665,1167,148,3989,25,890,138,25
"1542","2020-04-22",483,18,174,1240,5681,0.825558880478789,2055,7146,665,1167,107,4096,17,907,101,17
"1543","2020-04-23",460,18,212,1147,5681,0.825558880478789,2055,7146,665,1167,122,4218,35,942,112,35
"1544","2020-04-24",425,18,239,1102,5681,0.825558880478789,2055,7146,665,1167,98,4316,50,992,90,50
"1545","2020-04-25",412,18,215,1032,5681,0.825558880478789,2055,7146,665,1167,95,4411,51,1043,92,51
"1546","2020-04-26",376,18,210,963,5681,0.825558880478789,2055,7146,665,1167,81,4492,55,1098,75,55
"1547","2020-04-27",378,18,216,894,5681,0.825558880478789,2055,7146,665,1167,101,4593,49,1147,97,49
"1548","2020-04-28",365,18,222,832,5681,0.825558880478789,2055,7146,665,1167,82,4675,47,1194,76,47
"1549","2020-04-29",353,18,217,783,5681,0.825558880478789,2055,7146,665,1167,104,4779,37,1231,104,37
"1550","2020-04-30",343,18,208,748,5681,0.825558880478789,2055,7146,665,1167,83,4862,15,1246,76,15
"1551","2020-05-01",302,18,205,697,5681,0.825558880478789,2055,7146,665,1167,79,4941,19,1265,77,19
"1552","2020-05-02",292,18,168,662,5681,0.825558880478789,2055,7146,665,1167,48,4989,16,1281,46,16
"1553","2020-05-03",252,18,158,611,5681,0.825558880478789,2055,7146,665,1167,55,5044,20,1301,48,20
"1554","2020-05-04",233,18,166,571,5681,0.825558880478789,2055,7146,665,1167,53,5097,22,1323,50,22
"1555","2020-05-05",209,18,173,538,5681,0.825558880478789,2055,7146,665,1167,50,5147,38,1361,47,38
"1556","2020-05-06",187,18,175,501,5681,0.825558880478789,2055,7146,665,1167,43,5190,37,1398,39,37
"1557","2020-05-07",169,18,146,469,5681,0.825558880478789,2055,7146,665,1167,38,5228,47,1445,35,47
"1558","2020-05-08",145,18,145,435,5681,0.825558880478789,2055,7146,665,1167,50,5278,34,1479,45,34
"1559","2020-05-09",127,18,177,402,5681,0.825558880478789,2055,7146,665,1167,40,5318,17,1496,36,17
"1560","2020-05-10",147,18,220,385,5681,0.825558880478789,2055,7146,665,1167,36,5354,42,1538,28,42
"1561","2020-05-11",139,18,217,370,5681,0.825558880478789,2055,7146,665,1167,22,5376,21,1559,18,21
"1562","2020-05-12",129,18,200,364,5681,0.825558880478789,2055,7146,665,1167,35,5411,15,1574,32,15
"1563","2020-05-13",131,18,188,338,5681,0.825558880478789,2055,7146,665,1167,26,5437,6,1580,25,6
"1564","2020-05-14",132,18,214,304,5681,0.825558880478789,2055,7146,665,1167,22,5459,4,1584,18,4
"1565","2020-05-15",140,18,212,289,5681,0.825558880478789,2055,7146,665,1167,10,5469,11,1595,8,11
"1566","2020-05-16",137,18,207,268,5681,0.825558880478789,2055,7146,665,1167,18,5487,3,1598,13,3
"1567","2020-05-17",108,18,216,233,5681,0.825558880478789,2055,7146,665,1167,19,5506,3,1601,16,3
"1568","2020-05-18",102,18,197,228,5681,0.825558880478789,2055,7146,665,1167,12,5518,6,1607,8,6
"1569","2020-05-19",98,18,198,220,5681,0.825558880478789,2055,7146,665,1167,12,5530,29,1636,9,29
"1570","2020-05-20",85,18,194,211,5681,0.825558880478789,2055,7146,665,1167,17,5547,42,1678,14,42
"1571","2020-05-21",78,18,192,207,5681,0.825558880478789,2055,7146,665,1167,14,5561,22,1700,10,22
"1572","2020-05-22",63,18,172,189,5681,0.825558880478789,2055,7146,665,1167,9,5570,10,1710,8,10
"1573","2020-05-23",61,18,171,180,5681,0.825558880478789,2055,7146,665,1167,12,5582,43,1753,7,43
"1574","2020-05-24",57,18,157,171,5681,0.825558880478789,2055,7146,665,1167,8,5590,21,1774,5,21
"1575","2020-05-25",46,18,137,155,5681,0.825558880478789,2055,7146,665,1167,9,5599,21,1795,7,21
"1576","2020-05-26",39,18,115,151,5681,0.825558880478789,2055,7146,665,1167,6,5605,16,1811,5,16
"1577","2020-05-27",42,18,124,145,5681,0.825558880478789,2055,7146,665,1167,11,5616,26,1837,7,26
"1578","2020-05-28",42,18,153,136,5681,0.825558880478789,2055,7146,665,1167,7,5623,15,1852,7,15
"1579","2020-05-29",44,18,201,135,5681,0.825558880478789,2055,7146,665,1167,10,5633,11,1863,7,11
"1580","2020-05-30",45,18,223,131,5681,0.825558880478789,2055,7146,665,1167,4,5637,6,1869,2,6
"1581","2020-05-31",38,18,236,126,5681,0.825558880478789,2055,7146,665,1167,6,5643,16,1885,5,16
"1582","2020-06-01",39,18,222,120,5681,0.825558880478789,2055,7146,665,1167,6,5649,20,1905,5,20
"1583","2020-06-02",43,18,184,114,5681,0.825558880478789,2055,7146,665,1167,7,5656,30,1935,6,30
"1584","2020-06-03",46,18,173,107,5681,0.825558880478789,2055,7146,665,1167,4,5660,15,1950,4,15
"1585","2020-06-04",44,18,169,99,5681,0.825558880478789,2055,7146,665,1167,3,5663,17,1967,2,17
"1586","2020-06-05",44,18,174,90,5681,0.825558880478789,2055,7146,665,1167,4,5667,30,1997,4,30
"1587","2020-06-06",41,18,173,88,5681,0.825558880478789,2055,7146,665,1167,2,5669,19,2016,1,19
"1588","2020-06-07",41,18,184,84,5681,0.825558880478789,2055,7146,665,1167,4,5673,18,2034,4,18
"1589","2020-03-08",1,19,0,0,4660,0.519957081545064,2115,7181,479,641,NA,NA,NA,NA,NA,NA
"1590","2020-03-09",1,19,0,0,4660,0.519957081545064,2115,7181,479,641,NA,NA,NA,NA,NA,NA
"1591","2020-03-10",0,19,0,0,4660,0.519957081545064,2115,7181,479,641,NA,NA,7,7,NA,7
"1592","2020-03-11",0,19,0,0,4660,0.519957081545064,2115,7181,479,641,31,31,32,39,NA,32
"1593","2020-03-12",0,19,0,0,4660,0.519957081545064,2115,7181,479,641,33,64,30,69,5,30
"1594","2020-03-13",2,19,54,65,4660,0.519957081545064,2115,7181,479,641,46,110,18,87,8,18
"1595","2020-03-14",8,19,57,99,4660,0.519957081545064,2115,7181,479,641,43,153,16,103,13,16
"1596","2020-03-15",11,19,73,130,4660,0.519957081545064,2115,7181,479,641,36,189,19,122,16,19
"1597","2020-03-16",12,19,72,167,4660,0.519957081545064,2115,7181,479,641,59,248,13,135,24,13
"1598","2020-03-17",14,19,85,206,4660,0.519957081545064,2115,7181,479,641,55,303,31,166,28,31
"1599","2020-03-18",20,19,82,254,4660,0.519957081545064,2115,7181,479,641,75,378,26,192,44,26
"1600","2020-03-19",26,19,105,288,4660,0.519957081545064,2115,7181,479,641,80,458,30,222,51,30
"1601","2020-03-20",47,19,114,335,4660,0.519957081545064,2115,7181,479,641,87,545,38,260,54,38
"1602","2020-03-21",69,19,110,371,4660,0.519957081545064,2115,7181,479,641,91,636,35,295,64,35
"1603","2020-03-22",89,19,94,403,4660,0.519957081545064,2115,7181,479,641,103,739,18,313,72,18
"1604","2020-03-23",97,19,80,441,4660,0.519957081545064,2115,7181,479,641,115,854,46,359,86,46
"1605","2020-03-24",99,19,82,476,4660,0.519957081545064,2115,7181,479,641,110,964,25,384,84,25
"1606","2020-03-25",112,19,85,530,4660,0.519957081545064,2115,7181,479,641,92,1056,20,404,68,20
"1607","2020-03-26",124,19,97,561,4660,0.519957081545064,2115,7181,479,641,170,1226,14,418,138,14
"1608","2020-03-27",162,19,106,573,4660,0.519957081545064,2115,7181,479,641,185,1411,11,429,155,11
"1609","2020-03-28",179,19,117,610,4660,0.519957081545064,2115,7181,479,641,160,1571,40,469,129,40
"1610","2020-03-29",198,19,139,635,4660,0.519957081545064,2115,7181,479,641,139,1710,24,493,115,24
"1611","2020-03-30",207,19,170,684,4660,0.519957081545064,2115,7181,479,641,145,1855,29,522,111,29
"1612","2020-03-31",220,19,194,703,4660,0.519957081545064,2115,7181,479,641,177,2032,43,565,146,43
"1613","2020-04-01",218,19,184,724,4660,0.519957081545064,2115,7181,479,641,183,2215,28,593,164,28
"1614","2020-04-02",224,19,169,738,4660,0.519957081545064,2115,7181,479,641,174,2389,51,644,149,51
"1615","2020-04-03",248,19,162,774,4660,0.519957081545064,2115,7181,479,641,186,2575,18,662,157,18
"1616","2020-04-04",265,19,183,783,4660,0.519957081545064,2115,7181,479,641,144,2719,24,686,121,24
"1617","2020-04-05",254,19,177,804,4660,0.519957081545064,2115,7181,479,641,178,2897,53,739,153,53
"1618","2020-04-06",249,19,219,819,4660,0.519957081545064,2115,7181,479,641,191,3088,46,785,166,46
"1619","2020-04-07",254,19,211,841,4660,0.519957081545064,2115,7181,479,641,174,3262,28,813,147,28
"1620","2020-04-08",262,19,202,841,4660,0.519957081545064,2115,7181,479,641,164,3426,25,838,136,25
"1621","2020-04-09",274,19,170,859,4660,0.519957081545064,2115,7181,479,641,166,3592,22,860,147,22
"1622","2020-04-10",322,19,153,863,4660,0.519957081545064,2115,7181,479,641,175,3767,14,874,154,14
"1623","2020-04-11",314,19,128,863,4660,0.519957081545064,2115,7181,479,641,131,3898,20,894,115,20
"1624","2020-04-12",290,19,118,836,4660,0.519957081545064,2115,7181,479,641,160,4058,59,953,133,59
"1625","2020-04-13",298,19,97,832,4660,0.519957081545064,2115,7181,479,641,131,4189,63,1016,110,63
"1626","2020-04-14",283,19,89,843,4660,0.519957081545064,2115,7181,479,641,138,4327,63,1079,117,63
"1627","2020-04-15",289,19,92,848,4660,0.519957081545064,2115,7181,479,641,153,4480,34,1113,133,34
"1628","2020-04-16",281,19,127,829,4660,0.519957081545064,2115,7181,479,641,126,4606,39,1152,102,39
"1629","2020-04-17",276,19,128,814,4660,0.519957081545064,2115,7181,479,641,92,4698,29,1181,76,29
"1630","2020-04-18",287,19,156,819,4660,0.519957081545064,2115,7181,479,641,104,4802,14,1195,89,14
"1631","2020-04-19",281,19,180,803,4660,0.519957081545064,2115,7181,479,641,104,4906,28,1223,84,28
"1632","2020-04-20",262,19,182,794,4660,0.519957081545064,2115,7181,479,641,110,5016,22,1245,96,22
"1633","2020-04-21",261,19,186,802,4660,0.519957081545064,2115,7181,479,641,95,5111,12,1257,77,12
"1634","2020-04-22",259,19,166,793,4660,0.519957081545064,2115,7181,479,641,86,5197,22,1279,68,22
"1635","2020-04-23",262,19,171,785,4660,0.519957081545064,2115,7181,479,641,80,5277,58,1337,64,58
"1636","2020-04-24",288,19,198,790,4660,0.519957081545064,2115,7181,479,641,70,5347,67,1404,54,67
"1637","2020-04-25",294,19,196,771,4660,0.519957081545064,2115,7181,479,641,50,5397,30,1434,41,30
"1638","2020-04-26",268,19,212,768,4660,0.519957081545064,2115,7181,479,641,61,5458,61,1495,43,61
"1639","2020-04-27",267,19,219,743,4660,0.519957081545064,2115,7181,479,641,60,5518,28,1523,43,28
"1640","2020-04-28",266,19,206,728,4660,0.519957081545064,2115,7181,479,641,58,5576,18,1541,45,18
"1641","2020-04-29",265,19,195,722,4660,0.519957081545064,2115,7181,479,641,54,5630,16,1557,39,16
"1642","2020-04-30",251,19,183,720,4660,0.519957081545064,2115,7181,479,641,40,5670,19,1576,33,19
"1643","2020-05-01",258,19,197,709,4660,0.519957081545064,2115,7181,479,641,57,5727,14,1590,37,14
"1644","2020-05-02",263,19,214,697,4660,0.519957081545064,2115,7181,479,641,27,5754,13,1603,18,13
"1645","2020-05-03",244,19,219,690,4660,0.519957081545064,2115,7181,479,641,45,5799,53,1656,32,53
"1646","2020-05-04",243,19,221,683,4660,0.519957081545064,2115,7181,479,641,36,5835,43,1699,20,43
"1647","2020-05-05",235,19,203,692,4660,0.519957081545064,2115,7181,479,641,29,5864,19,1718,19,19
"1648","2020-05-06",231,19,206,672,4660,0.519957081545064,2115,7181,479,641,28,5892,67,1785,14,67
"1649","2020-05-07",234,19,213,652,4660,0.519957081545064,2115,7181,479,641,19,5911,27,1812,8,27
"1650","2020-05-08",238,19,194,634,4660,0.519957081545064,2115,7181,479,641,27,5938,27,1839,15,27
"1651","2020-05-09",218,19,208,610,4660,0.519957081545064,2115,7181,479,641,32,5970,47,1886,15,47
"1652","2020-05-10",225,19,241,587,4660,0.519957081545064,2115,7181,479,641,14,5984,21,1907,7,21
"1653","2020-05-11",210,19,215,565,4660,0.519957081545064,2115,7181,479,641,34,6018,22,1929,17,22
"1654","2020-05-12",207,19,188,542,4660,0.519957081545064,2115,7181,479,641,22,6040,52,1981,11,52
"1655","2020-05-13",195,19,172,522,4660,0.519957081545064,2115,7181,479,641,19,6059,75,2056,10,75
"1656","2020-05-14",196,19,158,506,4660,0.519957081545064,2115,7181,479,641,27,6086,35,2091,18,35
"1657","2020-05-15",177,19,160,498,4660,0.519957081545064,2115,7181,479,641,21,6107,58,2149,8,58
"1658","2020-05-16",176,19,191,472,4660,0.519957081545064,2115,7181,479,641,18,6125,44,2193,11,44
"1659","2020-05-17",155,19,200,449,4660,0.519957081545064,2115,7181,479,641,23,6148,43,2236,12,43
"1660","2020-05-18",150,19,226,441,4660,0.519957081545064,2115,7181,479,641,20,6168,29,2265,14,29
"1661","2020-05-19",152,19,217,419,4660,0.519957081545064,2115,7181,479,641,18,6186,58,2323,11,58
"1662","2020-05-20",149,19,207,406,4660,0.519957081545064,2115,7181,479,641,15,6201,24,2347,8,24
"1663","2020-05-21",143,19,178,386,4660,0.519957081545064,2115,7181,479,641,18,6219,27,2374,9,27
"1664","2020-05-22",152,19,180,366,4660,0.519957081545064,2115,7181,479,641,11,6230,32,2406,7,32
"1665","2020-05-23",146,19,186,347,4660,0.519957081545064,2115,7181,479,641,11,6241,21,2427,6,21
"1666","2020-05-24",132,19,176,333,4660,0.519957081545064,2115,7181,479,641,13,6254,15,2442,6,15
"1667","2020-05-25",127,19,171,307,4660,0.519957081545064,2115,7181,479,641,10,6264,13,2455,7,13
"1668","2020-05-26",113,19,144,294,4660,0.519957081545064,2115,7181,479,641,10,6274,30,2485,1,30
"1669","2020-05-27",118,19,130,292,4660,0.519957081545064,2115,7181,479,641,7,6281,21,2506,2,21
"1670","2020-05-28",113,19,103,279,4660,0.519957081545064,2115,7181,479,641,19,6300,57,2563,8,57
"1671","2020-05-29",91,19,121,264,4660,0.519957081545064,2115,7181,479,641,5,6305,47,2610,2,47
"1672","2020-05-30",87,19,139,256,4660,0.519957081545064,2115,7181,479,641,8,6313,31,2641,4,31
"1673","2020-05-31",81,19,135,252,4660,0.519957081545064,2115,7181,479,641,11,6324,44,2685,7,44
"1674","2020-06-01",78,19,137,241,4660,0.519957081545064,2115,7181,479,641,7,6331,20,2705,1,20
"1675","2020-06-02",77,19,138,228,4660,0.519957081545064,2115,7181,479,641,4,6335,15,2720,3,15
"1676","2020-06-03",69,19,117,222,4660,0.519957081545064,2115,7181,479,641,6,6341,16,2736,4,16
"1677","2020-06-04",62,19,109,219,4660,0.519957081545064,2115,7181,479,641,6,6347,9,2745,2,9
"1678","2020-06-05",59,19,106,209,4660,0.519957081545064,2115,7181,479,641,8,6355,7,2752,NA,7
"1679","2020-06-06",57,19,101,190,4660,0.519957081545064,2115,7181,479,641,5,6360,2,2754,3,2
"1680","2020-06-07",54,19,84,178,4660,0.519957081545064,2115,7181,479,641,6,6366,3,2757,NA,3
"1681","2020-03-08",1,20,0,0,5912,0.91745602165088,2025,7378,670,1018,NA,NA,NA,NA,NA,NA
"1682","2020-03-09",1,20,0,0,5912,0.91745602165088,2025,7378,670,1018,NA,NA,NA,NA,NA,NA
"1683","2020-03-10",0,20,0,0,5912,0.91745602165088,2025,7378,670,1018,NA,NA,NA,NA,NA,NA
"1684","2020-03-11",0,20,0,0,5912,0.91745602165088,2025,7378,670,1018,5,5,5,5,NA,5
"1685","2020-03-12",0,20,0,0,5912,0.91745602165088,2025,7378,670,1018,12,17,13,18,NA,13
"1686","2020-03-13",1,20,91,27,5912,0.91745602165088,2025,7378,670,1018,19,36,22,40,1,22
"1687","2020-03-14",3,20,120,43,5912,0.91745602165088,2025,7378,670,1018,20,56,15,55,5,15
"1688","2020-03-15",4,20,126,67,5912,0.91745602165088,2025,7378,670,1018,18,74,19,74,8,19
"1689","2020-03-16",5,20,145,87,5912,0.91745602165088,2025,7378,670,1018,25,99,23,97,16,23
"1690","2020-03-17",11,20,181,110,5912,0.91745602165088,2025,7378,670,1018,32,131,20,117,20,20
"1691","2020-03-18",12,20,168,137,5912,0.91745602165088,2025,7378,670,1018,40,171,19,136,30,19
"1692","2020-03-19",17,20,156,166,5912,0.91745602165088,2025,7378,670,1018,50,221,26,162,43,26
"1693","2020-03-20",27,20,158,203,5912,0.91745602165088,2025,7378,670,1018,38,259,25,187,33,25
"1694","2020-03-21",52,20,148,227,5912,0.91745602165088,2025,7378,670,1018,62,321,22,209,52,22
"1695","2020-03-22",58,20,160,286,5912,0.91745602165088,2025,7378,670,1018,43,364,19,228,36,19
"1696","2020-03-23",62,20,148,330,5912,0.91745602165088,2025,7378,670,1018,84,448,25,253,71,25
"1697","2020-03-24",63,20,180,383,5912,0.91745602165088,2025,7378,670,1018,58,506,18,271,48,18
"1698","2020-03-25",79,20,175,436,5912,0.91745602165088,2025,7378,670,1018,70,576,24,295,60,24
"1699","2020-03-26",87,20,154,476,5912,0.91745602165088,2025,7378,670,1018,74,650,23,318,61,23
"1700","2020-03-27",121,20,134,533,5912,0.91745602165088,2025,7378,670,1018,88,738,31,349,81,31
"1701","2020-03-28",116,20,123,593,5912,0.91745602165088,2025,7378,670,1018,84,822,25,374,74,25
"1702","2020-03-29",156,20,163,618,5912,0.91745602165088,2025,7378,670,1018,113,935,17,391,105,17
"1703","2020-03-30",168,20,200,712,5912,0.91745602165088,2025,7378,670,1018,140,1075,16,407,120,16
"1704","2020-03-31",175,20,196,779,5912,0.91745602165088,2025,7378,670,1018,151,1226,23,430,133,23
"1705","2020-04-01",185,20,195,892,5912,0.91745602165088,2025,7378,670,1018,156,1382,41,471,150,41
"1706","2020-04-02",209,20,201,947,5912,0.91745602165088,2025,7378,670,1018,109,1491,21,492,93,21
"1707","2020-04-03",261,20,229,1022,5912,0.91745602165088,2025,7378,670,1018,165,1656,28,520,155,28
"1708","2020-04-04",300,20,247,1124,5912,0.91745602165088,2025,7378,670,1018,149,1805,37,557,139,37
"1709","2020-04-05",337,20,241,1191,5912,0.91745602165088,2025,7378,670,1018,123,1928,30,587,115,30
"1710","2020-04-06",347,20,227,1263,5912,0.91745602165088,2025,7378,670,1018,139,2067,22,609,128,22
"1711","2020-04-07",343,20,206,1368,5912,0.91745602165088,2025,7378,670,1018,159,2226,27,636,147,27
"1712","2020-04-08",362,20,174,1445,5912,0.91745602165088,2025,7378,670,1018,184,2410,35,671,169,35
"1713","2020-04-09",374,20,161,1534,5912,0.91745602165088,2025,7378,670,1018,162,2572,26,697,148,26
"1714","2020-04-10",515,20,159,1611,5912,0.91745602165088,2025,7378,670,1018,142,2714,15,712,134,15
"1715","2020-04-11",548,20,141,1653,5912,0.91745602165088,2025,7378,670,1018,166,2880,24,736,162,24
"1716","2020-04-12",512,20,189,1670,5912,0.91745602165088,2025,7378,670,1018,173,3053,20,756,163,20
"1717","2020-04-13",525,20,188,1721,5912,0.91745602165088,2025,7378,670,1018,170,3223,14,770,165,14
"1718","2020-04-14",526,20,173,1726,5912,0.91745602165088,2025,7378,670,1018,150,3373,17,787,141,17
"1719","2020-04-15",549,20,152,1770,5912,0.91745602165088,2025,7378,670,1018,183,3556,30,817,174,30
"1720","2020-04-16",567,20,154,1767,5912,0.91745602165088,2025,7378,670,1018,138,3694,24,841,132,24
"1721","2020-04-17",619,20,210,1752,5912,0.91745602165088,2025,7378,670,1018,146,3840,30,871,133,30
"1722","2020-04-18",620,20,260,1743,5912,0.91745602165088,2025,7378,670,1018,138,3978,25,896,126,25
"1723","2020-04-19",579,20,237,1709,5912,0.91745602165088,2025,7378,670,1018,119,4097,32,928,114,32
"1724","2020-04-20",574,20,214,1709,5912,0.91745602165088,2025,7378,670,1018,127,4224,17,945,122,17
"1725","2020-04-21",568,20,192,1641,5912,0.91745602165088,2025,7378,670,1018,118,4342,24,969,106,24
"1726","2020-04-22",555,20,184,1584,5912,0.91745602165088,2025,7378,670,1018,97,4439,28,997,90,28
"1727","2020-04-23",559,20,231,1565,5912,0.91745602165088,2025,7378,670,1018,100,4539,37,1034,90,37
"1728","2020-04-24",584,20,211,1465,5912,0.91745602165088,2025,7378,670,1018,109,4648,36,1070,105,36
"1729","2020-04-25",562,20,186,1392,5912,0.91745602165088,2025,7378,670,1018,90,4738,30,1100,81,30
"1730","2020-04-26",483,20,173,1317,5912,0.91745602165088,2025,7378,670,1018,72,4810,29,1129,68,29
"1731","2020-04-27",465,20,151,1253,5912,0.91745602165088,2025,7378,670,1018,72,4882,26,1155,65,26
"1732","2020-04-28",463,20,135,1164,5912,0.91745602165088,2025,7378,670,1018,71,4953,47,1202,67,47
"1733","2020-04-29",442,20,117,1080,5912,0.91745602165088,2025,7378,670,1018,68,5021,27,1229,62,27
"1734","2020-04-30",408,20,114,1034,5912,0.91745602165088,2025,7378,670,1018,73,5094,43,1272,63,43
"1735","2020-05-01",378,20,108,948,5912,0.91745602165088,2025,7378,670,1018,45,5139,52,1324,40,52
"1736","2020-05-02",365,20,98,874,5912,0.91745602165088,2025,7378,670,1018,58,5197,32,1356,51,32
"1737","2020-05-03",336,20,88,825,5912,0.91745602165088,2025,7378,670,1018,42,5239,27,1383,31,27
"1738","2020-05-04",315,20,84,754,5912,0.91745602165088,2025,7378,670,1018,38,5277,26,1409,36,26
"1739","2020-05-05",292,20,99,699,5912,0.91745602165088,2025,7378,670,1018,34,5311,19,1428,28,19
"1740","2020-05-06",278,20,90,639,5912,0.91745602165088,2025,7378,670,1018,46,5357,40,1468,35,40
"1741","2020-05-07",258,20,98,580,5912,0.91745602165088,2025,7378,670,1018,39,5396,38,1506,29,38
"1742","2020-05-08",208,20,113,528,5912,0.91745602165088,2025,7378,670,1018,27,5423,33,1539,24,33
"1743","2020-05-09",213,20,179,491,5912,0.91745602165088,2025,7378,670,1018,32,5455,58,1597,28,58
"1744","2020-05-10",193,20,211,467,5912,0.91745602165088,2025,7378,670,1018,24,5479,53,1650,20,53
"1745","2020-05-11",184,20,235,433,5912,0.91745602165088,2025,7378,670,1018,27,5506,46,1696,21,46
"1746","2020-05-12",176,20,238,399,5912,0.91745602165088,2025,7378,670,1018,29,5535,44,1740,20,44
"1747","2020-05-13",171,20,244,361,5912,0.91745602165088,2025,7378,670,1018,27,5562,46,1786,19,46
"1748","2020-05-14",171,20,227,346,5912,0.91745602165088,2025,7378,670,1018,8,5570,56,1842,8,56
"1749","2020-05-15",157,20,237,345,5912,0.91745602165088,2025,7378,670,1018,18,5588,43,1885,13,43
"1750","2020-05-16",134,20,240,322,5912,0.91745602165088,2025,7378,670,1018,14,5602,43,1928,13,43
"1751","2020-05-17",123,20,258,300,5912,0.91745602165088,2025,7378,670,1018,10,5612,24,1952,9,24
"1752","2020-05-18",117,20,293,275,5912,0.91745602165088,2025,7378,670,1018,14,5626,43,1995,10,43
"1753","2020-05-19",108,20,297,264,5912,0.91745602165088,2025,7378,670,1018,13,5639,40,2035,6,40
"1754","2020-05-20",97,20,308,255,5912,0.91745602165088,2025,7378,670,1018,15,5654,27,2062,10,27
"1755","2020-05-21",86,20,273,245,5912,0.91745602165088,2025,7378,670,1018,14,5668,37,2099,9,37
"1756","2020-05-22",78,20,240,229,5912,0.91745602165088,2025,7378,670,1018,16,5684,55,2154,7,55
"1757","2020-05-23",81,20,205,221,5912,0.91745602165088,2025,7378,670,1018,5,5689,44,2198,4,44
"1758","2020-05-24",73,20,170,210,5912,0.91745602165088,2025,7378,670,1018,4,5693,56,2254,3,56
"1759","2020-05-25",72,20,139,196,5912,0.91745602165088,2025,7378,670,1018,5,5698,44,2298,3,44
"1760","2020-05-26",65,20,136,181,5912,0.91745602165088,2025,7378,670,1018,11,5709,46,2344,7,46
"1761","2020-05-27",66,20,130,174,5912,0.91745602165088,2025,7378,670,1018,8,5717,35,2379,4,35
"1762","2020-05-28",68,20,110,161,5912,0.91745602165088,2025,7378,670,1018,9,5726,48,2427,5,48
"1763","2020-05-29",64,20,100,156,5912,0.91745602165088,2025,7378,670,1018,8,5734,29,2456,5,29
"1764","2020-05-30",50,20,123,145,5912,0.91745602165088,2025,7378,670,1018,10,5744,38,2494,6,38
"1765","2020-05-31",53,20,153,142,5912,0.91745602165088,2025,7378,670,1018,6,5750,35,2529,5,35
"1766","2020-06-01",53,20,175,134,5912,0.91745602165088,2025,7378,670,1018,4,5754,40,2569,1,40
"1767","2020-06-02",49,20,194,129,5912,0.91745602165088,2025,7378,670,1018,13,5767,35,2604,9,35
"1768","2020-06-03",48,20,174,120,5912,0.91745602165088,2025,7378,670,1018,7,5774,32,2636,6,32
"1769","2020-06-04",44,20,195,106,5912,0.91745602165088,2025,7378,670,1018,4,5778,29,2665,3,29
"1770","2020-06-05",46,20,195,98,5912,0.91745602165088,2025,7378,670,1018,7,5785,26,2691,6,26
"1771","2020-06-06",50,20,187,91,5912,0.91745602165088,2025,7378,670,1018,4,5789,23,2714,1,23
"1772","2020-06-07",38,20,176,82,5912,0.91745602165088,2025,7378,670,1018,3,5792,31,2745,2,31
