"","Date","Absents","Paramset","Infections_or_Exposed_per_day_Patient","Infections_or_Exposed_per_day_HCW","total_infections","nosocomial_proportion","PCR_pooled","LFD_pooled","HCW_symp_test","patient_symp_test","new_hcw_infs","cumulative_hcw_infs","new_pat_infs","cumulative_pats_infs","new_nosocomial_hcw_infs","new_nosocomial_pat_infs"
"1","2020-03-13",2,1,60,121,5786,0.374006221914967,2085,8221,586,688,42,121,16,51,7,16
"2","2020-03-14",9,1,63,164,5786,0.374006221914967,2085,8221,586,688,43,164,14,65,7,14
"3","2020-03-15",24,1,64,219,5786,0.374006221914967,2085,8221,586,688,55,219,10,75,12,10
"4","2020-03-16",33,1,74,273,5786,0.374006221914967,2085,8221,586,688,54,273,20,95,12,20
"5","2020-03-17",33,1,95,339,5786,0.374006221914967,2085,8221,586,688,66,339,31,126,26,31
"6","2020-03-18",45,1,96,388,5786,0.374006221914967,2085,8221,586,688,53,392,12,138,18,12
"7","2020-03-19",59,1,95,442,5786,0.374006221914967,2085,8221,586,688,64,456,19,157,27,19
"8","2020-03-20",98,1,117,492,5786,0.374006221914967,2085,8221,586,688,73,529,34,191,27,34
"9","2020-03-21",128,1,127,561,5786,0.374006221914967,2085,8221,586,688,84,613,23,214,36,23
"10","2020-03-22",136,1,128,608,5786,0.374006221914967,2085,8221,586,688,71,684,22,236,32,22
"11","2020-03-23",145,1,121,665,5786,0.374006221914967,2085,8221,586,688,83,767,17,253,40,17
"12","2020-03-24",154,1,112,699,5786,0.374006221914967,2085,8221,586,688,78,845,12,265,37,12
"13","2020-03-25",171,1,120,743,5786,0.374006221914967,2085,8221,586,688,88,933,22,287,38,22
"14","2020-03-26",192,1,134,784,5786,0.374006221914967,2085,8221,586,688,87,1020,34,321,42,34
"15","2020-03-27",236,1,145,813,5786,0.374006221914967,2085,8221,586,688,75,1095,34,355,37,34
"16","2020-03-28",279,1,139,845,5786,0.374006221914967,2085,8221,586,688,83,1178,22,377,38,22
"17","2020-03-29",281,1,144,876,5786,0.374006221914967,2085,8221,586,688,96,1274,27,404,52,27
"18","2020-03-30",289,1,119,894,5786,0.374006221914967,2085,8221,586,688,78,1352,10,414,34,10
"19","2020-03-31",291,1,114,918,5786,0.374006221914967,2085,8221,586,688,85,1437,14,428,29,14
"20","2020-04-01",291,1,148,909,5786,0.374006221914967,2085,8221,586,688,70,1507,49,477,38,49
"21","2020-04-02",292,1,160,923,5786,0.374006221914967,2085,8221,586,688,84,1591,26,503,44,26
"22","2020-04-03",333,1,169,940,5786,0.374006221914967,2085,8221,586,688,89,1680,38,541,44,38
"23","2020-04-04",319,1,170,963,5786,0.374006221914967,2085,8221,586,688,102,1782,32,573,46,32
"24","2020-04-05",317,1,195,964,5786,0.374006221914967,2085,8221,586,688,80,1862,41,614,34,41
"25","2020-04-06",317,1,210,981,5786,0.374006221914967,2085,8221,586,688,96,1958,53,667,50,53
"26","2020-04-07",321,1,200,999,5786,0.374006221914967,2085,8221,586,688,99,2057,34,701,53,34
"27","2020-04-08",324,1,223,1013,5786,0.374006221914967,2085,8221,586,688,105,2162,44,745,49,44
"28","2020-04-09",319,1,223,1001,5786,0.374006221914967,2085,8221,586,688,65,2227,41,786,36,41
"29","2020-04-10",355,1,195,994,5786,0.374006221914967,2085,8221,586,688,85,2312,27,813,50,27
"30","2020-04-11",350,1,178,1001,5786,0.374006221914967,2085,8221,586,688,79,2391,18,831,34,18
"31","2020-04-12",310,1,189,1015,5786,0.374006221914967,2085,8221,586,688,97,2488,40,871,48,40
"32","2020-04-13",308,1,178,1018,5786,0.374006221914967,2085,8221,586,688,95,2583,24,895,46,24
"33","2020-04-14",314,1,171,1012,5786,0.374006221914967,2085,8221,586,688,79,2662,21,916,26,21
"34","2020-04-15",309,1,193,1001,5786,0.374006221914967,2085,8221,586,688,78,2740,51,967,34,51
"35","2020-04-16",316,1,206,982,5786,0.374006221914967,2085,8221,586,688,71,2811,42,1009,35,42
"36","2020-04-17",321,1,214,999,5786,0.374006221914967,2085,8221,586,688,94,2905,55,1064,34,55
"37","2020-04-18",327,1,194,993,5786,0.374006221914967,2085,8221,586,688,76,2981,25,1089,35,25
"38","2020-04-19",327,1,171,987,5786,0.374006221914967,2085,8221,586,688,97,3078,22,1111,47,22
"39","2020-04-20",323,1,158,972,5786,0.374006221914967,2085,8221,586,688,79,3157,15,1126,29,15
"40","2020-04-21",309,1,159,962,5786,0.374006221914967,2085,8221,586,688,79,3236,26,1152,26,26
"41","2020-04-22",316,1,172,943,5786,0.374006221914967,2085,8221,586,688,74,3310,36,1188,34,36
"42","2020-04-23",313,1,200,925,5786,0.374006221914967,2085,8221,586,688,76,3386,39,1227,31,39
"43","2020-04-24",350,1,193,920,5786,0.374006221914967,2085,8221,586,688,83,3469,47,1274,38,47
"44","2020-04-25",345,1,196,915,5786,0.374006221914967,2085,8221,586,688,73,3542,31,1305,29,31
"45","2020-04-26",319,1,209,891,5786,0.374006221914967,2085,8221,586,688,59,3601,39,1344,18,39
"46","2020-04-27",302,1,237,871,5786,0.374006221914967,2085,8221,586,688,64,3665,57,1401,27,57
"47","2020-04-28",299,1,234,852,5786,0.374006221914967,2085,8221,586,688,58,3723,32,1433,26,32
"48","2020-04-29",286,1,215,839,5786,0.374006221914967,2085,8221,586,688,62,3785,27,1460,31,27
"49","2020-04-30",281,1,198,804,5786,0.374006221914967,2085,8221,586,688,57,3842,16,1476,21,16
"50","2020-05-01",291,1,182,784,5786,0.374006221914967,2085,8221,586,688,57,3899,19,1495,24,19
"51","2020-05-02",283,1,167,758,5786,0.374006221914967,2085,8221,586,688,58,3957,18,1513,21,18
"52","2020-05-03",266,1,165,747,5786,0.374006221914967,2085,8221,586,688,58,4015,17,1530,21,17
"53","2020-05-04",262,1,188,726,5786,0.374006221914967,2085,8221,586,688,68,4083,41,1571,19,41
"54","2020-05-05",244,1,218,703,5786,0.374006221914967,2085,8221,586,688,49,4132,60,1631,16,60
"55","2020-05-06",248,1,248,686,5786,0.374006221914967,2085,8221,586,688,51,4183,64,1695,16,64
"56","2020-05-07",244,1,236,667,5786,0.374006221914967,2085,8221,586,688,61,4244,39,1734,30,39
"57","2020-05-08",249,1,225,659,5786,0.374006221914967,2085,8221,586,688,50,4294,39,1773,15,39
"58","2020-05-09",250,1,212,661,5786,0.374006221914967,2085,8221,586,688,63,4357,24,1797,24,24
"59","2020-05-10",233,1,191,659,5786,0.374006221914967,2085,8221,586,688,51,4408,15,1812,19,15
"60","2020-05-11",229,1,180,644,5786,0.374006221914967,2085,8221,586,688,54,4462,19,1831,17,19
"61","2020-05-12",224,1,189,628,5786,0.374006221914967,2085,8221,586,688,42,4504,36,1867,14,36
"62","2020-05-13",213,1,192,600,5786,0.374006221914967,2085,8221,586,688,38,4542,29,1896,12,29
"63","2020-05-14",210,1,184,600,5786,0.374006221914967,2085,8221,586,688,48,4590,31,1927,16,31
"64","2020-05-15",215,1,203,592,5786,0.374006221914967,2085,8221,586,688,49,4639,46,1973,20,46
"65","2020-05-16",210,1,205,587,5786,0.374006221914967,2085,8221,586,688,47,4686,40,2013,12,40
"66","2020-05-17",185,1,193,568,5786,0.374006221914967,2085,8221,586,688,45,4731,26,2039,14,26
"67","2020-05-18",183,1,226,552,5786,0.374006221914967,2085,8221,586,688,40,4771,56,2095,13,56
"68","2020-05-19",184,1,223,530,5786,0.374006221914967,2085,8221,586,688,26,4797,43,2138,10,43
"69","2020-05-20",185,1,212,511,5786,0.374006221914967,2085,8221,586,688,40,4837,20,2158,16,20
"70","2020-05-21",176,1,201,498,5786,0.374006221914967,2085,8221,586,688,33,4870,23,2181,14,23
"71","2020-05-22",175,1,185,479,5786,0.374006221914967,2085,8221,586,688,38,4908,24,2205,15,24
"72","2020-05-23",164,1,188,450,5786,0.374006221914967,2085,8221,586,688,37,4945,25,2230,11,25
"73","2020-05-24",146,1,186,439,5786,0.374006221914967,2085,8221,586,688,33,4978,37,2267,10,37
"74","2020-05-25",143,1,193,416,5786,0.374006221914967,2085,8221,586,688,15,4993,32,2299,7,32
"75","2020-05-26",132,1,188,407,5786,0.374006221914967,2085,8221,586,688,25,5018,31,2330,9,31
"76","2020-05-27",133,1,183,387,5786,0.374006221914967,2085,8221,586,688,17,5035,24,2354,6,24
"77","2020-05-28",130,1,160,359,5786,0.374006221914967,2085,8221,586,688,18,5053,21,2375,6,21
"78","2020-05-29",126,1,149,348,5786,0.374006221914967,2085,8221,586,688,30,5083,16,2391,11,16
"79","2020-05-30",136,1,152,319,5786,0.374006221914967,2085,8221,586,688,26,5109,29,2420,9,29
"80","2020-05-31",131,1,164,312,5786,0.374006221914967,2085,8221,586,688,19,5128,33,2453,6,33
"81","2020-06-01",122,1,155,290,5786,0.374006221914967,2085,8221,586,688,15,5143,20,2473,6,20
"82","2020-06-02",114,1,153,279,5786,0.374006221914967,2085,8221,586,688,20,5163,23,2496,6,23
"83","2020-06-03",104,1,143,261,5786,0.374006221914967,2085,8221,586,688,16,5179,28,2524,5,28
"84","2020-06-04",104,1,137,243,5786,0.374006221914967,2085,8221,586,688,17,5196,11,2535,6,11
"85","2020-06-05",100,1,128,228,5786,0.374006221914967,2085,8221,586,688,16,5212,22,2557,6,22
"86","2020-06-06",91,1,132,219,5786,0.374006221914967,2085,8221,586,688,14,5226,21,2578,5,21
"87","2020-06-07",85,1,148,207,5786,0.374006221914967,2085,8221,586,688,8,5234,30,2608,1,30
"88","2020-03-13",7,2,15,68,5763,0.704320666319625,2115,8375,520,426,53,114,29,60,10,29
"89","2020-03-14",13,2,14,93,5763,0.704320666319625,2115,8375,520,426,34,148,19,79,7,19
"90","2020-03-15",10,2,17,129,5763,0.704320666319625,2115,8375,520,426,49,197,27,106,18,27
"91","2020-03-16",10,2,20,163,5763,0.704320666319625,2115,8375,520,426,53,250,14,120,14,14
"92","2020-03-17",16,2,22,216,5763,0.704320666319625,2115,8375,520,426,40,290,23,143,9,23
"93","2020-03-18",20,2,30,257,5763,0.704320666319625,2115,8375,520,426,48,338,17,160,26,17
"94","2020-03-19",32,2,31,309,5763,0.704320666319625,2115,8375,520,426,75,413,13,173,31,13
"95","2020-03-20",44,2,54,350,5763,0.704320666319625,2115,8375,520,426,62,475,26,199,27,26
"96","2020-03-21",86,2,69,432,5763,0.704320666319625,2115,8375,520,426,71,546,29,228,36,29
"97","2020-03-22",107,2,58,489,5763,0.704320666319625,2115,8375,520,426,75,621,24,252,33,24
"98","2020-03-23",103,2,53,555,5763,0.704320666319625,2115,8375,520,426,79,700,27,279,52,27
"99","2020-03-24",114,2,70,607,5763,0.704320666319625,2115,8375,520,426,89,789,28,307,44,28
"100","2020-03-25",132,2,74,656,5763,0.704320666319625,2115,8375,520,426,94,883,19,326,56,19
"101","2020-03-26",154,2,80,693,5763,0.704320666319625,2115,8375,520,426,91,974,21,347,52,21
"102","2020-03-27",197,2,74,739,5763,0.704320666319625,2115,8375,520,426,73,1047,19,366,42,19
"103","2020-03-28",235,2,71,807,5763,0.704320666319625,2115,8375,520,426,92,1139,24,390,60,24
"104","2020-03-29",230,2,72,840,5763,0.704320666319625,2115,8375,520,426,99,1238,31,421,58,31
"105","2020-03-30",246,2,84,885,5763,0.704320666319625,2115,8375,520,426,76,1314,43,464,44,43
"106","2020-03-31",259,2,86,951,5763,0.704320666319625,2115,8375,520,426,87,1401,37,501,47,37
"107","2020-04-01",268,2,115,1000,5763,0.704320666319625,2115,8375,520,426,74,1475,33,534,46,33
"108","2020-04-02",252,2,127,1076,5763,0.704320666319625,2115,8375,520,426,80,1555,25,559,50,25
"109","2020-04-03",325,2,123,1101,5763,0.704320666319625,2115,8375,520,426,92,1647,33,592,60,33
"110","2020-04-04",317,2,137,1152,5763,0.704320666319625,2115,8375,520,426,92,1739,32,624,52,32
"111","2020-04-05",368,2,170,1215,5763,0.704320666319625,2115,8375,520,426,75,1814,24,648,45,24
"112","2020-04-06",366,2,182,1248,5763,0.704320666319625,2115,8375,520,426,92,1906,28,676,56,28
"113","2020-04-07",363,2,202,1288,5763,0.704320666319625,2115,8375,520,426,105,2011,23,699,52,23
"114","2020-04-08",372,2,215,1315,5763,0.704320666319625,2115,8375,520,426,82,2093,20,719,43,20
"115","2020-04-09",403,2,228,1311,5763,0.704320666319625,2115,8375,520,426,84,2177,25,744,47,25
"116","2020-04-10",447,2,233,1336,5763,0.704320666319625,2115,8375,520,426,87,2264,23,767,56,23
"117","2020-04-11",510,2,240,1369,5763,0.704320666319625,2115,8375,520,426,99,2363,20,787,58,20
"118","2020-04-12",436,2,254,1371,5763,0.704320666319625,2115,8375,520,426,85,2448,42,829,43,42
"119","2020-04-13",430,2,243,1389,5763,0.704320666319625,2115,8375,520,426,82,2530,21,850,46,21
"120","2020-04-14",439,2,214,1383,5763,0.704320666319625,2115,8375,520,426,67,2597,28,878,29,28
"121","2020-04-15",454,2,185,1375,5763,0.704320666319625,2115,8375,520,426,83,2680,26,904,43,26
"122","2020-04-16",455,2,183,1361,5763,0.704320666319625,2115,8375,520,426,86,2766,28,932,45,28
"123","2020-04-17",519,2,159,1354,5763,0.704320666319625,2115,8375,520,426,69,2835,33,965,42,33
"124","2020-04-18",477,2,139,1323,5763,0.704320666319625,2115,8375,520,426,69,2904,18,983,32,18
"125","2020-04-19",447,2,142,1264,5763,0.704320666319625,2115,8375,520,426,92,2996,22,1005,42,22
"126","2020-04-20",446,2,145,1232,5763,0.704320666319625,2115,8375,520,426,76,3072,23,1028,41,23
"127","2020-04-21",441,2,161,1226,5763,0.704320666319625,2115,8375,520,426,74,3146,26,1054,39,26
"128","2020-04-22",424,2,135,1190,5763,0.704320666319625,2115,8375,520,426,61,3207,21,1075,31,21
"129","2020-04-23",412,2,121,1153,5763,0.704320666319625,2115,8375,520,426,65,3272,16,1091,29,16
"130","2020-04-24",410,2,114,1086,5763,0.704320666319625,2115,8375,520,426,69,3341,15,1106,44,15
"131","2020-04-25",410,2,119,1021,5763,0.704320666319625,2115,8375,520,426,64,3405,19,1125,41,19
"132","2020-04-26",370,2,135,980,5763,0.704320666319625,2115,8375,520,426,66,3471,23,1148,33,23
"133","2020-04-27",360,2,157,939,5763,0.704320666319625,2115,8375,520,426,70,3541,12,1160,40,12
"134","2020-04-28",340,2,166,887,5763,0.704320666319625,2115,8375,520,426,76,3617,22,1182,37,22
"135","2020-04-29",332,2,152,866,5763,0.704320666319625,2115,8375,520,426,55,3672,12,1194,29,12
"136","2020-04-30",314,2,146,835,5763,0.704320666319625,2115,8375,520,426,60,3732,11,1205,30,11
"137","2020-05-01",286,2,146,794,5763,0.704320666319625,2115,8375,520,426,63,3795,16,1221,33,16
"138","2020-05-02",271,2,142,778,5763,0.704320666319625,2115,8375,520,426,60,3855,23,1244,29,23
"139","2020-05-03",265,2,169,769,5763,0.704320666319625,2115,8375,520,426,59,3914,33,1277,36,33
"140","2020-05-04",246,2,188,747,5763,0.704320666319625,2115,8375,520,426,66,3980,43,1320,28,43
"141","2020-05-05",246,2,171,691,5763,0.704320666319625,2115,8375,520,426,44,4024,24,1344,20,24
"142","2020-05-06",241,2,158,665,5763,0.704320666319625,2115,8375,520,426,48,4072,22,1366,24,22
"143","2020-05-07",248,2,148,633,5763,0.704320666319625,2115,8375,520,426,53,4125,26,1392,21,26
"144","2020-05-08",237,2,130,605,5763,0.704320666319625,2115,8375,520,426,54,4179,27,1419,24,27
"145","2020-05-09",242,2,129,567,5763,0.704320666319625,2115,8375,520,426,40,4219,40,1459,20,40
"146","2020-05-10",209,2,152,541,5763,0.704320666319625,2115,8375,520,426,40,4259,28,1487,20,28
"147","2020-05-11",204,2,164,520,5763,0.704320666319625,2115,8375,520,426,48,4307,19,1506,28,19
"148","2020-05-12",186,2,178,477,5763,0.704320666319625,2115,8375,520,426,43,4350,15,1521,24,15
"149","2020-05-13",182,2,178,454,5763,0.704320666319625,2115,8375,520,426,28,4378,38,1559,10,38
"150","2020-05-14",169,2,168,429,5763,0.704320666319625,2115,8375,520,426,38,4416,34,1593,15,34
"151","2020-05-15",157,2,173,420,5763,0.704320666319625,2115,8375,520,426,36,4452,38,1631,19,38
"152","2020-05-16",139,2,164,382,5763,0.704320666319625,2115,8375,520,426,42,4494,45,1676,15,45
"153","2020-05-17",132,2,137,349,5763,0.704320666319625,2115,8375,520,426,36,4530,43,1719,16,43
"154","2020-05-18",121,2,129,340,5763,0.704320666319625,2115,8375,520,426,37,4567,27,1746,13,27
"155","2020-05-19",118,2,126,328,5763,0.704320666319625,2115,8375,520,426,43,4610,20,1766,14,20
"156","2020-05-20",111,2,146,315,5763,0.704320666319625,2115,8375,520,426,25,4635,29,1795,12,29
"157","2020-05-21",112,2,150,300,5763,0.704320666319625,2115,8375,520,426,26,4661,28,1823,9,28
"158","2020-05-22",104,2,135,267,5763,0.704320666319625,2115,8375,520,426,32,4693,34,1857,15,34
"159","2020-05-23",97,2,146,264,5763,0.704320666319625,2115,8375,520,426,23,4716,29,1886,10,29
"160","2020-05-24",98,2,136,255,5763,0.704320666319625,2115,8375,520,426,27,4743,33,1919,12,33
"161","2020-05-25",91,2,148,248,5763,0.704320666319625,2115,8375,520,426,22,4765,19,1938,6,19
"162","2020-05-26",92,2,153,245,5763,0.704320666319625,2115,8375,520,426,22,4787,25,1963,10,25
"163","2020-05-27",88,2,150,232,5763,0.704320666319625,2115,8375,520,426,22,4809,22,1985,7,22
"164","2020-05-28",82,2,136,221,5763,0.704320666319625,2115,8375,520,426,23,4832,21,2006,14,21
"165","2020-05-29",81,2,128,213,5763,0.704320666319625,2115,8375,520,426,23,4855,16,2022,8,16
"166","2020-05-30",81,2,123,210,5763,0.704320666319625,2115,8375,520,426,14,4869,37,2059,5,37
"167","2020-05-31",72,2,126,205,5763,0.704320666319625,2115,8375,520,426,24,4893,36,2095,9,36
"168","2020-06-01",76,2,124,191,5763,0.704320666319625,2115,8375,520,426,17,4910,39,2134,7,39
"169","2020-06-02",73,2,131,191,5763,0.704320666319625,2115,8375,520,426,13,4923,33,2167,2,33
"170","2020-06-03",70,2,118,178,5763,0.704320666319625,2115,8375,520,426,21,4944,17,2184,10,17
"171","2020-06-04",65,2,118,178,5763,0.704320666319625,2115,8375,520,426,22,4966,30,2214,11,30
"172","2020-06-05",63,2,103,168,5763,0.704320666319625,2115,8375,520,426,14,4980,46,2260,7,46
"173","2020-06-06",60,2,108,159,5763,0.704320666319625,2115,8375,520,426,18,4998,25,2285,4,25
"174","2020-06-07",49,2,101,147,5763,0.704320666319625,2115,8375,520,426,14,5012,16,2301,4,16
"175","2020-03-13",1,3,118,117,6480,0.540740740740741,1995,8513,672,1449,29,68,11,30,13,11
"176","2020-03-14",8,3,151,160,6480,0.540740740740741,1995,8513,672,1449,27,95,14,44,13,14
"177","2020-03-15",20,3,157,231,6480,0.540740740740741,1995,8513,672,1449,40,135,8,52,22,8
"178","2020-03-16",23,3,150,294,6480,0.540740740740741,1995,8513,672,1449,30,165,10,62,20,10
"179","2020-03-17",28,3,179,350,6480,0.540740740740741,1995,8513,672,1449,53,218,20,82,34,20
"180","2020-03-18",45,3,201,428,6480,0.540740740740741,1995,8513,672,1449,40,258,11,93,35,11
"181","2020-03-19",65,3,217,497,6480,0.540740740740741,1995,8513,672,1449,47,305,13,106,42,13
"182","2020-03-20",106,3,251,554,6480,0.540740740740741,1995,8513,672,1449,57,362,24,130,47,24
"183","2020-03-21",125,3,237,639,6480,0.540740740740741,1995,8513,672,1449,85,447,32,162,69,32
"184","2020-03-22",165,3,222,723,6480,0.540740740740741,1995,8513,672,1449,74,521,18,180,67,18
"185","2020-03-23",184,3,244,774,6480,0.540740740740741,1995,8513,672,1449,73,594,27,207,66,27
"186","2020-03-24",193,3,271,844,6480,0.540740740740741,1995,8513,672,1449,75,669,32,239,64,32
"187","2020-03-25",204,3,254,897,6480,0.540740740740741,1995,8513,672,1449,124,793,41,280,111,41
"188","2020-03-26",203,3,236,941,6480,0.540740740740741,1995,8513,672,1449,98,891,50,330,86,50
"189","2020-03-27",282,3,259,979,6480,0.540740740740741,1995,8513,672,1449,93,984,30,360,86,30
"190","2020-03-28",332,3,241,1044,6480,0.540740740740741,1995,8513,672,1449,115,1099,31,391,103,31
"191","2020-03-29",305,3,232,1092,6480,0.540740740740741,1995,8513,672,1449,121,1220,23,414,114,23
"192","2020-03-30",306,3,243,1120,6480,0.540740740740741,1995,8513,672,1449,122,1342,15,429,112,15
"193","2020-03-31",306,3,237,1185,6480,0.540740740740741,1995,8513,672,1449,136,1478,16,445,128,16
"194","2020-04-01",328,3,263,1239,6480,0.540740740740741,1995,8513,672,1449,121,1599,18,463,112,18
"195","2020-04-02",360,3,256,1300,6480,0.540740740740741,1995,8513,672,1449,146,1745,31,494,133,31
"196","2020-04-03",420,3,250,1325,6480,0.540740740740741,1995,8513,672,1449,166,1911,32,526,156,32
"197","2020-04-04",403,3,233,1365,6480,0.540740740740741,1995,8513,672,1449,135,2046,34,560,124,34
"198","2020-04-05",432,3,206,1372,6480,0.540740740740741,1995,8513,672,1449,164,2210,30,590,150,30
"199","2020-04-06",436,3,204,1358,6480,0.540740740740741,1995,8513,672,1449,202,2412,43,633,186,43
"200","2020-04-07",444,3,213,1388,6480,0.540740740740741,1995,8513,672,1449,186,2598,39,672,171,39
"201","2020-04-08",441,3,241,1370,6480,0.540740740740741,1995,8513,672,1449,180,2778,24,696,167,24
"202","2020-04-09",449,3,245,1396,6480,0.540740740740741,1995,8513,672,1449,135,2913,18,714,129,18
"203","2020-04-10",518,3,251,1379,6480,0.540740740740741,1995,8513,672,1449,165,3078,39,753,154,39
"204","2020-04-11",538,3,257,1344,6480,0.540740740740741,1995,8513,672,1449,181,3259,31,784,170,31
"205","2020-04-12",465,3,246,1324,6480,0.540740740740741,1995,8513,672,1449,170,3429,28,812,161,28
"206","2020-04-13",462,3,226,1352,6480,0.540740740740741,1995,8513,672,1449,174,3603,41,853,159,41
"207","2020-04-14",454,3,250,1321,6480,0.540740740740741,1995,8513,672,1449,108,3711,49,902,105,49
"208","2020-04-15",443,3,263,1295,6480,0.540740740740741,1995,8513,672,1449,133,3844,18,920,124,18
"209","2020-04-16",428,3,272,1286,6480,0.540740740740741,1995,8513,672,1449,156,4000,23,943,143,23
"210","2020-04-17",439,3,264,1271,6480,0.540740740740741,1995,8513,672,1449,99,4099,32,975,88,32
"211","2020-04-18",444,3,275,1245,6480,0.540740740740741,1995,8513,672,1449,124,4223,37,1012,117,37
"212","2020-04-19",426,3,286,1225,6480,0.540740740740741,1995,8513,672,1449,115,4338,48,1060,103,48
"213","2020-04-20",425,3,290,1198,6480,0.540740740740741,1995,8513,672,1449,95,4433,38,1098,89,38
"214","2020-04-21",404,3,284,1172,6480,0.540740740740741,1995,8513,672,1449,126,4559,40,1138,117,40
"215","2020-04-22",403,3,290,1141,6480,0.540740740740741,1995,8513,672,1449,79,4638,30,1168,68,30
"216","2020-04-23",395,3,279,1078,6480,0.540740740740741,1995,8513,672,1449,85,4723,36,1204,76,36
"217","2020-04-24",435,3,292,1046,6480,0.540740740740741,1995,8513,672,1449,60,4783,44,1248,58,44
"218","2020-04-25",412,3,295,1017,6480,0.540740740740741,1995,8513,672,1449,93,4876,39,1287,80,39
"219","2020-04-26",388,3,294,999,6480,0.540740740740741,1995,8513,672,1449,74,4950,47,1334,66,47
"220","2020-04-27",373,3,285,964,6480,0.540740740740741,1995,8513,672,1449,70,5020,42,1376,63,42
"221","2020-04-28",361,3,269,916,6480,0.540740740740741,1995,8513,672,1449,62,5082,35,1411,54,35
"222","2020-04-29",357,3,262,893,6480,0.540740740740741,1995,8513,672,1449,61,5143,42,1453,48,42
"223","2020-04-30",351,3,274,860,6480,0.540740740740741,1995,8513,672,1449,66,5209,33,1486,60,33
"224","2020-05-01",318,3,274,831,6480,0.540740740740741,1995,8513,672,1449,57,5266,41,1527,52,41
"225","2020-05-02",345,3,273,796,6480,0.540740740740741,1995,8513,672,1449,56,5322,38,1565,50,38
"226","2020-05-03",301,3,267,776,6480,0.540740740740741,1995,8513,672,1449,42,5364,40,1605,36,40
"227","2020-05-04",288,3,276,752,6480,0.540740740740741,1995,8513,672,1449,44,5408,35,1640,33,35
"228","2020-05-05",283,3,264,720,6480,0.540740740740741,1995,8513,672,1449,29,5437,18,1658,22,18
"229","2020-05-06",271,3,265,692,6480,0.540740740740741,1995,8513,672,1449,33,5470,15,1673,27,15
"230","2020-05-07",265,3,243,673,6480,0.540740740740741,1995,8513,672,1449,40,5510,35,1708,39,35
"231","2020-05-08",255,3,251,666,6480,0.540740740740741,1995,8513,672,1449,35,5545,22,1730,27,22
"232","2020-05-09",218,3,243,649,6480,0.540740740740741,1995,8513,672,1449,28,5573,27,1757,18,27
"233","2020-05-10",203,3,231,622,6480,0.540740740740741,1995,8513,672,1449,31,5604,19,1776,22,19
"234","2020-05-11",192,3,244,586,6480,0.540740740740741,1995,8513,672,1449,21,5625,52,1828,20,52
"235","2020-05-12",191,3,305,550,6480,0.540740740740741,1995,8513,672,1449,27,5652,55,1883,23,55
"236","2020-05-13",190,3,292,515,6480,0.540740740740741,1995,8513,672,1449,29,5681,34,1917,22,34
"237","2020-05-14",185,3,292,492,6480,0.540740740740741,1995,8513,672,1449,22,5703,32,1949,18,32
"238","2020-05-15",159,3,285,465,6480,0.540740740740741,1995,8513,672,1449,26,5729,22,1971,20,22
"239","2020-05-16",172,3,289,439,6480,0.540740740740741,1995,8513,672,1449,25,5754,23,1994,16,23
"240","2020-05-17",172,3,291,427,6480,0.540740740740741,1995,8513,672,1449,26,5780,37,2031,21,37
"241","2020-05-18",167,3,282,403,6480,0.540740740740741,1995,8513,672,1449,16,5796,25,2056,14,25
"242","2020-05-19",149,3,280,385,6480,0.540740740740741,1995,8513,672,1449,20,5816,21,2077,16,21
"243","2020-05-20",141,3,286,364,6480,0.540740740740741,1995,8513,672,1449,14,5830,28,2105,10,28
"244","2020-05-21",134,3,285,343,6480,0.540740740740741,1995,8513,672,1449,16,5846,34,2139,11,34
"245","2020-05-22",136,3,295,331,6480,0.540740740740741,1995,8513,672,1449,8,5854,43,2182,5,43
"246","2020-05-23",126,3,321,320,6480,0.540740740740741,1995,8513,672,1449,15,5869,32,2214,9,32
"247","2020-05-24",117,3,325,306,6480,0.540740740740741,1995,8513,672,1449,19,5888,15,2229,15,15
"248","2020-05-25",109,3,331,296,6480,0.540740740740741,1995,8513,672,1449,19,5907,27,2256,15,27
"249","2020-05-26",101,3,355,289,6480,0.540740740740741,1995,8513,672,1449,14,5921,33,2289,11,33
"250","2020-05-27",103,3,332,278,6480,0.540740740740741,1995,8513,672,1449,11,5932,32,2321,9,32
"251","2020-05-28",97,3,341,268,6480,0.540740740740741,1995,8513,672,1449,12,5944,26,2347,10,26
"252","2020-05-29",95,3,329,254,6480,0.540740740740741,1995,8513,672,1449,12,5956,23,2370,9,23
"253","2020-05-30",94,3,321,239,6480,0.540740740740741,1995,8513,672,1449,15,5971,18,2388,14,18
"254","2020-05-31",78,3,294,214,6480,0.540740740740741,1995,8513,672,1449,6,5977,18,2406,5,18
"255","2020-06-01",77,3,288,210,6480,0.540740740740741,1995,8513,672,1449,12,5989,18,2424,7,18
"256","2020-06-02",75,3,298,204,6480,0.540740740740741,1995,8513,672,1449,12,6001,14,2438,10,14
"257","2020-06-03",67,3,288,193,6480,0.540740740740741,1995,8513,672,1449,5,6006,25,2463,4,25
"258","2020-06-04",64,3,286,184,6480,0.540740740740741,1995,8513,672,1449,16,6022,27,2490,12,27
"259","2020-06-05",59,3,279,173,6480,0.540740740740741,1995,8513,672,1449,8,6030,26,2516,6,26
"260","2020-06-06",53,3,244,163,6480,0.540740740740741,1995,8513,672,1449,4,6034,25,2541,3,25
"261","2020-06-07",57,3,261,159,6480,0.540740740740741,1995,8513,672,1449,11,6045,37,2578,8,37
"262","2020-03-13",3,4,69,62,5183,0.722361566660235,2070,7518,587,713,51,145,8,55,16,8
"263","2020-03-14",9,4,84,89,5183,0.722361566660235,2070,7518,587,713,61,206,9,64,24,9
"264","2020-03-15",13,4,96,133,5183,0.722361566660235,2070,7518,587,713,58,264,4,68,16,4
"265","2020-03-16",11,4,104,170,5183,0.722361566660235,2070,7518,587,713,88,352,5,73,26,5
"266","2020-03-17",14,4,122,209,5183,0.722361566660235,2070,7518,587,713,63,415,3,76,29,3
"267","2020-03-18",22,4,108,247,5183,0.722361566660235,2070,7518,587,713,80,495,3,79,39,3
"268","2020-03-19",33,4,97,297,5183,0.722361566660235,2070,7518,587,713,86,581,13,92,40,13
"269","2020-03-20",49,4,86,347,5183,0.722361566660235,2070,7518,587,713,82,663,44,136,47,44
"270","2020-03-21",66,4,72,383,5183,0.722361566660235,2070,7518,587,713,86,749,26,162,50,26
"271","2020-03-22",93,4,62,441,5183,0.722361566660235,2070,7518,587,713,83,832,65,227,47,65
"272","2020-03-23",102,4,74,478,5183,0.722361566660235,2070,7518,587,713,88,920,32,259,49,32
"273","2020-03-24",108,4,68,521,5183,0.722361566660235,2070,7518,587,713,97,1017,51,310,63,51
"274","2020-03-25",124,4,68,562,5183,0.722361566660235,2070,7518,587,713,112,1129,84,394,72,84
"275","2020-03-26",140,4,77,606,5183,0.722361566660235,2070,7518,587,713,109,1238,39,433,74,39
"276","2020-03-27",188,4,100,657,5183,0.722361566660235,2070,7518,587,713,124,1362,28,461,78,28
"277","2020-03-28",239,4,105,692,5183,0.722361566660235,2070,7518,587,713,105,1467,49,510,74,49
"278","2020-03-29",229,4,103,720,5183,0.722361566660235,2070,7518,587,713,114,1581,52,562,67,52
"279","2020-03-30",230,4,125,777,5183,0.722361566660235,2070,7518,587,713,111,1692,43,605,68,43
"280","2020-03-31",232,4,136,792,5183,0.722361566660235,2070,7518,587,713,90,1782,49,654,58,49
"281","2020-04-01",234,4,130,820,5183,0.722361566660235,2070,7518,587,713,112,1894,25,679,62,25
"282","2020-04-02",227,4,153,863,5183,0.722361566660235,2070,7518,587,713,103,1997,34,713,61,34
"283","2020-04-03",289,4,164,892,5183,0.722361566660235,2070,7518,587,713,101,2098,31,744,58,31
"284","2020-04-04",282,4,181,925,5183,0.722361566660235,2070,7518,587,713,108,2206,74,818,64,74
"285","2020-04-05",287,4,216,965,5183,0.722361566660235,2070,7518,587,713,87,2293,73,891,54,73
"286","2020-04-06",288,4,197,1001,5183,0.722361566660235,2070,7518,587,713,104,2397,76,967,58,76
"287","2020-04-07",295,4,177,1038,5183,0.722361566660235,2070,7518,587,713,107,2504,73,1040,61,73
"288","2020-04-08",298,4,149,1055,5183,0.722361566660235,2070,7518,587,713,109,2613,31,1071,60,31
"289","2020-04-09",315,4,151,1090,5183,0.722361566660235,2070,7518,587,713,94,2707,41,1112,53,41
"290","2020-04-10",370,4,186,1125,5183,0.722361566660235,2070,7518,587,713,95,2802,42,1154,58,42
"291","2020-04-11",371,4,209,1141,5183,0.722361566660235,2070,7518,587,713,102,2904,59,1213,61,59
"292","2020-04-12",368,4,231,1162,5183,0.722361566660235,2070,7518,587,713,76,2980,27,1240,45,27
"293","2020-04-13",377,4,239,1132,5183,0.722361566660235,2070,7518,587,713,100,3080,28,1268,57,28
"294","2020-04-14",368,4,239,1115,5183,0.722361566660235,2070,7518,587,713,101,3181,25,1293,57,25
"295","2020-04-15",372,4,197,1113,5183,0.722361566660235,2070,7518,587,713,93,3274,12,1305,47,12
"296","2020-04-16",370,4,183,1112,5183,0.722361566660235,2070,7518,587,713,92,3366,15,1320,45,15
"297","2020-04-17",371,4,166,1102,5183,0.722361566660235,2070,7518,587,713,82,3448,17,1337,44,17
"298","2020-04-18",373,4,163,1082,5183,0.722361566660235,2070,7518,587,713,72,3520,37,1374,45,37
"299","2020-04-19",361,4,140,1053,5183,0.722361566660235,2070,7518,587,713,69,3589,32,1406,37,32
"300","2020-04-20",364,4,128,1039,5183,0.722361566660235,2070,7518,587,713,79,3668,21,1427,50,21
"301","2020-04-21",357,4,170,1034,5183,0.722361566660235,2070,7518,587,713,90,3758,48,1475,50,48
"302","2020-04-22",351,4,163,1027,5183,0.722361566660235,2070,7518,587,713,75,3833,45,1520,35,45
"303","2020-04-23",350,4,152,999,5183,0.722361566660235,2070,7518,587,713,80,3913,25,1545,51,25
"304","2020-04-24",370,4,149,987,5183,0.722361566660235,2070,7518,587,713,78,3991,17,1562,46,17
"305","2020-04-25",379,4,127,948,5183,0.722361566660235,2070,7518,587,713,58,4049,15,1577,31,15
"306","2020-04-26",365,4,156,919,5183,0.722361566660235,2070,7518,587,713,76,4125,16,1593,37,16
"307","2020-04-27",346,4,198,890,5183,0.722361566660235,2070,7518,587,713,75,4200,50,1643,38,50
"308","2020-04-28",329,4,203,867,5183,0.722361566660235,2070,7518,587,713,78,4278,62,1705,48,62
"309","2020-04-29",329,4,194,818,5183,0.722361566660235,2070,7518,587,713,70,4348,34,1739,37,34
"310","2020-04-30",322,4,189,782,5183,0.722361566660235,2070,7518,587,713,60,4408,64,1803,31,64
"311","2020-05-01",306,4,176,726,5183,0.722361566660235,2070,7518,587,713,51,4459,80,1883,27,80
"312","2020-05-02",280,4,213,686,5183,0.722361566660235,2070,7518,587,713,52,4511,37,1920,24,37
"313","2020-05-03",234,4,221,668,5183,0.722361566660235,2070,7518,587,713,74,4585,41,1961,40,41
"314","2020-05-04",229,4,199,642,5183,0.722361566660235,2070,7518,587,713,63,4648,70,2031,34,70
"315","2020-05-05",221,4,175,615,5183,0.722361566660235,2070,7518,587,713,57,4705,16,2047,22,16
"316","2020-05-06",209,4,164,582,5183,0.722361566660235,2070,7518,587,713,55,4760,27,2074,34,27
"317","2020-05-07",203,4,164,555,5183,0.722361566660235,2070,7518,587,713,49,4809,37,2111,22,37
"318","2020-05-08",186,4,188,530,5183,0.722361566660235,2070,7518,587,713,64,4873,61,2172,34,61
"319","2020-05-09",190,4,173,522,5183,0.722361566660235,2070,7518,587,713,42,4915,34,2206,24,34
"320","2020-05-10",185,4,176,505,5183,0.722361566660235,2070,7518,587,713,40,4955,14,2220,19,14
"321","2020-05-11",174,4,193,489,5183,0.722361566660235,2070,7518,587,713,41,4996,18,2238,19,18
"322","2020-05-12",165,4,224,487,5183,0.722361566660235,2070,7518,587,713,36,5032,13,2251,12,13
"323","2020-05-13",165,4,229,473,5183,0.722361566660235,2070,7518,587,713,46,5078,11,2262,25,11
"324","2020-05-14",169,4,251,465,5183,0.722361566660235,2070,7518,587,713,41,5119,17,2279,21,17
"325","2020-05-15",160,4,250,444,5183,0.722361566660235,2070,7518,587,713,34,5153,13,2292,16,13
"326","2020-05-16",159,4,233,439,5183,0.722361566660235,2070,7518,587,713,34,5187,12,2304,16,12
"327","2020-05-17",162,4,223,439,5183,0.722361566660235,2070,7518,587,713,33,5220,13,2317,18,13
"328","2020-05-18",157,4,229,437,5183,0.722361566660235,2070,7518,587,713,30,5250,6,2323,13,6
"329","2020-05-19",154,4,240,421,5183,0.722361566660235,2070,7518,587,713,29,5279,10,2333,16,10
"330","2020-05-20",150,4,223,406,5183,0.722361566660235,2070,7518,587,713,24,5303,10,2343,9,10
"331","2020-05-21",136,4,213,384,5183,0.722361566660235,2070,7518,587,713,30,5333,81,2424,10,81
"332","2020-05-22",132,4,216,382,5183,0.722361566660235,2070,7518,587,713,32,5365,70,2494,15,70
"333","2020-05-23",137,4,206,383,5183,0.722361566660235,2070,7518,587,713,40,5405,58,2552,21,58
"334","2020-05-24",127,4,185,358,5183,0.722361566660235,2070,7518,587,713,34,5439,52,2604,20,52
"335","2020-05-25",121,4,161,321,5183,0.722361566660235,2070,7518,587,713,39,5478,30,2634,21,30
"336","2020-05-26",110,4,136,307,5183,0.722361566660235,2070,7518,587,713,28,5506,28,2662,17,28
"337","2020-05-27",108,4,146,289,5183,0.722361566660235,2070,7518,587,713,31,5537,41,2703,18,41
"338","2020-05-28",106,4,154,287,5183,0.722361566660235,2070,7518,587,713,35,5572,26,2729,10,26
"339","2020-05-29",106,4,158,280,5183,0.722361566660235,2070,7518,587,713,17,5589,36,2765,8,36
"340","2020-05-30",98,4,142,264,5183,0.722361566660235,2070,7518,587,713,20,5609,18,2783,3,18
"341","2020-05-31",83,4,145,255,5183,0.722361566660235,2070,7518,587,713,19,5628,19,2802,6,19
"342","2020-06-01",82,4,155,239,5183,0.722361566660235,2070,7518,587,713,24,5652,45,2847,11,45
"343","2020-06-02",81,4,167,234,5183,0.722361566660235,2070,7518,587,713,22,5674,26,2873,11,26
"344","2020-06-03",80,4,170,227,5183,0.722361566660235,2070,7518,587,713,19,5693,48,2921,13,48
"345","2020-06-04",83,4,155,218,5183,0.722361566660235,2070,7518,587,713,13,5706,36,2957,5,36
"346","2020-06-05",83,4,147,210,5183,0.722361566660235,2070,7518,587,713,12,5718,30,2987,3,30
"347","2020-06-06",72,4,136,204,5183,0.722361566660235,2070,7518,587,713,10,5728,28,3015,6,28
"348","2020-06-07",72,4,123,187,5183,0.722361566660235,2070,7518,587,713,20,5748,24,3039,15,24
"349","2020-03-07",1,5,0,0,5726,0.649668180230527,1995,7786,571,495,NA,NA,NA,NA,NA,NA
"350","2020-03-08",2,5,0,0,5726,0.649668180230527,1995,7786,571,495,NA,NA,NA,NA,NA,NA
"351","2020-03-09",1,5,0,0,5726,0.649668180230527,1995,7786,571,495,NA,NA,NA,NA,NA,NA
"352","2020-03-10",0,5,0,0,5726,0.649668180230527,1995,7786,571,495,NA,NA,2,2,NA,2
"353","2020-03-11",0,5,0,0,5726,0.649668180230527,1995,7786,571,495,11,11,10,12,2,10
"354","2020-03-12",0,5,0,0,5726,0.649668180230527,1995,7786,571,495,17,28,11,23,NA,11
"355","2020-03-13",3,5,41,76,5726,0.649668180230527,1995,7786,571,495,14,42,8,31,4,8
"356","2020-03-14",10,5,47,104,5726,0.649668180230527,1995,7786,571,495,26,68,11,42,10,11
"357","2020-03-15",14,5,60,137,5726,0.649668180230527,1995,7786,571,495,21,89,19,61,10,19
"358","2020-03-16",18,5,73,185,5726,0.649668180230527,1995,7786,571,495,29,118,9,70,13,9
"359","2020-03-17",21,5,71,242,5726,0.649668180230527,1995,7786,571,495,36,154,16,86,17,16
"360","2020-03-18",29,5,65,276,5726,0.649668180230527,1995,7786,571,495,40,194,22,108,30,22
"361","2020-03-19",38,5,67,320,5726,0.649668180230527,1995,7786,571,495,44,238,17,125,36,17
"362","2020-03-20",45,5,72,381,5726,0.649668180230527,1995,7786,571,495,69,307,34,159,60,34
"363","2020-03-21",62,5,78,448,5726,0.649668180230527,1995,7786,571,495,53,360,20,179,45,20
"364","2020-03-22",98,5,75,490,5726,0.649668180230527,1995,7786,571,495,68,428,28,207,56,28
"365","2020-03-23",99,5,85,543,5726,0.649668180230527,1995,7786,571,495,69,497,27,234,57,27
"366","2020-03-24",113,5,93,598,5726,0.649668180230527,1995,7786,571,495,68,565,28,262,58,28
"367","2020-03-25",137,5,89,640,5726,0.649668180230527,1995,7786,571,495,74,639,32,294,60,32
"368","2020-03-26",154,5,94,687,5726,0.649668180230527,1995,7786,571,495,86,725,21,315,74,21
"369","2020-03-27",217,5,105,737,5726,0.649668180230527,1995,7786,571,495,96,821,27,342,86,27
"370","2020-03-28",251,5,122,785,5726,0.649668180230527,1995,7786,571,495,117,938,27,369,106,27
"371","2020-03-29",247,5,124,848,5726,0.649668180230527,1995,7786,571,495,110,1048,32,401,102,32
"372","2020-03-30",257,5,141,900,5726,0.649668180230527,1995,7786,571,495,130,1178,62,463,115,62
"373","2020-03-31",252,5,132,936,5726,0.649668180230527,1995,7786,571,495,106,1284,36,499,89,36
"374","2020-04-01",254,5,125,957,5726,0.649668180230527,1995,7786,571,495,157,1441,22,521,144,22
"375","2020-04-02",261,5,127,1010,5726,0.649668180230527,1995,7786,571,495,176,1617,32,553,165,32
"376","2020-04-03",294,5,121,1036,5726,0.649668180230527,1995,7786,571,495,173,1790,45,598,161,45
"377","2020-04-04",325,5,112,1072,5726,0.649668180230527,1995,7786,571,495,164,1954,39,637,155,39
"378","2020-04-05",320,5,112,1143,5726,0.649668180230527,1995,7786,571,495,172,2126,28,665,154,28
"379","2020-04-06",314,5,93,1140,5726,0.649668180230527,1995,7786,571,495,179,2305,24,689,163,24
"380","2020-04-07",322,5,95,1158,5726,0.649668180230527,1995,7786,571,495,220,2525,28,717,207,28
"381","2020-04-08",341,5,81,1209,5726,0.649668180230527,1995,7786,571,495,188,2713,31,748,180,31
"382","2020-04-09",361,5,78,1262,5726,0.649668180230527,1995,7786,571,495,170,2883,23,771,161,23
"383","2020-04-10",435,5,71,1277,5726,0.649668180230527,1995,7786,571,495,172,3055,12,783,158,12
"384","2020-04-11",419,5,102,1271,5726,0.649668180230527,1995,7786,571,495,211,3266,24,807,196,24
"385","2020-04-12",414,5,108,1303,5726,0.649668180230527,1995,7786,571,495,180,3446,50,857,170,50
"386","2020-04-13",423,5,142,1288,5726,0.649668180230527,1995,7786,571,495,151,3597,38,895,140,38
"387","2020-04-14",430,5,143,1313,5726,0.649668180230527,1995,7786,571,495,173,3770,31,926,163,31
"388","2020-04-15",428,5,143,1318,5726,0.649668180230527,1995,7786,571,495,175,3945,49,975,168,49
"389","2020-04-16",415,5,149,1314,5726,0.649668180230527,1995,7786,571,495,151,4096,62,1037,141,62
"390","2020-04-17",440,5,127,1297,5726,0.649668180230527,1995,7786,571,495,118,4214,38,1075,110,38
"391","2020-04-18",448,5,123,1274,5726,0.649668180230527,1995,7786,571,495,132,4346,34,1109,125,34
"392","2020-04-19",424,5,112,1252,5726,0.649668180230527,1995,7786,571,495,144,4490,40,1149,135,40
"393","2020-04-20",432,5,123,1247,5726,0.649668180230527,1995,7786,571,495,114,4604,49,1198,104,49
"394","2020-04-21",425,5,126,1226,5726,0.649668180230527,1995,7786,571,495,116,4720,32,1230,103,32
"395","2020-04-22",424,5,158,1250,5726,0.649668180230527,1995,7786,571,495,112,4832,21,1251,101,21
"396","2020-04-23",435,5,146,1230,5726,0.649668180230527,1995,7786,571,495,111,4943,22,1273,101,22
"397","2020-04-24",451,5,144,1205,5726,0.649668180230527,1995,7786,571,495,88,5031,29,1302,78,29
"398","2020-04-25",458,5,155,1169,5726,0.649668180230527,1995,7786,571,495,78,5109,16,1318,72,16
"399","2020-04-26",426,5,162,1098,5726,0.649668180230527,1995,7786,571,495,80,5189,24,1342,68,24
"400","2020-04-27",394,5,175,1055,5726,0.649668180230527,1995,7786,571,495,73,5262,28,1370,71,28
"401","2020-04-28",388,5,161,1029,5726,0.649668180230527,1995,7786,571,495,62,5324,35,1405,50,35
"402","2020-04-29",375,5,162,991,5726,0.649668180230527,1995,7786,571,495,75,5399,34,1439,67,34
"403","2020-04-30",353,5,163,947,5726,0.649668180230527,1995,7786,571,495,36,5435,31,1470,33,31
"404","2020-05-01",326,5,172,915,5726,0.649668180230527,1995,7786,571,495,55,5490,42,1512,45,42
"405","2020-05-02",317,5,178,868,5726,0.649668180230527,1995,7786,571,495,41,5531,31,1543,38,31
"406","2020-05-03",292,5,171,814,5726,0.649668180230527,1995,7786,571,495,36,5567,29,1572,29,29
"407","2020-05-04",303,5,163,759,5726,0.649668180230527,1995,7786,571,495,24,5591,24,1596,17,24
"408","2020-05-05",292,5,185,709,5726,0.649668180230527,1995,7786,571,495,42,5633,49,1645,35,49
"409","2020-05-06",284,5,172,671,5726,0.649668180230527,1995,7786,571,495,37,5670,33,1678,30,33
"410","2020-05-07",277,5,154,623,5726,0.649668180230527,1995,7786,571,495,28,5698,21,1699,24,21
"411","2020-05-08",286,5,141,591,5726,0.649668180230527,1995,7786,571,495,40,5738,28,1727,34,28
"412","2020-05-09",268,5,126,573,5726,0.649668180230527,1995,7786,571,495,15,5753,52,1779,13,52
"413","2020-05-10",242,5,113,540,5726,0.649668180230527,1995,7786,571,495,17,5770,30,1809,14,30
"414","2020-05-11",218,5,105,521,5726,0.649668180230527,1995,7786,571,495,20,5790,18,1827,14,18
"415","2020-05-12",189,5,101,492,5726,0.649668180230527,1995,7786,571,495,24,5814,13,1840,18,13
"416","2020-05-13",179,5,97,468,5726,0.649668180230527,1995,7786,571,495,20,5834,20,1860,16,20
"417","2020-05-14",176,5,76,450,5726,0.649668180230527,1995,7786,571,495,17,5851,47,1907,10,47
"418","2020-05-15",158,5,74,427,5726,0.649668180230527,1995,7786,571,495,20,5871,61,1968,17,61
"419","2020-05-16",162,5,70,405,5726,0.649668180230527,1995,7786,571,495,14,5885,37,2005,11,37
"420","2020-05-17",148,5,85,374,5726,0.649668180230527,1995,7786,571,495,12,5897,23,2028,10,23
"421","2020-05-18",136,5,82,363,5726,0.649668180230527,1995,7786,571,495,16,5913,30,2058,12,30
"422","2020-05-19",146,5,89,344,5726,0.649668180230527,1995,7786,571,495,13,5926,19,2077,10,19
"423","2020-05-20",138,5,111,324,5726,0.649668180230527,1995,7786,571,495,4,5930,14,2091,4,14
"424","2020-05-21",131,5,115,314,5726,0.649668180230527,1995,7786,571,495,8,5938,22,2113,4,22
"425","2020-05-22",126,5,128,302,5726,0.649668180230527,1995,7786,571,495,10,5948,35,2148,3,35
"426","2020-05-23",116,5,138,291,5726,0.649668180230527,1995,7786,571,495,15,5963,37,2185,10,37
"427","2020-05-24",106,5,133,271,5726,0.649668180230527,1995,7786,571,495,6,5969,22,2207,5,22
"428","2020-05-25",103,5,150,266,5726,0.649668180230527,1995,7786,571,495,5,5974,11,2218,2,11
"429","2020-05-26",95,5,125,253,5726,0.649668180230527,1995,7786,571,495,5,5979,11,2229,2,11
"430","2020-05-27",95,5,139,238,5726,0.649668180230527,1995,7786,571,495,11,5990,9,2238,8,9
"431","2020-05-28",93,5,128,216,5726,0.649668180230527,1995,7786,571,495,12,6002,34,2272,7,34
"432","2020-05-29",78,5,127,209,5726,0.649668180230527,1995,7786,571,495,6,6008,42,2314,2,42
"433","2020-05-30",72,5,125,192,5726,0.649668180230527,1995,7786,571,495,10,6018,35,2349,6,35
"434","2020-05-31",66,5,121,173,5726,0.649668180230527,1995,7786,571,495,5,6023,38,2387,4,38
"435","2020-06-01",68,5,106,168,5726,0.649668180230527,1995,7786,571,495,5,6028,21,2408,1,21
"436","2020-06-02",68,5,100,156,5726,0.649668180230527,1995,7786,571,495,3,6031,33,2441,2,33
"437","2020-06-03",62,5,101,152,5726,0.649668180230527,1995,7786,571,495,3,6034,19,2460,3,19
"438","2020-06-04",57,5,94,140,5726,0.649668180230527,1995,7786,571,495,5,6039,28,2488,1,28
"439","2020-06-05",50,5,84,132,5726,0.649668180230527,1995,7786,571,495,1,6040,18,2506,NA,18
"440","2020-06-06",52,5,69,129,5726,0.649668180230527,1995,7786,571,495,10,6050,39,2545,6,39
"441","2020-06-07",51,5,70,113,5726,0.649668180230527,1995,7786,571,495,6,6056,22,2567,4,22
"442","2020-03-14",7,6,86,87,5300,0.707924528301887,1995,7372,534,1032,37,113,34,95,12,34
"443","2020-03-15",12,6,85,113,5300,0.707924528301887,1995,7372,534,1032,41,154,33,128,14,33
"444","2020-03-16",15,6,84,148,5300,0.707924528301887,1995,7372,534,1032,44,198,33,161,18,33
"445","2020-03-17",21,6,79,188,5300,0.707924528301887,1995,7372,534,1032,48,246,20,181,21,20
"446","2020-03-18",25,6,83,232,5300,0.707924528301887,1995,7372,534,1032,62,308,16,197,44,16
"447","2020-03-19",32,6,113,273,5300,0.707924528301887,1995,7372,534,1032,62,370,23,220,42,23
"448","2020-03-20",41,6,112,329,5300,0.707924528301887,1995,7372,534,1032,67,437,16,236,46,16
"449","2020-03-21",54,6,109,378,5300,0.707924528301887,1995,7372,534,1032,72,509,39,275,38,39
"450","2020-03-22",86,6,116,420,5300,0.707924528301887,1995,7372,534,1032,71,580,19,294,46,19
"451","2020-03-23",96,6,124,460,5300,0.707924528301887,1995,7372,534,1032,77,657,54,348,55,54
"452","2020-03-24",95,6,156,509,5300,0.707924528301887,1995,7372,534,1032,69,726,21,369,49,21
"453","2020-03-25",109,6,152,555,5300,0.707924528301887,1995,7372,534,1032,79,805,36,405,53,36
"454","2020-03-26",123,6,156,602,5300,0.707924528301887,1995,7372,534,1032,88,893,26,431,73,26
"455","2020-03-27",176,6,181,649,5300,0.707924528301887,1995,7372,534,1032,105,998,19,450,77,19
"456","2020-03-28",210,6,188,680,5300,0.707924528301887,1995,7372,534,1032,109,1107,50,500,87,50
"457","2020-03-29",192,6,171,721,5300,0.707924528301887,1995,7372,534,1032,108,1215,31,531,85,31
"458","2020-03-30",189,6,170,760,5300,0.707924528301887,1995,7372,534,1032,95,1310,13,544,70,13
"459","2020-03-31",200,6,189,790,5300,0.707924528301887,1995,7372,534,1032,114,1424,20,564,85,20
"460","2020-04-01",210,6,173,823,5300,0.707924528301887,1995,7372,534,1032,117,1541,8,572,93,8
"461","2020-04-02",217,6,167,858,5300,0.707924528301887,1995,7372,534,1032,117,1658,16,588,90,16
"462","2020-04-03",254,6,148,859,5300,0.707924528301887,1995,7372,534,1032,114,1772,15,603,85,15
"463","2020-04-04",259,6,144,884,5300,0.707924528301887,1995,7372,534,1032,120,1892,44,647,95,44
"464","2020-04-05",270,6,181,911,5300,0.707924528301887,1995,7372,534,1032,116,2008,30,677,96,30
"465","2020-04-06",271,6,226,945,5300,0.707924528301887,1995,7372,534,1032,101,2109,19,696,78,19
"466","2020-04-07",288,6,264,961,5300,0.707924528301887,1995,7372,534,1032,126,2235,17,713,100,17
"467","2020-04-08",296,6,257,1016,5300,0.707924528301887,1995,7372,534,1032,113,2348,26,739,91,26
"468","2020-04-09",303,6,218,1061,5300,0.707924528301887,1995,7372,534,1032,129,2477,49,788,95,49
"469","2020-04-10",331,6,204,1077,5300,0.707924528301887,1995,7372,534,1032,125,2602,52,840,98,52
"470","2020-04-11",361,6,209,1106,5300,0.707924528301887,1995,7372,534,1032,117,2719,26,866,94,26
"471","2020-04-12",361,6,217,1105,5300,0.707924528301887,1995,7372,534,1032,136,2855,28,894,105,28
"472","2020-04-13",368,6,206,1112,5300,0.707924528301887,1995,7372,534,1032,131,2986,27,921,105,27
"473","2020-04-14",356,6,189,1108,5300,0.707924528301887,1995,7372,534,1032,111,3097,42,963,96,42
"474","2020-04-15",361,6,167,1091,5300,0.707924528301887,1995,7372,534,1032,111,3208,30,993,90,30
"475","2020-04-16",377,6,151,1099,5300,0.707924528301887,1995,7372,534,1032,103,3311,28,1021,82,28
"476","2020-04-17",426,6,136,1088,5300,0.707924528301887,1995,7372,534,1032,103,3414,42,1063,82,42
"477","2020-04-18",403,6,127,1062,5300,0.707924528301887,1995,7372,534,1032,108,3522,34,1097,82,34
"478","2020-04-19",374,6,112,1047,5300,0.707924528301887,1995,7372,534,1032,107,3629,58,1155,89,58
"479","2020-04-20",367,6,114,1004,5300,0.707924528301887,1995,7372,534,1032,113,3742,33,1188,91,33
"480","2020-04-21",356,6,135,963,5300,0.707924528301887,1995,7372,534,1032,95,3837,26,1214,77,26
"481","2020-04-22",344,6,146,953,5300,0.707924528301887,1995,7372,534,1032,121,3958,32,1246,90,32
"482","2020-04-23",325,6,134,944,5300,0.707924528301887,1995,7372,534,1032,82,4040,36,1282,61,36
"483","2020-04-24",302,6,125,898,5300,0.707924528301887,1995,7372,534,1032,90,4130,53,1335,61,53
"484","2020-04-25",315,6,124,865,5300,0.707924528301887,1995,7372,534,1032,69,4199,29,1364,47,29
"485","2020-04-26",290,6,166,847,5300,0.707924528301887,1995,7372,534,1032,81,4280,18,1382,62,18
"486","2020-04-27",280,6,183,819,5300,0.707924528301887,1995,7372,534,1032,57,4337,9,1391,45,9
"487","2020-04-28",275,6,208,776,5300,0.707924528301887,1995,7372,534,1032,64,4401,31,1422,43,31
"488","2020-04-29",276,6,211,761,5300,0.707924528301887,1995,7372,534,1032,79,4480,17,1439,62,17
"489","2020-04-30",268,6,203,750,5300,0.707924528301887,1995,7372,534,1032,58,4538,46,1485,40,46
"490","2020-05-01",265,6,183,751,5300,0.707924528301887,1995,7372,534,1032,41,4579,37,1522,28,37
"491","2020-05-02",251,6,157,752,5300,0.707924528301887,1995,7372,534,1032,65,4644,26,1548,54,26
"492","2020-05-03",258,6,152,734,5300,0.707924528301887,1995,7372,534,1032,30,4674,44,1592,20,44
"493","2020-05-04",262,6,179,724,5300,0.707924528301887,1995,7372,534,1032,52,4726,56,1648,34,56
"494","2020-05-05",244,6,180,706,5300,0.707924528301887,1995,7372,534,1032,41,4767,63,1711,28,63
"495","2020-05-06",237,6,163,679,5300,0.707924528301887,1995,7372,534,1032,45,4812,31,1742,27,31
"496","2020-05-07",241,6,165,665,5300,0.707924528301887,1995,7372,534,1032,31,4843,16,1758,21,16
"497","2020-05-08",260,6,194,644,5300,0.707924528301887,1995,7372,534,1032,46,4889,26,1784,24,26
"498","2020-05-09",247,6,192,620,5300,0.707924528301887,1995,7372,534,1032,42,4931,29,1813,25,29
"499","2020-05-10",236,6,210,589,5300,0.707924528301887,1995,7372,534,1032,43,4974,49,1862,25,49
"500","2020-05-11",215,6,231,574,5300,0.707924528301887,1995,7372,534,1032,40,5014,46,1908,24,46
"501","2020-05-12",204,6,249,546,5300,0.707924528301887,1995,7372,534,1032,45,5059,32,1940,27,32
"502","2020-05-13",196,6,231,529,5300,0.707924528301887,1995,7372,534,1032,30,5089,59,1999,17,59
"503","2020-05-14",186,6,233,497,5300,0.707924528301887,1995,7372,534,1032,25,5114,31,2030,14,31
"504","2020-05-15",179,6,226,488,5300,0.707924528301887,1995,7372,534,1032,24,5138,62,2092,11,62
"505","2020-05-16",178,6,227,456,5300,0.707924528301887,1995,7372,534,1032,24,5162,39,2131,15,39
"506","2020-05-17",148,6,254,428,5300,0.707924528301887,1995,7372,534,1032,25,5187,26,2157,13,26
"507","2020-05-18",145,6,241,425,5300,0.707924528301887,1995,7372,534,1032,20,5207,22,2179,13,22
"508","2020-05-19",133,6,224,415,5300,0.707924528301887,1995,7372,534,1032,19,5226,44,2223,9,44
"509","2020-05-20",137,6,198,409,5300,0.707924528301887,1995,7372,534,1032,14,5240,49,2272,5,49
"510","2020-05-21",134,6,196,387,5300,0.707924528301887,1995,7372,534,1032,25,5265,32,2304,10,32
"511","2020-05-22",122,6,163,387,5300,0.707924528301887,1995,7372,534,1032,28,5293,23,2327,14,23
"512","2020-05-23",135,6,152,377,5300,0.707924528301887,1995,7372,534,1032,16,5309,36,2363,6,36
"513","2020-05-24",138,6,156,362,5300,0.707924528301887,1995,7372,534,1032,27,5336,43,2406,18,43
"514","2020-05-25",134,6,153,351,5300,0.707924528301887,1995,7372,534,1032,16,5352,23,2429,10,23
"515","2020-05-26",137,6,194,348,5300,0.707924528301887,1995,7372,534,1032,15,5367,9,2438,10,9
"516","2020-05-27",136,6,187,342,5300,0.707924528301887,1995,7372,534,1032,21,5388,15,2453,7,15
"517","2020-05-28",128,6,200,327,5300,0.707924528301887,1995,7372,534,1032,11,5399,8,2461,7,8
"518","2020-05-29",127,6,172,318,5300,0.707924528301887,1995,7372,534,1032,21,5420,8,2469,12,8
"519","2020-05-30",111,6,139,315,5300,0.707924528301887,1995,7372,534,1032,14,5434,4,2473,8,4
"520","2020-05-31",103,6,154,306,5300,0.707924528301887,1995,7372,534,1032,14,5448,2,2475,5,2
"521","2020-06-01",99,6,176,296,5300,0.707924528301887,1995,7372,534,1032,9,5457,29,2504,6,29
"522","2020-06-02",91,6,157,279,5300,0.707924528301887,1995,7372,534,1032,14,5471,27,2531,5,27
"523","2020-06-03",84,6,191,281,5300,0.707924528301887,1995,7372,534,1032,11,5482,22,2553,4,22
"524","2020-06-04",91,6,204,263,5300,0.707924528301887,1995,7372,534,1032,13,5495,7,2560,6,7
"525","2020-06-05",92,6,193,257,5300,0.707924528301887,1995,7372,534,1032,13,5508,17,2577,6,17
"526","2020-06-06",106,6,200,240,5300,0.707924528301887,1995,7372,534,1032,6,5514,19,2596,2,19
"527","2020-06-07",103,6,199,236,5300,0.707924528301887,1995,7372,534,1032,12,5526,20,2616,6,20
"528","2020-03-07",2,7,0,0,5763,0.39285094568801,2010,8056,616,497,NA,NA,NA,NA,NA,NA
"529","2020-03-08",2,7,0,0,5763,0.39285094568801,2010,8056,616,497,NA,NA,NA,NA,NA,NA
"530","2020-03-09",0,7,0,0,5763,0.39285094568801,2010,8056,616,497,NA,NA,NA,NA,NA,NA
"531","2020-03-10",0,7,0,0,5763,0.39285094568801,2010,8056,616,497,NA,NA,1,1,NA,1
"532","2020-03-11",0,7,0,0,5763,0.39285094568801,2010,8056,616,497,19,19,30,31,3,30
"533","2020-03-12",0,7,0,0,5763,0.39285094568801,2010,8056,616,497,19,38,18,49,2,18
"534","2020-03-13",5,7,34,125,5763,0.39285094568801,2010,8056,616,497,22,60,41,90,9,41
"535","2020-03-14",9,7,41,184,5763,0.39285094568801,2010,8056,616,497,21,81,12,102,11,12
"536","2020-03-15",28,7,47,237,5763,0.39285094568801,2010,8056,616,497,35,116,14,116,21,14
"537","2020-03-16",36,7,61,292,5763,0.39285094568801,2010,8056,616,497,41,157,45,161,28,45
"538","2020-03-17",37,7,66,354,5763,0.39285094568801,2010,8056,616,497,50,207,41,202,34,41
"539","2020-03-18",50,7,82,415,5763,0.39285094568801,2010,8056,616,497,34,241,40,242,21,40
"540","2020-03-19",67,7,89,460,5763,0.39285094568801,2010,8056,616,497,62,303,30,272,47,30
"541","2020-03-20",105,7,109,506,5763,0.39285094568801,2010,8056,616,497,57,360,39,311,47,39
"542","2020-03-21",149,7,103,561,5763,0.39285094568801,2010,8056,616,497,70,430,28,339,51,28
"543","2020-03-22",152,7,105,622,5763,0.39285094568801,2010,8056,616,497,68,498,24,363,49,24
"544","2020-03-23",160,7,101,684,5763,0.39285094568801,2010,8056,616,497,92,590,35,398,71,35
"545","2020-03-24",181,7,107,738,5763,0.39285094568801,2010,8056,616,497,82,672,26,424,69,26
"546","2020-03-25",194,7,117,755,5763,0.39285094568801,2010,8056,616,497,100,772,20,444,89,20
"547","2020-03-26",196,7,105,776,5763,0.39285094568801,2010,8056,616,497,103,875,24,468,92,24
"548","2020-03-27",231,7,97,822,5763,0.39285094568801,2010,8056,616,497,93,968,35,503,74,35
"549","2020-03-28",246,7,100,842,5763,0.39285094568801,2010,8056,616,497,101,1069,42,545,81,42
"550","2020-03-29",270,7,96,847,5763,0.39285094568801,2010,8056,616,497,124,1193,56,601,114,56
"551","2020-03-30",269,7,95,850,5763,0.39285094568801,2010,8056,616,497,131,1324,47,648,114,47
"552","2020-03-31",262,7,88,853,5763,0.39285094568801,2010,8056,616,497,112,1436,24,672,99,24
"553","2020-04-01",269,7,78,849,5763,0.39285094568801,2010,8056,616,497,148,1584,19,691,130,19
"554","2020-04-02",281,7,109,864,5763,0.39285094568801,2010,8056,616,497,120,1704,44,735,109,44
"555","2020-04-03",321,7,114,894,5763,0.39285094568801,2010,8056,616,497,134,1838,27,762,122,27
"556","2020-04-04",319,7,104,899,5763,0.39285094568801,2010,8056,616,497,133,1971,13,775,121,13
"557","2020-04-05",286,7,103,918,5763,0.39285094568801,2010,8056,616,497,142,2113,13,788,128,13
"558","2020-04-06",281,7,110,940,5763,0.39285094568801,2010,8056,616,497,141,2254,16,804,127,16
"559","2020-04-07",283,7,127,967,5763,0.39285094568801,2010,8056,616,497,171,2425,10,814,163,10
"560","2020-04-08",279,7,122,957,5763,0.39285094568801,2010,8056,616,497,162,2587,10,824,145,10
"561","2020-04-09",279,7,138,953,5763,0.39285094568801,2010,8056,616,497,124,2711,42,866,114,42
"562","2020-04-10",301,7,155,991,5763,0.39285094568801,2010,8056,616,497,147,2858,20,886,133,20
"563","2020-04-11",314,7,145,985,5763,0.39285094568801,2010,8056,616,497,111,2969,32,918,104,32
"564","2020-04-12",324,7,133,1005,5763,0.39285094568801,2010,8056,616,497,131,3100,31,949,120,31
"565","2020-04-13",329,7,123,1016,5763,0.39285094568801,2010,8056,616,497,121,3221,19,968,116,19
"566","2020-04-14",323,7,139,1017,5763,0.39285094568801,2010,8056,616,497,117,3338,18,986,103,18
"567","2020-04-15",323,7,141,1028,5763,0.39285094568801,2010,8056,616,497,110,3448,26,1012,99,26
"568","2020-04-16",325,7,153,1034,5763,0.39285094568801,2010,8056,616,497,132,3580,30,1042,124,30
"569","2020-04-17",347,7,179,1035,5763,0.39285094568801,2010,8056,616,497,111,3691,42,1084,101,42
"570","2020-04-18",346,7,208,1023,5763,0.39285094568801,2010,8056,616,497,109,3800,32,1116,103,32
"571","2020-04-19",326,7,227,1030,5763,0.39285094568801,2010,8056,616,497,93,3893,21,1137,81,21
"572","2020-04-20",314,7,251,1027,5763,0.39285094568801,2010,8056,616,497,103,3996,16,1153,94,16
"573","2020-04-21",318,7,241,999,5763,0.39285094568801,2010,8056,616,497,119,4115,39,1192,107,39
"574","2020-04-22",325,7,215,1009,5763,0.39285094568801,2010,8056,616,497,84,4199,22,1214,70,22
"575","2020-04-23",342,7,229,979,5763,0.39285094568801,2010,8056,616,497,85,4284,17,1231,75,17
"576","2020-04-24",360,7,209,959,5763,0.39285094568801,2010,8056,616,497,82,4366,10,1241,78,10
"577","2020-04-25",366,7,193,955,5763,0.39285094568801,2010,8056,616,497,76,4442,10,1251,68,10
"578","2020-04-26",336,7,208,942,5763,0.39285094568801,2010,8056,616,497,76,4518,3,1254,71,3
"579","2020-04-27",332,7,197,932,5763,0.39285094568801,2010,8056,616,497,96,4614,1,1255,81,1
"580","2020-04-28",324,7,196,917,5763,0.39285094568801,2010,8056,616,497,53,4667,2,1257,46,2
"581","2020-04-29",316,7,197,901,5763,0.39285094568801,2010,8056,616,497,61,4728,2,1259,51,2
"582","2020-04-30",311,7,183,858,5763,0.39285094568801,2010,8056,616,497,37,4765,7,1266,34,7
"583","2020-05-01",317,7,162,834,5763,0.39285094568801,2010,8056,616,497,45,4810,41,1307,38,41
"584","2020-05-02",316,7,138,818,5763,0.39285094568801,2010,8056,616,497,55,4865,47,1354,48,47
"585","2020-05-03",275,7,126,813,5763,0.39285094568801,2010,8056,616,497,37,4902,43,1397,30,43
"586","2020-05-04",278,7,130,799,5763,0.39285094568801,2010,8056,616,497,34,4936,25,1422,29,25
"587","2020-05-05",269,7,143,787,5763,0.39285094568801,2010,8056,616,497,39,4975,26,1448,36,26
"588","2020-05-06",271,7,158,759,5763,0.39285094568801,2010,8056,616,497,43,5018,18,1466,32,18
"589","2020-05-07",262,7,139,757,5763,0.39285094568801,2010,8056,616,497,27,5045,47,1513,22,48
"590","2020-05-08",256,7,131,708,5763,0.39285094568801,2010,8056,616,497,45,5090,57,1570,37,57
"591","2020-05-09",240,7,162,693,5763,0.39285094568801,2010,8056,616,497,39,5129,28,1598,27,28
"592","2020-05-10",259,7,152,654,5763,0.39285094568801,2010,8056,616,497,32,5161,19,1617,20,19
"593","2020-05-11",244,7,161,614,5763,0.39285094568801,2010,8056,616,497,21,5182,30,1647,13,30
"594","2020-05-12",227,7,155,587,5763,0.39285094568801,2010,8056,616,497,22,5204,19,1666,14,19
"595","2020-05-13",221,7,135,557,5763,0.39285094568801,2010,8056,616,497,25,5229,18,1684,19,18
"596","2020-05-14",198,7,127,529,5763,0.39285094568801,2010,8056,616,497,18,5247,33,1717,11,33
"597","2020-05-15",194,7,129,506,5763,0.39285094568801,2010,8056,616,497,27,5274,26,1743,15,26
"598","2020-05-16",201,7,140,481,5763,0.39285094568801,2010,8056,616,497,24,5298,16,1759,16,16
"599","2020-05-17",174,7,142,462,5763,0.39285094568801,2010,8056,616,497,22,5320,8,1767,12,8
"600","2020-05-18",167,7,133,451,5763,0.39285094568801,2010,8056,616,497,20,5340,10,1777,17,10
"601","2020-05-19",167,7,123,443,5763,0.39285094568801,2010,8056,616,497,17,5357,50,1827,12,50
"602","2020-05-20",155,7,117,432,5763,0.39285094568801,2010,8056,616,497,11,5368,52,1879,8,52
"603","2020-05-21",153,7,112,419,5763,0.39285094568801,2010,8056,616,497,17,5385,43,1922,7,43
"604","2020-05-22",147,7,129,401,5763,0.39285094568801,2010,8056,616,497,18,5403,31,1953,13,31
"605","2020-05-23",138,7,125,389,5763,0.39285094568801,2010,8056,616,497,12,5415,22,1975,9,22
"606","2020-05-24",140,7,119,383,5763,0.39285094568801,2010,8056,616,497,11,5426,15,1990,7,15
"607","2020-05-25",132,7,118,367,5763,0.39285094568801,2010,8056,616,497,10,5436,6,1996,4,6
"608","2020-05-26",117,7,121,356,5763,0.39285094568801,2010,8056,616,497,7,5443,22,2018,4,22
"609","2020-05-27",120,7,114,345,5763,0.39285094568801,2010,8056,616,497,18,5461,12,2030,12,12
"610","2020-05-28",122,7,112,333,5763,0.39285094568801,2010,8056,616,497,13,5474,40,2070,11,40
"611","2020-05-29",128,7,108,327,5763,0.39285094568801,2010,8056,616,497,8,5482,22,2092,7,22
"612","2020-05-30",120,7,106,322,5763,0.39285094568801,2010,8056,616,497,6,5488,15,2107,4,15
"613","2020-05-31",109,7,97,308,5763,0.39285094568801,2010,8056,616,497,9,5497,15,2122,7,15
"614","2020-06-01",104,7,101,296,5763,0.39285094568801,2010,8056,616,497,8,5505,31,2153,6,31
"615","2020-06-02",103,7,100,276,5763,0.39285094568801,2010,8056,616,497,4,5509,40,2193,3,40
"616","2020-06-03",95,7,93,259,5763,0.39285094568801,2010,8056,616,497,6,5515,35,2228,4,35
"617","2020-06-04",87,7,108,245,5763,0.39285094568801,2010,8056,616,497,8,5523,22,2250,4,22
"618","2020-06-05",76,7,94,233,5763,0.39285094568801,2010,8056,616,497,4,5527,42,2292,3,42
"619","2020-06-06",74,7,85,218,5763,0.39285094568801,2010,8056,616,497,3,5530,23,2315,2,23
"620","2020-06-07",71,7,89,213,5763,0.39285094568801,2010,8056,616,497,8,5538,13,2328,5,13
"621","2020-03-13",3,8,86,95,6033,0.590916625227913,2025,7551,589,1240,30,93,15,37,4,15
"622","2020-03-14",5,8,109,133,6033,0.590916625227913,2025,7551,589,1240,17,110,18,55,4,18
"623","2020-03-15",17,8,125,197,6033,0.590916625227913,2025,7551,589,1240,41,151,9,64,10,9
"624","2020-03-16",25,8,152,243,6033,0.590916625227913,2025,7551,589,1240,40,191,21,85,14,21
"625","2020-03-17",31,8,190,297,6033,0.590916625227913,2025,7551,589,1240,44,235,26,111,16,26
"626","2020-03-18",41,8,191,361,6033,0.590916625227913,2025,7551,589,1240,34,269,17,128,16,17
"627","2020-03-19",60,8,222,423,6033,0.590916625227913,2025,7551,589,1240,43,312,22,150,22,22
"628","2020-03-20",81,8,237,478,6033,0.590916625227913,2025,7551,589,1240,41,353,17,167,17,17
"629","2020-03-21",104,8,231,532,6033,0.590916625227913,2025,7551,589,1240,45,398,17,184,23,17
"630","2020-03-22",138,8,225,593,6033,0.590916625227913,2025,7551,589,1240,56,454,9,193,25,9
"631","2020-03-23",147,8,239,633,6033,0.590916625227913,2025,7551,589,1240,66,520,23,216,31,23
"632","2020-03-24",146,8,249,708,6033,0.590916625227913,2025,7551,589,1240,63,583,37,253,40,37
"633","2020-03-25",167,8,255,755,6033,0.590916625227913,2025,7551,589,1240,77,660,23,276,54,23
"634","2020-03-26",183,8,260,811,6033,0.590916625227913,2025,7551,589,1240,55,715,14,290,44,14
"635","2020-03-27",250,8,238,850,6033,0.590916625227913,2025,7551,589,1240,77,792,10,300,52,10
"636","2020-03-28",276,8,235,910,6033,0.590916625227913,2025,7551,589,1240,67,859,28,328,42,28
"637","2020-03-29",284,8,233,964,6033,0.590916625227913,2025,7551,589,1240,75,934,37,365,49,37
"638","2020-03-30",297,8,234,1023,6033,0.590916625227913,2025,7551,589,1240,81,1015,14,379,58,14
"639","2020-03-31",309,8,266,1082,6033,0.590916625227913,2025,7551,589,1240,85,1100,21,400,51,21
"640","2020-04-01",302,8,255,1088,6033,0.590916625227913,2025,7551,589,1240,91,1191,29,429,55,29
"641","2020-04-02",308,8,256,1138,6033,0.590916625227913,2025,7551,589,1240,64,1255,23,452,45,23
"642","2020-04-03",373,8,264,1184,6033,0.590916625227913,2025,7551,589,1240,81,1336,42,494,50,42
"643","2020-04-04",381,8,258,1207,6033,0.590916625227913,2025,7551,589,1240,90,1426,42,536,59,42
"644","2020-04-05",375,8,267,1226,6033,0.590916625227913,2025,7551,589,1240,86,1512,30,566,38,30
"645","2020-04-06",387,8,268,1256,6033,0.590916625227913,2025,7551,589,1240,65,1577,53,619,49,53
"646","2020-04-07",381,8,277,1267,6033,0.590916625227913,2025,7551,589,1240,77,1654,32,651,53,32
"647","2020-04-08",397,8,280,1301,6033,0.590916625227913,2025,7551,589,1240,91,1745,22,673,61,22
"648","2020-04-09",407,8,289,1299,6033,0.590916625227913,2025,7551,589,1240,96,1841,28,701,60,28
"649","2020-04-10",421,8,278,1263,6033,0.590916625227913,2025,7551,589,1240,87,1928,13,714,63,13
"650","2020-04-11",466,8,275,1235,6033,0.590916625227913,2025,7551,589,1240,102,2030,11,725,63,11
"651","2020-04-12",416,8,243,1237,6033,0.590916625227913,2025,7551,589,1240,84,2114,13,738,53,13
"652","2020-04-13",393,8,230,1234,6033,0.590916625227913,2025,7551,589,1240,65,2179,29,767,51,29
"653","2020-04-14",400,8,246,1237,6033,0.590916625227913,2025,7551,589,1240,82,2261,44,811,57,44
"654","2020-04-15",411,8,274,1238,6033,0.590916625227913,2025,7551,589,1240,89,2350,55,866,62,55
"655","2020-04-16",411,8,258,1245,6033,0.590916625227913,2025,7551,589,1240,74,2424,53,919,46,53
"656","2020-04-17",482,8,258,1237,6033,0.590916625227913,2025,7551,589,1240,66,2490,30,949,37,30
"657","2020-04-18",434,8,259,1212,6033,0.590916625227913,2025,7551,589,1240,78,2568,21,970,50,21
"658","2020-04-19",398,8,247,1164,6033,0.590916625227913,2025,7551,589,1240,82,2650,15,985,50,15
"659","2020-04-20",402,8,239,1152,6033,0.590916625227913,2025,7551,589,1240,64,2714,28,1013,40,28
"660","2020-04-21",394,8,245,1137,6033,0.590916625227913,2025,7551,589,1240,64,2778,23,1036,37,23
"661","2020-04-22",372,8,227,1113,6033,0.590916625227913,2025,7551,589,1240,80,2858,41,1077,42,41
"662","2020-04-23",371,8,259,1116,6033,0.590916625227913,2025,7551,589,1240,58,2916,34,1111,30,34
"663","2020-04-24",369,8,278,1090,6033,0.590916625227913,2025,7551,589,1240,63,2979,44,1155,35,44
"664","2020-04-25",389,8,270,1029,6033,0.590916625227913,2025,7551,589,1240,71,3050,58,1213,39,58
"665","2020-04-26",372,8,279,999,6033,0.590916625227913,2025,7551,589,1240,51,3101,40,1253,34,40
"666","2020-04-27",354,8,282,972,6033,0.590916625227913,2025,7551,589,1240,58,3159,46,1299,31,46
"667","2020-04-28",342,8,274,930,6033,0.590916625227913,2025,7551,589,1240,59,3218,43,1342,33,43
"668","2020-04-29",350,8,279,895,6033,0.590916625227913,2025,7551,589,1240,70,3288,54,1396,38,54
"669","2020-04-30",327,8,278,862,6033,0.590916625227913,2025,7551,589,1240,57,3345,34,1430,29,34
"670","2020-05-01",308,8,264,816,6033,0.590916625227913,2025,7551,589,1240,50,3395,46,1476,30,46
"671","2020-05-02",304,8,285,787,6033,0.590916625227913,2025,7551,589,1240,41,3436,33,1509,25,33
"672","2020-05-03",263,8,263,769,6033,0.590916625227913,2025,7551,589,1240,52,3488,19,1528,31,19
"673","2020-05-04",252,8,266,727,6033,0.590916625227913,2025,7551,589,1240,53,3541,48,1576,31,48
"674","2020-05-05",247,8,268,699,6033,0.590916625227913,2025,7551,589,1240,52,3593,26,1602,31,26
"675","2020-05-06",236,8,256,659,6033,0.590916625227913,2025,7551,589,1240,50,3643,52,1654,26,52
"676","2020-05-07",227,8,253,627,6033,0.590916625227913,2025,7551,589,1240,38,3681,45,1699,17,45
"677","2020-05-08",228,8,227,603,6033,0.590916625227913,2025,7551,589,1240,56,3737,59,1758,33,59
"678","2020-05-09",225,8,230,573,6033,0.590916625227913,2025,7551,589,1240,49,3786,47,1805,27,47
"679","2020-05-10",206,8,250,572,6033,0.590916625227913,2025,7551,589,1240,37,3823,39,1844,20,39
"680","2020-05-11",203,8,253,543,6033,0.590916625227913,2025,7551,589,1240,35,3858,11,1855,15,11
"681","2020-05-12",200,8,233,521,6033,0.590916625227913,2025,7551,589,1240,57,3915,8,1863,30,8
"682","2020-05-13",195,8,231,514,6033,0.590916625227913,2025,7551,589,1240,36,3951,30,1893,18,30
"683","2020-05-14",198,8,264,483,6033,0.590916625227913,2025,7551,589,1240,31,3982,18,1911,20,18
"684","2020-05-15",182,8,274,461,6033,0.590916625227913,2025,7551,589,1240,38,4020,33,1944,17,33
"685","2020-05-16",172,8,302,428,6033,0.590916625227913,2025,7551,589,1240,38,4058,36,1980,17,36
"686","2020-05-17",160,8,295,430,6033,0.590916625227913,2025,7551,589,1240,35,4093,34,2014,19,34
"687","2020-05-18",142,8,287,417,6033,0.590916625227913,2025,7551,589,1240,28,4121,30,2044,10,30
"688","2020-05-19",137,8,296,382,6033,0.590916625227913,2025,7551,589,1240,21,4142,41,2085,8,41
"689","2020-05-20",126,8,282,364,6033,0.590916625227913,2025,7551,589,1240,29,4171,24,2109,14,24
"690","2020-05-21",119,8,273,348,6033,0.590916625227913,2025,7551,589,1240,35,4206,19,2128,19,19
"691","2020-05-22",118,8,278,349,6033,0.590916625227913,2025,7551,589,1240,32,4238,13,2141,16,13
"692","2020-05-23",109,8,304,337,6033,0.590916625227913,2025,7551,589,1240,28,4266,13,2154,11,13
"693","2020-05-24",110,8,322,317,6033,0.590916625227913,2025,7551,589,1240,34,4300,16,2170,14,16
"694","2020-05-25",114,8,321,306,6033,0.590916625227913,2025,7551,589,1240,24,4324,11,2181,9,11
"695","2020-05-26",95,8,319,292,6033,0.590916625227913,2025,7551,589,1240,34,4358,8,2189,22,8
"696","2020-05-27",92,8,295,279,6033,0.590916625227913,2025,7551,589,1240,17,4375,7,2196,9,7
"697","2020-05-28",84,8,280,262,6033,0.590916625227913,2025,7551,589,1240,23,4398,17,2213,9,17
"698","2020-05-29",86,8,260,256,6033,0.590916625227913,2025,7551,589,1240,20,4418,27,2240,11,27
"699","2020-05-30",89,8,274,236,6033,0.590916625227913,2025,7551,589,1240,17,4435,22,2262,9,22
"700","2020-05-31",80,8,251,223,6033,0.590916625227913,2025,7551,589,1240,19,4454,25,2287,9,25
"701","2020-06-01",76,8,251,215,6033,0.590916625227913,2025,7551,589,1240,13,4467,33,2320,5,33
"702","2020-06-02",82,8,241,206,6033,0.590916625227913,2025,7551,589,1240,17,4484,20,2340,7,20
"703","2020-06-03",80,8,247,207,6033,0.590916625227913,2025,7551,589,1240,14,4498,12,2352,6,12
"704","2020-06-04",80,8,257,207,6033,0.590916625227913,2025,7551,589,1240,15,4513,33,2385,5,33
"705","2020-06-05",75,8,258,198,6033,0.590916625227913,2025,7551,589,1240,13,4526,13,2398,8,13
"706","2020-06-06",73,8,269,191,6033,0.590916625227913,2025,7551,589,1240,21,4547,15,2413,7,15
"707","2020-06-07",71,8,269,187,6033,0.590916625227913,2025,7551,589,1240,13,4560,17,2430,7,17
"708","2020-03-13",1,9,56,32,6098,0.937028533945556,2055,7257,589,785,14,26,40,86,8,40
"709","2020-03-14",3,9,68,48,6098,0.937028533945556,2055,7257,589,785,11,37,27,113,7,27
"710","2020-03-15",6,9,76,56,6098,0.937028533945556,2055,7257,589,785,20,57,24,137,12,24
"711","2020-03-16",10,9,84,73,6098,0.937028533945556,2055,7257,589,785,25,82,35,172,23,35
"712","2020-03-17",10,9,106,110,6098,0.937028533945556,2055,7257,589,785,36,118,10,182,31,10
"713","2020-03-18",14,9,132,146,6098,0.937028533945556,2055,7257,589,785,37,155,9,191,29,9
"714","2020-03-19",15,9,125,166,6098,0.937028533945556,2055,7257,589,785,26,181,45,236,21,45
"715","2020-03-20",22,9,110,205,6098,0.937028533945556,2055,7257,589,785,30,211,34,270,28,34
"716","2020-03-21",44,9,129,244,6098,0.937028533945556,2055,7257,589,785,40,251,58,328,36,58
"717","2020-03-22",46,9,140,286,6098,0.937028533945556,2055,7257,589,785,54,305,26,354,49,26
"718","2020-03-23",46,9,145,339,6098,0.937028533945556,2055,7257,589,785,76,381,21,375,70,21
"719","2020-03-24",58,9,128,390,6098,0.937028533945556,2055,7257,589,785,55,436,44,419,52,44
"720","2020-03-25",66,9,126,472,6098,0.937028533945556,2055,7257,589,785,67,503,30,449,63,30
"721","2020-03-26",94,9,131,519,6098,0.937028533945556,2055,7257,589,785,62,565,25,474,59,25
"722","2020-03-27",127,9,148,596,6098,0.937028533945556,2055,7257,589,785,74,639,50,524,68,50
"723","2020-03-28",151,9,133,666,6098,0.937028533945556,2055,7257,589,785,121,760,42,566,114,42
"724","2020-03-29",182,9,113,738,6098,0.937028533945556,2055,7257,589,785,85,845,59,625,81,59
"725","2020-03-30",192,9,98,823,6098,0.937028533945556,2055,7257,589,785,94,939,25,650,90,25
"726","2020-03-31",198,9,109,903,6098,0.937028533945556,2055,7257,589,785,118,1057,17,667,116,17
"727","2020-04-01",223,9,136,982,6098,0.937028533945556,2055,7257,589,785,95,1152,11,678,88,11
"728","2020-04-02",228,9,151,1054,6098,0.937028533945556,2055,7257,589,785,117,1269,10,688,114,10
"729","2020-04-03",337,9,172,1173,6098,0.937028533945556,2055,7257,589,785,155,1424,24,712,149,24
"730","2020-04-04",351,9,178,1260,6098,0.937028533945556,2055,7257,589,785,127,1551,41,753,122,41
"731","2020-04-05",364,9,185,1328,6098,0.937028533945556,2055,7257,589,785,132,1683,30,783,125,30
"732","2020-04-06",368,9,183,1401,6098,0.937028533945556,2055,7257,589,785,134,1817,55,838,127,55
"733","2020-04-07",371,9,152,1461,6098,0.937028533945556,2055,7257,589,785,150,1967,50,888,144,50
"734","2020-04-08",382,9,148,1542,6098,0.937028533945556,2055,7257,589,785,162,2129,36,924,151,36
"735","2020-04-09",414,9,178,1610,6098,0.937028533945556,2055,7257,589,785,185,2314,19,943,176,19
"736","2020-04-10",521,9,200,1667,6098,0.937028533945556,2055,7257,589,785,158,2472,14,957,152,14
"737","2020-04-11",541,9,221,1738,6098,0.937028533945556,2055,7257,589,785,167,2639,56,1013,158,56
"738","2020-04-12",499,9,226,1743,6098,0.937028533945556,2055,7257,589,785,183,2822,56,1069,176,56
"739","2020-04-13",534,9,242,1782,6098,0.937028533945556,2055,7257,589,785,170,2992,26,1095,162,26
"740","2020-04-14",540,9,211,1811,6098,0.937028533945556,2055,7257,589,785,154,3146,64,1159,154,64
"741","2020-04-15",544,9,196,1811,6098,0.937028533945556,2055,7257,589,785,174,3320,45,1204,170,45
"742","2020-04-16",538,9,188,1801,6098,0.937028533945556,2055,7257,589,785,177,3497,27,1231,173,27
"743","2020-04-17",596,9,170,1788,6098,0.937028533945556,2055,7257,589,785,131,3628,49,1280,125,49
"744","2020-04-18",598,9,191,1739,6098,0.937028533945556,2055,7257,589,785,156,3784,42,1322,153,42
"745","2020-04-19",572,9,214,1692,6098,0.937028533945556,2055,7257,589,785,163,3947,23,1345,160,23
"746","2020-04-20",553,9,212,1671,6098,0.937028533945556,2055,7257,589,785,131,4078,24,1369,127,24
"747","2020-04-21",546,9,248,1610,6098,0.937028533945556,2055,7257,589,785,125,4203,19,1388,122,19
"748","2020-04-22",554,9,276,1565,6098,0.937028533945556,2055,7257,589,785,117,4320,24,1412,113,24
"749","2020-04-23",542,9,287,1541,6098,0.937028533945556,2055,7257,589,785,90,4410,11,1423,86,11
"750","2020-04-24",555,9,275,1487,6098,0.937028533945556,2055,7257,589,785,93,4503,25,1448,90,25
"751","2020-04-25",551,9,285,1427,6098,0.937028533945556,2055,7257,589,785,101,4604,10,1458,101,10
"752","2020-04-26",490,9,250,1355,6098,0.937028533945556,2055,7257,589,785,84,4688,48,1506,75,48
"753","2020-04-27",469,9,225,1281,6098,0.937028533945556,2055,7257,589,785,90,4778,24,1530,87,24
"754","2020-04-28",453,9,237,1203,6098,0.937028533945556,2055,7257,589,785,81,4859,22,1552,78,22
"755","2020-04-29",431,9,243,1127,6098,0.937028533945556,2055,7257,589,785,67,4926,36,1588,61,36
"756","2020-04-30",421,9,230,1037,6098,0.937028533945556,2055,7257,589,785,76,5002,21,1609,73,21
"757","2020-05-01",371,9,241,972,6098,0.937028533945556,2055,7257,589,785,55,5057,10,1619,52,10
"758","2020-05-02",363,9,251,884,6098,0.937028533945556,2055,7257,589,785,56,5113,25,1644,54,25
"759","2020-05-03",326,9,252,822,6098,0.937028533945556,2055,7257,589,785,47,5160,65,1709,38,65
"760","2020-05-04",319,9,231,760,6098,0.937028533945556,2055,7257,589,785,43,5203,43,1752,41,43
"761","2020-05-05",305,9,203,700,6098,0.937028533945556,2055,7257,589,785,49,5252,56,1808,44,56
"762","2020-05-06",297,9,179,651,6098,0.937028533945556,2055,7257,589,785,34,5286,69,1877,30,69
"763","2020-05-07",287,9,169,599,6098,0.937028533945556,2055,7257,589,785,23,5309,23,1900,22,23
"764","2020-05-08",242,9,160,563,6098,0.937028533945556,2055,7257,589,785,27,5336,32,1932,24,32
"765","2020-05-09",226,9,141,522,6098,0.937028533945556,2055,7257,589,785,32,5368,21,1953,30,21
"766","2020-05-10",204,9,146,466,6098,0.937028533945556,2055,7257,589,785,33,5401,20,1973,30,20
"767","2020-05-11",185,9,178,435,6098,0.937028533945556,2055,7257,589,785,29,5430,21,1994,25,21
"768","2020-05-12",168,9,169,417,6098,0.937028533945556,2055,7257,589,785,28,5458,27,2021,22,27
"769","2020-05-13",156,9,156,382,6098,0.937028533945556,2055,7257,589,785,25,5483,34,2055,20,34
"770","2020-05-14",145,9,148,357,6098,0.937028533945556,2055,7257,589,785,19,5502,56,2111,18,56
"771","2020-05-15",136,9,131,329,6098,0.937028533945556,2055,7257,589,785,21,5523,28,2139,18,28
"772","2020-05-16",133,9,127,295,6098,0.937028533945556,2055,7257,589,785,25,5548,15,2154,24,15
"773","2020-05-17",131,9,120,270,6098,0.937028533945556,2055,7257,589,785,15,5563,12,2166,11,12
"774","2020-05-18",130,9,111,252,6098,0.937028533945556,2055,7257,589,785,14,5577,62,2228,12,62
"775","2020-05-19",123,9,143,234,6098,0.937028533945556,2055,7257,589,785,21,5598,28,2256,17,28
"776","2020-05-20",117,9,142,213,6098,0.937028533945556,2055,7257,589,785,15,5613,24,2280,11,24
"777","2020-05-21",108,9,125,188,6098,0.937028533945556,2055,7257,589,785,15,5628,40,2320,13,40
"778","2020-05-22",107,9,123,182,6098,0.937028533945556,2055,7257,589,785,13,5641,54,2374,10,54
"779","2020-05-23",92,9,109,176,6098,0.937028533945556,2055,7257,589,785,10,5651,28,2402,10,28
"780","2020-05-24",81,9,130,157,6098,0.937028533945556,2055,7257,589,785,8,5659,27,2429,4,27
"781","2020-05-25",71,9,138,151,6098,0.937028533945556,2055,7257,589,785,14,5673,54,2483,13,54
"782","2020-05-26",65,9,136,142,6098,0.937028533945556,2055,7257,589,785,10,5683,40,2523,9,40
"783","2020-05-27",57,9,121,131,6098,0.937028533945556,2055,7257,589,785,9,5692,36,2559,9,36
"784","2020-05-28",53,9,119,124,6098,0.937028533945556,2055,7257,589,785,18,5710,40,2599,15,40
"785","2020-05-29",45,9,111,110,6098,0.937028533945556,2055,7257,589,785,9,5719,37,2636,8,37
"786","2020-05-30",42,9,117,105,6098,0.937028533945556,2055,7257,589,785,12,5731,49,2685,10,49
"787","2020-05-31",41,9,137,99,6098,0.937028533945556,2055,7257,589,785,7,5738,18,2703,7,18
"788","2020-06-01",41,9,138,89,6098,0.937028533945556,2055,7257,589,785,6,5744,15,2718,4,15
"789","2020-06-02",34,9,139,86,6098,0.937028533945556,2055,7257,589,785,4,5748,15,2733,4,15
"790","2020-06-03",32,9,156,84,6098,0.937028533945556,2055,7257,589,785,9,5757,11,2744,4,11
"791","2020-06-04",33,9,155,81,6098,0.937028533945556,2055,7257,589,785,4,5761,44,2788,2,44
"792","2020-06-05",27,9,171,74,6098,0.937028533945556,2055,7257,589,785,4,5765,18,2806,4,18
"793","2020-06-06",23,9,164,70,6098,0.937028533945556,2055,7257,589,785,5,5770,19,2825,3,19
"794","2020-06-07",21,9,174,63,6098,0.937028533945556,2055,7257,589,785,2,5772,12,2837,1,12
"795","2020-03-07",1,10,0,0,5898,0.904543913190912,2055,7223,740,913,NA,NA,NA,NA,NA,NA
"796","2020-03-08",1,10,0,0,5898,0.904543913190912,2055,7223,740,913,NA,NA,NA,NA,NA,NA
"797","2020-03-09",0,10,0,0,5898,0.904543913190912,2055,7223,740,913,NA,NA,NA,NA,NA,NA
"798","2020-03-10",0,10,0,0,5898,0.904543913190912,2055,7223,740,913,NA,NA,NA,NA,NA,NA
"799","2020-03-11",0,10,0,0,5898,0.904543913190912,2055,7223,740,913,18,18,2,2,NA,2
"800","2020-03-12",0,10,0,0,5898,0.904543913190912,2055,7223,740,913,31,49,4,6,2,4
"801","2020-03-13",2,10,33,24,5898,0.904543913190912,2055,7223,740,913,19,68,2,8,5,2
"802","2020-03-14",3,10,44,44,5898,0.904543913190912,2055,7223,740,913,25,93,1,9,5,1
"803","2020-03-15",2,10,62,60,5898,0.904543913190912,2055,7223,740,913,36,129,2,11,9,2
"804","2020-03-16",3,10,71,80,5898,0.904543913190912,2055,7223,740,913,34,163,4,15,15,4
"805","2020-03-17",4,10,90,114,5898,0.904543913190912,2055,7223,740,913,54,217,3,18,31,3
"806","2020-03-18",7,10,91,137,5898,0.904543913190912,2055,7223,740,913,45,262,13,31,22,13
"807","2020-03-19",14,10,88,165,5898,0.904543913190912,2055,7223,740,913,60,322,6,37,40,6
"808","2020-03-20",23,10,84,207,5898,0.904543913190912,2055,7223,740,913,52,374,18,55,37,18
"809","2020-03-21",43,10,91,247,5898,0.904543913190912,2055,7223,740,913,90,464,23,78,67,23
"810","2020-03-22",61,10,89,293,5898,0.904543913190912,2055,7223,740,913,71,535,3,81,59,3
"811","2020-03-23",66,10,85,344,5898,0.904543913190912,2055,7223,740,913,89,624,10,91,58,10
"812","2020-03-24",74,10,87,384,5898,0.904543913190912,2055,7223,740,913,78,702,21,112,57,21
"813","2020-03-25",86,10,110,455,5898,0.904543913190912,2055,7223,740,913,80,782,17,129,65,17
"814","2020-03-26",94,10,110,501,5898,0.904543913190912,2055,7223,740,913,71,853,13,142,55,13
"815","2020-03-27",129,10,111,565,5898,0.904543913190912,2055,7223,740,913,87,940,6,148,65,6
"816","2020-03-28",160,10,131,636,5898,0.904543913190912,2055,7223,740,913,112,1052,12,160,86,12
"817","2020-03-29",166,10,138,712,5898,0.904543913190912,2055,7223,740,913,100,1152,9,169,84,9
"818","2020-03-30",172,10,126,755,5898,0.904543913190912,2055,7223,740,913,101,1253,16,185,78,16
"819","2020-03-31",189,10,120,809,5898,0.904543913190912,2055,7223,740,913,121,1374,19,204,94,19
"820","2020-04-01",214,10,109,875,5898,0.904543913190912,2055,7223,740,913,109,1483,34,238,85,34
"821","2020-04-02",229,10,112,963,5898,0.904543913190912,2055,7223,740,913,156,1639,31,269,127,31
"822","2020-04-03",263,10,128,1078,5898,0.904543913190912,2055,7223,740,913,101,1740,25,294,78,25
"823","2020-04-04",322,10,179,1149,5898,0.904543913190912,2055,7223,740,913,135,1875,37,331,116,37
"824","2020-04-05",343,10,194,1239,5898,0.904543913190912,2055,7223,740,913,140,2015,53,384,120,53
"825","2020-04-06",350,10,205,1362,5898,0.904543913190912,2055,7223,740,913,114,2129,38,422,90,38
"826","2020-04-07",350,10,207,1442,5898,0.904543913190912,2055,7223,740,913,135,2264,44,466,115,44
"827","2020-04-08",364,10,202,1531,5898,0.904543913190912,2055,7223,740,913,117,2381,59,525,99,59
"828","2020-04-09",387,10,227,1611,5898,0.904543913190912,2055,7223,740,913,108,2489,51,576,94,51
"829","2020-04-10",527,10,210,1632,5898,0.904543913190912,2055,7223,740,913,147,2636,50,626,125,50
"830","2020-04-11",534,10,206,1718,5898,0.904543913190912,2055,7223,740,913,134,2770,48,674,108,48
"831","2020-04-12",529,10,213,1768,5898,0.904543913190912,2055,7223,740,913,111,2881,53,727,95,53
"832","2020-04-13",539,10,200,1839,5898,0.904543913190912,2055,7223,740,913,135,3016,50,777,105,50
"833","2020-04-14",559,10,229,1853,5898,0.904543913190912,2055,7223,740,913,111,3127,25,802,94,25
"834","2020-04-15",570,10,246,1845,5898,0.904543913190912,2055,7223,740,913,128,3255,12,814,105,12
"835","2020-04-16",596,10,240,1883,5898,0.904543913190912,2055,7223,740,913,111,3366,28,842,93,28
"836","2020-04-17",683,10,261,1875,5898,0.904543913190912,2055,7223,740,913,109,3475,12,854,92,12
"837","2020-04-18",705,10,244,1847,5898,0.904543913190912,2055,7223,740,913,97,3572,17,871,71,17
"838","2020-04-19",622,10,235,1817,5898,0.904543913190912,2055,7223,740,913,70,3642,31,902,58,31
"839","2020-04-20",608,10,252,1756,5898,0.904543913190912,2055,7223,740,913,92,3734,23,925,71,23
"840","2020-04-21",620,10,221,1694,5898,0.904543913190912,2055,7223,740,913,94,3828,39,964,75,39
"841","2020-04-22",608,10,232,1637,5898,0.904543913190912,2055,7223,740,913,96,3924,10,974,71,10
"842","2020-04-23",600,10,222,1602,5898,0.904543913190912,2055,7223,740,913,66,3990,9,983,47,9
"843","2020-04-24",626,10,224,1503,5898,0.904543913190912,2055,7223,740,913,66,4056,15,998,52,15
"844","2020-04-25",567,10,248,1431,5898,0.904543913190912,2055,7223,740,913,54,4110,20,1018,41,20
"845","2020-04-26",518,10,243,1313,5898,0.904543913190912,2055,7223,740,913,74,4184,29,1047,53,29
"846","2020-04-27",505,10,221,1209,5898,0.904543913190912,2055,7223,740,913,74,4258,35,1082,54,35
"847","2020-04-28",478,10,184,1144,5898,0.904543913190912,2055,7223,740,913,61,4319,36,1118,36,36
"848","2020-04-29",458,10,174,1067,5898,0.904543913190912,2055,7223,740,913,80,4399,14,1132,58,14
"849","2020-04-30",430,10,165,972,5898,0.904543913190912,2055,7223,740,913,50,4449,21,1153,32,21
"850","2020-05-01",347,10,148,899,5898,0.904543913190912,2055,7223,740,913,66,4515,19,1172,51,19
"851","2020-05-02",335,10,151,842,5898,0.904543913190912,2055,7223,740,913,57,4572,25,1197,40,25
"852","2020-05-03",311,10,171,780,5898,0.904543913190912,2055,7223,740,913,57,4629,36,1233,36,36
"853","2020-05-04",316,10,175,723,5898,0.904543913190912,2055,7223,740,913,53,4682,40,1273,42,40
"854","2020-05-05",303,10,163,659,5898,0.904543913190912,2055,7223,740,913,42,4724,25,1298,26,25
"855","2020-05-06",295,10,146,618,5898,0.904543913190912,2055,7223,740,913,49,4773,23,1321,31,23
"856","2020-05-07",282,10,138,575,5898,0.904543913190912,2055,7223,740,913,43,4816,16,1337,30,16
"857","2020-05-08",240,10,174,523,5898,0.904543913190912,2055,7223,740,913,41,4857,16,1353,28,16
"858","2020-05-09",245,10,199,480,5898,0.904543913190912,2055,7223,740,913,26,4883,18,1371,21,18
"859","2020-05-10",227,10,200,457,5898,0.904543913190912,2055,7223,740,913,40,4923,33,1404,21,33
"860","2020-05-11",200,10,196,420,5898,0.904543913190912,2055,7223,740,913,39,4962,31,1435,31,31
"861","2020-05-12",178,10,219,393,5898,0.904543913190912,2055,7223,740,913,23,4985,42,1477,15,42
"862","2020-05-13",165,10,218,366,5898,0.904543913190912,2055,7223,740,913,27,5012,26,1503,12,26
"863","2020-05-14",149,10,198,337,5898,0.904543913190912,2055,7223,740,913,24,5036,19,1522,15,19
"864","2020-05-15",152,10,174,321,5898,0.904543913190912,2055,7223,740,913,40,5076,29,1551,23,29
"865","2020-05-16",135,10,165,296,5898,0.904543913190912,2055,7223,740,913,18,5094,27,1578,7,27
"866","2020-05-17",113,10,167,265,5898,0.904543913190912,2055,7223,740,913,18,5112,12,1590,9,12
"867","2020-05-18",103,10,187,239,5898,0.904543913190912,2055,7223,740,913,30,5142,10,1600,14,10
"868","2020-05-19",100,10,163,218,5898,0.904543913190912,2055,7223,740,913,25,5167,14,1614,15,14
"869","2020-05-20",98,10,168,198,5898,0.904543913190912,2055,7223,740,913,18,5185,36,1650,12,36
"870","2020-05-21",88,10,166,183,5898,0.904543913190912,2055,7223,740,913,23,5208,25,1675,21,25
"871","2020-05-22",75,10,151,164,5898,0.904543913190912,2055,7223,740,913,14,5222,16,1691,9,16
"872","2020-05-23",67,10,140,148,5898,0.904543913190912,2055,7223,740,913,29,5251,38,1729,12,38
"873","2020-05-24",63,10,117,132,5898,0.904543913190912,2055,7223,740,913,21,5272,29,1758,11,29
"874","2020-05-25",60,10,113,117,5898,0.904543913190912,2055,7223,740,913,20,5292,30,1788,13,30
"875","2020-05-26",54,10,107,112,5898,0.904543913190912,2055,7223,740,913,14,5306,22,1810,7,22
"876","2020-05-27",47,10,99,106,5898,0.904543913190912,2055,7223,740,913,20,5326,24,1834,11,24
"877","2020-05-28",53,10,95,95,5898,0.904543913190912,2055,7223,740,913,9,5335,17,1851,6,17
"878","2020-05-29",47,10,83,91,5898,0.904543913190912,2055,7223,740,913,15,5350,13,1864,7,13
"879","2020-05-30",45,10,76,89,5898,0.904543913190912,2055,7223,740,913,17,5367,22,1886,11,22
"880","2020-05-31",42,10,72,83,5898,0.904543913190912,2055,7223,740,913,18,5385,21,1907,9,21
"881","2020-06-01",38,10,66,81,5898,0.904543913190912,2055,7223,740,913,9,5394,17,1924,6,17
"882","2020-06-02",39,10,58,78,5898,0.904543913190912,2055,7223,740,913,18,5412,25,1949,12,25
"883","2020-06-03",39,10,59,73,5898,0.904543913190912,2055,7223,740,913,10,5422,14,1963,8,14
"884","2020-06-04",34,10,51,66,5898,0.904543913190912,2055,7223,740,913,14,5436,12,1975,9,12
"885","2020-06-05",33,10,54,66,5898,0.904543913190912,2055,7223,740,913,14,5450,9,1984,5,9
"886","2020-06-06",30,10,55,67,5898,0.904543913190912,2055,7223,740,913,9,5459,16,2000,2,16
"887","2020-06-07",34,10,66,69,5898,0.904543913190912,2055,7223,740,913,8,5467,18,2018,5,18
"888","2020-03-13",1,11,73,65,6757,0.701050762172562,2100,8131,634,800,41,117,38,101,5,38
"889","2020-03-14",13,11,110,108,6757,0.701050762172562,2100,8131,634,800,43,160,44,145,9,44
"890","2020-03-15",16,11,128,159,6757,0.701050762172562,2100,8131,634,800,71,231,33,178,28,33
"891","2020-03-16",18,11,116,207,6757,0.701050762172562,2100,8131,634,800,63,294,24,202,25,24
"892","2020-03-17",25,11,113,278,6757,0.701050762172562,2100,8131,634,800,56,350,48,250,20,48
"893","2020-03-18",33,11,102,343,6757,0.701050762172562,2100,8131,634,800,83,433,48,298,47,48
"894","2020-03-19",56,11,94,412,6757,0.701050762172562,2100,8131,634,800,84,517,40,338,50,40
"895","2020-03-20",86,11,124,481,6757,0.701050762172562,2100,8131,634,800,76,593,56,394,43,56
"896","2020-03-21",132,11,114,562,6757,0.701050762172562,2100,8131,634,800,98,691,34,428,55,34
"897","2020-03-22",139,11,116,650,6757,0.701050762172562,2100,8131,634,800,96,787,40,468,68,40
"898","2020-03-23",148,11,141,738,6757,0.701050762172562,2100,8131,634,800,85,872,59,527,45,59
"899","2020-03-24",171,11,167,837,6757,0.701050762172562,2100,8131,634,800,110,982,57,584,77,57
"900","2020-03-25",193,11,176,925,6757,0.701050762172562,2100,8131,634,800,105,1087,39,623,69,39
"901","2020-03-26",207,11,160,1018,6757,0.701050762172562,2100,8131,634,800,106,1193,36,659,59,36
"902","2020-03-27",306,11,144,1096,6757,0.701050762172562,2100,8131,634,800,118,1311,51,710,78,51
"903","2020-03-28",349,11,129,1192,6757,0.701050762172562,2100,8131,634,800,122,1433,42,752,77,42
"904","2020-03-29",366,11,118,1289,6757,0.701050762172562,2100,8131,634,800,120,1553,32,784,84,32
"905","2020-03-30",361,11,112,1346,6757,0.701050762172562,2100,8131,634,800,115,1668,42,826,84,42
"906","2020-03-31",376,11,96,1425,6757,0.701050762172562,2100,8131,634,800,146,1814,40,866,95,40
"907","2020-04-01",391,11,93,1477,6757,0.701050762172562,2100,8131,634,800,129,1943,60,926,97,60
"908","2020-04-02",415,11,136,1538,6757,0.701050762172562,2100,8131,634,800,145,2088,36,962,97,36
"909","2020-04-03",499,11,145,1621,6757,0.701050762172562,2100,8131,634,800,119,2207,41,1003,89,41
"910","2020-04-04",538,11,140,1646,6757,0.701050762172562,2100,8131,634,800,144,2351,33,1036,102,33
"911","2020-04-05",539,11,134,1700,6757,0.701050762172562,2100,8131,634,800,105,2456,33,1069,74,33
"912","2020-04-06",570,11,159,1781,6757,0.701050762172562,2100,8131,634,800,98,2554,24,1093,66,24
"913","2020-04-07",564,11,168,1806,6757,0.701050762172562,2100,8131,634,800,151,2705,39,1132,105,39
"914","2020-04-08",585,11,162,1845,6757,0.701050762172562,2100,8131,634,800,109,2814,51,1183,69,51
"915","2020-04-09",607,11,177,1846,6757,0.701050762172562,2100,8131,634,800,128,2942,39,1222,100,39
"916","2020-04-10",686,11,165,1836,6757,0.701050762172562,2100,8131,634,800,115,3057,35,1257,79,35
"917","2020-04-11",644,11,191,1831,6757,0.701050762172562,2100,8131,634,800,99,3156,39,1296,63,39
"918","2020-04-12",600,11,191,1814,6757,0.701050762172562,2100,8131,634,800,109,3265,29,1325,67,29
"919","2020-04-13",584,11,181,1784,6757,0.701050762172562,2100,8131,634,800,126,3391,35,1360,82,35
"920","2020-04-14",593,11,209,1754,6757,0.701050762172562,2100,8131,634,800,111,3502,51,1411,86,51
"921","2020-04-15",581,11,190,1749,6757,0.701050762172562,2100,8131,634,800,96,3598,50,1461,63,50
"922","2020-04-16",561,11,191,1727,6757,0.701050762172562,2100,8131,634,800,111,3709,33,1494,82,33
"923","2020-04-17",548,11,171,1654,6757,0.701050762172562,2100,8131,634,800,94,3803,32,1526,50,32
"924","2020-04-18",586,11,182,1625,6757,0.701050762172562,2100,8131,634,800,83,3886,38,1564,51,38
"925","2020-04-19",538,11,180,1588,6757,0.701050762172562,2100,8131,634,800,89,3975,53,1617,59,53
"926","2020-04-20",524,11,220,1513,6757,0.701050762172562,2100,8131,634,800,77,4052,45,1662,48,45
"927","2020-04-21",525,11,253,1521,6757,0.701050762172562,2100,8131,634,800,88,4140,36,1698,59,36
"928","2020-04-22",535,11,279,1454,6757,0.701050762172562,2100,8131,634,800,82,4222,47,1745,44,47
"929","2020-04-23",520,11,274,1378,6757,0.701050762172562,2100,8131,634,800,68,4290,43,1788,46,43
"930","2020-04-24",541,11,246,1288,6757,0.701050762172562,2100,8131,634,800,72,4362,45,1833,43,45
"931","2020-04-25",512,11,257,1199,6757,0.701050762172562,2100,8131,634,800,74,4436,50,1883,49,50
"932","2020-04-26",479,11,229,1121,6757,0.701050762172562,2100,8131,634,800,80,4516,51,1934,48,51
"933","2020-04-27",457,11,249,1059,6757,0.701050762172562,2100,8131,634,800,64,4580,35,1969,39,35
"934","2020-04-28",425,11,235,967,6757,0.701050762172562,2100,8131,634,800,53,4633,38,2007,34,38
"935","2020-04-29",396,11,215,895,6757,0.701050762172562,2100,8131,634,800,66,4699,34,2041,39,34
"936","2020-04-30",382,11,187,826,6757,0.701050762172562,2100,8131,634,800,66,4765,49,2090,41,49
"937","2020-05-01",318,11,164,778,6757,0.701050762172562,2100,8131,634,800,58,4823,35,2125,23,35
"938","2020-05-02",301,11,151,712,6757,0.701050762172562,2100,8131,634,800,44,4867,26,2151,21,26
"939","2020-05-03",274,11,163,675,6757,0.701050762172562,2100,8131,634,800,64,4931,31,2182,33,31
"940","2020-05-04",250,11,145,611,6757,0.701050762172562,2100,8131,634,800,58,4989,33,2215,25,33
"941","2020-05-05",242,11,132,568,6757,0.701050762172562,2100,8131,634,800,49,5038,27,2242,28,27
"942","2020-05-06",231,11,118,519,6757,0.701050762172562,2100,8131,634,800,45,5083,30,2272,23,30
"943","2020-05-07",212,11,120,465,6757,0.701050762172562,2100,8131,634,800,42,5125,32,2304,14,32
"944","2020-05-08",195,11,175,446,6757,0.701050762172562,2100,8131,634,800,54,5179,25,2329,23,25
"945","2020-05-09",186,11,164,429,6757,0.701050762172562,2100,8131,634,800,45,5224,35,2364,24,35
"946","2020-05-10",168,11,172,401,6757,0.701050762172562,2100,8131,634,800,44,5268,25,2389,19,25
"947","2020-05-11",162,11,148,381,6757,0.701050762172562,2100,8131,634,800,28,5296,28,2417,14,28
"948","2020-05-12",150,11,137,350,6757,0.701050762172562,2100,8131,634,800,35,5331,82,2499,19,82
"949","2020-05-13",137,11,117,330,6757,0.701050762172562,2100,8131,634,800,28,5359,39,2538,15,39
"950","2020-05-14",134,11,107,318,6757,0.701050762172562,2100,8131,634,800,31,5390,42,2580,13,42
"951","2020-05-15",117,11,94,289,6757,0.701050762172562,2100,8131,634,800,31,5421,37,2617,10,37
"952","2020-05-16",109,11,102,261,6757,0.701050762172562,2100,8131,634,800,23,5444,44,2661,11,44
"953","2020-05-17",102,11,139,233,6757,0.701050762172562,2100,8131,634,800,30,5474,38,2699,13,38
"954","2020-05-18",96,11,129,225,6757,0.701050762172562,2100,8131,634,800,31,5505,34,2733,11,34
"955","2020-05-19",87,11,114,217,6757,0.701050762172562,2100,8131,634,800,28,5533,40,2773,13,40
"956","2020-05-20",85,11,123,207,6757,0.701050762172562,2100,8131,634,800,28,5561,48,2821,13,48
"957","2020-05-21",79,11,131,199,6757,0.701050762172562,2100,8131,634,800,18,5579,52,2873,8,52
"958","2020-05-22",73,11,163,190,6757,0.701050762172562,2100,8131,634,800,26,5605,39,2912,8,39
"959","2020-05-23",65,11,198,173,6757,0.701050762172562,2100,8131,634,800,20,5625,54,2966,6,54
"960","2020-05-24",52,11,174,172,6757,0.701050762172562,2100,8131,634,800,20,5645,58,3024,11,58
"961","2020-05-25",47,11,160,162,6757,0.701050762172562,2100,8131,634,800,24,5669,58,3082,10,58
"962","2020-05-26",46,11,127,153,6757,0.701050762172562,2100,8131,634,800,18,5687,68,3150,7,68
"963","2020-05-27",42,11,138,142,6757,0.701050762172562,2100,8131,634,800,15,5702,47,3197,8,47
"964","2020-05-28",40,11,170,128,6757,0.701050762172562,2100,8131,634,800,22,5724,54,3251,9,54
"965","2020-05-29",39,11,190,120,6757,0.701050762172562,2100,8131,634,800,15,5739,49,3300,4,49
"966","2020-05-30",40,11,178,114,6757,0.701050762172562,2100,8131,634,800,13,5752,38,3338,5,38
"967","2020-05-31",40,11,155,115,6757,0.701050762172562,2100,8131,634,800,10,5762,35,3373,5,35
"968","2020-06-01",40,11,188,112,6757,0.701050762172562,2100,8131,634,800,16,5778,52,3425,4,52
"969","2020-06-02",38,11,207,110,6757,0.701050762172562,2100,8131,634,800,15,5793,58,3483,4,58
"970","2020-06-03",36,11,177,114,6757,0.701050762172562,2100,8131,634,800,17,5810,33,3516,5,33
"971","2020-06-04",39,11,190,111,6757,0.701050762172562,2100,8131,634,800,15,5825,48,3564,5,48
"972","2020-06-05",37,11,206,106,6757,0.701050762172562,2100,8131,634,800,14,5839,37,3601,2,37
"973","2020-06-06",35,11,191,98,6757,0.701050762172562,2100,8131,634,800,13,5852,27,3628,8,27
"974","2020-06-07",32,11,195,95,6757,0.701050762172562,2100,8131,634,800,12,5864,41,3669,5,41
"975","2020-03-07",1,12,0,0,5424,0.465523598820059,2010,7441,622,815,NA,NA,NA,NA,NA,NA
"976","2020-03-08",1,12,0,0,5424,0.465523598820059,2010,7441,622,815,NA,NA,NA,NA,NA,NA
"977","2020-03-09",0,12,0,0,5424,0.465523598820059,2010,7441,622,815,NA,NA,NA,NA,NA,NA
"978","2020-03-10",0,12,0,0,5424,0.465523598820059,2010,7441,622,815,NA,NA,2,2,NA,2
"979","2020-03-11",1,12,28,30,5424,0.465523598820059,2010,7441,622,815,20,20,18,20,2,18
"980","2020-03-12",1,12,49,61,5424,0.465523598820059,2010,7441,622,815,20,40,8,28,6,8
"981","2020-03-13",4,12,80,114,5424,0.465523598820059,2010,7441,622,815,22,62,21,49,10,21
"982","2020-03-14",21,12,85,148,5424,0.465523598820059,2010,7441,622,815,27,89,16,65,14,16
"983","2020-03-15",26,12,103,197,5424,0.465523598820059,2010,7441,622,815,44,133,25,90,19,25
"984","2020-03-16",30,12,98,250,5424,0.465523598820059,2010,7441,622,815,37,170,26,116,14,26
"985","2020-03-17",39,12,95,289,5424,0.465523598820059,2010,7441,622,815,42,212,25,141,25,25
"986","2020-03-18",46,12,89,333,5424,0.465523598820059,2010,7441,622,815,38,250,17,158,29,17
"987","2020-03-19",52,12,96,398,5424,0.465523598820059,2010,7441,622,815,52,302,19,177,35,19
"988","2020-03-20",77,12,104,444,5424,0.465523598820059,2010,7441,622,815,59,361,9,186,45,9
"989","2020-03-21",106,12,121,497,5424,0.465523598820059,2010,7441,622,815,49,410,7,193,32,7
"990","2020-03-22",119,12,126,551,5424,0.465523598820059,2010,7441,622,815,70,480,3,196,55,3
"991","2020-03-23",123,12,137,605,5424,0.465523598820059,2010,7441,622,815,53,533,21,217,32,21
"992","2020-03-24",134,12,142,658,5424,0.465523598820059,2010,7441,622,815,62,595,9,226,50,9
"993","2020-03-25",155,12,136,702,5424,0.465523598820059,2010,7441,622,815,74,669,10,236,56,10
"994","2020-03-26",179,12,134,742,5424,0.465523598820059,2010,7441,622,815,72,741,13,249,58,13
"995","2020-03-27",231,12,135,769,5424,0.465523598820059,2010,7441,622,815,89,830,37,286,65,37
"996","2020-03-28",284,12,141,819,5424,0.465523598820059,2010,7441,622,815,80,910,21,307,52,21
"997","2020-03-29",286,12,148,871,5424,0.465523598820059,2010,7441,622,815,76,986,16,323,50,16
"998","2020-03-30",279,12,172,880,5424,0.465523598820059,2010,7441,622,815,95,1081,31,354,73,31
"999","2020-03-31",294,12,183,908,5424,0.465523598820059,2010,7441,622,815,69,1150,22,376,51,22
"1000","2020-04-01",292,12,173,911,5424,0.465523598820059,2010,7441,622,815,86,1236,13,389,66,13
"1001","2020-04-02",304,12,175,924,5424,0.465523598820059,2010,7441,622,815,112,1348,46,435,86,46
"1002","2020-04-03",343,12,186,935,5424,0.465523598820059,2010,7441,622,815,92,1440,23,458,77,23
"1003","2020-04-04",311,12,178,957,5424,0.465523598820059,2010,7441,622,815,101,1541,49,507,82,49
"1004","2020-04-05",282,12,168,962,5424,0.465523598820059,2010,7441,622,815,119,1660,53,560,98,53
"1005","2020-04-06",288,12,161,949,5424,0.465523598820059,2010,7441,622,815,99,1759,27,587,86,27
"1006","2020-04-07",285,12,166,959,5424,0.465523598820059,2010,7441,622,815,109,1868,21,608,88,21
"1007","2020-04-08",292,12,157,950,5424,0.465523598820059,2010,7441,622,815,95,1963,16,624,73,16
"1008","2020-04-09",283,12,171,957,5424,0.465523598820059,2010,7441,622,815,124,2087,30,654,105,30
"1009","2020-04-10",320,12,161,977,5424,0.465523598820059,2010,7441,622,815,114,2201,48,702,96,48
"1010","2020-04-11",326,12,154,984,5424,0.465523598820059,2010,7441,622,815,115,2316,44,746,100,44
"1011","2020-04-12",328,12,178,971,5424,0.465523598820059,2010,7441,622,815,92,2408,55,801,73,55
"1012","2020-04-13",320,12,157,978,5424,0.465523598820059,2010,7441,622,815,84,2492,46,847,65,47
"1013","2020-04-14",313,12,166,964,5424,0.465523598820059,2010,7441,622,815,96,2588,41,888,80,41
"1014","2020-04-15",321,12,156,963,5424,0.465523598820059,2010,7441,622,815,88,2676,20,908,68,20
"1015","2020-04-16",320,12,163,959,5424,0.465523598820059,2010,7441,622,815,98,2774,29,937,78,29
"1016","2020-04-17",336,12,174,928,5424,0.465523598820059,2010,7441,622,815,95,2869,21,958,80,21
"1017","2020-04-18",351,12,159,911,5424,0.465523598820059,2010,7441,622,815,92,2961,19,977,74,19
"1018","2020-04-19",293,12,171,909,5424,0.465523598820059,2010,7441,622,815,78,3039,11,988,58,11
"1019","2020-04-20",289,12,162,907,5424,0.465523598820059,2010,7441,622,815,96,3135,13,1001,81,13
"1020","2020-04-21",285,12,163,899,5424,0.465523598820059,2010,7441,622,815,84,3219,51,1052,62,51
"1021","2020-04-22",289,12,161,888,5424,0.465523598820059,2010,7441,622,815,85,3304,16,1068,61,16
"1022","2020-04-23",284,12,141,871,5424,0.465523598820059,2010,7441,622,815,65,3369,30,1098,51,30
"1023","2020-04-24",282,12,140,863,5424,0.465523598820059,2010,7441,622,815,84,3453,22,1120,65,22
"1024","2020-04-25",295,12,138,852,5424,0.465523598820059,2010,7441,622,815,65,3518,11,1131,50,11
"1025","2020-04-26",304,12,135,847,5424,0.465523598820059,2010,7441,622,815,72,3590,41,1172,52,41
"1026","2020-04-27",292,12,124,842,5424,0.465523598820059,2010,7441,622,815,58,3648,60,1232,45,60
"1027","2020-04-28",301,12,132,828,5424,0.465523598820059,2010,7441,622,815,57,3705,34,1266,41,34
"1028","2020-04-29",280,12,122,809,5424,0.465523598820059,2010,7441,622,815,40,3745,26,1292,38,26
"1029","2020-04-30",277,12,115,796,5424,0.465523598820059,2010,7441,622,815,55,3800,14,1306,36,14
"1030","2020-05-01",292,12,121,777,5424,0.465523598820059,2010,7441,622,815,42,3842,29,1335,35,29
"1031","2020-05-02",278,12,128,766,5424,0.465523598820059,2010,7441,622,815,49,3891,57,1392,36,57
"1032","2020-05-03",245,12,153,756,5424,0.465523598820059,2010,7441,622,815,56,3947,41,1433,41,41
"1033","2020-05-04",237,12,171,752,5424,0.465523598820059,2010,7441,622,815,47,3994,17,1450,31,17
"1034","2020-05-05",226,12,174,711,5424,0.465523598820059,2010,7441,622,815,39,4033,12,1462,24,12
"1035","2020-05-06",217,12,158,688,5424,0.465523598820059,2010,7441,622,815,39,4072,24,1486,25,24
"1036","2020-05-07",223,12,159,665,5424,0.465523598820059,2010,7441,622,815,36,4108,29,1515,26,29
"1037","2020-05-08",233,12,166,671,5424,0.465523598820059,2010,7441,622,815,40,4148,43,1558,30,43
"1038","2020-05-09",232,12,187,649,5424,0.465523598820059,2010,7441,622,815,44,4192,24,1582,31,24
"1039","2020-05-10",223,12,182,619,5424,0.465523598820059,2010,7441,622,815,45,4237,26,1608,31,26
"1040","2020-05-11",218,12,173,600,5424,0.465523598820059,2010,7441,622,815,43,4280,53,1661,32,53
"1041","2020-05-12",211,12,164,570,5424,0.465523598820059,2010,7441,622,815,41,4321,54,1715,33,54
"1042","2020-05-13",211,12,176,548,5424,0.465523598820059,2010,7441,622,815,36,4357,48,1763,24,48
"1043","2020-05-14",202,12,191,529,5424,0.465523598820059,2010,7441,622,815,35,4392,58,1821,22,58
"1044","2020-05-15",191,12,213,501,5424,0.465523598820059,2010,7441,622,815,35,4427,50,1871,26,50
"1045","2020-05-16",179,12,230,499,5424,0.465523598820059,2010,7441,622,815,36,4463,30,1901,23,30
"1046","2020-05-17",168,12,227,482,5424,0.465523598820059,2010,7441,622,815,36,4499,36,1937,23,36
"1047","2020-05-18",164,12,208,462,5424,0.465523598820059,2010,7441,622,815,35,4534,42,1979,27,42
"1048","2020-05-19",162,12,201,463,5424,0.465523598820059,2010,7441,622,815,30,4564,49,2028,19,49
"1049","2020-05-20",161,12,196,440,5424,0.465523598820059,2010,7441,622,815,32,4596,25,2053,19,25
"1050","2020-05-21",158,12,195,419,5424,0.465523598820059,2010,7441,622,815,16,4612,28,2081,11,28
"1051","2020-05-22",159,12,192,418,5424,0.465523598820059,2010,7441,622,815,34,4646,40,2121,26,40
"1052","2020-05-23",178,12,193,402,5424,0.465523598820059,2010,7441,622,815,41,4687,39,2160,28,39
"1053","2020-05-24",160,12,198,381,5424,0.465523598820059,2010,7441,622,815,19,4706,23,2183,12,23
"1054","2020-05-25",147,12,189,348,5424,0.465523598820059,2010,7441,622,815,15,4721,12,2195,11,12
"1055","2020-05-26",131,12,178,337,5424,0.465523598820059,2010,7441,622,815,19,4740,15,2210,12,15
"1056","2020-05-27",126,12,165,307,5424,0.465523598820059,2010,7441,622,815,17,4757,34,2244,11,34
"1057","2020-05-28",117,12,164,297,5424,0.465523598820059,2010,7441,622,815,24,4781,27,2271,18,27
"1058","2020-05-29",109,12,158,278,5424,0.465523598820059,2010,7441,622,815,19,4800,17,2288,15,17
"1059","2020-05-30",83,12,173,264,5424,0.465523598820059,2010,7441,622,815,16,4816,10,2298,9,10
"1060","2020-05-31",90,12,188,253,5424,0.465523598820059,2010,7441,622,815,26,4842,30,2328,20,30
"1061","2020-06-01",91,12,190,241,5424,0.465523598820059,2010,7441,622,815,28,4870,22,2350,19,22
"1062","2020-06-02",88,12,191,231,5424,0.465523598820059,2010,7441,622,815,10,4880,41,2391,7,41
"1063","2020-06-03",92,12,168,234,5424,0.465523598820059,2010,7441,622,815,9,4889,30,2421,8,30
"1064","2020-06-04",91,12,183,226,5424,0.465523598820059,2010,7441,622,815,17,4906,23,2444,12,23
"1065","2020-06-05",82,12,196,221,5424,0.465523598820059,2010,7441,622,815,17,4923,10,2454,16,10
"1066","2020-06-06",81,12,189,215,5424,0.465523598820059,2010,7441,622,815,12,4935,15,2469,9,15
"1067","2020-06-07",79,12,184,209,5424,0.465523598820059,2010,7441,622,815,6,4941,14,2483,3,14
"1068","2020-03-14",1,13,65,40,5862,0.868474923234391,2160,7699,533,626,29,105,11,41,8,11
"1069","2020-03-15",4,13,79,57,5862,0.868474923234391,2160,7699,533,626,33,138,16,57,8,16
"1070","2020-03-16",5,13,88,79,5862,0.868474923234391,2160,7699,533,626,50,188,22,79,17,22
"1071","2020-03-17",11,13,91,106,5862,0.868474923234391,2160,7699,533,626,58,246,9,88,25,9
"1072","2020-03-18",16,13,97,124,5862,0.868474923234391,2160,7699,533,626,36,282,7,95,20,7
"1073","2020-03-19",22,13,100,147,5862,0.868474923234391,2160,7699,533,626,55,337,11,106,28,11
"1074","2020-03-20",29,13,97,172,5862,0.868474923234391,2160,7699,533,626,68,405,15,121,43,15
"1075","2020-03-21",45,13,103,207,5862,0.868474923234391,2160,7699,533,626,87,492,19,140,56,19
"1076","2020-03-22",50,13,94,248,5862,0.868474923234391,2160,7699,533,626,59,551,14,154,38,14
"1077","2020-03-23",52,13,106,285,5862,0.868474923234391,2160,7699,533,626,73,624,16,170,51,16
"1078","2020-03-24",53,13,94,328,5862,0.868474923234391,2160,7699,533,626,84,708,21,191,54,21
"1079","2020-03-25",60,13,94,366,5862,0.868474923234391,2160,7699,533,626,77,785,15,206,49,15
"1080","2020-03-26",70,13,96,420,5862,0.868474923234391,2160,7699,533,626,82,867,19,225,59,19
"1081","2020-03-27",99,13,96,453,5862,0.868474923234391,2160,7699,533,626,84,951,25,250,53,25
"1082","2020-03-28",142,13,119,504,5862,0.868474923234391,2160,7699,533,626,85,1036,26,276,53,26
"1083","2020-03-29",151,13,149,547,5862,0.868474923234391,2160,7699,533,626,106,1142,26,302,78,26
"1084","2020-03-30",149,13,159,600,5862,0.868474923234391,2160,7699,533,626,114,1256,38,340,86,38
"1085","2020-03-31",157,13,156,647,5862,0.868474923234391,2160,7699,533,626,93,1349,13,353,68,13
"1086","2020-04-01",167,13,170,734,5862,0.868474923234391,2160,7699,533,626,99,1448,15,368,72,15
"1087","2020-04-02",178,13,173,826,5862,0.868474923234391,2160,7699,533,626,126,1574,16,384,97,16
"1088","2020-04-03",245,13,188,872,5862,0.868474923234391,2160,7699,533,626,110,1684,21,405,86,21
"1089","2020-04-04",245,13,197,932,5862,0.868474923234391,2160,7699,533,626,106,1790,15,420,78,15
"1090","2020-04-05",261,13,210,1004,5862,0.868474923234391,2160,7699,533,626,147,1937,15,435,117,15
"1091","2020-04-06",282,13,228,1076,5862,0.868474923234391,2160,7699,533,626,103,2040,9,444,77,9
"1092","2020-04-07",289,13,216,1153,5862,0.868474923234391,2160,7699,533,626,115,2155,12,456,89,12
"1093","2020-04-08",311,13,234,1207,5862,0.868474923234391,2160,7699,533,626,127,2282,4,460,105,4
"1094","2020-04-09",328,13,262,1250,5862,0.868474923234391,2160,7699,533,626,127,2409,7,467,98,7
"1095","2020-04-10",414,13,281,1313,5862,0.868474923234391,2160,7699,533,626,112,2521,9,476,81,9
"1096","2020-04-11",456,13,268,1394,5862,0.868474923234391,2160,7699,533,626,106,2627,29,505,90,29
"1097","2020-04-12",445,13,258,1439,5862,0.868474923234391,2160,7699,533,626,134,2761,31,536,114,31
"1098","2020-04-13",441,13,249,1471,5862,0.868474923234391,2160,7699,533,626,109,2870,33,569,89,33
"1099","2020-04-14",451,13,243,1521,5862,0.868474923234391,2160,7699,533,626,118,2988,33,602,88,33
"1100","2020-04-15",463,13,216,1593,5862,0.868474923234391,2160,7699,533,626,104,3092,26,628,89,26
"1101","2020-04-16",495,13,209,1626,5862,0.868474923234391,2160,7699,533,626,113,3205,26,654,92,26
"1102","2020-04-17",602,13,185,1688,5862,0.868474923234391,2160,7699,533,626,116,3321,13,667,90,13
"1103","2020-04-18",606,13,167,1666,5862,0.868474923234391,2160,7699,533,626,98,3419,21,688,73,21
"1104","2020-04-19",568,13,160,1683,5862,0.868474923234391,2160,7699,533,626,103,3522,10,698,75,10
"1105","2020-04-20",572,13,170,1699,5862,0.868474923234391,2160,7699,533,626,114,3636,24,722,98,24
"1106","2020-04-21",578,13,188,1667,5862,0.868474923234391,2160,7699,533,626,100,3736,21,743,80,21
"1107","2020-04-22",582,13,189,1648,5862,0.868474923234391,2160,7699,533,626,107,3843,38,781,88,38
"1108","2020-04-23",568,13,218,1606,5862,0.868474923234391,2160,7699,533,626,109,3952,30,811,86,30
"1109","2020-04-24",561,13,215,1556,5862,0.868474923234391,2160,7699,533,626,74,4026,26,837,57,26
"1110","2020-04-25",552,13,194,1488,5862,0.868474923234391,2160,7699,533,626,81,4107,34,871,60,34
"1111","2020-04-26",536,13,222,1466,5862,0.868474923234391,2160,7699,533,626,62,4169,27,898,46,27
"1112","2020-04-27",516,13,210,1401,5862,0.868474923234391,2160,7699,533,626,58,4227,32,930,39,32
"1113","2020-04-28",493,13,229,1328,5862,0.868474923234391,2160,7699,533,626,81,4308,18,948,60,18
"1114","2020-04-29",473,13,253,1274,5862,0.868474923234391,2160,7699,533,626,67,4375,27,975,46,27
"1115","2020-04-30",449,13,259,1228,5862,0.868474923234391,2160,7699,533,626,53,4428,26,1001,32,26
"1116","2020-05-01",438,13,249,1169,5862,0.868474923234391,2160,7699,533,626,64,4492,39,1040,48,39
"1117","2020-05-02",434,13,245,1104,5862,0.868474923234391,2160,7699,533,626,59,4551,31,1071,38,31
"1118","2020-05-03",372,13,228,1033,5862,0.868474923234391,2160,7699,533,626,50,4601,25,1096,31,25
"1119","2020-05-04",365,13,248,958,5862,0.868474923234391,2160,7699,533,626,49,4650,24,1120,37,24
"1120","2020-05-05",353,13,259,901,5862,0.868474923234391,2160,7699,533,626,36,4686,41,1161,25,41
"1121","2020-05-06",350,13,251,833,5862,0.868474923234391,2160,7699,533,626,41,4727,18,1179,19,18
"1122","2020-05-07",342,13,226,780,5862,0.868474923234391,2160,7699,533,626,40,4767,16,1195,18,16
"1123","2020-05-08",305,13,215,720,5862,0.868474923234391,2160,7699,533,626,39,4806,18,1213,21,18
"1124","2020-05-09",294,13,203,665,5862,0.868474923234391,2160,7699,533,626,35,4841,9,1222,18,9
"1125","2020-05-10",274,13,205,627,5862,0.868474923234391,2160,7699,533,626,42,4883,9,1231,19,9
"1126","2020-05-11",257,13,206,586,5862,0.868474923234391,2160,7699,533,626,45,4928,8,1239,15,8
"1127","2020-05-12",239,13,189,556,5862,0.868474923234391,2160,7699,533,626,26,4954,15,1254,15,15
"1128","2020-05-13",229,13,181,517,5862,0.868474923234391,2160,7699,533,626,34,4988,5,1259,20,5
"1129","2020-05-14",214,13,207,479,5862,0.868474923234391,2160,7699,533,626,27,5015,5,1264,11,5
"1130","2020-05-15",201,13,236,442,5862,0.868474923234391,2160,7699,533,626,37,5052,7,1271,21,7
"1131","2020-05-16",187,13,236,395,5862,0.868474923234391,2160,7699,533,626,25,5077,7,1278,16,7
"1132","2020-05-17",163,13,229,359,5862,0.868474923234391,2160,7699,533,626,21,5098,19,1297,11,19
"1133","2020-05-18",150,13,227,336,5862,0.868474923234391,2160,7699,533,626,27,5125,10,1307,17,10
"1134","2020-05-19",142,13,214,314,5862,0.868474923234391,2160,7699,533,626,18,5143,18,1325,9,18
"1135","2020-05-20",125,13,191,293,5862,0.868474923234391,2160,7699,533,626,20,5163,28,1353,9,28
"1136","2020-05-21",119,13,175,278,5862,0.868474923234391,2160,7699,533,626,28,5191,24,1377,14,24
"1137","2020-05-22",94,13,175,250,5862,0.868474923234391,2160,7699,533,626,19,5210,20,1397,7,20
"1138","2020-05-23",83,13,173,226,5862,0.868474923234391,2160,7699,533,626,22,5232,29,1426,14,29
"1139","2020-05-24",77,13,167,209,5862,0.868474923234391,2160,7699,533,626,12,5244,24,1450,6,24
"1140","2020-05-25",75,13,163,187,5862,0.868474923234391,2160,7699,533,626,21,5265,34,1484,9,34
"1141","2020-05-26",67,13,174,176,5862,0.868474923234391,2160,7699,533,626,14,5279,22,1506,6,22
"1142","2020-05-27",62,13,174,163,5862,0.868474923234391,2160,7699,533,626,18,5297,28,1534,6,28
"1143","2020-05-28",57,13,150,156,5862,0.868474923234391,2160,7699,533,626,11,5308,17,1551,5,17
"1144","2020-05-29",50,13,146,139,5862,0.868474923234391,2160,7699,533,626,13,5321,19,1570,10,19
"1145","2020-05-30",51,13,142,126,5862,0.868474923234391,2160,7699,533,626,12,5333,19,1589,6,19
"1146","2020-05-31",44,13,143,117,5862,0.868474923234391,2160,7699,533,626,8,5341,14,1603,2,14
"1147","2020-06-01",36,13,162,103,5862,0.868474923234391,2160,7699,533,626,14,5355,12,1615,8,12
"1148","2020-06-02",32,13,174,98,5862,0.868474923234391,2160,7699,533,626,5,5360,9,1624,1,9
"1149","2020-06-03",30,13,168,95,5862,0.868474923234391,2160,7699,533,626,11,5371,14,1638,2,14
"1150","2020-06-04",30,13,158,93,5862,0.868474923234391,2160,7699,533,626,7,5378,10,1648,3,10
"1151","2020-06-05",33,13,173,91,5862,0.868474923234391,2160,7699,533,626,8,5386,10,1658,1,10
"1152","2020-06-06",36,13,195,86,5862,0.868474923234391,2160,7699,533,626,12,5398,3,1661,6,3
"1153","2020-06-07",31,13,188,82,5862,0.868474923234391,2160,7699,533,626,7,5405,4,1665,3,4
"1154","2020-03-13",2,14,51,68,6312,0.860583016476553,2070,7615,581,909,24,59,9,38,7,9
"1155","2020-03-14",4,14,64,95,6312,0.860583016476553,2070,7615,581,909,28,87,22,60,15,22
"1156","2020-03-15",11,14,68,135,6312,0.860583016476553,2070,7615,581,909,26,113,14,74,14,14
"1157","2020-03-16",17,14,62,164,6312,0.860583016476553,2070,7615,581,909,35,148,11,85,18,11
"1158","2020-03-17",17,14,77,217,6312,0.860583016476553,2070,7615,581,909,41,189,2,87,20,2
"1159","2020-03-18",30,14,75,256,6312,0.860583016476553,2070,7615,581,909,47,236,10,97,23,10
"1160","2020-03-19",39,14,81,296,6312,0.860583016476553,2070,7615,581,909,45,281,34,131,23,34
"1161","2020-03-20",64,14,92,341,6312,0.860583016476553,2070,7615,581,909,60,341,19,150,37,19
"1162","2020-03-21",92,14,112,413,6312,0.860583016476553,2070,7615,581,909,55,396,7,157,37,7
"1163","2020-03-22",100,14,121,480,6312,0.860583016476553,2070,7615,581,909,58,454,18,175,43,18
"1164","2020-03-23",110,14,134,525,6312,0.860583016476553,2070,7615,581,909,56,510,22,197,37,22
"1165","2020-03-24",124,14,154,582,6312,0.860583016476553,2070,7615,581,909,72,582,41,238,56,41
"1166","2020-03-25",133,14,166,682,6312,0.860583016476553,2070,7615,581,909,75,657,19,257,56,19
"1167","2020-03-26",143,14,194,742,6312,0.860583016476553,2070,7615,581,909,79,736,29,286,58,29
"1168","2020-03-27",202,14,176,802,6312,0.860583016476553,2070,7615,581,909,88,824,35,321,67,35
"1169","2020-03-28",230,14,179,861,6312,0.860583016476553,2070,7615,581,909,73,897,35,356,58,35
"1170","2020-03-29",258,14,162,932,6312,0.860583016476553,2070,7615,581,909,85,982,18,374,75,18
"1171","2020-03-30",264,14,141,994,6312,0.860583016476553,2070,7615,581,909,88,1070,29,403,72,29
"1172","2020-03-31",265,14,124,1064,6312,0.860583016476553,2070,7615,581,909,85,1155,47,450,74,47
"1173","2020-04-01",288,14,133,1125,6312,0.860583016476553,2070,7615,581,909,83,1238,24,474,69,24
"1174","2020-04-02",315,14,149,1190,6312,0.860583016476553,2070,7615,581,909,87,1325,14,488,68,14
"1175","2020-04-03",382,14,160,1273,6312,0.860583016476553,2070,7615,581,909,91,1416,17,505,71,18
"1176","2020-04-04",419,14,168,1342,6312,0.860583016476553,2070,7615,581,909,90,1506,18,523,72,18
"1177","2020-04-05",417,14,168,1412,6312,0.860583016476553,2070,7615,581,909,100,1606,37,560,81,37
"1178","2020-04-06",426,14,197,1503,6312,0.860583016476553,2070,7615,581,909,105,1711,57,617,82,57
"1179","2020-04-07",435,14,218,1583,6312,0.860583016476553,2070,7615,581,909,92,1803,50,667,77,50
"1180","2020-04-08",431,14,199,1659,6312,0.860583016476553,2070,7615,581,909,122,1925,45,712,94,45
"1181","2020-04-09",458,14,192,1662,6312,0.860583016476553,2070,7615,581,909,117,2042,24,736,96,24
"1182","2020-04-10",543,14,205,1710,6312,0.860583016476553,2070,7615,581,909,94,2136,17,753,75,17
"1183","2020-04-11",601,14,210,1739,6312,0.860583016476553,2070,7615,581,909,104,2240,40,793,82,40
"1184","2020-04-12",549,14,201,1783,6312,0.860583016476553,2070,7615,581,909,102,2342,24,817,81,24
"1185","2020-04-13",553,14,211,1808,6312,0.860583016476553,2070,7615,581,909,93,2435,17,834,77,17
"1186","2020-04-14",571,14,240,1750,6312,0.860583016476553,2070,7615,581,909,93,2528,20,854,69,20
"1187","2020-04-15",600,14,216,1737,6312,0.860583016476553,2070,7615,581,909,86,2614,8,862,68,8
"1188","2020-04-16",599,14,180,1738,6312,0.860583016476553,2070,7615,581,909,94,2708,9,871,67,9
"1189","2020-04-17",673,14,192,1690,6312,0.860583016476553,2070,7615,581,909,73,2781,10,881,51,10
"1190","2020-04-18",609,14,213,1630,6312,0.860583016476553,2070,7615,581,909,83,2864,3,884,60,3
"1191","2020-04-19",604,14,234,1585,6312,0.860583016476553,2070,7615,581,909,81,2945,4,888,61,4
"1192","2020-04-20",593,14,236,1512,6312,0.860583016476553,2070,7615,581,909,61,3006,7,895,39,7
"1193","2020-04-21",585,14,238,1477,6312,0.860583016476553,2070,7615,581,909,66,3072,24,919,51,24
"1194","2020-04-22",560,14,236,1404,6312,0.860583016476553,2070,7615,581,909,79,3151,31,950,55,31
"1195","2020-04-23",534,14,224,1328,6312,0.860583016476553,2070,7615,581,909,80,3231,13,963,55,13
"1196","2020-04-24",456,14,249,1219,6312,0.860583016476553,2070,7615,581,909,67,3298,12,975,50,12
"1197","2020-04-25",427,14,242,1175,6312,0.860583016476553,2070,7615,581,909,56,3354,16,991,39,16
"1198","2020-04-26",404,14,258,1113,6312,0.860583016476553,2070,7615,581,909,60,3414,47,1038,46,47
"1199","2020-04-27",391,14,253,1047,6312,0.860583016476553,2070,7615,581,909,58,3472,24,1062,44,24
"1200","2020-04-28",371,14,258,992,6312,0.860583016476553,2070,7615,581,909,71,3543,48,1110,49,48
"1201","2020-04-29",363,14,259,945,6312,0.860583016476553,2070,7615,581,909,68,3611,26,1136,53,26
"1202","2020-04-30",358,14,256,899,6312,0.860583016476553,2070,7615,581,909,56,3667,22,1158,37,22
"1203","2020-05-01",345,14,264,849,6312,0.860583016476553,2070,7615,581,909,76,3743,17,1175,57,17
"1204","2020-05-02",346,14,258,818,6312,0.860583016476553,2070,7615,581,909,67,3810,12,1187,50,12
"1205","2020-05-03",325,14,254,763,6312,0.860583016476553,2070,7615,581,909,49,3859,6,1193,37,6
"1206","2020-05-04",308,14,234,712,6312,0.860583016476553,2070,7615,581,909,56,3915,48,1241,37,48
"1207","2020-05-05",283,14,204,655,6312,0.860583016476553,2070,7615,581,909,49,3964,23,1264,36,23
"1208","2020-05-06",266,14,197,595,6312,0.860583016476553,2070,7615,581,909,47,4011,11,1275,36,11
"1209","2020-05-07",243,14,200,578,6312,0.860583016476553,2070,7615,581,909,55,4066,25,1300,38,25
"1210","2020-05-08",225,14,185,552,6312,0.860583016476553,2070,7615,581,909,47,4113,23,1323,33,23
"1211","2020-05-09",222,14,194,502,6312,0.860583016476553,2070,7615,581,909,44,4157,39,1362,31,39
"1212","2020-05-10",191,14,190,476,6312,0.860583016476553,2070,7615,581,909,27,4184,38,1400,22,38
"1213","2020-05-11",175,14,214,436,6312,0.860583016476553,2070,7615,581,909,48,4232,39,1439,33,39
"1214","2020-05-12",169,14,240,414,6312,0.860583016476553,2070,7615,581,909,38,4270,45,1484,28,45
"1215","2020-05-13",164,14,227,402,6312,0.860583016476553,2070,7615,581,909,49,4319,38,1522,32,38
"1216","2020-05-14",155,14,222,375,6312,0.860583016476553,2070,7615,581,909,33,4352,35,1557,19,35
"1217","2020-05-15",130,14,209,344,6312,0.860583016476553,2070,7615,581,909,30,4382,45,1602,20,45
"1218","2020-05-16",124,14,195,333,6312,0.860583016476553,2070,7615,581,909,31,4413,28,1630,21,28
"1219","2020-05-17",100,14,201,310,6312,0.860583016476553,2070,7615,581,909,26,4439,45,1675,20,45
"1220","2020-05-18",92,14,192,299,6312,0.860583016476553,2070,7615,581,909,40,4479,38,1713,29,38
"1221","2020-05-19",93,14,195,282,6312,0.860583016476553,2070,7615,581,909,35,4514,26,1739,26,26
"1222","2020-05-20",88,14,195,259,6312,0.860583016476553,2070,7615,581,909,44,4558,22,1761,30,22
"1223","2020-05-21",91,14,200,249,6312,0.860583016476553,2070,7615,581,909,20,4578,24,1785,15,24
"1224","2020-05-22",89,14,215,232,6312,0.860583016476553,2070,7615,581,909,38,4616,11,1796,25,11
"1225","2020-05-23",86,14,206,217,6312,0.860583016476553,2070,7615,581,909,26,4642,13,1809,18,13
"1226","2020-05-24",82,14,188,205,6312,0.860583016476553,2070,7615,581,909,30,4672,31,1840,21,31
"1227","2020-05-25",77,14,185,207,6312,0.860583016476553,2070,7615,581,909,22,4694,22,1862,16,22
"1228","2020-05-26",73,14,200,200,6312,0.860583016476553,2070,7615,581,909,35,4729,52,1914,27,52
"1229","2020-05-27",77,14,201,195,6312,0.860583016476553,2070,7615,581,909,27,4756,25,1939,20,25
"1230","2020-05-28",71,14,205,178,6312,0.860583016476553,2070,7615,581,909,21,4777,41,1980,13,41
"1231","2020-05-29",61,14,197,173,6312,0.860583016476553,2070,7615,581,909,22,4799,18,1998,16,18
"1232","2020-05-30",61,14,183,160,6312,0.860583016476553,2070,7615,581,909,26,4825,9,2007,18,9
"1233","2020-05-31",57,14,172,154,6312,0.860583016476553,2070,7615,581,909,23,4848,33,2040,15,33
"1234","2020-06-01",58,14,158,147,6312,0.860583016476553,2070,7615,581,909,24,4872,37,2077,19,37
"1235","2020-06-02",60,14,146,147,6312,0.860583016476553,2070,7615,581,909,15,4887,22,2099,9,22
"1236","2020-06-03",50,14,143,135,6312,0.860583016476553,2070,7615,581,909,25,4912,44,2143,23,44
"1237","2020-06-04",47,14,155,134,6312,0.860583016476553,2070,7615,581,909,19,4931,44,2187,17,44
"1238","2020-06-05",43,14,157,124,6312,0.860583016476553,2070,7615,581,909,15,4946,33,2220,9,33
"1239","2020-06-06",44,14,163,112,6312,0.860583016476553,2070,7615,581,909,15,4961,35,2255,8,35
"1240","2020-06-07",43,14,182,107,6312,0.860583016476553,2070,7615,581,909,20,4981,36,2291,13,36
"1241","2020-03-13",1,15,62,145,6398,0.501562988433886,2085,8674,718,1169,50,125,12,31,4,12
"1242","2020-03-14",10,15,73,206,6398,0.501562988433886,2085,8674,718,1169,59,184,14,45,5,14
"1243","2020-03-15",18,15,76,264,6398,0.501562988433886,2085,8674,718,1169,53,237,10,55,21,10
"1244","2020-03-16",25,15,75,351,6398,0.501562988433886,2085,8674,718,1169,55,292,19,74,13,19
"1245","2020-03-17",35,15,78,411,6398,0.501562988433886,2085,8674,718,1169,63,355,11,85,18,11
"1246","2020-03-18",47,15,75,481,6398,0.501562988433886,2085,8674,718,1169,65,420,22,107,27,22
"1247","2020-03-19",70,15,80,556,6398,0.501562988433886,2085,8674,718,1169,60,480,15,122,29,15
"1248","2020-03-20",115,15,132,616,6398,0.501562988433886,2085,8674,718,1169,69,549,32,154,30,32
"1249","2020-03-21",150,15,145,682,6398,0.501562988433886,2085,8674,718,1169,71,620,22,176,37,22
"1250","2020-03-22",206,15,186,736,6398,0.501562988433886,2085,8674,718,1169,87,707,12,188,44,12
"1251","2020-03-23",214,15,186,793,6398,0.501562988433886,2085,8674,718,1169,84,791,23,211,49,23
"1252","2020-03-24",214,15,214,846,6398,0.501562988433886,2085,8674,718,1169,93,884,24,235,47,24
"1253","2020-03-25",224,15,273,896,6398,0.501562988433886,2085,8674,718,1169,68,952,27,262,32,27
"1254","2020-03-26",225,15,270,951,6398,0.501562988433886,2085,8674,718,1169,79,1031,13,275,41,13
"1255","2020-03-27",301,15,265,1000,6398,0.501562988433886,2085,8674,718,1169,93,1124,18,293,49,18
"1256","2020-03-28",297,15,266,1038,6398,0.501562988433886,2085,8674,718,1169,85,1209,11,304,45,11
"1257","2020-03-29",288,15,283,1085,6398,0.501562988433886,2085,8674,718,1169,72,1281,16,320,32,16
"1258","2020-03-30",306,15,275,1124,6398,0.501562988433886,2085,8674,718,1169,83,1364,12,332,50,12
"1259","2020-03-31",310,15,274,1124,6398,0.501562988433886,2085,8674,718,1169,75,1439,8,340,34,8
"1260","2020-04-01",332,15,248,1155,6398,0.501562988433886,2085,8674,718,1169,87,1526,6,346,42,6
"1261","2020-04-02",352,15,221,1166,6398,0.501562988433886,2085,8674,718,1169,73,1599,30,376,30,30
"1262","2020-04-03",386,15,226,1176,6398,0.501562988433886,2085,8674,718,1169,100,1699,28,404,47,28
"1263","2020-04-04",398,15,279,1190,6398,0.501562988433886,2085,8674,718,1169,84,1783,13,417,39,13
"1264","2020-04-05",396,15,305,1177,6398,0.501562988433886,2085,8674,718,1169,96,1879,18,435,52,18
"1265","2020-04-06",385,15,322,1174,6398,0.501562988433886,2085,8674,718,1169,98,1977,28,463,55,28
"1266","2020-04-07",373,15,339,1152,6398,0.501562988433886,2085,8674,718,1169,89,2066,30,493,42,30
"1267","2020-04-08",367,15,295,1160,6398,0.501562988433886,2085,8674,718,1169,75,2141,24,517,47,24
"1268","2020-04-09",363,15,284,1152,6398,0.501562988433886,2085,8674,718,1169,85,2226,27,544,28,27
"1269","2020-04-10",413,15,267,1154,6398,0.501562988433886,2085,8674,718,1169,112,2338,33,577,66,33
"1270","2020-04-11",402,15,284,1129,6398,0.501562988433886,2085,8674,718,1169,85,2423,23,600,51,23
"1271","2020-04-12",354,15,272,1108,6398,0.501562988433886,2085,8674,718,1169,98,2521,19,619,51,19
"1272","2020-04-13",361,15,255,1105,6398,0.501562988433886,2085,8674,718,1169,92,2613,13,632,43,13
"1273","2020-04-14",359,15,233,1107,6398,0.501562988433886,2085,8674,718,1169,76,2689,33,665,27,33
"1274","2020-04-15",372,15,218,1092,6398,0.501562988433886,2085,8674,718,1169,88,2777,27,692,43,27
"1275","2020-04-16",376,15,209,1089,6398,0.501562988433886,2085,8674,718,1169,86,2863,30,722,41,30
"1276","2020-04-17",375,15,191,1065,6398,0.501562988433886,2085,8674,718,1169,88,2951,46,768,44,46
"1277","2020-04-18",410,15,203,1050,6398,0.501562988433886,2085,8674,718,1169,96,3047,55,823,49,55
"1278","2020-04-19",375,15,216,1027,6398,0.501562988433886,2085,8674,718,1169,92,3139,55,878,45,55
"1279","2020-04-20",380,15,212,1008,6398,0.501562988433886,2085,8674,718,1169,86,3225,60,938,27,60
"1280","2020-04-21",377,15,243,1011,6398,0.501562988433886,2085,8674,718,1169,67,3292,31,969,40,31
"1281","2020-04-22",354,15,247,994,6398,0.501562988433886,2085,8674,718,1169,92,3384,38,1007,42,38
"1282","2020-04-23",342,15,239,975,6398,0.501562988433886,2085,8674,718,1169,75,3459,52,1059,28,52
"1283","2020-04-24",343,15,232,961,6398,0.501562988433886,2085,8674,718,1169,71,3530,32,1091,33,32
"1284","2020-04-25",323,15,213,925,6398,0.501562988433886,2085,8674,718,1169,76,3606,18,1109,40,18
"1285","2020-04-26",301,15,208,919,6398,0.501562988433886,2085,8674,718,1169,71,3677,37,1146,34,37
"1286","2020-04-27",287,15,245,913,6398,0.501562988433886,2085,8674,718,1169,82,3759,32,1178,32,32
"1287","2020-04-28",274,15,269,899,6398,0.501562988433886,2085,8674,718,1169,66,3825,38,1216,28,38
"1288","2020-04-29",276,15,259,895,6398,0.501562988433886,2085,8674,718,1169,70,3895,25,1241,27,25
"1289","2020-04-30",272,15,289,864,6398,0.501562988433886,2085,8674,718,1169,62,3957,23,1264,27,23
"1290","2020-05-01",265,15,324,828,6398,0.501562988433886,2085,8674,718,1169,66,4023,14,1278,28,14
"1291","2020-05-02",251,15,299,794,6398,0.501562988433886,2085,8674,718,1169,64,4087,13,1291,24,13
"1292","2020-05-03",267,15,312,796,6398,0.501562988433886,2085,8674,718,1169,70,4157,16,1307,31,16
"1293","2020-05-04",264,15,309,773,6398,0.501562988433886,2085,8674,718,1169,49,4206,20,1327,12,20
"1294","2020-05-05",257,15,264,750,6398,0.501562988433886,2085,8674,718,1169,55,4261,26,1353,24,26
"1295","2020-05-06",257,15,253,731,6398,0.501562988433886,2085,8674,718,1169,49,4310,37,1390,20,37
"1296","2020-05-07",249,15,245,709,6398,0.501562988433886,2085,8674,718,1169,63,4373,15,1405,18,15
"1297","2020-05-08",269,15,287,704,6398,0.501562988433886,2085,8674,718,1169,39,4412,17,1422,18,17
"1298","2020-05-09",298,15,270,691,6398,0.501562988433886,2085,8674,718,1169,47,4459,39,1461,15,39
"1299","2020-05-10",265,15,238,666,6398,0.501562988433886,2085,8674,718,1169,40,4499,15,1476,12,15
"1300","2020-05-11",244,15,222,643,6398,0.501562988433886,2085,8674,718,1169,36,4535,34,1510,10,34
"1301","2020-05-12",234,15,191,606,6398,0.501562988433886,2085,8674,718,1169,40,4575,17,1527,13,17
"1302","2020-05-13",222,15,166,602,6398,0.501562988433886,2085,8674,718,1169,37,4612,11,1538,12,11
"1303","2020-05-14",223,15,152,578,6398,0.501562988433886,2085,8674,718,1169,36,4648,25,1563,12,25
"1304","2020-05-15",213,15,154,551,6398,0.501562988433886,2085,8674,718,1169,34,4682,20,1583,11,20
"1305","2020-05-16",192,15,146,531,6398,0.501562988433886,2085,8674,718,1169,30,4712,26,1609,10,26
"1306","2020-05-17",170,15,144,498,6398,0.501562988433886,2085,8674,718,1169,28,4740,29,1638,9,29
"1307","2020-05-18",168,15,132,476,6398,0.501562988433886,2085,8674,718,1169,35,4775,15,1653,12,15
"1308","2020-05-19",161,15,132,459,6398,0.501562988433886,2085,8674,718,1169,38,4813,15,1668,16,15
"1309","2020-05-20",162,15,125,441,6398,0.501562988433886,2085,8674,718,1169,38,4851,12,1680,7,12
"1310","2020-05-21",158,15,198,420,6398,0.501562988433886,2085,8674,718,1169,32,4883,22,1702,9,22
"1311","2020-05-22",151,15,256,408,6398,0.501562988433886,2085,8674,718,1169,31,4914,26,1728,7,26
"1312","2020-05-23",151,15,273,402,6398,0.501562988433886,2085,8674,718,1169,31,4945,22,1750,6,22
"1313","2020-05-24",129,15,273,397,6398,0.501562988433886,2085,8674,718,1169,28,4973,18,1768,12,18
"1314","2020-05-25",125,15,264,404,6398,0.501562988433886,2085,8674,718,1169,22,4995,15,1783,6,15
"1315","2020-05-26",132,15,241,383,6398,0.501562988433886,2085,8674,718,1169,19,5014,20,1803,6,20
"1316","2020-05-27",127,15,246,375,6398,0.501562988433886,2085,8674,718,1169,25,5039,11,1814,8,11
"1317","2020-05-28",126,15,240,386,6398,0.501562988433886,2085,8674,718,1169,31,5070,16,1830,16,16
"1318","2020-05-29",135,15,237,370,6398,0.501562988433886,2085,8674,718,1169,18,5088,12,1842,8,12
"1319","2020-05-30",140,15,220,353,6398,0.501562988433886,2085,8674,718,1169,30,5118,15,1857,7,15
"1320","2020-05-31",149,15,193,340,6398,0.501562988433886,2085,8674,718,1169,19,5137,12,1869,6,12
"1321","2020-06-01",141,15,224,330,6398,0.501562988433886,2085,8674,718,1169,14,5151,17,1886,5,17
"1322","2020-06-02",132,15,207,316,6398,0.501562988433886,2085,8674,718,1169,15,5166,16,1902,7,16
"1323","2020-06-03",131,15,220,307,6398,0.501562988433886,2085,8674,718,1169,16,5182,14,1916,6,14
"1324","2020-06-04",125,15,218,285,6398,0.501562988433886,2085,8674,718,1169,21,5203,24,1940,9,24
"1325","2020-06-05",115,15,191,265,6398,0.501562988433886,2085,8674,718,1169,18,5221,11,1951,10,11
"1326","2020-06-06",100,15,182,244,6398,0.501562988433886,2085,8674,718,1169,18,5239,12,1963,8,12
"1327","2020-06-07",84,15,176,234,6398,0.501562988433886,2085,8674,718,1169,16,5255,16,1979,4,16
"1328","2020-03-13",3,16,52,42,6240,0.857692307692308,1980,7718,772,1141,29,95,29,58,9,29
"1329","2020-03-14",3,16,61,68,6240,0.857692307692308,1980,7718,772,1141,38,133,22,80,12,22
"1330","2020-03-15",7,16,76,89,6240,0.857692307692308,1980,7718,772,1141,64,197,36,116,25,36
"1331","2020-03-16",9,16,66,118,6240,0.857692307692308,1980,7718,772,1141,46,243,44,160,16,44
"1332","2020-03-17",11,16,74,153,6240,0.857692307692308,1980,7718,772,1141,54,297,47,207,22,47
"1333","2020-03-18",15,16,90,193,6240,0.857692307692308,1980,7718,772,1141,67,364,42,249,45,42
"1334","2020-03-19",22,16,90,234,6240,0.857692307692308,1980,7718,772,1141,69,433,55,304,39,55
"1335","2020-03-20",36,16,126,300,6240,0.857692307692308,1980,7718,772,1141,71,504,49,353,48,49
"1336","2020-03-21",62,16,123,347,6240,0.857692307692308,1980,7718,772,1141,70,574,42,395,47,42
"1337","2020-03-22",67,16,137,408,6240,0.857692307692308,1980,7718,772,1141,84,658,34,429,44,34
"1338","2020-03-23",73,16,144,464,6240,0.857692307692308,1980,7718,772,1141,64,722,47,476,48,47
"1339","2020-03-24",80,16,148,506,6240,0.857692307692308,1980,7718,772,1141,101,823,42,518,57,42
"1340","2020-03-25",99,16,151,559,6240,0.857692307692308,1980,7718,772,1141,90,913,37,555,63,37
"1341","2020-03-26",111,16,149,618,6240,0.857692307692308,1980,7718,772,1141,107,1020,40,595,79,40
"1342","2020-03-27",140,16,158,684,6240,0.857692307692308,1980,7718,772,1141,88,1108,38,633,59,38
"1343","2020-03-28",188,16,169,757,6240,0.857692307692308,1980,7718,772,1141,115,1223,39,672,79,39
"1344","2020-03-29",216,16,181,832,6240,0.857692307692308,1980,7718,772,1141,106,1329,40,712,74,40
"1345","2020-03-30",219,16,209,908,6240,0.857692307692308,1980,7718,772,1141,121,1450,46,758,83,46
"1346","2020-03-31",239,16,209,956,6240,0.857692307692308,1980,7718,772,1141,139,1589,62,820,98,62
"1347","2020-04-01",248,16,199,1060,6240,0.857692307692308,1980,7718,772,1141,93,1682,38,858,67,38
"1348","2020-04-02",257,16,208,1161,6240,0.857692307692308,1980,7718,772,1141,120,1802,42,900,81,42
"1349","2020-04-03",359,16,215,1266,6240,0.857692307692308,1980,7718,772,1141,135,1937,58,958,105,58
"1350","2020-04-04",392,16,203,1362,6240,0.857692307692308,1980,7718,772,1141,112,2049,45,1003,83,45
"1351","2020-04-05",382,16,202,1443,6240,0.857692307692308,1980,7718,772,1141,98,2147,44,1047,75,44
"1352","2020-04-06",381,16,192,1514,6240,0.857692307692308,1980,7718,772,1141,112,2259,40,1087,79,40
"1353","2020-04-07",387,16,189,1638,6240,0.857692307692308,1980,7718,772,1141,108,2367,51,1138,71,51
"1354","2020-04-08",425,16,184,1738,6240,0.857692307692308,1980,7718,772,1141,132,2499,33,1171,100,33
"1355","2020-04-09",454,16,175,1782,6240,0.857692307692308,1980,7718,772,1141,122,2621,45,1216,90,45
"1356","2020-04-10",581,16,150,1826,6240,0.857692307692308,1980,7718,772,1141,97,2718,61,1277,59,61
"1357","2020-04-11",581,16,170,1888,6240,0.857692307692308,1980,7718,772,1141,89,2807,43,1320,59,43
"1358","2020-04-12",592,16,190,1923,6240,0.857692307692308,1980,7718,772,1141,108,2915,27,1347,72,27
"1359","2020-04-13",618,16,197,1947,6240,0.857692307692308,1980,7718,772,1141,101,3016,26,1373,80,26
"1360","2020-04-14",623,16,207,1937,6240,0.857692307692308,1980,7718,772,1141,100,3116,55,1428,69,55
"1361","2020-04-15",624,16,223,1935,6240,0.857692307692308,1980,7718,772,1141,124,3240,50,1478,86,50
"1362","2020-04-16",645,16,262,1932,6240,0.857692307692308,1980,7718,772,1141,106,3346,47,1525,79,47
"1363","2020-04-17",701,16,260,1883,6240,0.857692307692308,1980,7718,772,1141,115,3461,35,1560,83,35
"1364","2020-04-18",694,16,265,1826,6240,0.857692307692308,1980,7718,772,1141,96,3557,36,1596,61,36
"1365","2020-04-19",631,16,259,1783,6240,0.857692307692308,1980,7718,772,1141,75,3632,32,1628,46,32
"1366","2020-04-20",622,16,274,1708,6240,0.857692307692308,1980,7718,772,1141,90,3722,32,1660,58,32
"1367","2020-04-21",616,16,264,1646,6240,0.857692307692308,1980,7718,772,1141,96,3818,36,1696,68,36
"1368","2020-04-22",603,16,234,1590,6240,0.857692307692308,1980,7718,772,1141,81,3899,23,1719,67,23
"1369","2020-04-23",579,16,218,1520,6240,0.857692307692308,1980,7718,772,1141,104,4003,49,1768,80,49
"1370","2020-04-24",558,16,195,1445,6240,0.857692307692308,1980,7718,772,1141,76,4079,59,1827,45,59
"1371","2020-04-25",535,16,196,1364,6240,0.857692307692308,1980,7718,772,1141,52,4131,39,1866,34,39
"1372","2020-04-26",495,16,204,1285,6240,0.857692307692308,1980,7718,772,1141,73,4204,50,1916,41,50
"1373","2020-04-27",487,16,202,1219,6240,0.857692307692308,1980,7718,772,1141,75,4279,58,1974,56,58
"1374","2020-04-28",463,16,216,1128,6240,0.857692307692308,1980,7718,772,1141,58,4337,51,2025,40,51
"1375","2020-04-29",441,16,224,1089,6240,0.857692307692308,1980,7718,772,1141,66,4403,40,2065,43,40
"1376","2020-04-30",422,16,223,988,6240,0.857692307692308,1980,7718,772,1141,62,4465,51,2116,37,51
"1377","2020-05-01",372,16,234,931,6240,0.857692307692308,1980,7718,772,1141,49,4514,40,2156,30,40
"1378","2020-05-02",366,16,226,866,6240,0.857692307692308,1980,7718,772,1141,61,4575,46,2202,35,46
"1379","2020-05-03",325,16,200,791,6240,0.857692307692308,1980,7718,772,1141,56,4631,42,2244,36,42
"1380","2020-05-04",296,16,212,709,6240,0.857692307692308,1980,7718,772,1141,49,4680,45,2289,30,45
"1381","2020-05-05",287,16,238,652,6240,0.857692307692308,1980,7718,772,1141,45,4725,27,2316,31,27
"1382","2020-05-06",270,16,232,597,6240,0.857692307692308,1980,7718,772,1141,44,4769,25,2341,19,25
"1383","2020-05-07",257,16,226,550,6240,0.857692307692308,1980,7718,772,1141,40,4809,32,2373,17,32
"1384","2020-05-08",244,16,227,512,6240,0.857692307692308,1980,7718,772,1141,44,4853,20,2393,20,20
"1385","2020-05-09",220,16,253,451,6240,0.857692307692308,1980,7718,772,1141,25,4878,29,2422,13,29
"1386","2020-05-10",200,16,252,415,6240,0.857692307692308,1980,7718,772,1141,50,4928,43,2465,25,43
"1387","2020-05-11",180,16,230,381,6240,0.857692307692308,1980,7718,772,1141,29,4957,43,2508,14,43
"1388","2020-05-12",156,16,206,347,6240,0.857692307692308,1980,7718,772,1141,37,4994,36,2544,19,36
"1389","2020-05-13",145,16,204,322,6240,0.857692307692308,1980,7718,772,1141,48,5042,36,2580,26,36
"1390","2020-05-14",131,16,217,296,6240,0.857692307692308,1980,7718,772,1141,30,5072,66,2646,12,66
"1391","2020-05-15",102,16,260,280,6240,0.857692307692308,1980,7718,772,1141,32,5104,45,2691,23,45
"1392","2020-05-16",107,16,250,269,6240,0.857692307692308,1980,7718,772,1141,29,5133,59,2750,17,59
"1393","2020-05-17",85,16,230,244,6240,0.857692307692308,1980,7718,772,1141,37,5170,42,2792,19,42
"1394","2020-05-18",94,16,218,233,6240,0.857692307692308,1980,7718,772,1141,28,5198,36,2828,12,36
"1395","2020-05-19",85,16,210,209,6240,0.857692307692308,1980,7718,772,1141,19,5217,53,2881,9,53
"1396","2020-05-20",89,16,200,182,6240,0.857692307692308,1980,7718,772,1141,28,5245,38,2919,18,38
"1397","2020-05-21",88,16,199,162,6240,0.857692307692308,1980,7718,772,1141,26,5271,39,2958,12,39
"1398","2020-05-22",67,16,218,153,6240,0.857692307692308,1980,7718,772,1141,32,5303,56,3014,15,56
"1399","2020-05-23",59,16,227,151,6240,0.857692307692308,1980,7718,772,1141,30,5333,61,3075,13,61
"1400","2020-05-24",70,16,201,140,6240,0.857692307692308,1980,7718,772,1141,13,5346,70,3145,8,70
"1401","2020-05-25",62,16,171,131,6240,0.857692307692308,1980,7718,772,1141,19,5365,45,3190,8,45
"1402","2020-05-26",57,16,158,121,6240,0.857692307692308,1980,7718,772,1141,24,5389,45,3235,12,45
"1403","2020-05-27",48,16,146,109,6240,0.857692307692308,1980,7718,772,1141,16,5405,36,3271,11,36
"1404","2020-05-28",45,16,178,110,6240,0.857692307692308,1980,7718,772,1141,18,5423,41,3312,8,41
"1405","2020-05-29",48,16,201,96,6240,0.857692307692308,1980,7718,772,1141,26,5449,45,3357,11,45
"1406","2020-05-30",44,16,206,93,6240,0.857692307692308,1980,7718,772,1141,20,5469,38,3395,11,38
"1407","2020-05-31",33,16,217,89,6240,0.857692307692308,1980,7718,772,1141,9,5478,34,3429,4,34
"1408","2020-06-01",30,16,201,81,6240,0.857692307692308,1980,7718,772,1141,16,5494,37,3466,6,37
"1409","2020-06-02",29,16,205,79,6240,0.857692307692308,1980,7718,772,1141,13,5507,38,3504,4,38
"1410","2020-06-03",30,16,206,78,6240,0.857692307692308,1980,7718,772,1141,12,5519,32,3536,5,32
"1411","2020-06-04",27,16,200,71,6240,0.857692307692308,1980,7718,772,1141,18,5537,37,3573,12,37
"1412","2020-06-05",26,16,186,62,6240,0.857692307692308,1980,7718,772,1141,18,5555,40,3613,11,40
"1413","2020-06-06",27,16,198,65,6240,0.857692307692308,1980,7718,772,1141,15,5570,44,3657,5,44
"1414","2020-06-07",22,16,182,61,6240,0.857692307692308,1980,7718,772,1141,13,5583,45,3702,5,45
"1415","2020-03-12",1,17,59,55,5824,0.673248626373626,2040,7585,583,832,11,17,5,18,6,5
"1416","2020-03-13",4,17,91,76,5824,0.673248626373626,2040,7585,583,832,15,32,14,32,11,14
"1417","2020-03-14",11,17,119,113,5824,0.673248626373626,2040,7585,583,832,16,48,13,45,10,13
"1418","2020-03-15",15,17,142,154,5824,0.673248626373626,2040,7585,583,832,8,56,13,58,7,13
"1419","2020-03-16",19,17,147,198,5824,0.673248626373626,2040,7585,583,832,17,73,15,73,12,15
"1420","2020-03-17",21,17,140,245,5824,0.673248626373626,2040,7585,583,832,37,110,33,106,26,33
"1421","2020-03-18",26,17,131,304,5824,0.673248626373626,2040,7585,583,832,37,147,31,137,33,31
"1422","2020-03-19",36,17,133,362,5824,0.673248626373626,2040,7585,583,832,23,170,18,155,19,18
"1423","2020-03-20",60,17,122,415,5824,0.673248626373626,2040,7585,583,832,41,211,6,161,36,6
"1424","2020-03-21",72,17,138,468,5824,0.673248626373626,2040,7585,583,832,48,259,36,197,42,36
"1425","2020-03-22",114,17,137,523,5824,0.673248626373626,2040,7585,583,832,47,306,32,229,39,32
"1426","2020-03-23",127,17,170,577,5824,0.673248626373626,2040,7585,583,832,59,365,34,263,48,34
"1427","2020-03-24",127,17,150,612,5824,0.673248626373626,2040,7585,583,832,66,431,16,279,62,16
"1428","2020-03-25",151,17,158,661,5824,0.673248626373626,2040,7585,583,832,96,527,16,295,95,16
"1429","2020-03-26",154,17,152,716,5824,0.673248626373626,2040,7585,583,832,76,603,33,328,70,33
"1430","2020-03-27",189,17,150,776,5824,0.673248626373626,2040,7585,583,832,99,702,32,360,90,32
"1431","2020-03-28",238,17,176,836,5824,0.673248626373626,2040,7585,583,832,97,799,13,373,94,13
"1432","2020-03-29",236,17,182,888,5824,0.673248626373626,2040,7585,583,832,103,902,9,382,98,9
"1433","2020-03-30",242,17,160,930,5824,0.673248626373626,2040,7585,583,832,121,1023,14,396,110,14
"1434","2020-03-31",260,17,150,973,5824,0.673248626373626,2040,7585,583,832,125,1148,16,412,119,16
"1435","2020-04-01",262,17,135,1029,5824,0.673248626373626,2040,7585,583,832,120,1268,37,449,118,37
"1436","2020-04-02",293,17,125,1072,5824,0.673248626373626,2040,7585,583,832,136,1404,35,484,132,35
"1437","2020-04-03",353,17,127,1093,5824,0.673248626373626,2040,7585,583,832,182,1586,34,518,177,34
"1438","2020-04-04",368,17,156,1134,5824,0.673248626373626,2040,7585,583,832,162,1748,45,563,158,45
"1439","2020-04-05",387,17,159,1174,5824,0.673248626373626,2040,7585,583,832,156,1904,46,609,152,46
"1440","2020-04-06",385,17,161,1192,5824,0.673248626373626,2040,7585,583,832,160,2064,31,640,155,31
"1441","2020-04-07",388,17,148,1221,5824,0.673248626373626,2040,7585,583,832,166,2230,11,651,160,11
"1442","2020-04-08",412,17,153,1232,5824,0.673248626373626,2040,7585,583,832,178,2408,16,667,170,16
"1443","2020-04-09",406,17,189,1266,5824,0.673248626373626,2040,7585,583,832,177,2585,45,712,173,45
"1444","2020-04-10",484,17,208,1281,5824,0.673248626373626,2040,7585,583,832,176,2761,40,752,167,40
"1445","2020-04-11",454,17,197,1272,5824,0.673248626373626,2040,7585,583,832,201,2962,52,804,193,52
"1446","2020-04-12",396,17,185,1289,5824,0.673248626373626,2040,7585,583,832,148,3110,40,844,147,40
"1447","2020-04-13",412,17,186,1306,5824,0.673248626373626,2040,7585,583,832,167,3277,49,893,163,49
"1448","2020-04-14",409,17,192,1316,5824,0.673248626373626,2040,7585,583,832,171,3448,22,915,170,22
"1449","2020-04-15",392,17,185,1309,5824,0.673248626373626,2040,7585,583,832,170,3618,31,946,165,31
"1450","2020-04-16",403,17,180,1308,5824,0.673248626373626,2040,7585,583,832,157,3775,21,967,153,21
"1451","2020-04-17",418,17,194,1289,5824,0.673248626373626,2040,7585,583,832,160,3935,13,980,158,13
"1452","2020-04-18",457,17,202,1295,5824,0.673248626373626,2040,7585,583,832,120,4055,50,1030,117,50
"1453","2020-04-19",435,17,234,1288,5824,0.673248626373626,2040,7585,583,832,118,4173,57,1087,115,57
"1454","2020-04-20",420,17,221,1280,5824,0.673248626373626,2040,7585,583,832,133,4306,42,1129,127,42
"1455","2020-04-21",406,17,218,1245,5824,0.673248626373626,2040,7585,583,832,115,4421,57,1186,111,57
"1456","2020-04-22",416,17,229,1245,5824,0.673248626373626,2040,7585,583,832,128,4549,66,1252,119,66
"1457","2020-04-23",411,17,231,1212,5824,0.673248626373626,2040,7585,583,832,135,4684,57,1309,132,57
"1458","2020-04-24",412,17,253,1177,5824,0.673248626373626,2040,7585,583,832,107,4791,33,1342,105,33
"1459","2020-04-25",404,17,235,1130,5824,0.673248626373626,2040,7585,583,832,98,4889,48,1390,96,48
"1460","2020-04-26",391,17,213,1079,5824,0.673248626373626,2040,7585,583,832,91,4980,31,1421,87,31
"1461","2020-04-27",375,17,184,1027,5824,0.673248626373626,2040,7585,583,832,71,5051,23,1444,67,23
"1462","2020-04-28",370,17,184,972,5824,0.673248626373626,2040,7585,583,832,61,5112,33,1477,53,33
"1463","2020-04-29",358,17,171,970,5824,0.673248626373626,2040,7585,583,832,61,5173,45,1522,56,45
"1464","2020-04-30",350,17,203,931,5824,0.673248626373626,2040,7585,583,832,53,5226,25,1547,51,25
"1465","2020-05-01",331,17,201,861,5824,0.673248626373626,2040,7585,583,832,49,5275,29,1576,47,29
"1466","2020-05-02",300,17,206,828,5824,0.673248626373626,2040,7585,583,832,46,5321,48,1624,45,48
"1467","2020-05-03",286,17,213,762,5824,0.673248626373626,2040,7585,583,832,50,5371,40,1664,48,40
"1468","2020-05-04",283,17,240,725,5824,0.673248626373626,2040,7585,583,832,49,5420,29,1693,47,29
"1469","2020-05-05",271,17,274,669,5824,0.673248626373626,2040,7585,583,832,38,5458,14,1707,37,14
"1470","2020-05-06",257,17,245,644,5824,0.673248626373626,2040,7585,583,832,50,5508,10,1717,46,10
"1471","2020-05-07",252,17,215,597,5824,0.673248626373626,2040,7585,583,832,38,5546,15,1732,36,15
"1472","2020-05-08",226,17,200,571,5824,0.673248626373626,2040,7585,583,832,40,5586,22,1754,36,22
"1473","2020-05-09",235,17,208,541,5824,0.673248626373626,2040,7585,583,832,24,5610,11,1765,23,11
"1474","2020-05-10",201,17,236,524,5824,0.673248626373626,2040,7585,583,832,18,5628,13,1778,17,13
"1475","2020-05-11",185,17,237,510,5824,0.673248626373626,2040,7585,583,832,28,5656,48,1826,25,48
"1476","2020-05-12",177,17,232,502,5824,0.673248626373626,2040,7585,583,832,21,5677,24,1850,20,24
"1477","2020-05-13",170,17,254,489,5824,0.673248626373626,2040,7585,583,832,24,5701,20,1870,22,20
"1478","2020-05-14",149,17,233,459,5824,0.673248626373626,2040,7585,583,832,16,5717,12,1882,12,12
"1479","2020-05-15",142,17,260,434,5824,0.673248626373626,2040,7585,583,832,18,5735,11,1893,16,11
"1480","2020-05-16",140,17,250,406,5824,0.673248626373626,2040,7585,583,832,24,5759,13,1906,20,13
"1481","2020-05-17",145,17,224,379,5824,0.673248626373626,2040,7585,583,832,17,5776,7,1913,16,7
"1482","2020-05-18",136,17,202,353,5824,0.673248626373626,2040,7585,583,832,13,5789,12,1925,7,12
"1483","2020-05-19",124,17,213,327,5824,0.673248626373626,2040,7585,583,832,16,5805,41,1966,15,41
"1484","2020-05-20",123,17,236,291,5824,0.673248626373626,2040,7585,583,832,8,5813,20,1986,8,20
"1485","2020-05-21",123,17,222,275,5824,0.673248626373626,2040,7585,583,832,9,5822,11,1997,9,11
"1486","2020-05-22",120,17,203,279,5824,0.673248626373626,2040,7585,583,832,11,5833,13,2010,7,13
"1487","2020-05-23",111,17,195,266,5824,0.673248626373626,2040,7585,583,832,6,5839,9,2019,4,9
"1488","2020-05-24",98,17,233,264,5824,0.673248626373626,2040,7585,583,832,11,5850,37,2056,9,37
"1489","2020-05-25",92,17,201,249,5824,0.673248626373626,2040,7585,583,832,12,5862,26,2082,10,26
"1490","2020-05-26",85,17,180,230,5824,0.673248626373626,2040,7585,583,832,10,5872,14,2096,9,14
"1491","2020-05-27",81,17,159,227,5824,0.673248626373626,2040,7585,583,832,6,5878,19,2115,5,19
"1492","2020-05-28",73,17,147,216,5824,0.673248626373626,2040,7585,583,832,11,5889,12,2127,9,12
"1493","2020-05-29",68,17,128,217,5824,0.673248626373626,2040,7585,583,832,3,5892,10,2137,2,10
"1494","2020-05-30",61,17,111,206,5824,0.673248626373626,2040,7585,583,832,9,5901,9,2146,6,9
"1495","2020-05-31",59,17,89,198,5824,0.673248626373626,2040,7585,583,832,5,5906,29,2175,4,29
"1496","2020-06-01",61,17,108,193,5824,0.673248626373626,2040,7585,583,832,5,5911,27,2202,5,27
"1497","2020-06-02",56,17,134,186,5824,0.673248626373626,2040,7585,583,832,6,5917,17,2219,5,17
"1498","2020-06-03",57,17,134,172,5824,0.673248626373626,2040,7585,583,832,4,5921,39,2258,4,39
"1499","2020-06-04",62,17,119,161,5824,0.673248626373626,2040,7585,583,832,5,5926,25,2283,4,25
"1500","2020-06-05",61,17,124,162,5824,0.673248626373626,2040,7585,583,832,5,5931,35,2318,5,35
"1501","2020-06-06",59,17,127,148,5824,0.673248626373626,2040,7585,583,832,7,5938,29,2347,4,29
"1502","2020-06-07",61,17,130,138,5824,0.673248626373626,2040,7585,583,832,8,5946,27,2374,7,27
"1503","2020-03-13",1,18,119,60,5718,0.82773697096887,2055,7063,596,1264,12,24,2,19,2,2
"1504","2020-03-14",6,18,112,81,5718,0.82773697096887,2055,7063,596,1264,20,44,5,24,8,5
"1505","2020-03-15",11,18,125,116,5718,0.82773697096887,2055,7063,596,1264,17,61,16,40,5,16
"1506","2020-03-16",12,18,154,157,5718,0.82773697096887,2055,7063,596,1264,20,81,13,53,15,13
"1507","2020-03-17",22,18,187,207,5718,0.82773697096887,2055,7063,596,1264,34,115,24,77,25,24
"1508","2020-03-18",30,18,193,241,5718,0.82773697096887,2055,7063,596,1264,25,140,18,95,20,18
"1509","2020-03-19",41,18,194,299,5718,0.82773697096887,2055,7063,596,1264,29,169,13,108,21,13
"1510","2020-03-20",53,18,215,351,5718,0.82773697096887,2055,7063,596,1264,46,215,9,117,41,9
"1511","2020-03-21",77,18,193,410,5718,0.82773697096887,2055,7063,596,1264,44,259,13,130,38,13
"1512","2020-03-22",102,18,182,459,5718,0.82773697096887,2055,7063,596,1264,52,311,11,141,43,11
"1513","2020-03-23",116,18,196,534,5718,0.82773697096887,2055,7063,596,1264,61,372,6,147,54,6
"1514","2020-03-24",121,18,192,597,5718,0.82773697096887,2055,7063,596,1264,51,423,9,156,44,9
"1515","2020-03-25",128,18,182,667,5718,0.82773697096887,2055,7063,596,1264,82,505,23,179,75,23
"1516","2020-03-26",143,18,179,736,5718,0.82773697096887,2055,7063,596,1264,72,577,21,200,61,21
"1517","2020-03-27",202,18,194,786,5718,0.82773697096887,2055,7063,596,1264,92,669,27,227,80,27
"1518","2020-03-28",240,18,203,843,5718,0.82773697096887,2055,7063,596,1264,99,768,30,257,91,30
"1519","2020-03-29",260,18,245,909,5718,0.82773697096887,2055,7063,596,1264,108,876,33,290,97,33
"1520","2020-03-30",260,18,239,987,5718,0.82773697096887,2055,7063,596,1264,83,959,23,313,78,23
"1521","2020-03-31",276,18,222,1036,5718,0.82773697096887,2055,7063,596,1264,100,1059,19,332,92,19
"1522","2020-04-01",295,18,206,1110,5718,0.82773697096887,2055,7063,596,1264,113,1172,11,343,107,11
"1523","2020-04-02",310,18,221,1156,5718,0.82773697096887,2055,7063,596,1264,139,1311,19,362,128,19
"1524","2020-04-03",381,18,213,1224,5718,0.82773697096887,2055,7063,596,1264,178,1489,27,389,170,27
"1525","2020-04-04",415,18,181,1287,5718,0.82773697096887,2055,7063,596,1264,136,1625,53,442,129,53
"1526","2020-04-05",379,18,157,1321,5718,0.82773697096887,2055,7063,596,1264,144,1769,48,490,134,48
"1527","2020-04-06",385,18,156,1350,5718,0.82773697096887,2055,7063,596,1264,203,1972,32,522,193,32
"1528","2020-04-07",400,18,139,1415,5718,0.82773697096887,2055,7063,596,1264,159,2131,35,557,149,35
"1529","2020-04-08",413,18,133,1460,5718,0.82773697096887,2055,7063,596,1264,184,2315,33,590,177,33
"1530","2020-04-09",441,18,170,1476,5718,0.82773697096887,2055,7063,596,1264,189,2504,49,639,181,49
"1531","2020-04-10",505,18,167,1526,5718,0.82773697096887,2055,7063,596,1264,147,2651,23,662,141,23
"1532","2020-04-11",521,18,182,1520,5718,0.82773697096887,2055,7063,596,1264,198,2849,21,683,186,21
"1533","2020-04-12",520,18,178,1524,5718,0.82773697096887,2055,7063,596,1264,166,3015,43,726,161,43
"1534","2020-04-13",517,18,171,1511,5718,0.82773697096887,2055,7063,596,1264,200,3215,26,752,188,26
"1535","2020-04-14",501,18,170,1491,5718,0.82773697096887,2055,7063,596,1264,168,3383,59,811,158,59
"1536","2020-04-15",507,18,175,1452,5718,0.82773697096887,2055,7063,596,1264,161,3544,40,851,149,40
"1537","2020-04-16",492,18,183,1430,5718,0.82773697096887,2055,7063,596,1264,201,3745,32,883,196,32
"1538","2020-04-17",531,18,202,1405,5718,0.82773697096887,2055,7063,596,1264,140,3885,49,932,135,49
"1539","2020-04-18",512,18,210,1388,5718,0.82773697096887,2055,7063,596,1264,133,4018,39,971,132,39
"1540","2020-04-19",485,18,197,1366,5718,0.82773697096887,2055,7063,596,1264,149,4167,33,1004,141,33
"1541","2020-04-20",475,18,194,1309,5718,0.82773697096887,2055,7063,596,1264,133,4300,43,1047,125,43
"1542","2020-04-21",460,18,207,1299,5718,0.82773697096887,2055,7063,596,1264,103,4403,30,1077,97,30
"1543","2020-04-22",465,18,196,1231,5718,0.82773697096887,2055,7063,596,1264,113,4516,42,1119,108,42
"1544","2020-04-23",440,18,183,1196,5718,0.82773697096887,2055,7063,596,1264,119,4635,25,1144,118,25
"1545","2020-04-24",433,18,162,1159,5718,0.82773697096887,2055,7063,596,1264,90,4725,29,1173,86,29
"1546","2020-04-25",433,18,151,1104,5718,0.82773697096887,2055,7063,596,1264,78,4803,55,1228,75,55
"1547","2020-04-26",395,18,132,1062,5718,0.82773697096887,2055,7063,596,1264,73,4876,27,1255,69,27
"1548","2020-04-27",380,18,123,1056,5718,0.82773697096887,2055,7063,596,1264,63,4939,22,1277,61,22
"1549","2020-04-28",377,18,107,1001,5718,0.82773697096887,2055,7063,596,1264,69,5008,11,1288,64,11
"1550","2020-04-29",358,18,98,948,5718,0.82773697096887,2055,7063,596,1264,66,5074,13,1301,62,13
"1551","2020-04-30",370,18,101,866,5718,0.82773697096887,2055,7063,596,1264,55,5129,17,1318,51,17
"1552","2020-05-01",345,18,146,816,5718,0.82773697096887,2055,7063,596,1264,55,5184,12,1330,51,12
"1553","2020-05-02",325,18,190,770,5718,0.82773697096887,2055,7063,596,1264,56,5240,15,1345,51,15
"1554","2020-05-03",304,18,216,729,5718,0.82773697096887,2055,7063,596,1264,40,5280,33,1378,37,33
"1555","2020-05-04",287,18,184,680,5718,0.82773697096887,2055,7063,596,1264,38,5318,21,1399,34,21
"1556","2020-05-05",263,18,179,622,5718,0.82773697096887,2055,7063,596,1264,36,5354,18,1417,34,18
"1557","2020-05-06",254,18,178,591,5718,0.82773697096887,2055,7063,596,1264,43,5397,16,1433,38,16
"1558","2020-05-07",234,18,216,555,5718,0.82773697096887,2055,7063,596,1264,30,5427,9,1442,24,9
"1559","2020-05-08",210,18,247,534,5718,0.82773697096887,2055,7063,596,1264,26,5453,45,1487,25,45
"1560","2020-05-09",196,18,229,490,5718,0.82773697096887,2055,7063,596,1264,28,5481,49,1536,26,49
"1561","2020-05-10",185,18,201,459,5718,0.82773697096887,2055,7063,596,1264,34,5515,32,1568,29,32
"1562","2020-05-11",175,18,200,425,5718,0.82773697096887,2055,7063,596,1264,24,5539,35,1603,18,35
"1563","2020-05-12",170,18,185,394,5718,0.82773697096887,2055,7063,596,1264,24,5563,50,1653,20,50
"1564","2020-05-13",161,18,185,375,5718,0.82773697096887,2055,7063,596,1264,24,5587,35,1688,18,35
"1565","2020-05-14",152,18,207,343,5718,0.82773697096887,2055,7063,596,1264,18,5605,16,1704,14,16
"1566","2020-05-15",137,18,196,338,5718,0.82773697096887,2055,7063,596,1264,19,5624,15,1719,16,15
"1567","2020-05-16",142,18,175,322,5718,0.82773697096887,2055,7063,596,1264,16,5640,9,1728,12,9
"1568","2020-05-17",121,18,158,299,5718,0.82773697096887,2055,7063,596,1264,15,5655,14,1742,12,14
"1569","2020-05-18",120,18,143,287,5718,0.82773697096887,2055,7063,596,1264,10,5665,32,1774,9,32
"1570","2020-05-19",114,18,181,270,5718,0.82773697096887,2055,7063,596,1264,11,5676,17,1791,8,17
"1571","2020-05-20",108,18,217,258,5718,0.82773697096887,2055,7063,596,1264,5,5681,19,1810,3,19
"1572","2020-05-21",103,18,221,236,5718,0.82773697096887,2055,7063,596,1264,14,5695,31,1841,14,31
"1573","2020-05-22",97,18,220,229,5718,0.82773697096887,2055,7063,596,1264,7,5702,19,1860,3,19
"1574","2020-05-23",86,18,196,214,5718,0.82773697096887,2055,7063,596,1264,6,5708,13,1873,5,13
"1575","2020-05-24",87,18,178,196,5718,0.82773697096887,2055,7063,596,1264,7,5715,6,1879,5,6
"1576","2020-05-25",81,18,152,178,5718,0.82773697096887,2055,7063,596,1264,5,5720,9,1888,4,9
"1577","2020-05-26",77,18,146,170,5718,0.82773697096887,2055,7063,596,1264,10,5730,10,1898,6,10
"1578","2020-05-27",69,18,140,171,5718,0.82773697096887,2055,7063,596,1264,5,5735,5,1903,2,5
"1579","2020-05-28",69,18,158,159,5718,0.82773697096887,2055,7063,596,1264,8,5743,7,1910,6,7
"1580","2020-05-29",74,18,149,150,5718,0.82773697096887,2055,7063,596,1264,5,5748,2,1912,3,2
"1581","2020-05-30",74,18,133,139,5718,0.82773697096887,2055,7063,596,1264,7,5755,5,1917,4,5
"1582","2020-05-31",64,18,131,127,5718,0.82773697096887,2055,7063,596,1264,7,5762,2,1919,5,2
"1583","2020-06-01",58,18,138,121,5718,0.82773697096887,2055,7063,596,1264,4,5766,4,1923,2,4
"1584","2020-06-02",53,18,164,119,5718,0.82773697096887,2055,7063,596,1264,7,5773,2,1925,4,2
"1585","2020-06-03",50,18,166,114,5718,0.82773697096887,2055,7063,596,1264,6,5779,3,1928,2,3
"1586","2020-06-04",45,18,153,109,5718,0.82773697096887,2055,7063,596,1264,5,5784,2,1930,3,2
"1587","2020-06-05",37,18,174,97,5718,0.82773697096887,2055,7063,596,1264,6,5790,4,1934,6,4
"1588","2020-06-06",34,18,161,88,5718,0.82773697096887,2055,7063,596,1264,5,5795,NA,NA,5,NA
"1589","2020-06-07",26,18,144,88,5718,0.82773697096887,2055,7063,596,1264,4,5799,14,1948,2,14
"1590","2020-03-07",1,19,0,0,4814,0.537183215621105,2025,7155,566,760,NA,NA,NA,NA,NA,NA
"1591","2020-03-08",1,19,0,0,4814,0.537183215621105,2025,7155,566,760,NA,NA,NA,NA,NA,NA
"1592","2020-03-09",0,19,0,0,4814,0.537183215621105,2025,7155,566,760,NA,NA,NA,NA,NA,NA
"1593","2020-03-10",0,19,0,0,4814,0.537183215621105,2025,7155,566,760,NA,NA,3,3,NA,3
"1594","2020-03-11",0,19,0,0,4814,0.537183215621105,2025,7155,566,760,23,23,9,12,1,9
"1595","2020-03-12",0,19,0,0,4814,0.537183215621105,2025,7155,566,760,20,43,11,23,NA,11
"1596","2020-03-13",7,19,55,93,4814,0.537183215621105,2025,7155,566,760,22,65,29,52,5,29
"1597","2020-03-14",11,19,62,110,4814,0.537183215621105,2025,7155,566,760,43,108,32,84,15,32
"1598","2020-03-15",14,19,66,150,4814,0.537183215621105,2025,7155,566,760,51,159,28,112,17,28
"1599","2020-03-16",16,19,81,190,4814,0.537183215621105,2025,7155,566,760,48,207,20,132,18,20
"1600","2020-03-17",28,19,97,231,4814,0.537183215621105,2025,7155,566,760,71,278,12,144,40,12
"1601","2020-03-18",42,19,98,261,4814,0.537183215621105,2025,7155,566,760,65,343,6,150,35,6
"1602","2020-03-19",56,19,106,296,4814,0.537183215621105,2025,7155,566,760,75,418,10,160,47,10
"1603","2020-03-20",65,19,95,318,4814,0.537183215621105,2025,7155,566,760,79,497,33,193,47,33
"1604","2020-03-21",78,19,102,354,4814,0.537183215621105,2025,7155,566,760,92,589,14,207,61,14
"1605","2020-03-22",91,19,95,397,4814,0.537183215621105,2025,7155,566,760,104,693,14,221,78,14
"1606","2020-03-23",98,19,97,443,4814,0.537183215621105,2025,7155,566,760,114,807,32,253,76,32
"1607","2020-03-24",104,19,119,486,4814,0.537183215621105,2025,7155,566,760,133,940,50,303,103,50
"1608","2020-03-25",114,19,109,532,4814,0.537183215621105,2025,7155,566,760,125,1065,33,336,96,33
"1609","2020-03-26",128,19,109,559,4814,0.537183215621105,2025,7155,566,760,139,1204,11,347,113,11
"1610","2020-03-27",153,19,93,598,4814,0.537183215621105,2025,7155,566,760,131,1335,13,360,104,13
"1611","2020-03-28",171,19,109,624,4814,0.537183215621105,2025,7155,566,760,162,1497,11,371,124,11
"1612","2020-03-29",198,19,130,653,4814,0.537183215621105,2025,7155,566,760,166,1663,9,380,142,9
"1613","2020-03-30",210,19,122,692,4814,0.537183215621105,2025,7155,566,760,132,1795,7,387,110,7
"1614","2020-03-31",211,19,120,730,4814,0.537183215621105,2025,7155,566,760,158,1953,12,399,128,12
"1615","2020-04-01",210,19,139,762,4814,0.537183215621105,2025,7155,566,760,149,2102,7,406,128,7
"1616","2020-04-02",216,19,149,782,4814,0.537183215621105,2025,7155,566,760,159,2261,45,451,120,45
"1617","2020-04-03",245,19,169,798,4814,0.537183215621105,2025,7155,566,760,198,2459,18,469,165,18
"1618","2020-04-04",270,19,189,826,4814,0.537183215621105,2025,7155,566,760,149,2608,14,483,126,14
"1619","2020-04-05",272,19,189,855,4814,0.537183215621105,2025,7155,566,760,177,2785,17,500,150,17
"1620","2020-04-06",265,19,205,864,4814,0.537183215621105,2025,7155,566,760,199,2984,48,548,177,48
"1621","2020-04-07",258,19,202,869,4814,0.537183215621105,2025,7155,566,760,162,3146,28,576,136,28
"1622","2020-04-08",266,19,179,888,4814,0.537183215621105,2025,7155,566,760,201,3347,14,590,178,14
"1623","2020-04-09",263,19,165,899,4814,0.537183215621105,2025,7155,566,760,150,3497,44,634,127,44
"1624","2020-04-10",314,19,149,919,4814,0.537183215621105,2025,7155,566,760,138,3635,22,656,111,22
"1625","2020-04-11",340,19,126,936,4814,0.537183215621105,2025,7155,566,760,161,3796,53,709,131,53
"1626","2020-04-12",303,19,122,932,4814,0.537183215621105,2025,7155,566,760,142,3938,26,735,124,26
"1627","2020-04-13",309,19,119,923,4814,0.537183215621105,2025,7155,566,760,143,4081,21,756,121,21
"1628","2020-04-14",327,19,158,921,4814,0.537183215621105,2025,7155,566,760,117,4198,61,817,102,61
"1629","2020-04-15",325,19,188,934,4814,0.537183215621105,2025,7155,566,760,147,4345,31,848,123,31
"1630","2020-04-16",326,19,201,931,4814,0.537183215621105,2025,7155,566,760,163,4508,25,873,142,25
"1631","2020-04-17",331,19,194,925,4814,0.537183215621105,2025,7155,566,760,101,4609,19,892,82,19
"1632","2020-04-18",320,19,170,922,4814,0.537183215621105,2025,7155,566,760,123,4732,36,928,99,36
"1633","2020-04-19",307,19,158,925,4814,0.537183215621105,2025,7155,566,760,119,4851,26,954,102,26
"1634","2020-04-20",304,19,150,900,4814,0.537183215621105,2025,7155,566,760,89,4940,56,1010,72,56
"1635","2020-04-21",296,19,142,871,4814,0.537183215621105,2025,7155,566,760,157,5097,47,1057,139,47
"1636","2020-04-22",304,19,180,871,4814,0.537183215621105,2025,7155,566,760,82,5179,66,1123,60,66
"1637","2020-04-23",305,19,179,841,4814,0.537183215621105,2025,7155,566,760,70,5249,48,1171,52,48
"1638","2020-04-24",311,19,205,817,4814,0.537183215621105,2025,7155,566,760,65,5314,29,1200,50,29
"1639","2020-04-25",318,19,234,804,4814,0.537183215621105,2025,7155,566,760,54,5368,60,1260,40,60
"1640","2020-04-26",307,19,222,764,4814,0.537183215621105,2025,7155,566,760,53,5421,29,1289,41,29
"1641","2020-04-27",284,19,225,757,4814,0.537183215621105,2025,7155,566,760,75,5496,52,1341,56,52
"1642","2020-04-28",262,19,229,742,4814,0.537183215621105,2025,7155,566,760,34,5530,39,1380,23,39
"1643","2020-04-29",251,19,227,739,4814,0.537183215621105,2025,7155,566,760,52,5582,22,1402,39,22
"1644","2020-04-30",243,19,215,718,4814,0.537183215621105,2025,7155,566,760,47,5629,18,1420,36,18
"1645","2020-05-01",261,19,224,700,4814,0.537183215621105,2025,7155,566,760,51,5680,8,1428,33,8
"1646","2020-05-02",262,19,208,680,4814,0.537183215621105,2025,7155,566,760,34,5714,7,1435,19,7
"1647","2020-05-03",250,19,184,677,4814,0.537183215621105,2025,7155,566,760,40,5754,37,1472,22,37
"1648","2020-05-04",243,19,215,666,4814,0.537183215621105,2025,7155,566,760,36,5790,7,1479,23,7
"1649","2020-05-05",233,19,202,657,4814,0.537183215621105,2025,7155,566,760,39,5829,13,1492,22,13
"1650","2020-05-06",226,19,216,634,4814,0.537183215621105,2025,7155,566,760,20,5849,5,1497,8,5
"1651","2020-05-07",229,19,226,598,4814,0.537183215621105,2025,7155,566,760,16,5865,23,1520,8,23
"1652","2020-05-08",230,19,233,585,4814,0.537183215621105,2025,7155,566,760,36,5901,63,1583,19,63
"1653","2020-05-09",207,19,251,562,4814,0.537183215621105,2025,7155,566,760,25,5926,19,1602,17,19
"1654","2020-05-10",197,19,234,556,4814,0.537183215621105,2025,7155,566,760,18,5944,27,1629,8,27
"1655","2020-05-11",198,19,196,529,4814,0.537183215621105,2025,7155,566,760,22,5966,18,1647,8,18
"1656","2020-05-12",199,19,160,530,4814,0.537183215621105,2025,7155,566,760,13,5979,15,1662,8,15
"1657","2020-05-13",204,19,156,520,4814,0.537183215621105,2025,7155,566,760,24,6003,12,1674,11,12
"1658","2020-05-14",191,19,144,502,4814,0.537183215621105,2025,7155,566,760,29,6032,7,1681,11,7
"1659","2020-05-15",183,19,164,489,4814,0.537183215621105,2025,7155,566,760,17,6049,6,1687,5,6
"1660","2020-05-16",174,19,176,479,4814,0.537183215621105,2025,7155,566,760,11,6060,13,1700,4,13
"1661","2020-05-17",155,19,187,461,4814,0.537183215621105,2025,7155,566,760,13,6073,41,1741,8,41
"1662","2020-05-18",154,19,182,440,4814,0.537183215621105,2025,7155,566,760,16,6089,15,1756,7,15
"1663","2020-05-19",146,19,195,416,4814,0.537183215621105,2025,7155,566,760,18,6107,12,1768,6,12
"1664","2020-05-20",138,19,182,402,4814,0.537183215621105,2025,7155,566,760,18,6125,25,1793,6,25
"1665","2020-05-21",133,19,170,380,4814,0.537183215621105,2025,7155,566,760,16,6141,34,1827,8,34
"1666","2020-05-22",134,19,150,374,4814,0.537183215621105,2025,7155,566,760,13,6154,47,1874,3,47
"1667","2020-05-23",136,19,142,362,4814,0.537183215621105,2025,7155,566,760,7,6161,59,1933,5,59
"1668","2020-05-24",126,19,132,358,4814,0.537183215621105,2025,7155,566,760,16,6177,21,1954,7,21
"1669","2020-05-25",119,19,124,356,4814,0.537183215621105,2025,7155,566,760,10,6187,20,1974,5,20
"1670","2020-05-26",116,19,107,346,4814,0.537183215621105,2025,7155,566,760,11,6198,14,1988,7,14
"1671","2020-05-27",111,19,96,332,4814,0.537183215621105,2025,7155,566,760,10,6208,23,2011,5,23
"1672","2020-05-28",113,19,101,318,4814,0.537183215621105,2025,7155,566,760,7,6215,43,2054,1,43
"1673","2020-05-29",111,19,118,304,4814,0.537183215621105,2025,7155,566,760,12,6227,49,2103,5,49
"1674","2020-05-30",105,19,125,283,4814,0.537183215621105,2025,7155,566,760,5,6232,23,2126,3,23
"1675","2020-05-31",100,19,124,269,4814,0.537183215621105,2025,7155,566,760,11,6243,15,2141,5,15
"1676","2020-06-01",94,19,148,248,4814,0.537183215621105,2025,7155,566,760,7,6250,49,2190,3,49
"1677","2020-06-02",85,19,145,243,4814,0.537183215621105,2025,7155,566,760,11,6261,49,2239,2,49
"1678","2020-06-03",84,19,142,228,4814,0.537183215621105,2025,7155,566,760,13,6274,16,2255,4,16
"1679","2020-06-04",80,19,146,212,4814,0.537183215621105,2025,7155,566,760,5,6279,41,2296,1,41
"1680","2020-06-05",73,19,140,191,4814,0.537183215621105,2025,7155,566,760,5,6284,33,2329,2,33
"1681","2020-06-06",73,19,131,198,4814,0.537183215621105,2025,7155,566,760,7,6291,28,2357,NA,28
"1682","2020-06-07",66,19,126,189,4814,0.537183215621105,2025,7155,566,760,7,6298,41,2398,2,41
"1683","2020-03-15",3,20,136,57,5900,0.925762711864407,1965,7023,624,965,17,57,17,82,9,17
"1684","2020-03-16",5,20,139,82,5900,0.925762711864407,1965,7023,624,965,22,79,23,105,10,23
"1685","2020-03-17",10,20,132,118,5900,0.925762711864407,1965,7023,624,965,27,106,24,129,20,24
"1686","2020-03-18",13,20,117,154,5900,0.925762711864407,1965,7023,624,965,19,125,25,154,13,25
"1687","2020-03-19",17,20,147,178,5900,0.925762711864407,1965,7023,624,965,24,149,13,167,15,13
"1688","2020-03-20",28,20,156,205,5900,0.925762711864407,1965,7023,624,965,31,180,20,187,21,20
"1689","2020-03-21",41,20,191,241,5900,0.925762711864407,1965,7023,624,965,39,219,20,207,30,20
"1690","2020-03-22",58,20,180,290,5900,0.925762711864407,1965,7023,624,965,48,267,16,223,30,16
"1691","2020-03-23",70,20,169,355,5900,0.925762711864407,1965,7023,624,965,46,313,23,246,40,23
"1692","2020-03-24",69,20,193,392,5900,0.925762711864407,1965,7023,624,965,55,368,17,263,44,17
"1693","2020-03-25",78,20,178,442,5900,0.925762711864407,1965,7023,624,965,56,424,17,280,45,17
"1694","2020-03-26",93,20,167,494,5900,0.925762711864407,1965,7023,624,965,71,495,24,304,59,24
"1695","2020-03-27",112,20,200,540,5900,0.925762711864407,1965,7023,624,965,50,545,15,319,45,15
"1696","2020-03-28",130,20,217,626,5900,0.925762711864407,1965,7023,624,965,78,623,37,356,70,37
"1697","2020-03-29",164,20,230,683,5900,0.925762711864407,1965,7023,624,965,72,695,45,401,62,45
"1698","2020-03-30",171,20,220,733,5900,0.925762711864407,1965,7023,624,965,88,783,37,438,80,37
"1699","2020-03-31",180,20,199,804,5900,0.925762711864407,1965,7023,624,965,84,867,32,470,79,32
"1700","2020-04-01",197,20,159,859,5900,0.925762711864407,1965,7023,624,965,119,986,34,504,103,34
"1701","2020-04-02",204,20,138,928,5900,0.925762711864407,1965,7023,624,965,128,1114,36,540,113,36
"1702","2020-04-03",271,20,146,1029,5900,0.925762711864407,1965,7023,624,965,99,1213,39,579,88,39
"1703","2020-04-04",297,20,160,1083,5900,0.925762711864407,1965,7023,624,965,114,1327,35,614,106,35
"1704","2020-04-05",301,20,172,1143,5900,0.925762711864407,1965,7023,624,965,124,1451,47,661,114,47
"1705","2020-04-06",306,20,189,1198,5900,0.925762711864407,1965,7023,624,965,141,1592,50,711,129,50
"1706","2020-04-07",320,20,214,1265,5900,0.925762711864407,1965,7023,624,965,148,1740,37,748,141,37
"1707","2020-04-08",339,20,224,1340,5900,0.925762711864407,1965,7023,624,965,125,1865,45,793,112,45
"1708","2020-04-09",376,20,192,1431,5900,0.925762711864407,1965,7023,624,965,116,1981,60,853,110,60
"1709","2020-04-10",459,20,176,1477,5900,0.925762711864407,1965,7023,624,965,156,2137,68,921,147,68
"1710","2020-04-11",499,20,202,1530,5900,0.925762711864407,1965,7023,624,965,183,2320,51,972,164,51
"1711","2020-04-12",457,20,239,1599,5900,0.925762711864407,1965,7023,624,965,158,2478,44,1016,145,44
"1712","2020-04-13",471,20,230,1647,5900,0.925762711864407,1965,7023,624,965,124,2602,39,1055,119,39
"1713","2020-04-14",483,20,269,1688,5900,0.925762711864407,1965,7023,624,965,169,2771,37,1092,153,37
"1714","2020-04-15",500,20,262,1738,5900,0.925762711864407,1965,7023,624,965,172,2943,30,1122,162,30
"1715","2020-04-16",505,20,237,1787,5900,0.925762711864407,1965,7023,624,965,154,3097,27,1149,139,27
"1716","2020-04-17",616,20,247,1767,5900,0.925762711864407,1965,7023,624,965,184,3281,22,1171,176,22
"1717","2020-04-18",599,20,252,1764,5900,0.925762711864407,1965,7023,624,965,136,3417,25,1196,131,25
"1718","2020-04-19",599,20,230,1772,5900,0.925762711864407,1965,7023,624,965,159,3576,22,1218,146,22
"1719","2020-04-20",597,20,206,1755,5900,0.925762711864407,1965,7023,624,965,145,3721,26,1244,138,26
"1720","2020-04-21",573,20,190,1719,5900,0.925762711864407,1965,7023,624,965,111,3832,39,1283,104,39
"1721","2020-04-22",577,20,174,1658,5900,0.925762711864407,1965,7023,624,965,126,3958,41,1324,119,41
"1722","2020-04-23",564,20,157,1575,5900,0.925762711864407,1965,7023,624,965,111,4069,50,1374,106,50
"1723","2020-04-24",570,20,159,1506,5900,0.925762711864407,1965,7023,624,965,124,4193,31,1405,113,31
"1724","2020-04-25",573,20,152,1436,5900,0.925762711864407,1965,7023,624,965,113,4306,25,1430,103,25
"1725","2020-04-26",502,20,187,1371,5900,0.925762711864407,1965,7023,624,965,119,4425,49,1479,107,49
"1726","2020-04-27",478,20,187,1293,5900,0.925762711864407,1965,7023,624,965,87,4512,32,1511,80,32
"1727","2020-04-28",471,20,184,1222,5900,0.925762711864407,1965,7023,624,965,76,4588,38,1549,73,38
"1728","2020-04-29",435,20,191,1156,5900,0.925762711864407,1965,7023,624,965,86,4674,55,1604,80,55
"1729","2020-04-30",419,20,175,1090,5900,0.925762711864407,1965,7023,624,965,89,4763,48,1652,81,48
"1730","2020-05-01",381,20,149,1030,5900,0.925762711864407,1965,7023,624,965,79,4842,41,1693,74,41
"1731","2020-05-02",366,20,165,957,5900,0.925762711864407,1965,7023,624,965,67,4909,40,1733,56,40
"1732","2020-05-03",373,20,220,868,5900,0.925762711864407,1965,7023,624,965,61,4970,30,1763,58,30
"1733","2020-05-04",367,20,231,802,5900,0.925762711864407,1965,7023,624,965,63,5033,55,1818,53,55
"1734","2020-05-05",338,20,259,729,5900,0.925762711864407,1965,7023,624,965,58,5091,52,1870,54,52
"1735","2020-05-06",328,20,273,671,5900,0.925762711864407,1965,7023,624,965,39,5130,44,1914,37,44
"1736","2020-05-07",315,20,246,615,5900,0.925762711864407,1965,7023,624,965,41,5171,26,1940,37,26
"1737","2020-05-08",272,20,240,551,5900,0.925762711864407,1965,7023,624,965,44,5215,32,1972,43,32
"1738","2020-05-09",253,20,225,516,5900,0.925762711864407,1965,7023,624,965,38,5253,33,2005,33,33
"1739","2020-05-10",204,20,202,485,5900,0.925762711864407,1965,7023,624,965,51,5304,33,2038,48,33
"1740","2020-05-11",192,20,184,446,5900,0.925762711864407,1965,7023,624,965,29,5333,37,2075,26,37
"1741","2020-05-12",173,20,184,420,5900,0.925762711864407,1965,7023,624,965,32,5365,30,2105,30,30
"1742","2020-05-13",160,20,185,384,5900,0.925762711864407,1965,7023,624,965,29,5394,34,2139,27,34
"1743","2020-05-14",146,20,218,358,5900,0.925762711864407,1965,7023,624,965,29,5423,49,2188,24,49
"1744","2020-05-15",123,20,205,338,5900,0.925762711864407,1965,7023,624,965,31,5454,53,2241,25,53
"1745","2020-05-16",116,20,185,322,5900,0.925762711864407,1965,7023,624,965,15,5469,46,2287,12,46
"1746","2020-05-17",114,20,172,295,5900,0.925762711864407,1965,7023,624,965,16,5485,37,2324,12,37
"1747","2020-05-18",106,20,223,269,5900,0.925762711864407,1965,7023,624,965,18,5503,38,2362,13,38
"1748","2020-05-19",103,20,219,251,5900,0.925762711864407,1965,7023,624,965,25,5528,29,2391,21,29
"1749","2020-05-20",99,20,186,237,5900,0.925762711864407,1965,7023,624,965,17,5545,22,2413,14,22
"1750","2020-05-21",103,20,200,229,5900,0.925762711864407,1965,7023,624,965,16,5561,27,2440,11,27
"1751","2020-05-22",99,20,230,208,5900,0.925762711864407,1965,7023,624,965,12,5573,24,2464,9,24
"1752","2020-05-23",96,20,212,187,5900,0.925762711864407,1965,7023,624,965,9,5582,32,2496,6,32
"1753","2020-05-24",82,20,210,178,5900,0.925762711864407,1965,7023,624,965,15,5597,28,2524,14,28
"1754","2020-05-25",72,20,229,169,5900,0.925762711864407,1965,7023,624,965,10,5607,25,2549,5,25
"1755","2020-05-26",65,20,237,159,5900,0.925762711864407,1965,7023,624,965,14,5621,31,2580,7,31
"1756","2020-05-27",63,20,230,154,5900,0.925762711864407,1965,7023,624,965,9,5630,28,2608,6,28
"1757","2020-05-28",53,20,237,154,5900,0.925762711864407,1965,7023,624,965,13,5643,22,2630,7,22
"1758","2020-05-29",53,20,228,147,5900,0.925762711864407,1965,7023,624,965,5,5648,19,2649,3,19
"1759","2020-05-30",51,20,240,137,5900,0.925762711864407,1965,7023,624,965,7,5655,21,2670,7,21
"1760","2020-05-31",52,20,218,127,5900,0.925762711864407,1965,7023,624,965,9,5664,20,2690,5,20
"1761","2020-06-01",50,20,186,119,5900,0.925762711864407,1965,7023,624,965,7,5671,30,2720,4,30
"1762","2020-06-02",46,20,173,103,5900,0.925762711864407,1965,7023,624,965,7,5678,39,2759,3,39
"1763","2020-06-03",46,20,143,102,5900,0.925762711864407,1965,7023,624,965,11,5689,25,2784,7,25
"1764","2020-06-04",43,20,170,93,5900,0.925762711864407,1965,7023,624,965,7,5696,27,2811,4,27
"1765","2020-06-05",38,20,148,83,5900,0.925762711864407,1965,7023,624,965,9,5705,36,2847,5,36
"1766","2020-06-06",35,20,137,75,5900,0.925762711864407,1965,7023,624,965,4,5709,42,2889,2,42
"1767","2020-06-07",30,20,125,68,5900,0.925762711864407,1965,7023,624,965,5,5714,33,2922,2,33
