"","Date","Absents","Paramset","Infections_or_Exposed_per_day_Patient","Infections_or_Exposed_per_day_HCW","total_infections","nosocomial_proportion","PCR_pooled","LFD_pooled","HCW_symp_test","patient_symp_test","new_hcw_infs","cumulative_hcw_infs","new_pat_infs","cumulative_pats_infs","new_nosocomial_hcw_infs","new_nosocomial_pat_infs"
"1","2020-03-12",1,1,73,180,8320,0.296995192307692,8340,40835,526,1412,101,180,24,44,5,24
"2","2020-03-13",8,1,88,290,8320,0.296995192307692,8340,40835,526,1412,110,290,15,59,9,15
"3","2020-03-14",16,1,85,393,8320,0.296995192307692,8340,40835,526,1412,103,393,9,68,17,9
"4","2020-03-15",56,1,78,525,8320,0.296995192307692,8340,40835,526,1412,132,525,11,79,31,11
"5","2020-03-16",71,1,99,628,8320,0.296995192307692,8340,40835,526,1412,103,628,21,100,27,21
"6","2020-03-17",80,1,136,768,8320,0.296995192307692,8340,40835,526,1412,140,768,42,142,50,42
"7","2020-03-18",105,1,162,884,8320,0.296995192307692,8340,40835,526,1412,126,894,38,180,37,38
"8","2020-03-19",133,1,174,1007,8320,0.296995192307692,8340,40835,526,1412,146,1040,43,223,57,43
"9","2020-03-20",224,1,175,1097,8320,0.296995192307692,8340,40835,526,1412,135,1175,29,252,50,29
"10","2020-03-21",317,1,189,1198,8320,0.296995192307692,8340,40835,526,1412,142,1317,39,291,70,39
"11","2020-03-22",320,1,210,1297,8320,0.296995192307692,8340,40835,526,1412,149,1466,62,353,65,62
"12","2020-03-23",354,1,212,1410,8320,0.296995192307692,8340,40835,526,1412,166,1632,24,377,95,24
"13","2020-03-24",380,1,193,1462,8320,0.296995192307692,8340,40835,526,1412,142,1774,26,403,73,26
"14","2020-03-25",415,1,188,1513,8320,0.296995192307692,8340,40835,526,1412,147,1921,25,428,63,25
"15","2020-03-26",457,1,190,1558,8320,0.296995192307692,8340,40835,526,1412,140,2061,33,461,72,33
"16","2020-03-27",540,1,211,1565,8320,0.296995192307692,8340,40835,526,1412,126,2187,57,518,52,57
"17","2020-03-28",518,1,222,1582,8320,0.296995192307692,8340,40835,526,1412,144,2331,31,549,66,31
"18","2020-03-29",508,1,251,1610,8320,0.296995192307692,8340,40835,526,1412,133,2464,60,609,62,60
"19","2020-03-30",492,1,252,1622,8320,0.296995192307692,8340,40835,526,1412,143,2607,54,663,70,54
"20","2020-03-31",480,1,240,1616,8320,0.296995192307692,8340,40835,526,1412,127,2734,30,693,62,30
"21","2020-04-01",473,1,205,1622,8320,0.296995192307692,8340,40835,526,1412,153,2887,18,711,73,18
"22","2020-04-02",473,1,215,1619,8320,0.296995192307692,8340,40835,526,1412,141,3028,47,758,56,47
"23","2020-04-03",530,1,230,1624,8320,0.296995192307692,8340,40835,526,1412,134,3162,36,794,63,36
"24","2020-04-04",540,1,212,1618,8320,0.296995192307692,8340,40835,526,1412,113,3275,31,825,38,31
"25","2020-04-05",516,1,193,1595,8320,0.296995192307692,8340,40835,526,1412,131,3406,20,845,59,20
"26","2020-04-06",502,1,185,1587,8320,0.296995192307692,8340,40835,526,1412,119,3525,19,864,50,19
"27","2020-04-07",499,1,178,1565,8320,0.296995192307692,8340,40835,526,1412,108,3633,24,888,41,24
"28","2020-04-08",484,1,210,1553,8320,0.296995192307692,8340,40835,526,1412,119,3752,49,937,55,49
"29","2020-04-09",462,1,217,1548,8320,0.296995192307692,8340,40835,526,1412,123,3875,32,969,55,32
"30","2020-04-10",492,1,206,1519,8320,0.296995192307692,8340,40835,526,1412,119,3994,21,990,52,21
"31","2020-04-11",470,1,199,1487,8320,0.296995192307692,8340,40835,526,1412,121,4115,22,1012,52,22
"32","2020-04-12",443,1,188,1469,8320,0.296995192307692,8340,40835,526,1412,109,4224,20,1032,41,20
"33","2020-04-13",437,1,175,1435,8320,0.296995192307692,8340,40835,526,1412,106,4330,24,1056,34,24
"34","2020-04-14",428,1,219,1407,8320,0.296995192307692,8340,40835,526,1412,99,4429,49,1105,33,49
"35","2020-04-15",430,1,211,1366,8320,0.296995192307692,8340,40835,526,1412,93,4522,28,1133,32,28
"36","2020-04-16",423,1,190,1344,8320,0.296995192307692,8340,40835,526,1412,86,4608,20,1153,23,20
"37","2020-04-17",441,1,177,1314,8320,0.296995192307692,8340,40835,526,1412,85,4693,19,1172,29,19
"38","2020-04-18",436,1,172,1277,8320,0.296995192307692,8340,40835,526,1412,94,4787,26,1198,35,26
"39","2020-04-19",410,1,168,1255,8320,0.296995192307692,8340,40835,526,1412,91,4878,10,1208,36,10
"40","2020-04-20",412,1,137,1202,8320,0.296995192307692,8340,40835,526,1412,72,4950,5,1213,23,5
"41","2020-04-21",393,1,151,1184,8320,0.296995192307692,8340,40835,526,1412,83,5033,14,1227,28,14
"42","2020-04-22",394,1,193,1151,8320,0.296995192307692,8340,40835,526,1412,81,5114,48,1275,24,48
"43","2020-04-23",394,1,203,1147,8320,0.296995192307692,8340,40835,526,1412,80,5194,30,1305,25,30
"44","2020-04-24",385,1,193,1121,8320,0.296995192307692,8340,40835,526,1412,83,5277,21,1326,25,21
"45","2020-04-25",388,1,237,1073,8320,0.296995192307692,8340,40835,526,1412,60,5337,60,1386,19,60
"46","2020-04-26",355,1,238,1037,8320,0.296995192307692,8340,40835,526,1412,62,5399,43,1429,20,43
"47","2020-04-27",338,1,280,1004,8320,0.296995192307692,8340,40835,526,1412,61,5460,55,1484,12,55
"48","2020-04-28",338,1,305,971,8320,0.296995192307692,8340,40835,526,1412,57,5517,50,1534,20,50
"49","2020-04-29",322,1,291,952,8320,0.296995192307692,8340,40835,526,1412,66,5583,40,1574,18,40
"50","2020-04-30",309,1,282,929,8320,0.296995192307692,8340,40835,526,1412,65,5648,39,1613,28,39
"51","2020-05-01",321,1,289,908,8320,0.296995192307692,8340,40835,526,1412,58,5706,39,1652,18,39
"52","2020-05-02",329,1,305,880,8320,0.296995192307692,8340,40835,526,1412,65,5771,60,1712,13,60
"53","2020-05-03",282,1,313,861,8320,0.296995192307692,8340,40835,526,1412,64,5835,39,1751,8,39
"54","2020-05-04",279,1,311,836,8320,0.296995192307692,8340,40835,526,1412,55,5890,57,1808,18,57
"55","2020-05-05",267,1,315,805,8320,0.296995192307692,8340,40835,526,1412,50,5940,55,1863,10,55
"56","2020-05-06",273,1,299,772,8320,0.296995192307692,8340,40835,526,1412,50,5990,46,1909,12,46
"57","2020-05-07",268,1,287,754,8320,0.296995192307692,8340,40835,526,1412,47,6037,40,1949,17,40
"58","2020-05-08",263,1,295,726,8320,0.296995192307692,8340,40835,526,1412,43,6080,47,1996,10,47
"59","2020-05-09",241,1,288,717,8320,0.296995192307692,8340,40835,526,1412,51,6131,31,2027,14,31
"60","2020-05-10",252,1,277,698,8320,0.296995192307692,8340,40835,526,1412,55,6186,26,2053,12,26
"61","2020-05-11",240,1,257,673,8320,0.296995192307692,8340,40835,526,1412,31,6217,34,2087,12,34
"62","2020-05-12",231,1,276,654,8320,0.296995192307692,8340,40835,526,1412,39,6256,46,2133,12,46
"63","2020-05-13",220,1,251,604,8320,0.296995192307692,8340,40835,526,1412,24,6280,23,2156,6,23
"64","2020-05-14",220,1,233,577,8320,0.296995192307692,8340,40835,526,1412,41,6321,31,2187,10,31
"65","2020-05-15",201,1,232,548,8320,0.296995192307692,8340,40835,526,1412,35,6356,40,2227,5,40
"66","2020-05-16",201,1,229,524,8320,0.296995192307692,8340,40835,526,1412,34,6390,29,2256,8,29
"67","2020-05-17",161,1,212,499,8320,0.296995192307692,8340,40835,526,1412,32,6422,24,2280,12,24
"68","2020-05-18",158,1,232,474,8320,0.296995192307692,8340,40835,526,1412,23,6445,50,2330,5,50
"69","2020-05-19",150,1,224,454,8320,0.296995192307692,8340,40835,526,1412,26,6471,25,2355,9,25
"70","2020-05-20",147,1,222,432,8320,0.296995192307692,8340,40835,526,1412,27,6498,25,2380,3,25
"71","2020-05-21",140,1,239,414,8320,0.296995192307692,8340,40835,526,1412,25,6523,47,2427,6,47
"72","2020-05-22",131,1,265,378,8320,0.296995192307692,8340,40835,526,1412,22,6545,48,2475,4,48
"73","2020-05-23",149,1,259,361,8320,0.296995192307692,8340,40835,526,1412,19,6564,52,2527,5,52
"74","2020-05-24",135,1,255,340,8320,0.296995192307692,8340,40835,526,1412,18,6582,38,2565,4,38
"75","2020-05-25",129,1,234,313,8320,0.296995192307692,8340,40835,526,1412,17,6599,26,2591,5,26
"76","2020-05-26",126,1,222,305,8320,0.296995192307692,8340,40835,526,1412,22,6621,19,2610,4,19
"77","2020-05-27",119,1,196,306,8320,0.296995192307692,8340,40835,526,1412,26,6647,20,2630,2,20
"78","2020-05-28",111,1,200,282,8320,0.296995192307692,8340,40835,526,1412,20,6667,22,2652,2,22
"79","2020-05-29",118,1,225,274,8320,0.296995192307692,8340,40835,526,1412,13,6680,46,2698,3,46
"80","2020-05-30",99,1,255,253,8320,0.296995192307692,8340,40835,526,1412,13,6693,65,2763,1,65
"81","2020-05-31",95,1,270,254,8320,0.296995192307692,8340,40835,526,1412,21,6714,48,2811,5,48
"82","2020-06-01",93,1,269,249,8320,0.296995192307692,8340,40835,526,1412,20,6734,52,2863,6,52
"83","2020-06-02",95,1,269,254,8320,0.296995192307692,8340,40835,526,1412,24,6758,42,2905,5,42
"84","2020-06-03",88,1,257,239,8320,0.296995192307692,8340,40835,526,1412,12,6770,26,2931,1,26
"85","2020-06-04",83,1,235,234,8320,0.296995192307692,8340,40835,526,1412,17,6787,21,2952,4,21
"86","2020-06-05",71,1,236,217,8320,0.296995192307692,8340,40835,526,1412,5,6792,49,3001,3,49
"87","2020-06-06",76,1,238,205,8320,0.296995192307692,8340,40835,526,1412,11,6803,33,3034,5,33
"88","2020-06-07",70,1,237,196,8320,0.296995192307692,8340,40835,526,1412,13,6816,37,3071,4,37
"89","2020-03-13",1,2,47,146,7102,0.596029287524641,8265,36550,401,930,71,201,34,68,7,34
"90","2020-03-14",5,2,38,217,7102,0.596029287524641,8265,36550,401,930,67,268,23,91,14,23
"91","2020-03-15",19,2,35,279,7102,0.596029287524641,8265,36550,401,930,86,354,34,125,17,34
"92","2020-03-16",29,2,30,360,7102,0.596029287524641,8265,36550,401,930,94,448,41,166,36,41
"93","2020-03-17",42,2,45,464,7102,0.596029287524641,8265,36550,401,930,103,551,60,226,47,60
"94","2020-03-18",62,2,82,562,7102,0.596029287524641,8265,36550,401,930,120,671,53,279,49,53
"95","2020-03-19",89,2,106,672,7102,0.596029287524641,8265,36550,401,930,115,786,51,330,54,51
"96","2020-03-20",133,2,142,778,7102,0.596029287524641,8265,36550,401,930,118,904,52,382,57,52
"97","2020-03-21",175,2,156,890,7102,0.596029287524641,8265,36550,401,930,131,1035,32,414,70,32
"98","2020-03-22",256,2,174,978,7102,0.596029287524641,8265,36550,401,930,159,1194,31,445,82,31
"99","2020-03-23",265,2,199,1079,7102,0.596029287524641,8265,36550,401,930,124,1318,26,471,70,26
"100","2020-03-24",260,2,210,1172,7102,0.596029287524641,8265,36550,401,930,154,1472,35,506,87,35
"101","2020-03-25",278,2,231,1267,7102,0.596029287524641,8265,36550,401,930,141,1613,19,525,85,19
"102","2020-03-26",312,2,235,1326,7102,0.596029287524641,8265,36550,401,930,157,1770,18,543,92,18
"103","2020-03-27",438,2,214,1394,7102,0.596029287524641,8265,36550,401,930,139,1909,38,581,78,38
"104","2020-03-28",468,2,222,1445,7102,0.596029287524641,8265,36550,401,930,154,2063,32,613,100,32
"105","2020-03-29",445,2,229,1497,7102,0.596029287524641,8265,36550,401,930,157,2220,32,645,98,32
"106","2020-03-30",460,2,245,1541,7102,0.596029287524641,8265,36550,401,930,130,2350,15,660,71,15
"107","2020-03-31",458,2,238,1580,7102,0.596029287524641,8265,36550,401,930,157,2507,23,683,85,23
"108","2020-04-01",465,2,278,1615,7102,0.596029287524641,8265,36550,401,930,128,2635,47,730,65,47
"109","2020-04-02",462,2,264,1643,7102,0.596029287524641,8265,36550,401,930,142,2777,45,775,82,45
"110","2020-04-03",526,2,248,1674,7102,0.596029287524641,8265,36550,401,930,157,2934,31,806,92,31
"111","2020-04-04",573,2,220,1684,7102,0.596029287524641,8265,36550,401,930,160,3094,36,842,77,36
"112","2020-04-05",531,2,219,1687,7102,0.596029287524641,8265,36550,401,930,134,3228,25,867,74,25
"113","2020-04-06",512,2,204,1696,7102,0.596029287524641,8265,36550,401,930,133,3361,63,930,75,63
"114","2020-04-07",527,2,201,1698,7102,0.596029287524641,8265,36550,401,930,114,3475,55,985,62,55
"115","2020-04-08",538,2,229,1656,7102,0.596029287524641,8265,36550,401,930,113,3588,58,1043,62,58
"116","2020-04-09",543,2,218,1637,7102,0.596029287524641,8265,36550,401,930,114,3702,36,1079,58,36
"117","2020-04-10",581,2,201,1628,7102,0.596029287524641,8265,36550,401,930,125,3827,26,1105,67,26
"118","2020-04-11",588,2,223,1613,7102,0.596029287524641,8265,36550,401,930,117,3944,24,1129,48,24
"119","2020-04-12",537,2,238,1607,7102,0.596029287524641,8265,36550,401,930,111,4055,37,1166,54,37
"120","2020-04-13",522,2,239,1583,7102,0.596029287524641,8265,36550,401,930,100,4155,24,1190,54,24
"121","2020-04-14",519,2,238,1535,7102,0.596029287524641,8265,36550,401,930,102,4257,30,1220,55,30
"122","2020-04-15",512,2,224,1477,7102,0.596029287524641,8265,36550,401,930,113,4370,37,1257,59,37
"123","2020-04-16",511,2,205,1438,7102,0.596029287524641,8265,36550,401,930,94,4464,57,1314,54,57
"124","2020-04-17",542,2,191,1398,7102,0.596029287524641,8265,36550,401,930,92,4556,57,1371,49,57
"125","2020-04-18",502,2,167,1351,7102,0.596029287524641,8265,36550,401,930,80,4636,35,1406,41,35
"126","2020-04-19",461,2,181,1290,7102,0.596029287524641,8265,36550,401,930,92,4728,50,1456,44,50
"127","2020-04-20",457,2,183,1230,7102,0.596029287524641,8265,36550,401,930,68,4796,43,1499,27,43
"128","2020-04-21",440,2,215,1193,7102,0.596029287524641,8265,36550,401,930,72,4868,47,1546,27,47
"129","2020-04-22",431,2,240,1146,7102,0.596029287524641,8265,36550,401,930,59,4927,44,1590,30,44
"130","2020-04-23",407,2,236,1103,7102,0.596029287524641,8265,36550,401,930,75,5002,42,1632,28,42
"131","2020-04-24",387,2,255,1046,7102,0.596029287524641,8265,36550,401,930,55,5057,53,1685,21,53
"132","2020-04-25",377,2,249,1003,7102,0.596029287524641,8265,36550,401,930,84,5141,41,1726,33,41
"133","2020-04-26",346,2,267,957,7102,0.596029287524641,8265,36550,401,930,64,5205,38,1764,24,38
"134","2020-04-27",342,2,264,905,7102,0.596029287524641,8265,36550,401,930,62,5267,49,1813,23,49
"135","2020-04-28",318,2,251,841,7102,0.596029287524641,8265,36550,401,930,58,5325,32,1845,14,32
"136","2020-04-29",311,2,288,797,7102,0.596029287524641,8265,36550,401,930,60,5385,35,1880,18,35
"137","2020-04-30",297,2,298,737,7102,0.596029287524641,8265,36550,401,930,50,5435,29,1909,14,29
"138","2020-05-01",276,2,287,703,7102,0.596029287524641,8265,36550,401,930,63,5498,38,1947,16,38
"139","2020-05-02",270,2,237,676,7102,0.596029287524641,8265,36550,401,930,61,5559,23,1970,21,23
"140","2020-05-03",242,2,214,661,7102,0.596029287524641,8265,36550,401,930,62,5621,27,1997,14,27
"141","2020-05-04",216,2,253,612,7102,0.596029287524641,8265,36550,401,930,33,5654,35,2032,7,35
"142","2020-05-05",219,2,238,595,7102,0.596029287524641,8265,36550,401,930,50,5704,33,2065,10,33
"143","2020-05-06",202,2,240,575,7102,0.596029287524641,8265,36550,401,930,59,5763,26,2091,16,26
"144","2020-05-07",189,2,221,541,7102,0.596029287524641,8265,36550,401,930,41,5804,34,2125,14,34
"145","2020-05-08",162,2,214,514,7102,0.596029287524641,8265,36550,401,930,35,5839,25,2150,13,25
"146","2020-05-09",160,2,208,494,7102,0.596029287524641,8265,36550,401,930,37,5876,33,2183,9,33
"147","2020-05-10",177,2,210,474,7102,0.596029287524641,8265,36550,401,930,37,5913,20,2203,11,20
"148","2020-05-11",172,2,217,461,7102,0.596029287524641,8265,36550,401,930,38,5951,10,2213,4,10
"149","2020-05-12",141,2,215,443,7102,0.596029287524641,8265,36550,401,930,35,5986,32,2245,9,32
"150","2020-05-13",142,2,190,419,7102,0.596029287524641,8265,36550,401,930,31,6017,57,2302,7,57
"151","2020-05-14",143,2,170,399,7102,0.596029287524641,8265,36550,401,930,25,6042,50,2352,5,50
"152","2020-05-15",141,2,165,372,7102,0.596029287524641,8265,36550,401,930,30,6072,36,2388,4,36
"153","2020-05-16",141,2,162,376,7102,0.596029287524641,8265,36550,401,930,42,6114,23,2411,8,23
"154","2020-05-17",109,2,187,361,7102,0.596029287524641,8265,36550,401,930,30,6144,33,2444,8,33
"155","2020-05-18",113,2,218,352,7102,0.596029287524641,8265,36550,401,930,34,6178,28,2472,4,28
"156","2020-05-19",117,2,206,317,7102,0.596029287524641,8265,36550,401,930,27,6205,25,2497,5,25
"157","2020-05-20",109,2,218,312,7102,0.596029287524641,8265,36550,401,930,28,6233,21,2518,5,21
"158","2020-05-21",105,2,247,303,7102,0.596029287524641,8265,36550,401,930,27,6260,23,2541,8,23
"159","2020-05-22",109,2,239,281,7102,0.596029287524641,8265,36550,401,930,17,6277,37,2578,3,37
"160","2020-05-23",109,2,228,268,7102,0.596029287524641,8265,36550,401,930,19,6296,36,2614,6,36
"161","2020-05-24",101,2,219,257,7102,0.596029287524641,8265,36550,401,930,13,6309,30,2644,4,30
"162","2020-05-25",87,2,202,239,7102,0.596029287524641,8265,36550,401,930,19,6328,39,2683,5,39
"163","2020-05-26",85,2,177,226,7102,0.596029287524641,8265,36550,401,930,21,6349,24,2707,3,24
"164","2020-05-27",82,2,154,222,7102,0.596029287524641,8265,36550,401,930,15,6364,31,2738,6,31
"165","2020-05-28",80,2,150,218,7102,0.596029287524641,8265,36550,401,930,16,6380,43,2781,2,43
"166","2020-05-29",78,2,144,206,7102,0.596029287524641,8265,36550,401,930,16,6396,28,2809,5,28
"167","2020-05-30",66,2,170,202,7102,0.596029287524641,8265,36550,401,930,10,6406,26,2835,2,26
"168","2020-05-31",64,2,173,190,7102,0.596029287524641,8265,36550,401,930,19,6425,34,2869,5,34
"169","2020-06-01",67,2,148,198,7102,0.596029287524641,8265,36550,401,930,11,6436,46,2915,2,46
"170","2020-06-02",66,2,164,181,7102,0.596029287524641,8265,36550,401,930,11,6447,32,2947,3,32
"171","2020-06-03",69,2,190,175,7102,0.596029287524641,8265,36550,401,930,11,6458,30,2977,4,30
"172","2020-06-04",69,2,198,161,7102,0.596029287524641,8265,36550,401,930,13,6471,24,3001,4,24
"173","2020-06-05",62,2,227,155,7102,0.596029287524641,8265,36550,401,930,9,6480,29,3030,1,29
"174","2020-06-06",70,2,203,140,7102,0.596029287524641,8265,36550,401,930,9,6489,26,3056,2,26
"175","2020-06-07",64,2,203,132,7102,0.596029287524641,8265,36550,401,930,12,6501,41,3097,2,41
"176","2020-03-12",2,3,111,154,8380,0.431742243436754,8295,38653,525,2696,24,53,25,54,4,25
"177","2020-03-13",4,3,140,258,8380,0.431742243436754,8295,38653,525,2696,52,105,23,77,28,23
"178","2020-03-14",22,3,145,360,8380,0.431742243436754,8295,38653,525,2696,55,160,25,102,28,25
"179","2020-03-15",48,3,154,470,8380,0.431742243436754,8295,38653,525,2696,52,212,18,120,36,18
"180","2020-03-16",58,3,170,598,8380,0.431742243436754,8295,38653,525,2696,53,265,14,134,40,14
"181","2020-03-17",75,3,247,729,8380,0.431742243436754,8295,38653,525,2696,91,356,30,164,70,30
"182","2020-03-18",100,3,256,828,8380,0.431742243436754,8295,38653,525,2696,90,446,45,209,61,45
"183","2020-03-19",130,3,296,976,8380,0.431742243436754,8295,38653,525,2696,91,537,32,241,73,32
"184","2020-03-20",203,3,296,1077,8380,0.431742243436754,8295,38653,525,2696,127,664,47,288,109,47
"185","2020-03-21",288,3,288,1186,8380,0.431742243436754,8295,38653,525,2696,114,778,32,320,92,32
"186","2020-03-22",321,3,279,1354,8380,0.431742243436754,8295,38653,525,2696,130,908,23,343,101,23
"187","2020-03-23",327,3,294,1479,8380,0.431742243436754,8295,38653,525,2696,127,1035,31,374,107,31
"188","2020-03-24",344,3,260,1565,8380,0.431742243436754,8295,38653,525,2696,181,1216,51,425,160,51
"189","2020-03-25",377,3,252,1677,8380,0.431742243436754,8295,38653,525,2696,185,1401,51,476,166,51
"190","2020-03-26",405,3,255,1779,8380,0.431742243436754,8295,38653,525,2696,151,1552,41,517,129,41
"191","2020-03-27",574,3,236,1823,8380,0.431742243436754,8295,38653,525,2696,218,1770,34,551,194,34
"192","2020-03-28",557,3,226,1903,8380,0.431742243436754,8295,38653,525,2696,186,1956,32,583,169,32
"193","2020-03-29",563,3,241,1959,8380,0.431742243436754,8295,38653,525,2696,164,2120,28,611,145,28
"194","2020-03-30",590,3,258,1987,8380,0.431742243436754,8295,38653,525,2696,202,2322,38,649,181,38
"195","2020-03-31",598,3,243,2010,8380,0.431742243436754,8295,38653,525,2696,179,2501,39,688,160,39
"196","2020-04-01",610,3,238,2008,8380,0.431742243436754,8295,38653,525,2696,189,2690,61,749,167,61
"197","2020-04-02",627,3,245,2003,8380,0.431742243436754,8295,38653,525,2696,202,2892,55,804,191,55
"198","2020-04-03",682,3,252,1994,8380,0.431742243436754,8295,38653,525,2696,213,3105,61,865,192,61
"199","2020-04-04",703,3,265,2007,8380,0.431742243436754,8295,38653,525,2696,173,3278,64,929,150,64
"200","2020-04-05",655,3,277,1978,8380,0.431742243436754,8295,38653,525,2696,210,3488,43,972,190,43
"201","2020-04-06",649,3,259,1950,8380,0.431742243436754,8295,38653,525,2696,180,3668,38,1010,164,38
"202","2020-04-07",636,3,262,1922,8380,0.431742243436754,8295,38653,525,2696,209,3877,45,1055,189,45
"203","2020-04-08",641,3,276,1894,8380,0.431742243436754,8295,38653,525,2696,151,4028,35,1090,138,35
"204","2020-04-09",639,3,268,1819,8380,0.431742243436754,8295,38653,525,2696,152,4180,27,1117,132,27
"205","2020-04-10",640,3,293,1773,8380,0.431742243436754,8295,38653,525,2696,121,4301,24,1141,101,24
"206","2020-04-11",627,3,287,1741,8380,0.431742243436754,8295,38653,525,2696,137,4438,24,1165,118,24
"207","2020-04-12",569,3,295,1692,8380,0.431742243436754,8295,38653,525,2696,123,4561,17,1182,103,17
"208","2020-04-13",558,3,288,1621,8380,0.431742243436754,8295,38653,525,2696,117,4678,23,1205,100,23
"209","2020-04-14",543,3,294,1558,8380,0.431742243436754,8295,38653,525,2696,101,4779,20,1225,78,20
"210","2020-04-15",517,3,275,1487,8380,0.431742243436754,8295,38653,525,2696,127,4906,28,1253,113,28
"211","2020-04-16",488,3,286,1435,8380,0.431742243436754,8295,38653,525,2696,73,4979,28,1281,72,28
"212","2020-04-17",480,3,284,1390,8380,0.431742243436754,8295,38653,525,2696,87,5066,36,1317,73,36
"213","2020-04-18",468,3,273,1317,8380,0.431742243436754,8295,38653,525,2696,96,5162,39,1356,79,39
"214","2020-04-19",433,3,274,1296,8380,0.431742243436754,8295,38653,525,2696,82,5244,29,1385,71,29
"215","2020-04-20",409,3,287,1241,8380,0.431742243436754,8295,38653,525,2696,75,5319,35,1420,64,35
"216","2020-04-21",392,3,304,1187,8380,0.431742243436754,8295,38653,525,2696,76,5395,25,1445,60,25
"217","2020-04-22",396,3,327,1148,8380,0.431742243436754,8295,38653,525,2696,69,5464,26,1471,58,26
"218","2020-04-23",385,3,347,1086,8380,0.431742243436754,8295,38653,525,2696,68,5532,13,1484,50,13
"219","2020-04-24",345,3,323,1027,8380,0.431742243436754,8295,38653,525,2696,64,5596,20,1504,51,20
"220","2020-04-25",354,3,326,978,8380,0.431742243436754,8295,38653,525,2696,48,5644,22,1526,38,22
"221","2020-04-26",331,3,308,946,8380,0.431742243436754,8295,38653,525,2696,58,5702,30,1556,45,30
"222","2020-04-27",315,3,312,915,8380,0.431742243436754,8295,38653,525,2696,51,5753,38,1594,38,38
"223","2020-04-28",307,3,305,885,8380,0.431742243436754,8295,38653,525,2696,45,5798,53,1647,31,53
"224","2020-04-29",276,3,335,837,8380,0.431742243436754,8295,38653,525,2696,46,5844,46,1693,33,46
"225","2020-04-30",266,3,321,806,8380,0.431742243436754,8295,38653,525,2696,50,5894,31,1724,35,31
"226","2020-05-01",271,3,339,781,8380,0.431742243436754,8295,38653,525,2696,43,5937,28,1752,33,28
"227","2020-05-02",250,3,367,760,8380,0.431742243436754,8295,38653,525,2696,46,5983,26,1778,36,26
"228","2020-05-03",251,3,378,707,8380,0.431742243436754,8295,38653,525,2696,46,6029,38,1816,33,38
"229","2020-05-04",246,3,364,675,8380,0.431742243436754,8295,38653,525,2696,33,6062,33,1849,29,33
"230","2020-05-05",224,3,335,651,8380,0.431742243436754,8295,38653,525,2696,23,6085,31,1880,19,31
"231","2020-05-06",225,3,337,631,8380,0.431742243436754,8295,38653,525,2696,19,6104,28,1908,12,28
"232","2020-05-07",224,3,321,596,8380,0.431742243436754,8295,38653,525,2696,32,6136,31,1939,26,31
"233","2020-05-08",231,3,307,573,8380,0.431742243436754,8295,38653,525,2696,19,6155,23,1962,12,23
"234","2020-05-09",241,3,304,540,8380,0.431742243436754,8295,38653,525,2696,21,6176,29,1991,16,29
"235","2020-05-10",189,3,286,533,8380,0.431742243436754,8295,38653,525,2696,26,6202,20,2011,18,20
"236","2020-05-11",173,3,297,510,8380,0.431742243436754,8295,38653,525,2696,17,6219,35,2046,12,35
"237","2020-05-12",174,3,320,490,8380,0.431742243436754,8295,38653,525,2696,30,6249,30,2076,20,30
"238","2020-05-13",170,3,327,450,8380,0.431742243436754,8295,38653,525,2696,25,6274,52,2128,18,52
"239","2020-05-14",163,3,322,421,8380,0.431742243436754,8295,38653,525,2696,27,6301,35,2163,17,35
"240","2020-05-15",144,3,338,405,8380,0.431742243436754,8295,38653,525,2696,11,6312,35,2198,4,35
"241","2020-05-16",127,3,336,390,8380,0.431742243436754,8295,38653,525,2696,17,6329,29,2227,10,29
"242","2020-05-17",133,3,365,361,8380,0.431742243436754,8295,38653,525,2696,23,6352,19,2246,14,19
"243","2020-05-18",131,3,344,350,8380,0.431742243436754,8295,38653,525,2696,19,6371,25,2271,16,25
"244","2020-05-19",121,3,331,335,8380,0.431742243436754,8295,38653,525,2696,20,6391,20,2291,16,20
"245","2020-05-20",106,3,322,317,8380,0.431742243436754,8295,38653,525,2696,13,6404,17,2308,8,17
"246","2020-05-21",102,3,317,305,8380,0.431742243436754,8295,38653,525,2696,17,6421,22,2330,9,22
"247","2020-05-22",113,3,294,287,8380,0.431742243436754,8295,38653,525,2696,18,6439,18,2348,8,18
"248","2020-05-23",123,3,295,280,8380,0.431742243436754,8295,38653,525,2696,10,6449,40,2388,7,40
"249","2020-05-24",109,3,321,268,8380,0.431742243436754,8295,38653,525,2696,18,6467,35,2423,12,35
"250","2020-05-25",99,3,321,253,8380,0.431742243436754,8295,38653,525,2696,12,6479,29,2452,9,29
"251","2020-05-26",95,3,327,250,8380,0.431742243436754,8295,38653,525,2696,7,6486,25,2477,3,25
"252","2020-05-27",99,3,330,240,8380,0.431742243436754,8295,38653,525,2696,12,6498,23,2500,10,23
"253","2020-05-28",95,3,333,234,8380,0.431742243436754,8295,38653,525,2696,10,6508,16,2516,9,16
"254","2020-05-29",97,3,315,220,8380,0.431742243436754,8295,38653,525,2696,12,6520,19,2535,9,19
"255","2020-05-30",84,3,315,207,8380,0.431742243436754,8295,38653,525,2696,10,6530,15,2550,8,15
"256","2020-05-31",68,3,308,204,8380,0.431742243436754,8295,38653,525,2696,3,6533,21,2571,2,21
"257","2020-06-01",66,3,309,189,8380,0.431742243436754,8295,38653,525,2696,3,6536,13,2584,2,13
"258","2020-06-02",61,3,320,179,8380,0.431742243436754,8295,38653,525,2696,11,6547,40,2624,6,40
"259","2020-06-03",59,3,320,165,8380,0.431742243436754,8295,38653,525,2696,6,6553,27,2651,2,27
"260","2020-06-04",57,3,313,145,8380,0.431742243436754,8295,38653,525,2696,8,6561,28,2679,4,28
"261","2020-06-05",45,3,326,138,8380,0.431742243436754,8295,38653,525,2696,6,6567,22,2701,3,22
"262","2020-06-06",47,3,343,139,8380,0.431742243436754,8295,38653,525,2696,8,6575,21,2722,5,21
"263","2020-06-07",50,3,390,135,8380,0.431742243436754,8295,38653,525,2696,7,6582,39,2761,4,39
"264","2020-03-13",3,4,110,114,6618,0.622695678452705,8235,35786,356,1154,125,307,100,263,32,101
"265","2020-03-14",21,4,158,161,6618,0.622695678452705,8235,35786,356,1154,148,455,44,307,59,44
"266","2020-03-15",27,4,196,215,6618,0.622695678452705,8235,35786,356,1154,126,581,70,377,63,70
"267","2020-03-16",31,4,185,274,6618,0.622695678452705,8235,35786,356,1154,132,713,33,410,73,33
"268","2020-03-17",36,4,196,344,6618,0.622695678452705,8235,35786,356,1154,157,870,32,442,88,32
"269","2020-03-18",49,4,212,435,6618,0.622695678452705,8235,35786,356,1154,158,1028,52,494,91,52
"270","2020-03-19",73,4,219,529,6618,0.622695678452705,8235,35786,356,1154,156,1184,40,534,86,40
"271","2020-03-20",105,4,214,617,6618,0.622695678452705,8235,35786,356,1154,156,1340,14,548,84,14
"272","2020-03-21",127,4,214,704,6618,0.622695678452705,8235,35786,356,1154,163,1503,22,570,99,22
"273","2020-03-22",180,4,220,777,6618,0.622695678452705,8235,35786,356,1154,174,1677,19,589,98,19
"274","2020-03-23",196,4,218,843,6618,0.622695678452705,8235,35786,356,1154,170,1847,21,610,93,21
"275","2020-03-24",205,4,245,932,6618,0.622695678452705,8235,35786,356,1154,140,1987,13,623,82,13
"276","2020-03-25",231,4,280,1006,6618,0.622695678452705,8235,35786,356,1154,169,2156,11,634,81,11
"277","2020-03-26",247,4,265,1082,6618,0.622695678452705,8235,35786,356,1154,151,2307,24,658,82,24
"278","2020-03-27",310,4,221,1154,6618,0.622695678452705,8235,35786,356,1154,165,2472,20,678,98,20
"279","2020-03-28",374,4,191,1216,6618,0.622695678452705,8235,35786,356,1154,164,2636,55,733,96,55
"280","2020-03-29",349,4,163,1286,6618,0.622695678452705,8235,35786,356,1154,124,2760,48,781,70,48
"281","2020-03-30",340,4,202,1344,6618,0.622695678452705,8235,35786,356,1154,158,2918,46,827,95,46
"282","2020-03-31",376,4,218,1404,6618,0.622695678452705,8235,35786,356,1154,136,3054,92,919,80,92
"283","2020-04-01",386,4,256,1440,6618,0.622695678452705,8235,35786,356,1154,147,3201,75,994,81,75
"284","2020-04-02",414,4,264,1456,6618,0.622695678452705,8235,35786,356,1154,156,3357,39,1033,95,39
"285","2020-04-03",493,4,230,1481,6618,0.622695678452705,8235,35786,356,1154,152,3509,25,1058,86,25
"286","2020-04-04",496,4,203,1486,6618,0.622695678452705,8235,35786,356,1154,151,3660,16,1074,97,16
"287","2020-04-05",479,4,173,1496,6618,0.622695678452705,8235,35786,356,1154,130,3790,18,1092,68,18
"288","2020-04-06",494,4,194,1496,6618,0.622695678452705,8235,35786,356,1154,135,3925,16,1108,80,16
"289","2020-04-07",479,4,201,1487,6618,0.622695678452705,8235,35786,356,1154,134,4059,13,1121,68,13
"290","2020-04-08",496,4,192,1474,6618,0.622695678452705,8235,35786,356,1154,119,4178,18,1139,48,18
"291","2020-04-09",484,4,209,1461,6618,0.622695678452705,8235,35786,356,1154,125,4303,31,1170,63,31
"292","2020-04-10",516,4,200,1457,6618,0.622695678452705,8235,35786,356,1154,114,4417,59,1229,56,59
"293","2020-04-11",521,4,175,1421,6618,0.622695678452705,8235,35786,356,1154,108,4525,28,1257,63,28
"294","2020-04-12",485,4,167,1415,6618,0.622695678452705,8235,35786,356,1154,99,4624,24,1281,39,24
"295","2020-04-13",464,4,173,1377,6618,0.622695678452705,8235,35786,356,1154,97,4721,36,1317,40,36
"296","2020-04-14",467,4,209,1359,6618,0.622695678452705,8235,35786,356,1154,94,4815,37,1354,50,37
"297","2020-04-15",444,4,215,1359,6618,0.622695678452705,8235,35786,356,1154,103,4918,28,1382,56,28
"298","2020-04-16",429,4,247,1332,6618,0.622695678452705,8235,35786,356,1154,100,5018,17,1399,38,17
"299","2020-04-17",463,4,242,1344,6618,0.622695678452705,8235,35786,356,1154,89,5107,21,1420,44,21
"300","2020-04-18",439,4,253,1300,6618,0.622695678452705,8235,35786,356,1154,76,5183,4,1424,38,4
"301","2020-04-19",425,4,263,1253,6618,0.622695678452705,8235,35786,356,1154,67,5250,11,1435,33,11
"302","2020-04-20",425,4,261,1221,6618,0.622695678452705,8235,35786,356,1154,90,5340,45,1480,35,45
"303","2020-04-21",404,4,282,1168,6618,0.622695678452705,8235,35786,356,1154,67,5407,39,1519,32,39
"304","2020-04-22",410,4,280,1138,6618,0.622695678452705,8235,35786,356,1154,68,5475,25,1544,29,25
"305","2020-04-23",407,4,312,1079,6618,0.622695678452705,8235,35786,356,1154,77,5552,23,1567,36,23
"306","2020-04-24",392,4,347,1033,6618,0.622695678452705,8235,35786,356,1154,72,5624,27,1594,29,27
"307","2020-04-25",377,4,322,990,6618,0.622695678452705,8235,35786,356,1154,58,5682,11,1605,27,11
"308","2020-04-26",343,4,286,942,6618,0.622695678452705,8235,35786,356,1154,77,5759,18,1623,28,18
"309","2020-04-27",334,4,282,904,6618,0.622695678452705,8235,35786,356,1154,63,5822,31,1654,26,31
"310","2020-04-28",326,4,271,864,6618,0.622695678452705,8235,35786,356,1154,63,5885,16,1670,30,16
"311","2020-04-29",314,4,256,826,6618,0.622695678452705,8235,35786,356,1154,63,5948,13,1683,25,13
"312","2020-04-30",312,4,249,783,6618,0.622695678452705,8235,35786,356,1154,57,6005,23,1706,18,23
"313","2020-05-01",278,4,254,767,6618,0.622695678452705,8235,35786,356,1154,52,6057,70,1776,19,70
"314","2020-05-02",280,4,285,724,6618,0.622695678452705,8235,35786,356,1154,50,6107,44,1820,18,44
"315","2020-05-03",258,4,285,710,6618,0.622695678452705,8235,35786,356,1154,57,6164,47,1867,15,47
"316","2020-05-04",250,4,252,688,6618,0.622695678452705,8235,35786,356,1154,53,6217,26,1893,17,26
"317","2020-05-05",245,4,226,655,6618,0.622695678452705,8235,35786,356,1154,51,6268,13,1906,22,13
"318","2020-05-06",232,4,192,646,6618,0.622695678452705,8235,35786,356,1154,42,6310,25,1931,9,25
"319","2020-05-07",217,4,174,625,6618,0.622695678452705,8235,35786,356,1154,36,6346,39,1970,12,39
"320","2020-05-08",211,4,194,592,6618,0.622695678452705,8235,35786,356,1154,45,6391,43,2013,16,43
"321","2020-05-09",210,4,219,572,6618,0.622695678452705,8235,35786,356,1154,32,6423,26,2039,8,26
"322","2020-05-10",191,4,252,544,6618,0.622695678452705,8235,35786,356,1154,31,6454,16,2055,14,16
"323","2020-05-11",177,4,245,520,6618,0.622695678452705,8235,35786,356,1154,41,6495,18,2073,14,18
"324","2020-05-12",161,4,238,520,6618,0.622695678452705,8235,35786,356,1154,24,6519,5,2078,5,5
"325","2020-05-13",156,4,254,491,6618,0.622695678452705,8235,35786,356,1154,27,6546,11,2089,10,11
"326","2020-05-14",158,4,251,463,6618,0.622695678452705,8235,35786,356,1154,36,6582,11,2100,11,11
"327","2020-05-15",154,4,237,441,6618,0.622695678452705,8235,35786,356,1154,27,6609,15,2115,4,15
"328","2020-05-16",144,4,253,420,6618,0.622695678452705,8235,35786,356,1154,30,6639,8,2123,11,8
"329","2020-05-17",144,4,239,412,6618,0.622695678452705,8235,35786,356,1154,16,6655,8,2131,5,8
"330","2020-05-18",146,4,212,397,6618,0.622695678452705,8235,35786,356,1154,29,6684,6,2137,7,6
"331","2020-05-19",147,4,178,379,6618,0.622695678452705,8235,35786,356,1154,15,6699,19,2156,6,19
"332","2020-05-20",139,4,198,349,6618,0.622695678452705,8235,35786,356,1154,29,6728,76,2232,10,76
"333","2020-05-21",128,4,197,323,6618,0.622695678452705,8235,35786,356,1154,32,6760,26,2258,11,26
"334","2020-05-22",118,4,201,308,6618,0.622695678452705,8235,35786,356,1154,22,6782,24,2282,4,24
"335","2020-05-23",112,4,199,305,6618,0.622695678452705,8235,35786,356,1154,26,6808,47,2329,12,47
"336","2020-05-24",119,4,261,289,6618,0.622695678452705,8235,35786,356,1154,16,6824,53,2382,3,53
"337","2020-05-25",104,4,281,272,6618,0.622695678452705,8235,35786,356,1154,15,6839,29,2411,4,29
"338","2020-05-26",91,4,265,260,6618,0.622695678452705,8235,35786,356,1154,17,6856,14,2425,7,14
"339","2020-05-27",93,4,251,254,6618,0.622695678452705,8235,35786,356,1154,17,6873,46,2471,3,46
"340","2020-05-28",88,4,232,249,6618,0.622695678452705,8235,35786,356,1154,16,6889,41,2512,4,41
"341","2020-05-29",90,4,217,242,6618,0.622695678452705,8235,35786,356,1154,20,6909,55,2567,6,55
"342","2020-05-30",90,4,214,231,6618,0.622695678452705,8235,35786,356,1154,19,6928,69,2636,5,69
"343","2020-05-31",82,4,248,224,6618,0.622695678452705,8235,35786,356,1154,15,6943,42,2678,4,42
"344","2020-06-01",87,4,232,206,6618,0.622695678452705,8235,35786,356,1154,16,6959,27,2705,5,27
"345","2020-06-02",85,4,232,205,6618,0.622695678452705,8235,35786,356,1154,12,6971,39,2744,3,39
"346","2020-06-03",78,4,260,194,6618,0.622695678452705,8235,35786,356,1154,12,6983,30,2774,6,30
"347","2020-06-04",78,4,287,183,6618,0.622695678452705,8235,35786,356,1154,12,6995,17,2791,5,17
"348","2020-06-05",79,4,298,170,6618,0.622695678452705,8235,35786,356,1154,17,7012,13,2804,6,13
"349","2020-06-06",74,4,296,168,6618,0.622695678452705,8235,35786,356,1154,10,7022,23,2827,3,23
"350","2020-06-07",68,4,269,165,6618,0.622695678452705,8235,35786,356,1154,10,7032,30,2857,4,30
"351","2020-03-07",2,5,0,0,7248,0.537389624724062,8355,37537,387,747,NA,NA,NA,NA,NA,NA
"352","2020-03-08",2,5,0,0,7248,0.537389624724062,8355,37537,387,747,NA,NA,NA,NA,NA,NA
"353","2020-03-09",0,5,0,0,7248,0.537389624724062,8355,37537,387,747,NA,NA,NA,NA,NA,NA
"354","2020-03-10",0,5,0,0,7248,0.537389624724062,8355,37537,387,747,NA,NA,1,1,NA,1
"355","2020-03-11",0,5,0,0,7248,0.537389624724062,8355,37537,387,747,18,18,10,11,NA,10
"356","2020-03-12",0,5,0,0,7248,0.537389624724062,8355,37537,387,747,25,43,16,27,3,16
"357","2020-03-13",6,5,65,149,7248,0.537389624724062,8355,37537,387,747,23,66,31,58,3,31
"358","2020-03-14",16,5,61,210,7248,0.537389624724062,8355,37537,387,747,34,100,34,92,6,34
"359","2020-03-15",22,5,72,287,7248,0.537389624724062,8355,37537,387,747,40,140,39,131,14,39
"360","2020-03-16",30,5,73,385,7248,0.537389624724062,8355,37537,387,747,47,187,27,158,18,27
"361","2020-03-17",39,5,80,453,7248,0.537389624724062,8355,37537,387,747,60,247,24,182,39,24
"362","2020-03-18",52,5,81,569,7248,0.537389624724062,8355,37537,387,747,73,320,23,205,49,23
"363","2020-03-19",66,5,75,644,7248,0.537389624724062,8355,37537,387,747,91,411,57,262,67,57
"364","2020-03-20",118,5,90,748,7248,0.537389624724062,8355,37537,387,747,88,499,32,294,63,32
"365","2020-03-21",159,5,103,833,7248,0.537389624724062,8355,37537,387,747,89,588,45,339,60,45
"366","2020-03-22",221,5,134,917,7248,0.537389624724062,8355,37537,387,747,102,690,26,365,75,26
"367","2020-03-23",230,5,139,1039,7248,0.537389624724062,8355,37537,387,747,126,816,35,400,107,35
"368","2020-03-24",245,5,140,1115,7248,0.537389624724062,8355,37537,387,747,113,929,41,441,88,41
"369","2020-03-25",263,5,150,1203,7248,0.537389624724062,8355,37537,387,747,155,1084,50,491,127,50
"370","2020-03-26",288,5,174,1272,7248,0.537389624724062,8355,37537,387,747,160,1244,37,528,134,37
"371","2020-03-27",406,5,198,1323,7248,0.537389624724062,8355,37537,387,747,160,1404,38,566,138,38
"372","2020-03-28",461,5,227,1393,7248,0.537389624724062,8355,37537,387,747,169,1573,26,592,144,26
"373","2020-03-29",432,5,240,1477,7248,0.537389624724062,8355,37537,387,747,174,1747,22,614,152,22
"374","2020-03-30",454,5,236,1572,7248,0.537389624724062,8355,37537,387,747,176,1923,21,635,158,21
"375","2020-03-31",468,5,223,1607,7248,0.537389624724062,8355,37537,387,747,245,2168,17,652,219,17
"376","2020-04-01",492,5,227,1641,7248,0.537389624724062,8355,37537,387,747,167,2335,50,702,147,50
"377","2020-04-02",514,5,222,1703,7248,0.537389624724062,8355,37537,387,747,225,2560,50,752,198,50
"378","2020-04-03",583,5,221,1754,7248,0.537389624724062,8355,37537,387,747,177,2737,44,796,159,44
"379","2020-04-04",565,5,196,1757,7248,0.537389624724062,8355,37537,387,747,255,2992,29,825,238,29
"380","2020-04-05",544,5,181,1738,7248,0.537389624724062,8355,37537,387,747,196,3188,38,863,172,38
"381","2020-04-06",536,5,177,1742,7248,0.537389624724062,8355,37537,387,747,181,3369,26,889,167,26
"382","2020-04-07",522,5,168,1759,7248,0.537389624724062,8355,37537,387,747,212,3581,22,911,185,22
"383","2020-04-08",533,5,169,1729,7248,0.537389624724062,8355,37537,387,747,238,3819,19,930,217,19
"384","2020-04-09",534,5,191,1722,7248,0.537389624724062,8355,37537,387,747,208,4027,24,954,192,24
"385","2020-04-10",577,5,219,1703,7248,0.537389624724062,8355,37537,387,747,187,4214,17,971,167,17
"386","2020-04-11",581,5,205,1679,7248,0.537389624724062,8355,37537,387,747,128,4342,64,1035,110,64
"387","2020-04-12",540,5,205,1627,7248,0.537389624724062,8355,37537,387,747,182,4524,39,1074,168,39
"388","2020-04-13",535,5,244,1598,7248,0.537389624724062,8355,37537,387,747,170,4694,34,1108,158,34
"389","2020-04-14",545,5,233,1558,7248,0.537389624724062,8355,37537,387,747,148,4842,44,1152,133,44
"390","2020-04-15",542,5,226,1498,7248,0.537389624724062,8355,37537,387,747,161,5003,53,1205,141,53
"391","2020-04-16",544,5,202,1474,7248,0.537389624724062,8355,37537,387,747,119,5122,37,1242,105,37
"392","2020-04-17",541,5,185,1403,7248,0.537389624724062,8355,37537,387,747,107,5229,20,1262,98,20
"393","2020-04-18",534,5,207,1329,7248,0.537389624724062,8355,37537,387,747,123,5352,28,1290,105,28
"394","2020-04-19",513,5,203,1282,7248,0.537389624724062,8355,37537,387,747,94,5446,20,1310,79,20
"395","2020-04-20",486,5,190,1194,7248,0.537389624724062,8355,37537,387,747,87,5533,13,1323,69,13
"396","2020-04-21",449,5,231,1141,7248,0.537389624724062,8355,37537,387,747,73,5606,20,1343,62,20
"397","2020-04-22",434,5,221,1068,7248,0.537389624724062,8355,37537,387,747,67,5673,13,1356,61,13
"398","2020-04-23",397,5,214,1014,7248,0.537389624724062,8355,37537,387,747,79,5752,33,1389,64,33
"399","2020-04-24",382,5,197,980,7248,0.537389624724062,8355,37537,387,747,39,5791,32,1421,32,32
"400","2020-04-25",374,5,191,952,7248,0.537389624724062,8355,37537,387,747,59,5850,27,1448,49,27
"401","2020-04-26",326,5,188,917,7248,0.537389624724062,8355,37537,387,747,60,5910,27,1475,46,27
"402","2020-04-27",324,5,217,901,7248,0.537389624724062,8355,37537,387,747,47,5957,22,1497,32,22
"403","2020-04-28",314,5,228,846,7248,0.537389624724062,8355,37537,387,747,38,5995,22,1519,23,22
"404","2020-04-29",285,5,222,808,7248,0.537389624724062,8355,37537,387,747,42,6037,32,1551,27,32
"405","2020-04-30",283,5,210,797,7248,0.537389624724062,8355,37537,387,747,50,6087,34,1585,34,34
"406","2020-05-01",288,5,208,749,7248,0.537389624724062,8355,37537,387,747,22,6109,21,1606,15,21
"407","2020-05-02",284,5,225,709,7248,0.537389624724062,8355,37537,387,747,25,6134,37,1643,18,37
"408","2020-05-03",245,5,261,675,7248,0.537389624724062,8355,37537,387,747,37,6171,28,1671,21,28
"409","2020-05-04",237,5,282,650,7248,0.537389624724062,8355,37537,387,747,21,6192,29,1700,14,29
"410","2020-05-05",228,5,247,620,7248,0.537389624724062,8355,37537,387,747,20,6212,26,1726,10,26
"411","2020-05-06",230,5,242,580,7248,0.537389624724062,8355,37537,387,747,28,6240,57,1783,15,57
"412","2020-05-07",223,5,227,561,7248,0.537389624724062,8355,37537,387,747,19,6259,33,1816,11,33
"413","2020-05-08",206,5,256,523,7248,0.537389624724062,8355,37537,387,747,16,6275,41,1857,13,41
"414","2020-05-09",193,5,258,508,7248,0.537389624724062,8355,37537,387,747,15,6290,25,1882,10,25
"415","2020-05-10",192,5,250,497,7248,0.537389624724062,8355,37537,387,747,9,6299,31,1913,7,31
"416","2020-05-11",185,5,247,489,7248,0.537389624724062,8355,37537,387,747,25,6324,34,1947,12,34
"417","2020-05-12",170,5,270,476,7248,0.537389624724062,8355,37537,387,747,10,6334,45,1992,3,45
"418","2020-05-13",167,5,277,445,7248,0.537389624724062,8355,37537,387,747,11,6345,34,2026,1,34
"419","2020-05-14",166,5,249,414,7248,0.537389624724062,8355,37537,387,747,14,6359,24,2050,8,24
"420","2020-05-15",153,5,251,395,7248,0.537389624724062,8355,37537,387,747,5,6364,27,2077,3,27
"421","2020-05-16",160,5,222,380,7248,0.537389624724062,8355,37537,387,747,10,6374,18,2095,1,18
"422","2020-05-17",131,5,219,365,7248,0.537389624724062,8355,37537,387,747,12,6386,16,2111,7,16
"423","2020-05-18",122,5,218,354,7248,0.537389624724062,8355,37537,387,747,14,6400,37,2148,4,37
"424","2020-05-19",127,5,215,349,7248,0.537389624724062,8355,37537,387,747,8,6408,29,2177,4,29
"425","2020-05-20",114,5,193,337,7248,0.537389624724062,8355,37537,387,747,8,6416,34,2211,2,34
"426","2020-05-21",107,5,180,319,7248,0.537389624724062,8355,37537,387,747,8,6424,29,2240,3,29
"427","2020-05-22",99,5,178,312,7248,0.537389624724062,8355,37537,387,747,13,6437,16,2256,7,16
"428","2020-05-23",89,5,164,300,7248,0.537389624724062,8355,37537,387,747,10,6447,20,2276,6,20
"429","2020-05-24",109,5,188,280,7248,0.537389624724062,8355,37537,387,747,9,6456,28,2304,6,28
"430","2020-05-25",102,5,179,266,7248,0.537389624724062,8355,37537,387,747,12,6468,23,2327,8,23
"431","2020-05-26",96,5,158,262,7248,0.537389624724062,8355,37537,387,747,11,6479,37,2364,4,37
"432","2020-05-27",100,5,155,254,7248,0.537389624724062,8355,37537,387,747,12,6491,36,2400,5,36
"433","2020-05-28",101,5,163,241,7248,0.537389624724062,8355,37537,387,747,7,6498,26,2426,6,26
"434","2020-05-29",100,5,185,225,7248,0.537389624724062,8355,37537,387,747,7,6505,23,2449,2,23
"435","2020-05-30",99,5,216,223,7248,0.537389624724062,8355,37537,387,747,8,6513,25,2474,5,25
"436","2020-05-31",86,5,227,217,7248,0.537389624724062,8355,37537,387,747,5,6518,28,2502,2,28
"437","2020-06-01",80,5,224,203,7248,0.537389624724062,8355,37537,387,747,9,6527,53,2555,4,53
"438","2020-06-02",75,5,235,195,7248,0.537389624724062,8355,37537,387,747,6,6533,42,2597,3,42
"439","2020-06-03",74,5,211,184,7248,0.537389624724062,8355,37537,387,747,5,6538,23,2620,3,23
"440","2020-06-04",67,5,198,184,7248,0.537389624724062,8355,37537,387,747,5,6543,22,2642,1,22
"441","2020-06-05",64,5,200,180,7248,0.537389624724062,8355,37537,387,747,5,6548,16,2658,2,16
"442","2020-06-06",59,5,188,172,7248,0.537389624724062,8355,37537,387,747,4,6552,45,2703,1,45
"443","2020-06-07",53,5,194,166,7248,0.537389624724062,8355,37537,387,747,7,6559,32,2735,2,32
"444","2020-03-13",4,6,235,158,6958,0.627622880137971,8265,37527,420,2058,63,160,32,130,13,32
"445","2020-03-14",24,6,280,243,6958,0.627622880137971,8265,37527,420,2058,58,218,27,157,14,27
"446","2020-03-15",32,6,324,325,6958,0.627622880137971,8265,37527,420,2058,75,293,8,165,21,8
"447","2020-03-16",29,6,292,408,6958,0.627622880137971,8265,37527,420,2058,96,389,15,180,46,15
"448","2020-03-17",39,6,297,508,6958,0.627622880137971,8265,37527,420,2058,81,470,7,187,44,7
"449","2020-03-18",61,6,303,629,6958,0.627622880137971,8265,37527,420,2058,92,562,8,195,50,8
"450","2020-03-19",87,6,285,717,6958,0.627622880137971,8265,37527,420,2058,88,650,10,205,47,10
"451","2020-03-20",147,6,278,798,6958,0.627622880137971,8265,37527,420,2058,137,787,16,221,84,16
"452","2020-03-21",221,6,234,870,6958,0.627622880137971,8265,37527,420,2058,122,909,77,298,69,77
"453","2020-03-22",245,6,215,968,6958,0.627622880137971,8265,37527,420,2058,119,1028,30,328,80,30
"454","2020-03-23",256,6,208,1044,6958,0.627622880137971,8265,37527,420,2058,141,1169,53,381,92,53
"455","2020-03-24",272,6,188,1141,6958,0.627622880137971,8265,37527,420,2058,155,1324,32,413,106,32
"456","2020-03-25",286,6,163,1204,6958,0.627622880137971,8265,37527,420,2058,131,1455,32,445,95,32
"457","2020-03-26",299,6,143,1248,6958,0.627622880137971,8265,37527,420,2058,159,1614,49,494,106,49
"458","2020-03-27",398,6,126,1323,6958,0.627622880137971,8265,37527,420,2058,195,1809,64,558,150,64
"459","2020-03-28",393,6,133,1348,6958,0.627622880137971,8265,37527,420,2058,183,1992,61,619,129,61
"460","2020-03-29",408,6,144,1383,6958,0.627622880137971,8265,37527,420,2058,180,2172,59,678,142,59
"461","2020-03-30",422,6,197,1406,6958,0.627622880137971,8265,37527,420,2058,205,2377,36,714,159,36
"462","2020-03-31",422,6,196,1408,6958,0.627622880137971,8265,37527,420,2058,192,2569,34,748,134,34
"463","2020-04-01",440,6,177,1436,6958,0.627622880137971,8265,37527,420,2058,176,2745,30,778,140,30
"464","2020-04-02",452,6,184,1465,6958,0.627622880137971,8265,37527,420,2058,185,2930,27,805,143,27
"465","2020-04-03",510,6,224,1503,6958,0.627622880137971,8265,37527,420,2058,155,3085,34,839,118,34
"466","2020-04-04",500,6,224,1517,6958,0.627622880137971,8265,37527,420,2058,154,3239,26,865,119,26
"467","2020-04-05",460,6,222,1510,6958,0.627622880137971,8265,37527,420,2058,165,3404,23,888,116,23
"468","2020-04-06",461,6,220,1496,6958,0.627622880137971,8265,37527,420,2058,147,3551,20,908,109,20
"469","2020-04-07",468,6,196,1465,6958,0.627622880137971,8265,37527,420,2058,141,3692,59,967,105,59
"470","2020-04-08",477,6,225,1458,6958,0.627622880137971,8265,37527,420,2058,114,3806,56,1023,92,56
"471","2020-04-09",480,6,212,1442,6958,0.627622880137971,8265,37527,420,2058,133,3939,30,1053,88,30
"472","2020-04-10",518,6,219,1406,6958,0.627622880137971,8265,37527,420,2058,144,4083,23,1076,108,23
"473","2020-04-11",523,6,205,1377,6958,0.627622880137971,8265,37527,420,2058,119,4202,22,1098,92,22
"474","2020-04-12",468,6,199,1326,6958,0.627622880137971,8265,37527,420,2058,124,4326,32,1130,80,32
"475","2020-04-13",462,6,202,1317,6958,0.627622880137971,8265,37527,420,2058,99,4425,58,1188,66,58
"476","2020-04-14",453,6,258,1292,6958,0.627622880137971,8265,37527,420,2058,106,4531,52,1240,67,52
"477","2020-04-15",435,6,262,1262,6958,0.627622880137971,8265,37527,420,2058,117,4648,36,1276,76,36
"478","2020-04-16",424,6,233,1243,6958,0.627622880137971,8265,37527,420,2058,83,4731,20,1296,46,20
"479","2020-04-17",412,6,242,1201,6958,0.627622880137971,8265,37527,420,2058,110,4841,20,1316,75,20
"480","2020-04-18",393,6,229,1168,6958,0.627622880137971,8265,37527,420,2058,65,4906,33,1349,30,33
"481","2020-04-19",393,6,221,1129,6958,0.627622880137971,8265,37527,420,2058,69,4975,18,1367,42,18
"482","2020-04-20",388,6,208,1115,6958,0.627622880137971,8265,37527,420,2058,82,5057,14,1381,52,14
"483","2020-04-21",370,6,198,1076,6958,0.627622880137971,8265,37527,420,2058,94,5151,11,1392,59,11
"484","2020-04-22",360,6,201,1060,6958,0.627622880137971,8265,37527,420,2058,71,5222,20,1412,41,20
"485","2020-04-23",357,6,193,1018,6958,0.627622880137971,8265,37527,420,2058,82,5304,24,1436,46,24
"486","2020-04-24",366,6,184,986,6958,0.627622880137971,8265,37527,420,2058,50,5354,61,1497,23,61
"487","2020-04-25",399,6,225,961,6958,0.627622880137971,8265,37527,420,2058,77,5431,46,1543,45,46
"488","2020-04-26",362,6,205,924,6958,0.627622880137971,8265,37527,420,2058,55,5486,20,1563,31,20
"489","2020-04-27",348,6,222,884,6958,0.627622880137971,8265,37527,420,2058,55,5541,21,1584,29,21
"490","2020-04-28",337,6,180,853,6958,0.627622880137971,8265,37527,420,2058,53,5594,26,1610,25,26
"491","2020-04-29",330,6,194,835,6958,0.627622880137971,8265,37527,420,2058,51,5645,24,1634,29,24
"492","2020-04-30",327,6,197,813,6958,0.627622880137971,8265,37527,420,2058,42,5687,55,1689,17,55
"493","2020-05-01",312,6,174,789,6958,0.627622880137971,8265,37527,420,2058,42,5729,47,1736,22,47
"494","2020-05-02",286,6,182,750,6958,0.627622880137971,8265,37527,420,2058,36,5765,50,1786,17,50
"495","2020-05-03",266,6,251,726,6958,0.627622880137971,8265,37527,420,2058,43,5808,31,1817,21,31
"496","2020-05-04",257,6,270,718,6958,0.627622880137971,8265,37527,420,2058,48,5856,18,1835,30,18
"497","2020-05-05",253,6,286,698,6958,0.627622880137971,8265,37527,420,2058,33,5889,28,1863,13,28
"498","2020-05-06",246,6,278,681,6958,0.627622880137971,8265,37527,420,2058,40,5929,22,1885,14,22
"499","2020-05-07",231,6,271,660,6958,0.627622880137971,8265,37527,420,2058,27,5956,14,1899,13,14
"500","2020-05-08",223,6,270,639,6958,0.627622880137971,8265,37527,420,2058,39,5995,35,1934,17,35
"501","2020-05-09",224,6,241,621,6958,0.627622880137971,8265,37527,420,2058,23,6018,15,1949,4,15
"502","2020-05-10",198,6,216,600,6958,0.627622880137971,8265,37527,420,2058,28,6046,14,1963,16,14
"503","2020-05-11",192,6,214,560,6958,0.627622880137971,8265,37527,420,2058,24,6070,21,1984,9,21
"504","2020-05-12",188,6,249,553,6958,0.627622880137971,8265,37527,420,2058,30,6100,33,2017,8,33
"505","2020-05-13",182,6,259,530,6958,0.627622880137971,8265,37527,420,2058,26,6126,26,2043,6,26
"506","2020-05-14",182,6,236,517,6958,0.627622880137971,8265,37527,420,2058,25,6151,11,2054,14,11
"507","2020-05-15",178,6,202,476,6958,0.627622880137971,8265,37527,420,2058,23,6174,21,2075,9,21
"508","2020-05-16",181,6,177,458,6958,0.627622880137971,8265,37527,420,2058,14,6188,18,2093,4,18
"509","2020-05-17",161,6,205,446,6958,0.627622880137971,8265,37527,420,2058,19,6207,43,2136,4,43
"510","2020-05-18",149,6,203,439,6958,0.627622880137971,8265,37527,420,2058,18,6225,50,2186,6,50
"511","2020-05-19",142,6,205,421,6958,0.627622880137971,8265,37527,420,2058,20,6245,22,2208,4,22
"512","2020-05-20",137,6,170,386,6958,0.627622880137971,8265,37527,420,2058,27,6272,17,2225,6,17
"513","2020-05-21",126,6,173,374,6958,0.627622880137971,8265,37527,420,2058,10,6282,31,2256,2,31
"514","2020-05-22",122,6,217,353,6958,0.627622880137971,8265,37527,420,2058,13,6295,52,2308,5,52
"515","2020-05-23",107,6,274,321,6958,0.627622880137971,8265,37527,420,2058,16,6311,24,2332,7,24
"516","2020-05-24",110,6,306,307,6958,0.627622880137971,8265,37527,420,2058,14,6325,16,2348,5,16
"517","2020-05-25",107,6,282,296,6958,0.627622880137971,8265,37527,420,2058,15,6340,16,2364,5,16
"518","2020-05-26",95,6,230,286,6958,0.627622880137971,8265,37527,420,2058,14,6354,13,2377,3,13
"519","2020-05-27",93,6,196,271,6958,0.627622880137971,8265,37527,420,2058,20,6374,17,2394,6,17
"520","2020-05-28",87,6,187,250,6958,0.627622880137971,8265,37527,420,2058,8,6382,21,2415,3,21
"521","2020-05-29",96,6,171,247,6958,0.627622880137971,8265,37527,420,2058,13,6395,20,2435,7,20
"522","2020-05-30",98,6,186,245,6958,0.627622880137971,8265,37527,420,2058,8,6403,19,2454,3,19
"523","2020-05-31",94,6,195,238,6958,0.627622880137971,8265,37527,420,2058,14,6417,30,2484,5,30
"524","2020-06-01",89,6,185,227,6958,0.627622880137971,8265,37527,420,2058,11,6428,17,2501,1,17
"525","2020-06-02",85,6,194,213,6958,0.627622880137971,8265,37527,420,2058,8,6436,10,2511,1,10
"526","2020-06-03",87,6,181,210,6958,0.627622880137971,8265,37527,420,2058,12,6448,7,2518,5,7
"527","2020-06-04",86,6,202,216,6958,0.627622880137971,8265,37527,420,2058,7,6455,11,2529,3,11
"528","2020-06-05",85,6,201,209,6958,0.627622880137971,8265,37527,420,2058,12,6467,37,2566,4,37
"529","2020-06-06",78,6,247,207,6958,0.627622880137971,8265,37527,420,2058,7,6474,47,2613,NA,47
"530","2020-06-07",74,6,279,208,6958,0.627622880137971,8265,37527,420,2058,14,6488,21,2634,2,21
"531","2020-03-13",5,7,108,275,8112,0.297707100591716,8340,39505,452,881,42,112,30,152,11,30
"532","2020-03-14",26,7,117,356,8112,0.297707100591716,8340,39505,452,881,32,144,16,168,9,16
"533","2020-03-15",60,7,147,460,8112,0.297707100591716,8340,39505,452,881,60,204,9,177,39,9
"534","2020-03-16",68,7,143,591,8112,0.297707100591716,8340,39505,452,881,61,265,47,224,34,47
"535","2020-03-17",75,7,134,702,8112,0.297707100591716,8340,39505,452,881,87,352,24,248,62,24
"536","2020-03-18",98,7,122,794,8112,0.297707100591716,8340,39505,452,881,83,435,22,270,60,22
"537","2020-03-19",124,7,117,913,8112,0.297707100591716,8340,39505,452,881,84,519,8,278,65,8
"538","2020-03-20",214,7,129,1014,8112,0.297707100591716,8340,39505,452,881,101,620,8,286,78,8
"539","2020-03-21",286,7,129,1113,8112,0.297707100591716,8340,39505,452,881,129,749,8,294,98,8
"540","2020-03-22",292,7,166,1208,8112,0.297707100591716,8340,39505,452,881,134,883,6,300,113,6
"541","2020-03-23",306,7,182,1294,8112,0.297707100591716,8340,39505,452,881,132,1015,8,308,106,8
"542","2020-03-24",333,7,203,1340,8112,0.297707100591716,8340,39505,452,881,147,1162,12,320,120,12
"543","2020-03-25",370,7,214,1419,8112,0.297707100591716,8340,39505,452,881,148,1310,11,331,124,11
"544","2020-03-26",391,7,235,1469,8112,0.297707100591716,8340,39505,452,881,156,1466,8,339,132,8
"545","2020-03-27",489,7,233,1516,8112,0.297707100591716,8340,39505,452,881,172,1638,45,384,146,45
"546","2020-03-28",475,7,230,1548,8112,0.297707100591716,8340,39505,452,881,185,1823,19,403,164,19
"547","2020-03-29",496,7,222,1552,8112,0.297707100591716,8340,39505,452,881,175,1998,19,422,156,19
"548","2020-03-30",525,7,248,1594,8112,0.297707100591716,8340,39505,452,881,170,2168,26,448,150,26
"549","2020-03-31",517,7,264,1598,8112,0.297707100591716,8340,39505,452,881,196,2364,18,466,167,18
"550","2020-04-01",522,7,273,1612,8112,0.297707100591716,8340,39505,452,881,217,2581,5,471,189,5
"551","2020-04-02",531,7,262,1645,8112,0.297707100591716,8340,39505,452,881,180,2761,14,485,157,14
"552","2020-04-03",581,7,238,1637,8112,0.297707100591716,8340,39505,452,881,190,2951,12,497,162,12
"553","2020-04-04",584,7,198,1630,8112,0.297707100591716,8340,39505,452,881,195,3146,8,505,176,8
"554","2020-04-05",513,7,185,1631,8112,0.297707100591716,8340,39505,452,881,172,3318,4,509,156,4
"555","2020-04-06",503,7,205,1610,8112,0.297707100591716,8340,39505,452,881,162,3480,10,519,146,10
"556","2020-04-07",501,7,229,1612,8112,0.297707100591716,8340,39505,452,881,188,3668,5,524,172,5
"557","2020-04-08",482,7,216,1591,8112,0.297707100591716,8340,39505,452,881,168,3836,49,573,152,49
"558","2020-04-09",481,7,194,1558,8112,0.297707100591716,8340,39505,452,881,174,4010,45,618,149,45
"559","2020-04-10",515,7,194,1523,8112,0.297707100591716,8340,39505,452,881,135,4145,44,662,108,44
"560","2020-04-11",531,7,211,1492,8112,0.297707100591716,8340,39505,452,881,149,4294,36,698,134,36
"561","2020-04-12",480,7,209,1500,8112,0.297707100591716,8340,39505,452,881,105,4399,53,751,92,53
"562","2020-04-13",466,7,205,1452,8112,0.297707100591716,8340,39505,452,881,113,4512,48,799,93,48
"563","2020-04-14",464,7,232,1428,8112,0.297707100591716,8340,39505,452,881,116,4628,64,863,102,64
"564","2020-04-15",457,7,213,1397,8112,0.297707100591716,8340,39505,452,881,116,4744,48,911,93,48
"565","2020-04-16",453,7,210,1366,8112,0.297707100591716,8340,39505,452,881,116,4860,19,930,98,19
"566","2020-04-17",494,7,205,1332,8112,0.297707100591716,8340,39505,452,881,86,4946,15,945,67,15
"567","2020-04-18",462,7,234,1294,8112,0.297707100591716,8340,39505,452,881,94,5040,20,965,78,20
"568","2020-04-19",438,7,230,1234,8112,0.297707100591716,8340,39505,452,881,76,5116,27,992,60,27
"569","2020-04-20",433,7,233,1182,8112,0.297707100591716,8340,39505,452,881,102,5218,14,1006,90,14
"570","2020-04-21",417,7,207,1138,8112,0.297707100591716,8340,39505,452,881,65,5283,7,1013,49,7
"571","2020-04-22",421,7,194,1109,8112,0.297707100591716,8340,39505,452,881,56,5339,7,1020,39,7
"572","2020-04-23",420,7,181,1097,8112,0.297707100591716,8340,39505,452,881,73,5412,12,1032,58,12
"573","2020-04-24",389,7,175,1066,8112,0.297707100591716,8340,39505,452,881,50,5462,19,1051,41,19
"574","2020-04-25",397,7,156,1037,8112,0.297707100591716,8340,39505,452,881,55,5517,27,1078,44,27
"575","2020-04-26",353,7,147,1026,8112,0.297707100591716,8340,39505,452,881,52,5569,25,1103,40,25
"576","2020-04-27",333,7,159,993,8112,0.297707100591716,8340,39505,452,881,46,5615,42,1145,31,42
"577","2020-04-28",338,7,171,936,8112,0.297707100591716,8340,39505,452,881,42,5657,26,1171,36,26
"578","2020-04-29",322,7,165,907,8112,0.297707100591716,8340,39505,452,881,43,5700,31,1202,27,31
"579","2020-04-30",297,7,163,882,8112,0.297707100591716,8340,39505,452,881,36,5736,29,1231,26,29
"580","2020-05-01",296,7,195,856,8112,0.297707100591716,8340,39505,452,881,37,5773,16,1247,29,16
"581","2020-05-02",272,7,213,833,8112,0.297707100591716,8340,39505,452,881,28,5801,15,1262,21,15
"582","2020-05-03",261,7,226,809,8112,0.297707100591716,8340,39505,452,881,32,5833,14,1276,18,14
"583","2020-05-04",253,7,207,785,8112,0.297707100591716,8340,39505,452,881,35,5868,13,1289,21,13
"584","2020-05-05",234,7,188,765,8112,0.297707100591716,8340,39505,452,881,26,5894,5,1294,18,5
"585","2020-05-06",233,7,186,742,8112,0.297707100591716,8340,39505,452,881,29,5923,1,1295,14,1
"586","2020-05-07",226,7,179,720,8112,0.297707100591716,8340,39505,452,881,34,5957,4,1299,21,4
"587","2020-05-08",222,7,160,704,8112,0.297707100591716,8340,39505,452,881,23,5980,9,1308,15,9
"588","2020-05-09",227,7,159,682,8112,0.297707100591716,8340,39505,452,881,27,6007,12,1320,17,12
"589","2020-05-10",218,7,162,655,8112,0.297707100591716,8340,39505,452,881,29,6036,15,1335,18,15
"590","2020-05-11",214,7,162,639,8112,0.297707100591716,8340,39505,452,881,17,6053,59,1394,8,59
"591","2020-05-12",201,7,204,618,8112,0.297707100591716,8340,39505,452,881,20,6073,31,1425,11,31
"592","2020-05-13",194,7,233,597,8112,0.297707100591716,8340,39505,452,881,26,6099,54,1479,15,54
"593","2020-05-14",199,7,231,556,8112,0.297707100591716,8340,39505,452,881,14,6113,29,1508,4,29
"594","2020-05-15",188,7,220,525,8112,0.297707100591716,8340,39505,452,881,22,6135,17,1525,12,17
"595","2020-05-16",207,7,226,519,8112,0.297707100591716,8340,39505,452,881,14,6149,33,1558,9,33
"596","2020-05-17",191,7,252,484,8112,0.297707100591716,8340,39505,452,881,14,6163,27,1585,8,27
"597","2020-05-18",173,7,270,458,8112,0.297707100591716,8340,39505,452,881,10,6173,35,1620,3,35
"598","2020-05-19",164,7,280,436,8112,0.297707100591716,8340,39505,452,881,20,6193,12,1632,8,12
"599","2020-05-20",154,7,280,413,8112,0.297707100591716,8340,39505,452,881,11,6204,16,1648,6,16
"600","2020-05-21",140,7,265,382,8112,0.297707100591716,8340,39505,452,881,10,6214,6,1654,6,6
"601","2020-05-22",149,7,268,375,8112,0.297707100591716,8340,39505,452,881,5,6219,19,1673,3,19
"602","2020-05-23",122,7,268,362,8112,0.297707100591716,8340,39505,452,881,13,6232,16,1689,6,16
"603","2020-05-24",109,7,242,339,8112,0.297707100591716,8340,39505,452,881,12,6244,13,1702,5,13
"604","2020-05-25",106,7,215,327,8112,0.297707100591716,8340,39505,452,881,10,6254,56,1758,NA,56
"605","2020-05-26",100,7,236,314,8112,0.297707100591716,8340,39505,452,881,11,6265,38,1796,4,38
"606","2020-05-27",99,7,207,295,8112,0.297707100591716,8340,39505,452,881,14,6279,36,1832,4,36
"607","2020-05-28",102,7,191,282,8112,0.297707100591716,8340,39505,452,881,12,6291,26,1858,6,26
"608","2020-05-29",92,7,183,269,8112,0.297707100591716,8340,39505,452,881,10,6301,15,1873,NA,15
"609","2020-05-30",101,7,212,264,8112,0.297707100591716,8340,39505,452,881,10,6311,20,1893,4,20
"610","2020-05-31",86,7,208,248,8112,0.297707100591716,8340,39505,452,881,9,6320,21,1914,6,21
"611","2020-06-01",82,7,206,240,8112,0.297707100591716,8340,39505,452,881,10,6330,24,1938,7,24
"612","2020-06-02",74,7,187,221,8112,0.297707100591716,8340,39505,452,881,6,6336,38,1976,3,38
"613","2020-06-03",77,7,164,213,8112,0.297707100591716,8340,39505,452,881,9,6345,32,2008,8,32
"614","2020-06-04",76,7,170,203,8112,0.297707100591716,8340,39505,452,881,11,6356,20,2028,4,20
"615","2020-06-05",70,7,167,200,8112,0.297707100591716,8340,39505,452,881,9,6365,25,2053,5,25
"616","2020-06-06",64,7,161,188,8112,0.297707100591716,8340,39505,452,881,6,6371,29,2082,2,29
"617","2020-06-07",61,7,164,180,8112,0.297707100591716,8340,39505,452,881,14,6385,24,2106,4,24
"618","2020-03-13",5,8,191,194,7752,0.481295149638803,8385,37843,440,2029,49,147,26,91,2,26
"619","2020-03-14",16,8,228,274,7752,0.481295149638803,8385,37843,440,2029,50,197,4,95,10,4
"620","2020-03-15",37,8,264,353,7752,0.481295149638803,8385,37843,440,2029,63,260,12,107,13,12
"621","2020-03-16",49,8,281,445,7752,0.481295149638803,8385,37843,440,2029,75,335,9,116,29,9
"622","2020-03-17",60,8,317,569,7752,0.481295149638803,8385,37843,440,2029,75,410,30,146,31,30
"623","2020-03-18",79,8,312,678,7752,0.481295149638803,8385,37843,440,2029,82,492,20,166,34,20
"624","2020-03-19",104,8,296,797,7752,0.481295149638803,8385,37843,440,2029,88,580,38,204,40,38
"625","2020-03-20",159,8,301,886,7752,0.481295149638803,8385,37843,440,2029,88,668,47,251,42,47
"626","2020-03-21",261,8,332,973,7752,0.481295149638803,8385,37843,440,2029,96,764,59,310,44,59
"627","2020-03-22",281,8,345,1076,7752,0.481295149638803,8385,37843,440,2029,101,865,27,337,53,27
"628","2020-03-23",289,8,351,1182,7752,0.481295149638803,8385,37843,440,2029,110,975,18,355,56,18
"629","2020-03-24",309,8,332,1263,7752,0.481295149638803,8385,37843,440,2029,92,1067,20,375,44,20
"630","2020-03-25",332,8,319,1331,7752,0.481295149638803,8385,37843,440,2029,102,1169,36,411,53,36
"631","2020-03-26",358,8,293,1421,7752,0.481295149638803,8385,37843,440,2029,125,1294,24,435,83,24
"632","2020-03-27",449,8,274,1533,7752,0.481295149638803,8385,37843,440,2029,118,1412,19,454,68,19
"633","2020-03-28",405,8,281,1635,7752,0.481295149638803,8385,37843,440,2029,91,1503,25,479,52,25
"634","2020-03-29",457,8,275,1727,7752,0.481295149638803,8385,37843,440,2029,113,1616,35,514,64,35
"635","2020-03-30",478,8,274,1774,7752,0.481295149638803,8385,37843,440,2029,112,1728,29,543,57,29
"636","2020-03-31",488,8,267,1828,7752,0.481295149638803,8385,37843,440,2029,101,1829,17,560,56,17
"637","2020-04-01",507,8,262,1856,7752,0.481295149638803,8385,37843,440,2029,106,1935,15,575,60,15
"638","2020-04-02",520,8,261,1899,7752,0.481295149638803,8385,37843,440,2029,111,2046,28,603,60,28
"639","2020-04-03",667,8,250,1928,7752,0.481295149638803,8385,37843,440,2029,105,2151,22,625,54,22
"640","2020-04-04",690,8,257,1904,7752,0.481295149638803,8385,37843,440,2029,103,2254,18,643,59,18
"641","2020-04-05",615,8,248,1892,7752,0.481295149638803,8385,37843,440,2029,85,2339,15,658,48,15
"642","2020-04-06",610,8,251,1890,7752,0.481295149638803,8385,37843,440,2029,121,2460,18,676,72,18
"643","2020-04-07",603,8,263,1861,7752,0.481295149638803,8385,37843,440,2029,128,2588,58,734,77,58
"644","2020-04-08",603,8,261,1832,7752,0.481295149638803,8385,37843,440,2029,98,2686,37,771,57,37
"645","2020-04-09",607,8,295,1807,7752,0.481295149638803,8385,37843,440,2029,110,2796,51,822,70,51
"646","2020-04-10",605,8,299,1740,7752,0.481295149638803,8385,37843,440,2029,98,2894,59,881,50,59
"647","2020-04-11",607,8,309,1716,7752,0.481295149638803,8385,37843,440,2029,129,3023,39,920,74,39
"648","2020-04-12",541,8,299,1655,7752,0.481295149638803,8385,37843,440,2029,107,3130,38,958,58,38
"649","2020-04-13",539,8,304,1619,7752,0.481295149638803,8385,37843,440,2029,112,3242,36,994,59,36
"650","2020-04-14",527,8,297,1565,7752,0.481295149638803,8385,37843,440,2029,111,3353,41,1035,67,41
"651","2020-04-15",515,8,293,1521,7752,0.481295149638803,8385,37843,440,2029,105,3458,17,1052,63,17
"652","2020-04-16",505,8,299,1442,7752,0.481295149638803,8385,37843,440,2029,94,3552,23,1075,55,23
"653","2020-04-17",493,8,295,1404,7752,0.481295149638803,8385,37843,440,2029,96,3648,49,1124,44,49
"654","2020-04-18",520,8,312,1363,7752,0.481295149638803,8385,37843,440,2029,90,3738,27,1151,48,27
"655","2020-04-19",510,8,306,1301,7752,0.481295149638803,8385,37843,440,2029,96,3834,20,1171,50,20
"656","2020-04-20",488,8,298,1243,7752,0.481295149638803,8385,37843,440,2029,104,3938,17,1188,69,17
"657","2020-04-21",476,8,298,1185,7752,0.481295149638803,8385,37843,440,2029,68,4006,61,1249,33,61
"658","2020-04-22",467,8,310,1136,7752,0.481295149638803,8385,37843,440,2029,69,4075,45,1294,36,45
"659","2020-04-23",447,8,307,1081,7752,0.481295149638803,8385,37843,440,2029,90,4165,19,1313,49,19
"660","2020-04-24",434,8,286,1072,7752,0.481295149638803,8385,37843,440,2029,83,4248,21,1334,40,21
"661","2020-04-25",386,8,286,1019,7752,0.481295149638803,8385,37843,440,2029,79,4327,38,1372,26,38
"662","2020-04-26",355,8,277,979,7752,0.481295149638803,8385,37843,440,2029,64,4391,32,1404,27,32
"663","2020-04-27",323,8,269,933,7752,0.481295149638803,8385,37843,440,2029,62,4453,37,1441,30,37
"664","2020-04-28",314,8,295,905,7752,0.481295149638803,8385,37843,440,2029,80,4533,19,1460,40,19
"665","2020-04-29",310,8,312,866,7752,0.481295149638803,8385,37843,440,2029,50,4583,16,1476,22,16
"666","2020-04-30",298,8,306,834,7752,0.481295149638803,8385,37843,440,2029,71,4654,47,1523,37,47
"667","2020-05-01",257,8,306,797,7752,0.481295149638803,8385,37843,440,2029,58,4712,63,1586,20,63
"668","2020-05-02",248,8,305,772,7752,0.481295149638803,8385,37843,440,2029,55,4767,32,1618,18,32
"669","2020-05-03",247,8,305,721,7752,0.481295149638803,8385,37843,440,2029,47,4814,24,1642,19,24
"670","2020-05-04",255,8,318,710,7752,0.481295149638803,8385,37843,440,2029,74,4888,20,1662,28,20
"671","2020-05-05",238,8,312,665,7752,0.481295149638803,8385,37843,440,2029,56,4944,32,1694,30,32
"672","2020-05-06",225,8,343,630,7752,0.481295149638803,8385,37843,440,2029,51,4995,26,1720,22,26
"673","2020-05-07",224,8,333,577,7752,0.481295149638803,8385,37843,440,2029,53,5048,15,1735,27,15
"674","2020-05-08",227,8,314,548,7752,0.481295149638803,8385,37843,440,2029,49,5097,38,1773,19,38
"675","2020-05-09",230,8,316,514,7752,0.481295149638803,8385,37843,440,2029,42,5139,67,1840,14,67
"676","2020-05-10",200,8,334,487,7752,0.481295149638803,8385,37843,440,2029,44,5183,55,1895,12,55
"677","2020-05-11",183,8,328,468,7752,0.481295149638803,8385,37843,440,2029,50,5233,34,1929,22,34
"678","2020-05-12",171,8,320,450,7752,0.481295149638803,8385,37843,440,2029,38,5271,14,1943,16,14
"679","2020-05-13",163,8,313,418,7752,0.481295149638803,8385,37843,440,2029,33,5304,4,1947,17,4
"680","2020-05-14",156,8,318,398,7752,0.481295149638803,8385,37843,440,2029,41,5345,9,1956,17,9
"681","2020-05-15",142,8,335,382,7752,0.481295149638803,8385,37843,440,2029,35,5380,36,1992,18,36
"682","2020-05-16",146,8,328,349,7752,0.481295149638803,8385,37843,440,2029,42,5422,32,2024,15,32
"683","2020-05-17",129,8,310,328,7752,0.481295149638803,8385,37843,440,2029,35,5457,61,2085,15,61
"684","2020-05-18",122,8,303,310,7752,0.481295149638803,8385,37843,440,2029,23,5480,35,2120,8,35
"685","2020-05-19",127,8,295,309,7752,0.481295149638803,8385,37843,440,2029,19,5499,54,2174,6,54
"686","2020-05-20",118,8,290,298,7752,0.481295149638803,8385,37843,440,2029,28,5527,50,2224,10,50
"687","2020-05-21",110,8,298,288,7752,0.481295149638803,8385,37843,440,2029,21,5548,25,2249,4,25
"688","2020-05-22",105,8,311,286,7752,0.481295149638803,8385,37843,440,2029,24,5572,20,2269,10,20
"689","2020-05-23",97,8,324,283,7752,0.481295149638803,8385,37843,440,2029,35,5607,45,2314,12,45
"690","2020-05-24",97,8,324,272,7752,0.481295149638803,8385,37843,440,2029,22,5629,43,2357,7,43
"691","2020-05-25",90,8,335,268,7752,0.481295149638803,8385,37843,440,2029,24,5653,46,2403,4,46
"692","2020-05-26",83,8,342,257,7752,0.481295149638803,8385,37843,440,2029,30,5683,54,2457,9,54
"693","2020-05-27",86,8,358,238,7752,0.481295149638803,8385,37843,440,2029,18,5701,41,2498,2,41
"694","2020-05-28",89,8,362,234,7752,0.481295149638803,8385,37843,440,2029,22,5723,21,2519,8,21
"695","2020-05-29",83,8,357,233,7752,0.481295149638803,8385,37843,440,2029,23,5746,34,2553,9,34
"696","2020-05-30",85,8,351,219,7752,0.481295149638803,8385,37843,440,2029,14,5760,23,2576,6,23
"697","2020-05-31",77,8,335,202,7752,0.481295149638803,8385,37843,440,2029,22,5782,22,2598,10,22
"698","2020-06-01",71,8,355,200,7752,0.481295149638803,8385,37843,440,2029,13,5795,38,2636,4,38
"699","2020-06-02",72,8,345,193,7752,0.481295149638803,8385,37843,440,2029,18,5813,32,2668,8,32
"700","2020-06-03",69,8,348,189,7752,0.481295149638803,8385,37843,440,2029,18,5831,39,2707,7,39
"701","2020-06-04",61,8,328,177,7752,0.481295149638803,8385,37843,440,2029,8,5839,20,2727,NA,20
"702","2020-06-05",57,8,292,164,7752,0.481295149638803,8385,37843,440,2029,16,5855,16,2743,7,16
"703","2020-06-06",53,8,286,154,7752,0.481295149638803,8385,37843,440,2029,3,5858,22,2765,1,22
"704","2020-06-07",58,8,272,153,7752,0.481295149638803,8385,37843,440,2029,11,5869,19,2784,4,19
"705","2020-03-13",1,9,136,64,6779,0.890249299306682,8250,33594,344,1366,26,51,74,213,18,74
"706","2020-03-14",10,9,181,107,6779,0.890249299306682,8250,33594,344,1366,25,76,64,277,17,64
"707","2020-03-15",12,9,222,144,6779,0.890249299306682,8250,33594,344,1366,41,117,28,305,30,28
"708","2020-03-16",9,9,228,203,6779,0.890249299306682,8250,33594,344,1366,35,152,22,327,24,22
"709","2020-03-17",17,9,242,272,6779,0.890249299306682,8250,33594,344,1366,41,193,34,361,31,34
"710","2020-03-18",24,9,214,340,6779,0.890249299306682,8250,33594,344,1366,72,265,34,395,55,34
"711","2020-03-19",45,9,218,398,6779,0.890249299306682,8250,33594,344,1366,63,328,59,454,59,59
"712","2020-03-20",65,9,210,474,6779,0.890249299306682,8250,33594,344,1366,55,383,24,478,45,24
"713","2020-03-21",76,9,189,575,6779,0.890249299306682,8250,33594,344,1366,83,466,38,516,73,38
"714","2020-03-22",128,9,168,664,6779,0.890249299306682,8250,33594,344,1366,90,556,31,547,71,31
"715","2020-03-23",153,9,195,769,6779,0.890249299306682,8250,33594,344,1366,97,653,24,571,82,24
"716","2020-03-24",158,9,251,841,6779,0.890249299306682,8250,33594,344,1366,127,780,15,586,114,15
"717","2020-03-25",178,9,279,932,6779,0.890249299306682,8250,33594,344,1366,122,902,12,598,115,12
"718","2020-03-26",182,9,272,1037,6779,0.890249299306682,8250,33594,344,1366,121,1023,25,623,112,25
"719","2020-03-27",275,9,258,1148,6779,0.890249299306682,8250,33594,344,1366,119,1142,19,642,107,19
"720","2020-03-28",327,9,267,1246,6779,0.890249299306682,8250,33594,344,1366,136,1278,12,654,127,12
"721","2020-03-29",340,9,291,1327,6779,0.890249299306682,8250,33594,344,1366,152,1430,6,660,146,6
"722","2020-03-30",361,9,286,1415,6779,0.890249299306682,8250,33594,344,1366,134,1564,6,666,120,6
"723","2020-03-31",376,9,257,1520,6779,0.890249299306682,8250,33594,344,1366,146,1710,12,678,135,12
"724","2020-04-01",384,9,238,1607,6779,0.890249299306682,8250,33594,344,1366,194,1904,60,738,187,60
"725","2020-04-02",432,9,195,1724,6779,0.890249299306682,8250,33594,344,1366,186,2090,28,766,176,28
"726","2020-04-03",570,9,189,1822,6779,0.890249299306682,8250,33594,344,1366,165,2255,23,789,153,23
"727","2020-04-04",584,9,175,1860,6779,0.890249299306682,8250,33594,344,1366,174,2429,55,844,158,55
"728","2020-04-05",565,9,186,1882,6779,0.890249299306682,8250,33594,344,1366,183,2612,61,905,172,61
"729","2020-04-06",581,9,182,1965,6779,0.890249299306682,8250,33594,344,1366,200,2812,65,970,188,65
"730","2020-04-07",594,9,205,1994,6779,0.890249299306682,8250,33594,344,1366,153,2965,48,1018,147,48
"731","2020-04-08",630,9,193,2023,6779,0.890249299306682,8250,33594,344,1366,146,3111,30,1048,138,30
"732","2020-04-09",648,9,168,2074,6779,0.890249299306682,8250,33594,344,1366,194,3305,13,1061,181,13
"733","2020-04-10",734,9,152,2051,6779,0.890249299306682,8250,33594,344,1366,167,3472,14,1075,156,14
"734","2020-04-11",725,9,134,2043,6779,0.890249299306682,8250,33594,344,1366,176,3648,13,1088,162,13
"735","2020-04-12",677,9,146,2066,6779,0.890249299306682,8250,33594,344,1366,162,3810,13,1101,153,13
"736","2020-04-13",681,9,152,2025,6779,0.890249299306682,8250,33594,344,1366,158,3968,17,1118,149,17
"737","2020-04-14",668,9,164,1995,6779,0.890249299306682,8250,33594,344,1366,140,4108,39,1157,132,39
"738","2020-04-15",675,9,154,1916,6779,0.890249299306682,8250,33594,344,1366,150,4258,45,1202,147,45
"739","2020-04-16",651,9,152,1838,6779,0.890249299306682,8250,33594,344,1366,147,4405,34,1236,138,34
"740","2020-04-17",684,9,227,1798,6779,0.890249299306682,8250,33594,344,1366,129,4534,30,1266,120,30
"741","2020-04-18",679,9,245,1733,6779,0.890249299306682,8250,33594,344,1366,121,4655,48,1314,111,48
"742","2020-04-19",630,9,234,1661,6779,0.890249299306682,8250,33594,344,1366,92,4747,28,1342,81,28
"743","2020-04-20",600,9,226,1531,6779,0.890249299306682,8250,33594,344,1366,102,4849,17,1359,95,17
"744","2020-04-21",602,9,227,1421,6779,0.890249299306682,8250,33594,344,1366,89,4938,18,1377,79,18
"745","2020-04-22",573,9,251,1356,6779,0.890249299306682,8250,33594,344,1366,100,5038,11,1388,93,11
"746","2020-04-23",555,9,252,1280,6779,0.890249299306682,8250,33594,344,1366,63,5101,17,1405,55,17
"747","2020-04-24",480,9,261,1189,6779,0.890249299306682,8250,33594,344,1366,65,5166,47,1452,60,47
"748","2020-04-25",479,9,236,1116,6779,0.890249299306682,8250,33594,344,1366,52,5218,41,1493,49,41
"749","2020-04-26",430,9,224,1030,6779,0.890249299306682,8250,33594,344,1366,57,5275,27,1520,51,27
"750","2020-04-27",420,9,209,934,6779,0.890249299306682,8250,33594,344,1366,48,5323,13,1533,42,13
"751","2020-04-28",376,9,247,854,6779,0.890249299306682,8250,33594,344,1366,59,5382,25,1558,47,25
"752","2020-04-29",369,9,244,804,6779,0.890249299306682,8250,33594,344,1366,36,5418,43,1601,32,43
"753","2020-04-30",346,9,240,753,6779,0.890249299306682,8250,33594,344,1366,40,5458,34,1635,33,34
"754","2020-05-01",295,9,229,672,6779,0.890249299306682,8250,33594,344,1366,30,5488,34,1669,25,34
"755","2020-05-02",282,9,246,610,6779,0.890249299306682,8250,33594,344,1366,31,5519,24,1693,25,24
"756","2020-05-03",258,9,276,553,6779,0.890249299306682,8250,33594,344,1366,34,5553,14,1707,31,14
"757","2020-05-04",227,9,310,497,6779,0.890249299306682,8250,33594,344,1366,31,5584,47,1754,22,47
"758","2020-05-05",210,9,262,453,6779,0.890249299306682,8250,33594,344,1366,21,5605,67,1821,17,67
"759","2020-05-06",189,9,262,414,6779,0.890249299306682,8250,33594,344,1366,28,5633,59,1880,25,59
"760","2020-05-07",170,9,253,372,6779,0.890249299306682,8250,33594,344,1366,33,5666,30,1910,25,30
"761","2020-05-08",146,9,243,344,6779,0.890249299306682,8250,33594,344,1366,26,5692,19,1929,22,19
"762","2020-05-09",129,9,226,328,6779,0.890249299306682,8250,33594,344,1366,26,5718,18,1947,19,18
"763","2020-05-10",112,9,196,311,6779,0.890249299306682,8250,33594,344,1366,26,5744,38,1985,18,38
"764","2020-05-11",106,9,194,310,6779,0.890249299306682,8250,33594,344,1366,20,5764,53,2038,16,53
"765","2020-05-12",107,9,239,303,6779,0.890249299306682,8250,33594,344,1366,21,5785,27,2065,17,27
"766","2020-05-13",90,9,290,277,6779,0.890249299306682,8250,33594,344,1366,16,5801,76,2141,8,76
"767","2020-05-14",98,9,319,256,6779,0.890249299306682,8250,33594,344,1366,32,5833,42,2183,25,42
"768","2020-05-15",94,9,286,252,6779,0.890249299306682,8250,33594,344,1366,25,5858,49,2232,16,49
"769","2020-05-16",93,9,256,230,6779,0.890249299306682,8250,33594,344,1366,19,5877,22,2254,15,22
"770","2020-05-17",81,9,233,221,6779,0.890249299306682,8250,33594,344,1366,20,5897,17,2271,17,17
"771","2020-05-18",84,9,264,202,6779,0.890249299306682,8250,33594,344,1366,17,5914,54,2325,12,54
"772","2020-05-19",78,9,270,189,6779,0.890249299306682,8250,33594,344,1366,21,5935,15,2340,17,15
"773","2020-05-20",78,9,256,183,6779,0.890249299306682,8250,33594,344,1366,17,5952,17,2357,14,17
"774","2020-05-21",71,9,263,175,6779,0.890249299306682,8250,33594,344,1366,13,5965,7,2364,10,7
"775","2020-05-22",61,9,248,160,6779,0.890249299306682,8250,33594,344,1366,12,5977,9,2373,9,9
"776","2020-05-23",54,9,230,148,6779,0.890249299306682,8250,33594,344,1366,10,5987,8,2381,10,8
"777","2020-05-24",59,9,222,137,6779,0.890249299306682,8250,33594,344,1366,14,6001,14,2395,10,14
"778","2020-05-25",48,9,243,135,6779,0.890249299306682,8250,33594,344,1366,12,6013,27,2422,10,27
"779","2020-05-26",48,9,239,121,6779,0.890249299306682,8250,33594,344,1366,8,6021,14,2436,4,14
"780","2020-05-27",45,9,219,124,6779,0.890249299306682,8250,33594,344,1366,7,6028,25,2461,5,25
"781","2020-05-28",39,9,202,120,6779,0.890249299306682,8250,33594,344,1366,6,6034,60,2521,3,60
"782","2020-05-29",43,9,212,114,6779,0.890249299306682,8250,33594,344,1366,11,6045,21,2542,9,21
"783","2020-05-30",43,9,235,111,6779,0.890249299306682,8250,33594,344,1366,10,6055,25,2567,6,25
"784","2020-05-31",36,9,254,107,6779,0.890249299306682,8250,33594,344,1366,9,6064,65,2632,9,65
"785","2020-06-01",32,9,253,106,6779,0.890249299306682,8250,33594,344,1366,6,6070,40,2672,4,40
"786","2020-06-02",27,9,269,103,6779,0.890249299306682,8250,33594,344,1366,8,6078,63,2735,3,63
"787","2020-06-03",30,9,274,92,6779,0.890249299306682,8250,33594,344,1366,6,6084,52,2787,5,52
"788","2020-06-04",33,9,260,92,6779,0.890249299306682,8250,33594,344,1366,11,6095,32,2819,9,32
"789","2020-06-05",31,9,256,87,6779,0.890249299306682,8250,33594,344,1366,6,6101,58,2877,5,58
"790","2020-06-06",29,9,252,80,6779,0.890249299306682,8250,33594,344,1366,9,6110,41,2918,7,41
"791","2020-06-07",30,9,283,77,6779,0.890249299306682,8250,33594,344,1366,7,6117,24,2942,6,24
"792","2020-03-07",1,10,0,0,6514,0.846638010439054,8265,32184,429,1899,NA,NA,NA,NA,NA,NA
"793","2020-03-08",1,10,0,0,6514,0.846638010439054,8265,32184,429,1899,NA,NA,NA,NA,NA,NA
"794","2020-03-09",0,10,0,0,6514,0.846638010439054,8265,32184,429,1899,NA,NA,NA,NA,NA,NA
"795","2020-03-10",0,10,0,0,6514,0.846638010439054,8265,32184,429,1899,1,1,2,2,1,2
"796","2020-03-11",1,10,76,9,6514,0.846638010439054,8265,32184,429,1899,44,45,13,15,NA,13
"797","2020-03-12",1,10,119,23,6514,0.846638010439054,8265,32184,429,1899,46,91,5,20,4,5
"798","2020-03-13",2,10,126,38,6514,0.846638010439054,8265,32184,429,1899,55,146,5,25,7,5
"799","2020-03-14",5,10,129,57,6514,0.846638010439054,8265,32184,429,1899,71,217,1,26,23,1
"800","2020-03-15",9,10,122,67,6514,0.846638010439054,8265,32184,429,1899,62,279,1,27,16,1
"801","2020-03-16",11,10,102,100,6514,0.846638010439054,8265,32184,429,1899,82,361,3,30,41,3
"802","2020-03-17",14,10,149,129,6514,0.846638010439054,8265,32184,429,1899,105,466,12,42,51,12
"803","2020-03-18",14,10,205,157,6514,0.846638010439054,8265,32184,429,1899,102,568,31,73,60,31
"804","2020-03-19",18,10,191,206,6514,0.846638010439054,8265,32184,429,1899,128,696,35,108,85,35
"805","2020-03-20",30,10,165,247,6514,0.846638010439054,8265,32184,429,1899,129,825,34,142,91,34
"806","2020-03-21",38,10,158,297,6514,0.846638010439054,8265,32184,429,1899,139,964,39,181,93,39
"807","2020-03-22",46,10,182,373,6514,0.846638010439054,8265,32184,429,1899,118,1082,40,221,77,40
"808","2020-03-23",55,10,181,422,6514,0.846638010439054,8265,32184,429,1899,130,1212,48,269,89,48
"809","2020-03-24",67,10,182,486,6514,0.846638010439054,8265,32184,429,1899,144,1356,41,310,107,41
"810","2020-03-25",83,10,204,553,6514,0.846638010439054,8265,32184,429,1899,168,1524,51,361,115,51
"811","2020-03-26",94,10,186,628,6514,0.846638010439054,8265,32184,429,1899,140,1664,39,400,98,39
"812","2020-03-27",112,10,184,725,6514,0.846638010439054,8265,32184,429,1899,138,1802,29,429,109,29
"813","2020-03-28",158,10,194,791,6514,0.846638010439054,8265,32184,429,1899,149,1951,45,474,111,45
"814","2020-03-29",205,10,196,906,6514,0.846638010439054,8265,32184,429,1899,162,2113,46,520,128,46
"815","2020-03-30",222,10,177,991,6514,0.846638010439054,8265,32184,429,1899,152,2265,55,575,116,55
"816","2020-03-31",237,10,152,1092,6514,0.846638010439054,8265,32184,429,1899,156,2421,33,608,126,33
"817","2020-04-01",260,10,148,1196,6514,0.846638010439054,8265,32184,429,1899,153,2574,70,678,122,70
"818","2020-04-02",293,10,144,1308,6514,0.846638010439054,8265,32184,429,1899,165,2739,31,709,123,31
"819","2020-04-03",406,10,148,1425,6514,0.846638010439054,8265,32184,429,1899,162,2901,31,740,121,31
"820","2020-04-04",423,10,200,1544,6514,0.846638010439054,8265,32184,429,1899,135,3036,34,774,96,34
"821","2020-04-05",468,10,245,1669,6514,0.846638010439054,8265,32184,429,1899,159,3195,27,801,116,27
"822","2020-04-06",477,10,262,1758,6514,0.846638010439054,8265,32184,429,1899,146,3341,35,836,114,35
"823","2020-04-07",480,10,304,1863,6514,0.846638010439054,8265,32184,429,1899,153,3494,21,857,116,21
"824","2020-04-08",529,10,314,1978,6514,0.846638010439054,8265,32184,429,1899,117,3611,61,918,82,61
"825","2020-04-09",546,10,332,2054,6514,0.846638010439054,8265,32184,429,1899,133,3744,30,948,107,30
"826","2020-04-10",773,10,318,2113,6514,0.846638010439054,8265,32184,429,1899,139,3883,24,972,99,24
"827","2020-04-11",798,10,301,2188,6514,0.846638010439054,8265,32184,429,1899,125,4008,48,1020,96,48
"828","2020-04-12",699,10,270,2193,6514,0.846638010439054,8265,32184,429,1899,128,4136,38,1058,100,38
"829","2020-04-13",718,10,249,2175,6514,0.846638010439054,8265,32184,429,1899,120,4256,24,1082,83,24
"830","2020-04-14",732,10,234,2184,6514,0.846638010439054,8265,32184,429,1899,108,4364,50,1132,81,50
"831","2020-04-15",716,10,231,2154,6514,0.846638010439054,8265,32184,429,1899,96,4460,29,1161,65,29
"832","2020-04-16",731,10,208,2123,6514,0.846638010439054,8265,32184,429,1899,101,4561,22,1183,67,22
"833","2020-04-17",719,10,204,2050,6514,0.846638010439054,8265,32184,429,1899,90,4651,31,1214,54,31
"834","2020-04-18",711,10,201,1972,6514,0.846638010439054,8265,32184,429,1899,110,4761,15,1229,71,15
"835","2020-04-19",685,10,186,1891,6514,0.846638010439054,8265,32184,429,1899,75,4836,27,1256,53,27
"836","2020-04-20",676,10,155,1776,6514,0.846638010439054,8265,32184,429,1899,75,4911,23,1279,51,23
"837","2020-04-21",652,10,220,1673,6514,0.846638010439054,8265,32184,429,1899,93,5004,59,1338,63,59
"838","2020-04-22",633,10,236,1552,6514,0.846638010439054,8265,32184,429,1899,78,5082,48,1386,53,48
"839","2020-04-23",613,10,274,1442,6514,0.846638010439054,8265,32184,429,1899,68,5150,25,1411,48,25
"840","2020-04-24",549,10,250,1360,6514,0.846638010439054,8265,32184,429,1899,61,5211,55,1466,43,55
"841","2020-04-25",563,10,229,1277,6514,0.846638010439054,8265,32184,429,1899,62,5273,24,1490,39,24
"842","2020-04-26",508,10,276,1187,6514,0.846638010439054,8265,32184,429,1899,61,5334,46,1536,34,46
"843","2020-04-27",469,10,328,1112,6514,0.846638010439054,8265,32184,429,1899,56,5390,53,1589,30,53
"844","2020-04-28",456,10,331,1028,6514,0.846638010439054,8265,32184,429,1899,35,5425,35,1624,19,35
"845","2020-04-29",445,10,298,944,6514,0.846638010439054,8265,32184,429,1899,57,5482,59,1683,35,59
"846","2020-04-30",422,10,264,867,6514,0.846638010439054,8265,32184,429,1899,38,5520,48,1731,24,48
"847","2020-05-01",380,10,252,814,6514,0.846638010439054,8265,32184,429,1899,50,5570,27,1758,21,27
"848","2020-05-02",329,10,272,741,6514,0.846638010439054,8265,32184,429,1899,49,5619,7,1765,27,7
"849","2020-05-03",290,10,251,692,6514,0.846638010439054,8265,32184,429,1899,53,5672,16,1781,34,16
"850","2020-05-04",276,10,223,651,6514,0.846638010439054,8265,32184,429,1899,37,5709,65,1846,20,65
"851","2020-05-05",253,10,217,610,6514,0.846638010439054,8265,32184,429,1899,37,5746,32,1878,16,32
"852","2020-05-06",244,10,182,551,6514,0.846638010439054,8265,32184,429,1899,47,5793,29,1907,22,29
"853","2020-05-07",225,10,183,509,6514,0.846638010439054,8265,32184,429,1899,32,5825,23,1930,14,23
"854","2020-05-08",189,10,168,479,6514,0.846638010439054,8265,32184,429,1899,26,5851,30,1960,18,30
"855","2020-05-09",191,10,169,438,6514,0.846638010439054,8265,32184,429,1899,43,5894,24,1984,17,24
"856","2020-05-10",186,10,213,397,6514,0.846638010439054,8265,32184,429,1899,39,5933,27,2011,17,27
"857","2020-05-11",169,10,236,359,6514,0.846638010439054,8265,32184,429,1899,35,5968,19,2030,16,19
"858","2020-05-12",156,10,264,342,6514,0.846638010439054,8265,32184,429,1899,30,5998,34,2064,17,34
"859","2020-05-13",138,10,252,323,6514,0.846638010439054,8265,32184,429,1899,24,6022,22,2086,7,22
"860","2020-05-14",132,10,268,288,6514,0.846638010439054,8265,32184,429,1899,25,6047,9,2095,11,9
"861","2020-05-15",116,10,271,266,6514,0.846638010439054,8265,32184,429,1899,18,6065,13,2108,9,13
"862","2020-05-16",114,10,244,236,6514,0.846638010439054,8265,32184,429,1899,42,6107,24,2132,28,24
"863","2020-05-17",101,10,222,229,6514,0.846638010439054,8265,32184,429,1899,27,6134,41,2173,7,41
"864","2020-05-18",97,10,191,210,6514,0.846638010439054,8265,32184,429,1899,25,6159,46,2219,9,46
"865","2020-05-19",90,10,180,196,6514,0.846638010439054,8265,32184,429,1899,14,6173,27,2246,5,27
"866","2020-05-20",84,10,182,184,6514,0.846638010439054,8265,32184,429,1899,18,6191,43,2289,11,43
"867","2020-05-21",78,10,178,174,6514,0.846638010439054,8265,32184,429,1899,20,6211,53,2342,14,53
"868","2020-05-22",77,10,199,159,6514,0.846638010439054,8265,32184,429,1899,18,6229,34,2376,12,34
"869","2020-05-23",63,10,180,161,6514,0.846638010439054,8265,32184,429,1899,21,6250,23,2399,10,23
"870","2020-05-24",57,10,198,160,6514,0.846638010439054,8265,32184,429,1899,18,6268,20,2419,8,20
"871","2020-05-25",51,10,235,150,6514,0.846638010439054,8265,32184,429,1899,16,6284,16,2435,7,16
"872","2020-05-26",50,10,228,145,6514,0.846638010439054,8265,32184,429,1899,16,6300,11,2446,9,11
"873","2020-05-27",44,10,228,138,6514,0.846638010439054,8265,32184,429,1899,14,6314,8,2454,6,8
"874","2020-05-28",43,10,241,129,6514,0.846638010439054,8265,32184,429,1899,19,6333,9,2463,4,9
"875","2020-05-29",43,10,251,121,6514,0.846638010439054,8265,32184,429,1899,10,6343,17,2480,3,17
"876","2020-05-30",49,10,244,115,6514,0.846638010439054,8265,32184,429,1899,18,6361,43,2523,5,43
"877","2020-05-31",41,10,228,101,6514,0.846638010439054,8265,32184,429,1899,12,6373,24,2547,6,24
"878","2020-06-01",38,10,237,97,6514,0.846638010439054,8265,32184,429,1899,16,6389,12,2559,9,12
"879","2020-06-02",32,10,205,93,6514,0.846638010439054,8265,32184,429,1899,10,6399,34,2593,3,34
"880","2020-06-03",32,10,200,89,6514,0.846638010439054,8265,32184,429,1899,10,6409,42,2635,4,42
"881","2020-06-04",33,10,184,79,6514,0.846638010439054,8265,32184,429,1899,9,6418,30,2665,4,30
"882","2020-06-05",30,10,157,73,6514,0.846638010439054,8265,32184,429,1899,9,6427,49,2714,2,49
"883","2020-06-06",23,10,169,69,6514,0.846638010439054,8265,32184,429,1899,6,6433,22,2736,3,22
"884","2020-06-07",22,10,160,68,6514,0.846638010439054,8265,32184,429,1899,6,6439,19,2755,4,19
"885","2020-03-08",1,11,0,0,7966,0.600928948029124,8325,35654,444,1557,NA,NA,NA,NA,NA,NA
"886","2020-03-09",1,11,0,0,7966,0.600928948029124,8325,35654,444,1557,NA,NA,NA,NA,NA,NA
"887","2020-03-10",0,11,0,0,7966,0.600928948029124,8325,35654,444,1557,NA,NA,7,7,NA,7
"888","2020-03-11",0,11,0,0,7966,0.600928948029124,8325,35654,444,1557,75,75,28,35,1,28
"889","2020-03-12",1,11,163,114,7966,0.600928948029124,8325,35654,444,1557,79,154,28,63,8,28
"890","2020-03-13",4,11,169,209,7966,0.600928948029124,8325,35654,444,1557,104,258,17,80,21,17
"891","2020-03-14",27,11,159,296,7966,0.600928948029124,8325,35654,444,1557,102,360,19,99,27,19
"892","2020-03-15",40,11,141,386,7966,0.600928948029124,8325,35654,444,1557,110,470,27,126,37,27
"893","2020-03-16",45,11,127,502,7966,0.600928948029124,8325,35654,444,1557,129,599,34,160,62,34
"894","2020-03-17",57,11,119,616,7966,0.600928948029124,8325,35654,444,1557,134,733,72,232,60,72
"895","2020-03-18",77,11,123,734,7966,0.600928948029124,8325,35654,444,1557,112,845,47,279,59,47
"896","2020-03-19",98,11,119,876,7966,0.600928948029124,8325,35654,444,1557,175,1020,67,346,90,67
"897","2020-03-20",191,11,108,1016,7966,0.600928948029124,8325,35654,444,1557,130,1150,55,401,70,55
"898","2020-03-21",231,11,128,1193,7966,0.600928948029124,8325,35654,444,1557,160,1310,40,441,95,40
"899","2020-03-22",331,11,163,1350,7966,0.600928948029124,8325,35654,444,1557,208,1518,42,483,129,42
"900","2020-03-23",348,11,197,1466,7966,0.600928948029124,8325,35654,444,1557,182,1700,44,527,114,44
"901","2020-03-24",364,11,257,1611,7966,0.600928948029124,8325,35654,444,1557,165,1865,35,562,98,35
"902","2020-03-25",414,11,270,1778,7966,0.600928948029124,8325,35654,444,1557,209,2074,27,589,147,27
"903","2020-03-26",459,11,235,1915,7966,0.600928948029124,8325,35654,444,1557,207,2281,35,624,146,35
"904","2020-03-27",635,11,203,2017,7966,0.600928948029124,8325,35654,444,1557,165,2446,34,658,112,34
"905","2020-03-28",676,11,181,2108,7966,0.600928948029124,8325,35654,444,1557,209,2655,35,693,132,35
"906","2020-03-29",624,11,162,2186,7966,0.600928948029124,8325,35654,444,1557,165,2820,45,738,98,45
"907","2020-03-30",658,11,163,2254,7966,0.600928948029124,8325,35654,444,1557,167,2987,35,773,100,35
"908","2020-03-31",678,11,155,2327,7966,0.600928948029124,8325,35654,444,1557,162,3149,34,807,103,34
"909","2020-04-01",681,11,139,2359,7966,0.600928948029124,8325,35654,444,1557,160,3309,31,838,101,31
"910","2020-04-02",700,11,137,2400,7966,0.600928948029124,8325,35654,444,1557,158,3467,31,869,88,31
"911","2020-04-03",820,11,206,2411,7966,0.600928948029124,8325,35654,444,1557,161,3628,30,899,101,30
"912","2020-04-04",819,11,283,2392,7966,0.600928948029124,8325,35654,444,1557,174,3802,46,945,118,46
"913","2020-04-05",753,11,300,2394,7966,0.600928948029124,8325,35654,444,1557,142,3944,36,981,89,36
"914","2020-04-06",741,11,268,2374,7966,0.600928948029124,8325,35654,444,1557,148,4092,28,1009,98,28
"915","2020-04-07",714,11,314,2326,7966,0.600928948029124,8325,35654,444,1557,127,4219,33,1042,72,33
"916","2020-04-08",740,11,357,2243,7966,0.600928948029124,8325,35654,444,1557,131,4350,33,1075,78,33
"917","2020-04-09",735,11,337,2151,7966,0.600928948029124,8325,35654,444,1557,98,4448,33,1108,59,33
"918","2020-04-10",744,11,330,2074,7966,0.600928948029124,8325,35654,444,1557,104,4552,44,1152,75,44
"919","2020-04-11",715,11,276,1959,7966,0.600928948029124,8325,35654,444,1557,132,4684,36,1188,67,36
"920","2020-04-12",676,11,245,1898,7966,0.600928948029124,8325,35654,444,1557,111,4795,34,1222,63,34
"921","2020-04-13",675,11,211,1811,7966,0.600928948029124,8325,35654,444,1557,117,4912,29,1251,60,29
"922","2020-04-14",665,11,182,1703,7966,0.600928948029124,8325,35654,444,1557,95,5007,33,1284,57,33
"923","2020-04-15",623,11,187,1598,7966,0.600928948029124,8325,35654,444,1557,87,5094,29,1313,43,29
"924","2020-04-16",610,11,198,1510,7966,0.600928948029124,8325,35654,444,1557,92,5186,30,1343,45,30
"925","2020-04-17",524,11,191,1397,7966,0.600928948029124,8325,35654,444,1557,84,5270,34,1377,40,34
"926","2020-04-18",535,11,203,1311,7966,0.600928948029124,8325,35654,444,1557,72,5342,27,1404,28,27
"927","2020-04-19",487,11,245,1214,7966,0.600928948029124,8325,35654,444,1557,93,5435,37,1441,50,37
"928","2020-04-20",440,11,242,1113,7966,0.600928948029124,8325,35654,444,1557,68,5503,32,1473,41,32
"929","2020-04-21",413,11,261,1034,7966,0.600928948029124,8325,35654,444,1557,74,5577,44,1517,36,44
"930","2020-04-22",391,11,266,956,7966,0.600928948029124,8325,35654,444,1557,72,5649,48,1565,28,48
"931","2020-04-23",359,11,270,897,7966,0.600928948029124,8325,35654,444,1557,62,5711,54,1619,32,54
"932","2020-04-24",343,11,242,849,7966,0.600928948029124,8325,35654,444,1557,64,5775,28,1647,23,28
"933","2020-04-25",324,11,209,775,7966,0.600928948029124,8325,35654,444,1557,55,5830,41,1688,22,41
"934","2020-04-26",295,11,205,724,7966,0.600928948029124,8325,35654,444,1557,64,5894,24,1712,27,24
"935","2020-04-27",283,11,244,663,7966,0.600928948029124,8325,35654,444,1557,47,5941,29,1741,22,29
"936","2020-04-28",267,11,241,638,7966,0.600928948029124,8325,35654,444,1557,57,5998,38,1779,21,38
"937","2020-04-29",245,11,212,594,7966,0.600928948029124,8325,35654,444,1557,47,6045,43,1822,24,43
"938","2020-04-30",229,11,209,553,7966,0.600928948029124,8325,35654,444,1557,55,6100,43,1865,16,43
"939","2020-05-01",191,11,272,509,7966,0.600928948029124,8325,35654,444,1557,44,6144,46,1911,17,46
"940","2020-05-02",179,11,317,466,7966,0.600928948029124,8325,35654,444,1557,47,6191,47,1958,12,47
"941","2020-05-03",154,11,294,447,7966,0.600928948029124,8325,35654,444,1557,33,6224,56,2014,14,56
"942","2020-05-04",149,11,271,429,7966,0.600928948029124,8325,35654,444,1557,40,6264,40,2054,14,40
"943","2020-05-05",130,11,267,413,7966,0.600928948029124,8325,35654,444,1557,38,6302,32,2086,9,32
"944","2020-05-06",129,11,305,400,7966,0.600928948029124,8325,35654,444,1557,47,6349,34,2120,13,34
"945","2020-05-07",118,11,325,377,7966,0.600928948029124,8325,35654,444,1557,41,6390,27,2147,15,27
"946","2020-05-08",105,11,318,357,7966,0.600928948029124,8325,35654,444,1557,43,6433,25,2172,11,25
"947","2020-05-09",97,11,309,342,7966,0.600928948029124,8325,35654,444,1557,31,6464,32,2204,5,32
"948","2020-05-10",99,11,293,328,7966,0.600928948029124,8325,35654,444,1557,30,6494,24,2228,12,24
"949","2020-05-11",98,11,248,317,7966,0.600928948029124,8325,35654,444,1557,30,6524,34,2262,8,34
"950","2020-05-12",105,11,247,305,7966,0.600928948029124,8325,35654,444,1557,24,6548,44,2306,6,44
"951","2020-05-13",101,11,229,289,7966,0.600928948029124,8325,35654,444,1557,16,6564,43,2349,2,43
"952","2020-05-14",100,11,202,269,7966,0.600928948029124,8325,35654,444,1557,16,6580,30,2379,4,30
"953","2020-05-15",97,11,184,257,7966,0.600928948029124,8325,35654,444,1557,23,6603,50,2429,9,50
"954","2020-05-16",96,11,161,250,7966,0.600928948029124,8325,35654,444,1557,26,6629,45,2474,8,45
"955","2020-05-17",79,11,157,229,7966,0.600928948029124,8325,35654,444,1557,22,6651,49,2523,8,49
"956","2020-05-18",77,11,155,207,7966,0.600928948029124,8325,35654,444,1557,26,6677,46,2569,8,46
"957","2020-05-19",63,11,152,187,7966,0.600928948029124,8325,35654,444,1557,24,6701,34,2603,4,34
"958","2020-05-20",58,11,156,172,7966,0.600928948029124,8325,35654,444,1557,22,6723,40,2643,3,40
"959","2020-05-21",56,11,158,171,7966,0.600928948029124,8325,35654,444,1557,20,6743,42,2685,7,42
"960","2020-05-22",54,11,185,166,7966,0.600928948029124,8325,35654,444,1557,13,6756,29,2714,2,29
"961","2020-05-23",52,11,226,163,7966,0.600928948029124,8325,35654,444,1557,12,6768,33,2747,2,33
"962","2020-05-24",55,11,223,150,7966,0.600928948029124,8325,35654,444,1557,18,6786,36,2783,4,36
"963","2020-05-25",47,11,234,143,7966,0.600928948029124,8325,35654,444,1557,16,6802,43,2826,2,43
"964","2020-05-26",44,11,240,137,7966,0.600928948029124,8325,35654,444,1557,17,6819,44,2870,6,44
"965","2020-05-27",44,11,253,136,7966,0.600928948029124,8325,35654,444,1557,17,6836,36,2906,2,36
"966","2020-05-28",40,11,246,127,7966,0.600928948029124,8325,35654,444,1557,12,6848,44,2950,1,44
"967","2020-05-29",39,11,222,128,7966,0.600928948029124,8325,35654,444,1557,8,6856,33,2983,NA,33
"968","2020-05-30",38,11,230,126,7966,0.600928948029124,8325,35654,444,1557,12,6868,35,3018,1,35
"969","2020-05-31",27,11,248,125,7966,0.600928948029124,8325,35654,444,1557,13,6881,40,3058,1,40
"970","2020-06-01",33,11,253,122,7966,0.600928948029124,8325,35654,444,1557,13,6894,41,3099,1,41
"971","2020-06-02",35,11,246,120,7966,0.600928948029124,8325,35654,444,1557,15,6909,44,3143,5,44
"972","2020-06-03",33,11,277,117,7966,0.600928948029124,8325,35654,444,1557,7,6916,46,3189,1,46
"973","2020-06-04",35,11,254,112,7966,0.600928948029124,8325,35654,444,1557,7,6923,38,3227,3,38
"974","2020-06-05",35,11,227,109,7966,0.600928948029124,8325,35654,444,1557,7,6930,51,3278,NA,51
"975","2020-06-06",38,11,203,108,7966,0.600928948029124,8325,35654,444,1557,14,6944,51,3329,4,51
"976","2020-06-07",43,11,199,101,7966,0.600928948029124,8325,35654,444,1557,11,6955,85,3414,1,85
"977","2020-03-07",1,12,0,0,7553,0.383953396001589,8220,38297,414,1194,NA,NA,NA,NA,NA,NA
"978","2020-03-08",1,12,0,0,7553,0.383953396001589,8220,38297,414,1194,NA,NA,NA,NA,NA,NA
"979","2020-03-09",0,12,0,0,7553,0.383953396001589,8220,38297,414,1194,NA,NA,NA,NA,NA,NA
"980","2020-03-10",0,12,0,0,7553,0.383953396001589,8220,38297,414,1194,NA,NA,10,10,NA,10
"981","2020-03-11",0,12,0,0,7553,0.383953396001589,8220,38297,414,1194,35,35,37,47,7,37
"982","2020-03-12",0,12,0,0,7553,0.383953396001589,8220,38297,414,1194,38,73,24,71,10,24
"983","2020-03-13",6,12,102,201,7553,0.383953396001589,8220,38297,414,1194,41,114,24,95,13,24
"984","2020-03-14",12,12,108,268,7553,0.383953396001589,8220,38297,414,1194,47,161,55,150,18,55
"985","2020-03-15",45,12,138,354,7553,0.383953396001589,8220,38297,414,1194,54,215,51,201,25,51
"986","2020-03-16",58,12,159,448,7553,0.383953396001589,8220,38297,414,1194,59,274,25,226,32,25
"987","2020-03-17",58,12,196,549,7553,0.383953396001589,8220,38297,414,1194,71,345,45,271,39,45
"988","2020-03-18",78,12,225,659,7553,0.383953396001589,8220,38297,414,1194,93,438,47,318,57,47
"989","2020-03-19",100,12,240,757,7553,0.383953396001589,8220,38297,414,1194,103,541,55,373,63,55
"990","2020-03-20",175,12,250,842,7553,0.383953396001589,8220,38297,414,1194,99,640,37,410,67,37
"991","2020-03-21",209,12,234,943,7553,0.383953396001589,8220,38297,414,1194,113,753,22,432,73,22
"992","2020-03-22",225,12,223,1059,7553,0.383953396001589,8220,38297,414,1194,93,846,63,495,65,63
"993","2020-03-23",246,12,220,1136,7553,0.383953396001589,8220,38297,414,1194,89,935,29,524,62,29
"994","2020-03-24",266,12,204,1231,7553,0.383953396001589,8220,38297,414,1194,131,1066,63,587,91,63
"995","2020-03-25",299,12,181,1291,7553,0.383953396001589,8220,38297,414,1194,130,1196,69,656,97,69
"996","2020-03-26",317,12,177,1360,7553,0.383953396001589,8220,38297,414,1194,136,1332,38,694,98,38
"997","2020-03-27",425,12,187,1415,7553,0.383953396001589,8220,38297,414,1194,150,1482,14,708,103,14
"998","2020-03-28",486,12,192,1466,7553,0.383953396001589,8220,38297,414,1194,138,1620,18,726,106,18
"999","2020-03-29",466,12,178,1520,7553,0.383953396001589,8220,38297,414,1194,145,1765,14,740,119,14
"1000","2020-03-30",461,12,163,1538,7553,0.383953396001589,8220,38297,414,1194,150,1915,60,800,119,60
"1001","2020-03-31",466,12,163,1575,7553,0.383953396001589,8220,38297,414,1194,146,2061,38,838,106,38
"1002","2020-04-01",473,12,195,1573,7553,0.383953396001589,8220,38297,414,1194,133,2194,69,907,98,69
"1003","2020-04-02",492,12,227,1589,7553,0.383953396001589,8220,38297,414,1194,122,2316,47,954,89,47
"1004","2020-04-03",543,12,209,1620,7553,0.383953396001589,8220,38297,414,1194,148,2464,18,972,120,18
"1005","2020-04-04",517,12,220,1658,7553,0.383953396001589,8220,38297,414,1194,117,2581,10,982,87,10
"1006","2020-04-05",504,12,212,1637,7553,0.383953396001589,8220,38297,414,1194,133,2714,9,991,102,9
"1007","2020-04-06",521,12,245,1643,7553,0.383953396001589,8220,38297,414,1194,121,2835,44,1035,95,44
"1008","2020-04-07",524,12,276,1622,7553,0.383953396001589,8220,38297,414,1194,115,2950,28,1063,91,28
"1009","2020-04-08",519,12,295,1591,7553,0.383953396001589,8220,38297,414,1194,121,3071,20,1083,95,20
"1010","2020-04-09",513,12,274,1580,7553,0.383953396001589,8220,38297,414,1194,118,3189,44,1127,96,44
"1011","2020-04-10",550,12,264,1571,7553,0.383953396001589,8220,38297,414,1194,138,3327,36,1163,105,36
"1012","2020-04-11",582,12,242,1539,7553,0.383953396001589,8220,38297,414,1194,98,3425,15,1178,67,15
"1013","2020-04-12",517,12,237,1514,7553,0.383953396001589,8220,38297,414,1194,127,3552,14,1192,99,14
"1014","2020-04-13",487,12,230,1467,7553,0.383953396001589,8220,38297,414,1194,102,3654,20,1212,74,20
"1015","2020-04-14",474,12,217,1442,7553,0.383953396001589,8220,38297,414,1194,118,3772,52,1264,86,52
"1016","2020-04-15",457,12,242,1396,7553,0.383953396001589,8220,38297,414,1194,122,3894,28,1292,87,28
"1017","2020-04-16",437,12,263,1353,7553,0.383953396001589,8220,38297,414,1194,99,3993,54,1346,76,54
"1018","2020-04-17",461,12,267,1305,7553,0.383953396001589,8220,38297,414,1194,134,4127,30,1376,93,30
"1019","2020-04-18",431,12,273,1262,7553,0.383953396001589,8220,38297,414,1194,82,4209,49,1425,48,49
"1020","2020-04-19",386,12,282,1235,7553,0.383953396001589,8220,38297,414,1194,77,4286,42,1467,48,42
"1021","2020-04-20",381,12,282,1196,7553,0.383953396001589,8220,38297,414,1194,90,4376,37,1504,58,37
"1022","2020-04-21",364,12,278,1130,7553,0.383953396001589,8220,38297,414,1194,65,4441,62,1566,49,62
"1023","2020-04-22",370,12,281,1082,7553,0.383953396001589,8220,38297,414,1194,74,4515,28,1594,53,28
"1024","2020-04-23",364,12,280,1068,7553,0.383953396001589,8220,38297,414,1194,74,4589,79,1673,42,79
"1025","2020-04-24",344,12,280,1018,7553,0.383953396001589,8220,38297,414,1194,69,4658,84,1757,48,84
"1026","2020-04-25",345,12,284,1010,7553,0.383953396001589,8220,38297,414,1194,64,4722,32,1789,38,32
"1027","2020-04-26",331,12,282,956,7553,0.383953396001589,8220,38297,414,1194,57,4779,35,1824,39,35
"1028","2020-04-27",319,12,305,918,7553,0.383953396001589,8220,38297,414,1194,65,4844,26,1850,49,26
"1029","2020-04-28",317,12,285,871,7553,0.383953396001589,8220,38297,414,1194,54,4898,26,1876,22,26
"1030","2020-04-29",305,12,280,837,7553,0.383953396001589,8220,38297,414,1194,51,4949,16,1892,28,16
"1031","2020-04-30",312,12,268,794,7553,0.383953396001589,8220,38297,414,1194,51,5000,20,1912,32,20
"1032","2020-05-01",299,12,274,796,7553,0.383953396001589,8220,38297,414,1194,65,5065,41,1953,36,41
"1033","2020-05-02",308,12,257,779,7553,0.383953396001589,8220,38297,414,1194,58,5123,65,2018,34,65
"1034","2020-05-03",295,12,244,771,7553,0.383953396001589,8220,38297,414,1194,53,5176,41,2059,31,41
"1035","2020-05-04",283,12,236,712,7553,0.383953396001589,8220,38297,414,1194,41,5217,23,2082,24,23
"1036","2020-05-05",264,12,247,699,7553,0.383953396001589,8220,38297,414,1194,46,5263,13,2095,29,13
"1037","2020-05-06",249,12,249,698,7553,0.383953396001589,8220,38297,414,1194,43,5306,8,2103,26,8
"1038","2020-05-07",232,12,237,679,7553,0.383953396001589,8220,38297,414,1194,48,5354,9,2112,33,9
"1039","2020-05-08",254,12,234,637,7553,0.383953396001589,8220,38297,414,1194,42,5396,36,2148,19,36
"1040","2020-05-09",226,12,230,609,7553,0.383953396001589,8220,38297,414,1194,31,5427,43,2191,23,43
"1041","2020-05-10",190,12,223,578,7553,0.383953396001589,8220,38297,414,1194,37,5464,71,2262,21,71
"1042","2020-05-11",178,12,205,560,7553,0.383953396001589,8220,38297,414,1194,34,5498,25,2287,16,25
"1043","2020-05-12",168,12,206,525,7553,0.383953396001589,8220,38297,414,1194,45,5543,26,2313,27,26
"1044","2020-05-13",175,12,249,505,7553,0.383953396001589,8220,38297,414,1194,28,5571,52,2365,16,52
"1045","2020-05-14",171,12,272,480,7553,0.383953396001589,8220,38297,414,1194,26,5597,33,2398,13,33
"1046","2020-05-15",146,12,268,456,7553,0.383953396001589,8220,38297,414,1194,25,5622,25,2423,18,25
"1047","2020-05-16",150,12,262,449,7553,0.383953396001589,8220,38297,414,1194,19,5641,43,2466,11,43
"1048","2020-05-17",142,12,255,438,7553,0.383953396001589,8220,38297,414,1194,40,5681,26,2492,18,26
"1049","2020-05-18",142,12,247,435,7553,0.383953396001589,8220,38297,414,1194,27,5708,11,2503,14,11
"1050","2020-05-19",143,12,240,413,7553,0.383953396001589,8220,38297,414,1194,25,5733,13,2516,16,13
"1051","2020-05-20",132,12,224,396,7553,0.383953396001589,8220,38297,414,1194,20,5753,46,2562,10,46
"1052","2020-05-21",130,12,210,391,7553,0.383953396001589,8220,38297,414,1194,18,5771,26,2588,6,26
"1053","2020-05-22",117,12,215,368,7553,0.383953396001589,8220,38297,414,1194,19,5790,30,2618,9,30
"1054","2020-05-23",113,12,236,355,7553,0.383953396001589,8220,38297,414,1194,24,5814,24,2642,11,24
"1055","2020-05-24",109,12,241,334,7553,0.383953396001589,8220,38297,414,1194,17,5831,70,2712,7,70
"1056","2020-05-25",110,12,250,311,7553,0.383953396001589,8220,38297,414,1194,16,5847,60,2772,6,60
"1057","2020-05-26",110,12,237,284,7553,0.383953396001589,8220,38297,414,1194,23,5870,43,2815,8,43
"1058","2020-05-27",107,12,246,268,7553,0.383953396001589,8220,38297,414,1194,24,5894,22,2837,13,22
"1059","2020-05-28",111,12,256,259,7553,0.383953396001589,8220,38297,414,1194,20,5914,12,2849,8,12
"1060","2020-05-29",110,12,242,242,7553,0.383953396001589,8220,38297,414,1194,21,5935,40,2889,14,40
"1061","2020-05-30",109,12,240,221,7553,0.383953396001589,8220,38297,414,1194,14,5949,24,2913,6,24
"1062","2020-05-31",102,12,234,213,7553,0.383953396001589,8220,38297,414,1194,18,5967,75,2988,7,75
"1063","2020-06-01",88,12,257,195,7553,0.383953396001589,8220,38297,414,1194,14,5981,23,3011,9,24
"1064","2020-06-02",75,12,244,189,7553,0.383953396001589,8220,38297,414,1194,12,5993,32,3043,5,32
"1065","2020-06-03",74,12,242,174,7553,0.383953396001589,8220,38297,414,1194,5,5998,59,3102,3,59
"1066","2020-06-04",65,12,236,161,7553,0.383953396001589,8220,38297,414,1194,15,6013,62,3164,10,62
"1067","2020-06-05",65,12,232,156,7553,0.383953396001589,8220,38297,414,1194,14,6027,54,3218,6,54
"1068","2020-06-06",54,12,223,151,7553,0.383953396001589,8220,38297,414,1194,8,6035,38,3256,4,38
"1069","2020-06-07",46,12,231,143,7553,0.383953396001589,8220,38297,414,1194,13,6048,35,3291,7,35
"1070","2020-03-14",9,13,86,95,6510,0.775268817204301,8280,34005,354,990,62,211,6,45,19,6
"1071","2020-03-15",16,13,92,132,6510,0.775268817204301,8280,34005,354,990,77,288,12,57,25,12
"1072","2020-03-16",16,13,105,176,6510,0.775268817204301,8280,34005,354,990,98,386,18,75,29,18
"1073","2020-03-17",23,13,112,217,6510,0.775268817204301,8280,34005,354,990,69,455,15,90,35,15
"1074","2020-03-18",31,13,114,270,6510,0.775268817204301,8280,34005,354,990,122,577,15,105,60,15
"1075","2020-03-19",40,13,119,354,6510,0.775268817204301,8280,34005,354,990,88,665,10,115,47,10
"1076","2020-03-20",64,13,164,409,6510,0.775268817204301,8280,34005,354,990,125,790,25,140,82,25
"1077","2020-03-21",99,13,206,476,6510,0.775268817204301,8280,34005,354,990,107,897,22,162,65,22
"1078","2020-03-22",132,13,236,533,6510,0.775268817204301,8280,34005,354,990,116,1013,40,202,69,40
"1079","2020-03-23",147,13,219,610,6510,0.775268817204301,8280,34005,354,990,165,1178,26,228,117,26
"1080","2020-03-24",151,13,228,693,6510,0.775268817204301,8280,34005,354,990,132,1310,26,254,94,26
"1081","2020-03-25",174,13,223,763,6510,0.775268817204301,8280,34005,354,990,151,1461,32,286,114,32
"1082","2020-03-26",179,13,220,856,6510,0.775268817204301,8280,34005,354,990,141,1602,46,332,102,46
"1083","2020-03-27",259,13,234,931,6510,0.775268817204301,8280,34005,354,990,120,1722,52,384,79,52
"1084","2020-03-28",276,13,241,1043,6510,0.775268817204301,8280,34005,354,990,158,1880,54,438,123,54
"1085","2020-03-29",281,13,264,1125,6510,0.775268817204301,8280,34005,354,990,176,2056,52,490,139,52
"1086","2020-03-30",283,13,254,1211,6510,0.775268817204301,8280,34005,354,990,196,2252,40,530,146,40
"1087","2020-03-31",303,13,242,1300,6510,0.775268817204301,8280,34005,354,990,141,2393,27,557,98,27
"1088","2020-04-01",325,13,225,1380,6510,0.775268817204301,8280,34005,354,990,158,2551,39,596,108,39
"1089","2020-04-02",365,13,256,1445,6510,0.775268817204301,8280,34005,354,990,194,2745,27,623,144,27
"1090","2020-04-03",453,13,259,1534,6510,0.775268817204301,8280,34005,354,990,159,2904,30,653,126,30
"1091","2020-04-04",490,13,270,1594,6510,0.775268817204301,8280,34005,354,990,138,3042,32,685,100,32
"1092","2020-04-05",495,13,280,1672,6510,0.775268817204301,8280,34005,354,990,132,3174,22,707,100,22
"1093","2020-04-06",515,13,296,1750,6510,0.775268817204301,8280,34005,354,990,147,3321,17,724,114,17
"1094","2020-04-07",521,13,295,1775,6510,0.775268817204301,8280,34005,354,990,154,3475,18,742,118,18
"1095","2020-04-08",519,13,280,1793,6510,0.775268817204301,8280,34005,354,990,128,3603,22,764,84,22
"1096","2020-04-09",516,13,281,1827,6510,0.775268817204301,8280,34005,354,990,137,3740,40,804,98,40
"1097","2020-04-10",618,13,293,1819,6510,0.775268817204301,8280,34005,354,990,157,3897,50,854,117,50
"1098","2020-04-11",621,13,271,1846,6510,0.775268817204301,8280,34005,354,990,129,4026,25,879,86,25
"1099","2020-04-12",581,13,268,1836,6510,0.775268817204301,8280,34005,354,990,110,4136,31,910,70,31
"1100","2020-04-13",584,13,277,1850,6510,0.775268817204301,8280,34005,354,990,104,4240,58,968,75,58
"1101","2020-04-14",582,13,259,1841,6510,0.775268817204301,8280,34005,354,990,111,4351,27,995,78,27
"1102","2020-04-15",596,13,287,1822,6510,0.775268817204301,8280,34005,354,990,97,4448,24,1019,58,24
"1103","2020-04-16",609,13,279,1790,6510,0.775268817204301,8280,34005,354,990,100,4548,14,1033,64,14
"1104","2020-04-17",635,13,292,1759,6510,0.775268817204301,8280,34005,354,990,84,4632,23,1056,51,23
"1105","2020-04-18",649,13,276,1679,6510,0.775268817204301,8280,34005,354,990,73,4705,41,1097,48,41
"1106","2020-04-19",597,13,258,1650,6510,0.775268817204301,8280,34005,354,990,90,4795,24,1121,61,24
"1107","2020-04-20",595,13,238,1610,6510,0.775268817204301,8280,34005,354,990,66,4861,18,1139,41,18
"1108","2020-04-21",585,13,212,1535,6510,0.775268817204301,8280,34005,354,990,76,4937,59,1198,44,59
"1109","2020-04-22",573,13,202,1460,6510,0.775268817204301,8280,34005,354,990,72,5009,35,1233,39,35
"1110","2020-04-23",552,13,206,1395,6510,0.775268817204301,8280,34005,354,990,64,5073,22,1255,30,22
"1111","2020-04-24",538,13,221,1311,6510,0.775268817204301,8280,34005,354,990,79,5152,15,1270,45,15
"1112","2020-04-25",501,13,254,1222,6510,0.775268817204301,8280,34005,354,990,71,5223,20,1290,40,20
"1113","2020-04-26",442,13,273,1148,6510,0.775268817204301,8280,34005,354,990,68,5291,21,1311,38,21
"1114","2020-04-27",410,13,255,1051,6510,0.775268817204301,8280,34005,354,990,60,5351,45,1356,30,45
"1115","2020-04-28",387,13,271,969,6510,0.775268817204301,8280,34005,354,990,45,5396,37,1393,27,37
"1116","2020-04-29",383,13,294,897,6510,0.775268817204301,8280,34005,354,990,41,5437,21,1414,16,21
"1117","2020-04-30",369,13,297,829,6510,0.775268817204301,8280,34005,354,990,67,5504,15,1429,30,15
"1118","2020-05-01",312,13,285,784,6510,0.775268817204301,8280,34005,354,990,38,5542,31,1460,16,31
"1119","2020-05-02",294,13,295,731,6510,0.775268817204301,8280,34005,354,990,45,5587,34,1494,14,34
"1120","2020-05-03",285,13,330,682,6510,0.775268817204301,8280,34005,354,990,42,5629,58,1552,22,58
"1121","2020-05-04",275,13,335,646,6510,0.775268817204301,8280,34005,354,990,44,5673,43,1595,13,43
"1122","2020-05-05",259,13,308,596,6510,0.775268817204301,8280,34005,354,990,42,5715,26,1621,20,26
"1123","2020-05-06",234,13,314,565,6510,0.775268817204301,8280,34005,354,990,31,5746,20,1641,13,20
"1124","2020-05-07",225,13,303,523,6510,0.775268817204301,8280,34005,354,990,41,5787,28,1669,17,28
"1125","2020-05-08",200,13,287,498,6510,0.775268817204301,8280,34005,354,990,26,5813,41,1710,10,41
"1126","2020-05-09",193,13,275,461,6510,0.775268817204301,8280,34005,354,990,48,5861,45,1755,16,45
"1127","2020-05-10",169,13,262,416,6510,0.775268817204301,8280,34005,354,990,33,5894,22,1777,12,22
"1128","2020-05-11",153,13,258,380,6510,0.775268817204301,8280,34005,354,990,36,5930,32,1809,18,32
"1129","2020-05-12",141,13,272,369,6510,0.775268817204301,8280,34005,354,990,39,5969,43,1852,13,43
"1130","2020-05-13",133,13,258,358,6510,0.775268817204301,8280,34005,354,990,24,5993,48,1900,9,48
"1131","2020-05-14",124,13,268,331,6510,0.775268817204301,8280,34005,354,990,19,6012,27,1927,6,27
"1132","2020-05-15",120,13,257,297,6510,0.775268817204301,8280,34005,354,990,20,6032,35,1962,8,35
"1133","2020-05-16",116,13,252,273,6510,0.775268817204301,8280,34005,354,990,30,6062,17,1979,11,17
"1134","2020-05-17",109,13,255,260,6510,0.775268817204301,8280,34005,354,990,20,6082,17,1996,8,17
"1135","2020-05-18",104,13,262,236,6510,0.775268817204301,8280,34005,354,990,27,6109,30,2026,8,30
"1136","2020-05-19",100,13,269,230,6510,0.775268817204301,8280,34005,354,990,26,6135,27,2053,10,27
"1137","2020-05-20",91,13,265,222,6510,0.775268817204301,8280,34005,354,990,27,6162,16,2069,8,16
"1138","2020-05-21",87,13,246,209,6510,0.775268817204301,8280,34005,354,990,16,6178,13,2082,3,13
"1139","2020-05-22",73,13,236,184,6510,0.775268817204301,8280,34005,354,990,23,6201,13,2095,9,13
"1140","2020-05-23",74,13,249,164,6510,0.775268817204301,8280,34005,354,990,25,6226,13,2108,14,13
"1141","2020-05-24",64,13,241,147,6510,0.775268817204301,8280,34005,354,990,18,6244,39,2147,8,39
"1142","2020-05-25",56,13,248,140,6510,0.775268817204301,8280,34005,354,990,20,6264,21,2168,4,21
"1143","2020-05-26",53,13,257,124,6510,0.775268817204301,8280,34005,354,990,19,6283,11,2179,7,11
"1144","2020-05-27",51,13,254,115,6510,0.775268817204301,8280,34005,354,990,16,6299,11,2190,5,11
"1145","2020-05-28",46,13,243,112,6510,0.775268817204301,8280,34005,354,990,17,6316,30,2220,5,30
"1146","2020-05-29",44,13,229,103,6510,0.775268817204301,8280,34005,354,990,11,6327,40,2260,6,40
"1147","2020-05-30",39,13,217,100,6510,0.775268817204301,8280,34005,354,990,17,6344,45,2305,4,45
"1148","2020-05-31",39,13,245,101,6510,0.775268817204301,8280,34005,354,990,17,6361,35,2340,8,35
"1149","2020-06-01",37,13,246,95,6510,0.775268817204301,8280,34005,354,990,13,6374,36,2376,2,36
"1150","2020-06-02",31,13,233,83,6510,0.775268817204301,8280,34005,354,990,13,6387,40,2416,5,40
"1151","2020-06-03",26,13,239,81,6510,0.775268817204301,8280,34005,354,990,14,6401,14,2430,1,14
"1152","2020-06-04",28,13,218,77,6510,0.775268817204301,8280,34005,354,990,15,6416,21,2451,4,21
"1153","2020-06-05",26,13,201,73,6510,0.775268817204301,8280,34005,354,990,13,6429,32,2483,6,32
"1154","2020-06-06",21,13,194,71,6510,0.775268817204301,8280,34005,354,990,12,6441,12,2495,5,12
"1155","2020-06-07",23,13,216,70,6510,0.775268817204301,8280,34005,354,990,11,6452,30,2525,3,30
"1156","2020-03-13",1,14,101,105,7012,0.797632629777524,8370,34508,411,1672,61,159,82,167,24,82
"1157","2020-03-14",7,14,121,160,7012,0.797632629777524,8370,34508,411,1672,85,244,71,238,41,71
"1158","2020-03-15",16,14,120,211,7012,0.797632629777524,8370,34508,411,1672,83,327,74,312,53,74
"1159","2020-03-16",27,14,109,264,7012,0.797632629777524,8370,34508,411,1672,84,411,29,341,52,29
"1160","2020-03-17",43,14,149,355,7012,0.797632629777524,8370,34508,411,1672,104,515,47,388,65,47
"1161","2020-03-18",57,14,187,439,7012,0.797632629777524,8370,34508,411,1672,125,640,50,438,92,50
"1162","2020-03-19",70,14,194,523,7012,0.797632629777524,8370,34508,411,1672,101,741,33,471,71,33
"1163","2020-03-20",114,14,208,643,7012,0.797632629777524,8370,34508,411,1672,113,854,32,503,79,32
"1164","2020-03-21",138,14,203,739,7012,0.797632629777524,8370,34508,411,1672,96,950,21,524,68,21
"1165","2020-03-22",200,14,186,848,7012,0.797632629777524,8370,34508,411,1672,135,1085,21,545,104,21
"1166","2020-03-23",210,14,187,940,7012,0.797632629777524,8370,34508,411,1672,115,1200,15,560,90,15
"1167","2020-03-24",205,14,218,1080,7012,0.797632629777524,8370,34508,411,1672,146,1346,13,573,108,13
"1168","2020-03-25",225,14,246,1211,7012,0.797632629777524,8370,34508,411,1672,131,1477,6,579,98,6
"1169","2020-03-26",254,14,235,1306,7012,0.797632629777524,8370,34508,411,1672,138,1615,6,585,108,6
"1170","2020-03-27",360,14,227,1449,7012,0.797632629777524,8370,34508,411,1672,153,1768,6,591,114,6
"1171","2020-03-28",390,14,227,1545,7012,0.797632629777524,8370,34508,411,1672,118,1886,11,602,81,11
"1172","2020-03-29",411,14,212,1609,7012,0.797632629777524,8370,34508,411,1672,130,2016,17,619,85,17
"1173","2020-03-30",425,14,227,1723,7012,0.797632629777524,8370,34508,411,1672,136,2152,53,672,100,53
"1174","2020-03-31",449,14,226,1775,7012,0.797632629777524,8370,34508,411,1672,123,2275,22,694,82,22
"1175","2020-04-01",484,14,273,1848,7012,0.797632629777524,8370,34508,411,1672,132,2407,7,701,103,7
"1176","2020-04-02",524,14,305,1909,7012,0.797632629777524,8370,34508,411,1672,146,2553,23,724,108,23
"1177","2020-04-03",604,14,327,1996,7012,0.797632629777524,8370,34508,411,1672,149,2702,46,770,116,46
"1178","2020-04-04",707,14,323,2018,7012,0.797632629777524,8370,34508,411,1672,139,2841,28,798,109,28
"1179","2020-04-05",675,14,303,2093,7012,0.797632629777524,8370,34508,411,1672,124,2965,20,818,99,20
"1180","2020-04-06",671,14,296,2105,7012,0.797632629777524,8370,34508,411,1672,121,3086,20,838,88,20
"1181","2020-04-07",683,14,275,2131,7012,0.797632629777524,8370,34508,411,1672,115,3201,12,850,79,12
"1182","2020-04-08",690,14,267,2111,7012,0.797632629777524,8370,34508,411,1672,112,3313,34,884,71,34
"1183","2020-04-09",688,14,245,2078,7012,0.797632629777524,8370,34508,411,1672,123,3436,16,900,96,16
"1184","2020-04-10",805,14,244,2005,7012,0.797632629777524,8370,34508,411,1672,89,3525,23,923,68,23
"1185","2020-04-11",746,14,240,1946,7012,0.797632629777524,8370,34508,411,1672,112,3637,14,937,79,14
"1186","2020-04-12",673,14,224,1902,7012,0.797632629777524,8370,34508,411,1672,100,3737,14,951,73,14
"1187","2020-04-13",670,14,217,1815,7012,0.797632629777524,8370,34508,411,1672,107,3844,16,967,77,16
"1188","2020-04-14",640,14,211,1723,7012,0.797632629777524,8370,34508,411,1672,102,3946,56,1023,68,56
"1189","2020-04-15",629,14,225,1647,7012,0.797632629777524,8370,34508,411,1672,94,4040,41,1064,64,41
"1190","2020-04-16",598,14,239,1523,7012,0.797632629777524,8370,34508,411,1672,93,4133,24,1088,64,24
"1191","2020-04-17",538,14,236,1438,7012,0.797632629777524,8370,34508,411,1672,81,4214,26,1114,55,26
"1192","2020-04-18",504,14,246,1339,7012,0.797632629777524,8370,34508,411,1672,82,4296,21,1135,50,21
"1193","2020-04-19",458,14,255,1268,7012,0.797632629777524,8370,34508,411,1672,73,4369,15,1150,47,15
"1194","2020-04-20",432,14,265,1199,7012,0.797632629777524,8370,34508,411,1672,93,4462,11,1161,54,11
"1195","2020-04-21",410,14,245,1118,7012,0.797632629777524,8370,34508,411,1672,68,4530,12,1173,45,12
"1196","2020-04-22",391,14,246,1061,7012,0.797632629777524,8370,34508,411,1672,86,4616,30,1203,54,30
"1197","2020-04-23",381,14,224,1023,7012,0.797632629777524,8370,34508,411,1672,91,4707,7,1210,62,7
"1198","2020-04-24",330,14,214,971,7012,0.797632629777524,8370,34508,411,1672,62,4769,19,1229,38,19
"1199","2020-04-25",340,14,207,909,7012,0.797632629777524,8370,34508,411,1672,72,4841,37,1266,46,37
"1200","2020-04-26",319,14,219,859,7012,0.797632629777524,8370,34508,411,1672,70,4911,30,1296,44,30
"1201","2020-04-27",314,14,247,806,7012,0.797632629777524,8370,34508,411,1672,56,4967,17,1313,30,17
"1202","2020-04-28",295,14,281,755,7012,0.797632629777524,8370,34508,411,1672,51,5018,12,1325,38,12
"1203","2020-04-29",278,14,302,727,7012,0.797632629777524,8370,34508,411,1672,59,5077,16,1341,35,16
"1204","2020-04-30",262,14,290,705,7012,0.797632629777524,8370,34508,411,1672,58,5135,9,1350,36,9
"1205","2020-05-01",272,14,272,669,7012,0.797632629777524,8370,34508,411,1672,54,5189,9,1359,36,9
"1206","2020-05-02",271,14,271,646,7012,0.797632629777524,8370,34508,411,1672,54,5243,12,1371,29,12
"1207","2020-05-03",233,14,286,614,7012,0.797632629777524,8370,34508,411,1672,54,5297,65,1436,34,65
"1208","2020-05-04",225,14,278,574,7012,0.797632629777524,8370,34508,411,1672,54,5351,55,1491,33,55
"1209","2020-05-05",222,14,274,529,7012,0.797632629777524,8370,34508,411,1672,48,5399,36,1527,28,36
"1210","2020-05-06",211,14,276,484,7012,0.797632629777524,8370,34508,411,1672,58,5457,33,1560,33,33
"1211","2020-05-07",201,14,281,455,7012,0.797632629777524,8370,34508,411,1672,50,5507,30,1590,31,30
"1212","2020-05-08",195,14,271,416,7012,0.797632629777524,8370,34508,411,1672,41,5548,22,1612,31,22
"1213","2020-05-09",169,14,264,399,7012,0.797632629777524,8370,34508,411,1672,43,5591,22,1634,22,22
"1214","2020-05-10",161,14,240,381,7012,0.797632629777524,8370,34508,411,1672,40,5631,16,1650,23,16
"1215","2020-05-11",150,14,256,345,7012,0.797632629777524,8370,34508,411,1672,31,5662,31,1681,17,31
"1216","2020-05-12",137,14,273,333,7012,0.797632629777524,8370,34508,411,1672,47,5709,43,1724,28,43
"1217","2020-05-13",131,14,297,330,7012,0.797632629777524,8370,34508,411,1672,37,5746,32,1756,20,32
"1218","2020-05-14",133,14,299,319,7012,0.797632629777524,8370,34508,411,1672,44,5790,10,1766,28,10
"1219","2020-05-15",108,14,296,286,7012,0.797632629777524,8370,34508,411,1672,24,5814,11,1777,11,11
"1220","2020-05-16",108,14,271,263,7012,0.797632629777524,8370,34508,411,1672,19,5833,7,1784,10,7
"1221","2020-05-17",96,14,269,255,7012,0.797632629777524,8370,34508,411,1672,31,5864,44,1828,24,44
"1222","2020-05-18",90,14,271,248,7012,0.797632629777524,8370,34508,411,1672,36,5900,22,1850,28,22
"1223","2020-05-19",90,14,262,251,7012,0.797632629777524,8370,34508,411,1672,29,5929,22,1872,14,22
"1224","2020-05-20",90,14,243,237,7012,0.797632629777524,8370,34508,411,1672,18,5947,9,1881,7,9
"1225","2020-05-21",84,14,242,231,7012,0.797632629777524,8370,34508,411,1672,26,5973,10,1891,16,10
"1226","2020-05-22",73,14,234,231,7012,0.797632629777524,8370,34508,411,1672,26,5999,47,1938,11,47
"1227","2020-05-23",81,14,251,220,7012,0.797632629777524,8370,34508,411,1672,13,6012,67,2005,6,67
"1228","2020-05-24",78,14,261,210,7012,0.797632629777524,8370,34508,411,1672,22,6034,54,2059,14,54
"1229","2020-05-25",76,14,244,198,7012,0.797632629777524,8370,34508,411,1672,26,6060,28,2087,17,28
"1230","2020-05-26",74,14,251,174,7012,0.797632629777524,8370,34508,411,1672,19,6079,20,2107,11,20
"1231","2020-05-27",74,14,239,171,7012,0.797632629777524,8370,34508,411,1672,21,6100,12,2119,13,12
"1232","2020-05-28",69,14,218,163,7012,0.797632629777524,8370,34508,411,1672,11,6111,11,2130,5,11
"1233","2020-05-29",73,14,215,150,7012,0.797632629777524,8370,34508,411,1672,28,6139,9,2139,14,9
"1234","2020-05-30",58,14,204,149,7012,0.797632629777524,8370,34508,411,1672,17,6156,44,2183,10,44
"1235","2020-05-31",51,14,191,137,7012,0.797632629777524,8370,34508,411,1672,17,6173,26,2209,13,26
"1236","2020-06-01",43,14,178,121,7012,0.797632629777524,8370,34508,411,1672,21,6194,21,2230,6,21
"1237","2020-06-02",44,14,220,109,7012,0.797632629777524,8370,34508,411,1672,15,6209,25,2255,13,25
"1238","2020-06-03",38,14,227,103,7012,0.797632629777524,8370,34508,411,1672,18,6227,20,2275,9,20
"1239","2020-06-04",39,14,218,96,7012,0.797632629777524,8370,34508,411,1672,22,6249,35,2310,16,35
"1240","2020-06-05",38,14,209,91,7012,0.797632629777524,8370,34508,411,1672,13,6262,29,2339,8,29
"1241","2020-06-06",37,14,212,87,7012,0.797632629777524,8370,34508,411,1672,14,6276,70,2409,6,70
"1242","2020-06-07",39,14,231,85,7012,0.797632629777524,8370,34508,411,1672,18,6294,63,2472,10,63
"1243","2020-03-13",10,15,309,307,8622,0.415912781257249,8355,40536,428,2029,78,275,32,86,8,32
"1244","2020-03-14",39,15,321,455,8622,0.415912781257249,8355,40536,428,2029,81,356,24,110,15,24
"1245","2020-03-15",80,15,339,580,8622,0.415912781257249,8355,40536,428,2029,104,460,40,150,24,40
"1246","2020-03-16",81,15,307,711,8622,0.415912781257249,8355,40536,428,2029,132,592,33,183,53,33
"1247","2020-03-17",97,15,304,868,8622,0.415912781257249,8355,40536,428,2029,114,706,20,203,48,20
"1248","2020-03-18",132,15,335,1015,8622,0.415912781257249,8355,40536,428,2029,105,811,6,209,43,6
"1249","2020-03-19",167,15,315,1147,8622,0.415912781257249,8355,40536,428,2029,154,965,12,221,66,12
"1250","2020-03-20",281,15,281,1261,8622,0.415912781257249,8355,40536,428,2029,134,1099,34,255,64,34
"1251","2020-03-21",317,15,251,1375,8622,0.415912781257249,8355,40536,428,2029,134,1233,28,283,46,28
"1252","2020-03-22",368,15,221,1494,8622,0.415912781257249,8355,40536,428,2029,140,1373,42,325,68,42
"1253","2020-03-23",398,15,213,1587,8622,0.415912781257249,8355,40536,428,2029,141,1514,49,374,61,49
"1254","2020-03-24",408,15,205,1639,8622,0.415912781257249,8355,40536,428,2029,132,1646,52,426,66,52
"1255","2020-03-25",437,15,178,1709,8622,0.415912781257249,8355,40536,428,2029,160,1806,38,464,77,38
"1256","2020-03-26",467,15,192,1736,8622,0.415912781257249,8355,40536,428,2029,136,1942,56,520,67,56
"1257","2020-03-27",574,15,189,1781,8622,0.415912781257249,8355,40536,428,2029,154,2096,36,556,71,36
"1258","2020-03-28",625,15,221,1805,8622,0.415912781257249,8355,40536,428,2029,145,2241,41,597,75,41
"1259","2020-03-29",547,15,247,1755,8622,0.415912781257249,8355,40536,428,2029,132,2373,35,632,66,35
"1260","2020-03-30",552,15,255,1755,8622,0.415912781257249,8355,40536,428,2029,150,2523,63,695,69,63
"1261","2020-03-31",566,15,337,1747,8622,0.415912781257249,8355,40536,428,2029,132,2655,55,750,53,55
"1262","2020-04-01",573,15,372,1756,8622,0.415912781257249,8355,40536,428,2029,141,2796,49,799,78,49
"1263","2020-04-02",558,15,351,1746,8622,0.415912781257249,8355,40536,428,2029,150,2946,54,853,67,54
"1264","2020-04-03",627,15,313,1749,8622,0.415912781257249,8355,40536,428,2029,143,3089,33,886,73,33
"1265","2020-04-04",600,15,286,1754,8622,0.415912781257249,8355,40536,428,2029,124,3213,22,908,53,22
"1266","2020-04-05",556,15,267,1753,8622,0.415912781257249,8355,40536,428,2029,137,3350,17,925,61,17
"1267","2020-04-06",536,15,239,1753,8622,0.415912781257249,8355,40536,428,2029,119,3469,46,971,52,46
"1268","2020-04-07",540,15,219,1734,8622,0.415912781257249,8355,40536,428,2029,144,3613,52,1023,72,52
"1269","2020-04-08",534,15,212,1713,8622,0.415912781257249,8355,40536,428,2029,119,3732,34,1057,55,34
"1270","2020-04-09",533,15,225,1689,8622,0.415912781257249,8355,40536,428,2029,113,3845,17,1074,45,17
"1271","2020-04-10",555,15,262,1659,8622,0.415912781257249,8355,40536,428,2029,115,3960,24,1098,50,24
"1272","2020-04-11",574,15,257,1601,8622,0.415912781257249,8355,40536,428,2029,106,4066,54,1152,44,54
"1273","2020-04-12",521,15,243,1543,8622,0.415912781257249,8355,40536,428,2029,122,4188,27,1179,53,27
"1274","2020-04-13",518,15,269,1508,8622,0.415912781257249,8355,40536,428,2029,93,4281,31,1210,34,31
"1275","2020-04-14",487,15,262,1469,8622,0.415912781257249,8355,40536,428,2029,105,4386,53,1263,48,53
"1276","2020-04-15",475,15,268,1436,8622,0.415912781257249,8355,40536,428,2029,101,4487,28,1291,36,28
"1277","2020-04-16",469,15,246,1412,8622,0.415912781257249,8355,40536,428,2029,95,4582,23,1314,36,23
"1278","2020-04-17",445,15,237,1376,8622,0.415912781257249,8355,40536,428,2029,95,4677,26,1340,36,26
"1279","2020-04-18",430,15,232,1318,8622,0.415912781257249,8355,40536,428,2029,80,4757,53,1393,29,53
"1280","2020-04-19",443,15,222,1263,8622,0.415912781257249,8355,40536,428,2029,71,4828,33,1426,18,33
"1281","2020-04-20",434,15,261,1226,8622,0.415912781257249,8355,40536,428,2029,73,4901,41,1467,13,41
"1282","2020-04-21",424,15,283,1184,8622,0.415912781257249,8355,40536,428,2029,62,4963,18,1485,22,18
"1283","2020-04-22",414,15,269,1127,8622,0.415912781257249,8355,40536,428,2029,72,5035,14,1499,29,14
"1284","2020-04-23",398,15,271,1105,8622,0.415912781257249,8355,40536,428,2029,84,5119,19,1518,22,19
"1285","2020-04-24",411,15,268,1081,8622,0.415912781257249,8355,40536,428,2029,64,5183,15,1533,14,15
"1286","2020-04-25",407,15,264,1019,8622,0.415912781257249,8355,40536,428,2029,60,5243,13,1546,15,13
"1287","2020-04-26",337,15,238,991,8622,0.415912781257249,8355,40536,428,2029,74,5317,12,1558,22,12
"1288","2020-04-27",315,15,259,963,8622,0.415912781257249,8355,40536,428,2029,58,5375,37,1595,13,37
"1289","2020-04-28",305,15,244,937,8622,0.415912781257249,8355,40536,428,2029,50,5425,27,1622,13,27
"1290","2020-04-29",289,15,238,913,8622,0.415912781257249,8355,40536,428,2029,66,5491,24,1646,16,24
"1291","2020-04-30",302,15,237,905,8622,0.415912781257249,8355,40536,428,2029,58,5549,14,1660,15,14
"1292","2020-05-01",310,15,306,880,8622,0.415912781257249,8355,40536,428,2029,55,5604,52,1712,17,52
"1293","2020-05-02",299,15,314,859,8622,0.415912781257249,8355,40536,428,2029,51,5655,33,1745,16,33
"1294","2020-05-03",284,15,330,841,8622,0.415912781257249,8355,40536,428,2029,48,5703,51,1796,10,51
"1295","2020-05-04",280,15,302,796,8622,0.415912781257249,8355,40536,428,2029,51,5754,26,1822,13,26
"1296","2020-05-05",266,15,270,776,8622,0.415912781257249,8355,40536,428,2029,61,5815,16,1838,9,16
"1297","2020-05-06",270,15,264,730,8622,0.415912781257249,8355,40536,428,2029,52,5867,18,1856,9,18
"1298","2020-05-07",252,15,300,688,8622,0.415912781257249,8355,40536,428,2029,45,5912,11,1867,7,11
"1299","2020-05-08",235,15,306,663,8622,0.415912781257249,8355,40536,428,2029,43,5955,13,1880,8,13
"1300","2020-05-09",235,15,298,628,8622,0.415912781257249,8355,40536,428,2029,57,6012,15,1895,12,15
"1301","2020-05-10",211,15,283,602,8622,0.415912781257249,8355,40536,428,2029,34,6046,14,1909,5,14
"1302","2020-05-11",199,15,258,568,8622,0.415912781257249,8355,40536,428,2029,48,6094,27,1936,16,27
"1303","2020-05-12",200,15,232,533,8622,0.415912781257249,8355,40536,428,2029,38,6132,51,1987,3,51
"1304","2020-05-13",180,15,207,502,8622,0.415912781257249,8355,40536,428,2029,34,6166,57,2044,7,57
"1305","2020-05-14",167,15,207,494,8622,0.415912781257249,8355,40536,428,2029,21,6187,30,2074,1,30
"1306","2020-05-15",153,15,199,467,8622,0.415912781257249,8355,40536,428,2029,32,6219,18,2092,3,18
"1307","2020-05-16",131,15,176,437,8622,0.415912781257249,8355,40536,428,2029,30,6249,49,2141,11,49
"1308","2020-05-17",122,15,162,409,8622,0.415912781257249,8355,40536,428,2029,19,6268,53,2194,3,53
"1309","2020-05-18",115,15,164,383,8622,0.415912781257249,8355,40536,428,2029,25,6293,48,2242,10,48
"1310","2020-05-19",94,15,182,356,8622,0.415912781257249,8355,40536,428,2029,31,6324,59,2301,4,59
"1311","2020-05-20",96,15,248,338,8622,0.415912781257249,8355,40536,428,2029,23,6347,46,2347,3,46
"1312","2020-05-21",102,15,240,334,8622,0.415912781257249,8355,40536,428,2029,17,6364,30,2377,1,30
"1313","2020-05-22",89,15,237,320,8622,0.415912781257249,8355,40536,428,2029,25,6389,33,2410,3,33
"1314","2020-05-23",92,15,246,320,8622,0.415912781257249,8355,40536,428,2029,25,6414,41,2451,6,41
"1315","2020-05-24",88,15,281,312,8622,0.415912781257249,8355,40536,428,2029,22,6436,24,2475,7,24
"1316","2020-05-25",94,15,267,293,8622,0.415912781257249,8355,40536,428,2029,22,6458,28,2503,5,28
"1317","2020-05-26",98,15,245,289,8622,0.415912781257249,8355,40536,428,2029,23,6481,47,2550,NA,47
"1318","2020-05-27",100,15,267,279,8622,0.415912781257249,8355,40536,428,2029,17,6498,20,2570,4,20
"1319","2020-05-28",99,15,266,265,8622,0.415912781257249,8355,40536,428,2029,20,6518,16,2586,6,16
"1320","2020-05-29",99,15,291,260,8622,0.415912781257249,8355,40536,428,2029,18,6536,18,2604,2,18
"1321","2020-05-30",99,15,318,250,8622,0.415912781257249,8355,40536,428,2029,16,6552,49,2653,4,49
"1322","2020-05-31",83,15,293,238,8622,0.415912781257249,8355,40536,428,2029,14,6566,38,2691,4,38
"1323","2020-06-01",74,15,269,234,8622,0.415912781257249,8355,40536,428,2029,20,6586,29,2720,2,29
"1324","2020-06-02",76,15,261,223,8622,0.415912781257249,8355,40536,428,2029,8,6594,18,2738,2,18
"1325","2020-06-03",68,15,249,204,8622,0.415912781257249,8355,40536,428,2029,14,6608,9,2747,3,9
"1326","2020-06-04",57,15,228,188,8622,0.415912781257249,8355,40536,428,2029,14,6622,32,2779,2,32
"1327","2020-06-05",51,15,213,179,8622,0.415912781257249,8355,40536,428,2029,14,6636,21,2800,3,21
"1328","2020-06-06",55,15,206,165,8622,0.415912781257249,8355,40536,428,2029,12,6648,13,2813,2,13
"1329","2020-06-07",51,15,206,154,8622,0.415912781257249,8355,40536,428,2029,10,6658,20,2833,2,20
"1330","2020-03-13",2,16,96,66,6963,0.770644836995548,8295,32692,336,1652,75,194,62,149,16,62
"1331","2020-03-14",6,16,132,100,6963,0.770644836995548,8295,32692,336,1652,80,274,42,191,29,42
"1332","2020-03-15",7,16,168,138,6963,0.770644836995548,8295,32692,336,1652,79,353,61,252,20,61
"1333","2020-03-16",14,16,172,185,6963,0.770644836995548,8295,32692,336,1652,93,446,52,304,30,52
"1334","2020-03-17",22,16,174,244,6963,0.770644836995548,8295,32692,336,1652,126,572,57,361,69,57
"1335","2020-03-18",29,16,169,315,6963,0.770644836995548,8295,32692,336,1652,110,682,51,412,59,51
"1336","2020-03-19",36,16,211,400,6963,0.770644836995548,8295,32692,336,1652,139,821,37,449,80,37
"1337","2020-03-20",63,16,228,477,6963,0.770644836995548,8295,32692,336,1652,123,944,50,499,65,50
"1338","2020-03-21",111,16,232,555,6963,0.770644836995548,8295,32692,336,1652,118,1062,53,552,65,53
"1339","2020-03-22",143,16,225,644,6963,0.770644836995548,8295,32692,336,1652,148,1210,64,616,91,64
"1340","2020-03-23",147,16,208,748,6963,0.770644836995548,8295,32692,336,1652,149,1359,64,680,84,64
"1341","2020-03-24",167,16,234,837,6963,0.770644836995548,8295,32692,336,1652,143,1502,43,723,113,43
"1342","2020-03-25",195,16,251,955,6963,0.770644836995548,8295,32692,336,1652,146,1648,33,756,103,33
"1343","2020-03-26",215,16,224,1082,6963,0.770644836995548,8295,32692,336,1652,171,1819,35,791,107,35
"1344","2020-03-27",296,16,222,1185,6963,0.770644836995548,8295,32692,336,1652,194,2013,32,823,140,32
"1345","2020-03-28",336,16,211,1285,6963,0.770644836995548,8295,32692,336,1652,187,2200,43,866,124,43
"1346","2020-03-29",358,16,215,1401,6963,0.770644836995548,8295,32692,336,1652,185,2385,38,904,121,38
"1347","2020-03-30",364,16,197,1495,6963,0.770644836995548,8295,32692,336,1652,176,2561,44,948,108,44
"1348","2020-03-31",381,16,196,1639,6963,0.770644836995548,8295,32692,336,1652,185,2746,31,979,136,31
"1349","2020-04-01",401,16,248,1707,6963,0.770644836995548,8295,32692,336,1652,167,2913,35,1014,105,35
"1350","2020-04-02",431,16,270,1829,6963,0.770644836995548,8295,32692,336,1652,178,3091,26,1040,129,26
"1351","2020-04-03",583,16,289,1874,6963,0.770644836995548,8295,32692,336,1652,167,3258,33,1073,114,33
"1352","2020-04-04",596,16,262,1990,6963,0.770644836995548,8295,32692,336,1652,150,3408,40,1113,98,40
"1353","2020-04-05",600,16,249,2048,6963,0.770644836995548,8295,32692,336,1652,161,3569,15,1128,103,15
"1354","2020-04-06",618,16,220,2069,6963,0.770644836995548,8295,32692,336,1652,140,3709,29,1157,87,29
"1355","2020-04-07",633,16,215,2120,6963,0.770644836995548,8295,32692,336,1652,124,3833,38,1195,82,38
"1356","2020-04-08",656,16,204,2208,6963,0.770644836995548,8295,32692,336,1652,128,3961,33,1228,78,33
"1357","2020-04-09",669,16,192,2240,6963,0.770644836995548,8295,32692,336,1652,126,4087,48,1276,76,48
"1358","2020-04-10",737,16,197,2213,6963,0.770644836995548,8295,32692,336,1652,120,4207,47,1323,72,47
"1359","2020-04-11",737,16,250,2162,6963,0.770644836995548,8295,32692,336,1652,128,4335,35,1358,85,35
"1360","2020-04-12",708,16,274,2171,6963,0.770644836995548,8295,32692,336,1652,115,4450,38,1396,71,38
"1361","2020-04-13",720,16,265,2123,6963,0.770644836995548,8295,32692,336,1652,132,4582,40,1436,87,41
"1362","2020-04-14",709,16,278,2072,6963,0.770644836995548,8295,32692,336,1652,107,4689,35,1471,62,35
"1363","2020-04-15",710,16,321,2041,6963,0.770644836995548,8295,32692,336,1652,108,4797,27,1498,62,27
"1364","2020-04-16",698,16,282,1949,6963,0.770644836995548,8295,32692,336,1652,89,4886,29,1527,50,29
"1365","2020-04-17",709,16,252,1815,6963,0.770644836995548,8295,32692,336,1652,99,4985,29,1556,58,29
"1366","2020-04-18",689,16,256,1768,6963,0.770644836995548,8295,32692,336,1652,82,5067,39,1595,41,39
"1367","2020-04-19",637,16,249,1690,6963,0.770644836995548,8295,32692,336,1652,72,5139,36,1631,38,36
"1368","2020-04-20",614,16,229,1596,6963,0.770644836995548,8295,32692,336,1652,67,5206,34,1665,31,34
"1369","2020-04-21",584,16,226,1479,6963,0.770644836995548,8295,32692,336,1652,68,5274,27,1692,33,27
"1370","2020-04-22",561,16,218,1353,6963,0.770644836995548,8295,32692,336,1652,69,5343,33,1725,35,33
"1371","2020-04-23",562,16,242,1266,6963,0.770644836995548,8295,32692,336,1652,56,5399,32,1757,25,32
"1372","2020-04-24",483,16,258,1160,6963,0.770644836995548,8295,32692,336,1652,82,5481,27,1784,42,27
"1373","2020-04-25",454,16,248,1067,6963,0.770644836995548,8295,32692,336,1652,57,5538,34,1818,32,34
"1374","2020-04-26",411,16,242,1002,6963,0.770644836995548,8295,32692,336,1652,75,5613,17,1835,32,17
"1375","2020-04-27",390,16,217,921,6963,0.770644836995548,8295,32692,336,1652,58,5671,25,1860,19,25
"1376","2020-04-28",361,16,238,840,6963,0.770644836995548,8295,32692,336,1652,61,5732,37,1897,31,37
"1377","2020-04-29",331,16,247,768,6963,0.770644836995548,8295,32692,336,1652,63,5795,45,1942,29,45
"1378","2020-04-30",290,16,259,707,6963,0.770644836995548,8295,32692,336,1652,52,5847,28,1970,17,28
"1379","2020-05-01",259,16,248,641,6963,0.770644836995548,8295,32692,336,1652,39,5886,29,1999,18,29
"1380","2020-05-02",271,16,251,585,6963,0.770644836995548,8295,32692,336,1652,51,5937,36,2035,26,36
"1381","2020-05-03",233,16,256,538,6963,0.770644836995548,8295,32692,336,1652,33,5970,38,2073,12,38
"1382","2020-05-04",213,16,259,503,6963,0.770644836995548,8295,32692,336,1652,48,6018,40,2113,16,40
"1383","2020-05-05",201,16,259,453,6963,0.770644836995548,8295,32692,336,1652,33,6051,27,2140,17,27
"1384","2020-05-06",190,16,310,424,6963,0.770644836995548,8295,32692,336,1652,40,6091,48,2188,17,48
"1385","2020-05-07",190,16,313,388,6963,0.770644836995548,8295,32692,336,1652,21,6112,37,2225,12,37
"1386","2020-05-08",162,16,309,358,6963,0.770644836995548,8295,32692,336,1652,39,6151,30,2255,13,30
"1387","2020-05-09",152,16,272,330,6963,0.770644836995548,8295,32692,336,1652,32,6183,34,2289,9,34
"1388","2020-05-10",130,16,271,294,6963,0.770644836995548,8295,32692,336,1652,33,6216,43,2332,13,43
"1389","2020-05-11",120,16,297,280,6963,0.770644836995548,8295,32692,336,1652,30,6246,36,2368,10,36
"1390","2020-05-12",109,16,290,245,6963,0.770644836995548,8295,32692,336,1652,24,6270,28,2396,7,28
"1391","2020-05-13",105,16,286,216,6963,0.770644836995548,8295,32692,336,1652,17,6287,26,2422,5,26
"1392","2020-05-14",94,16,282,206,6963,0.770644836995548,8295,32692,336,1652,22,6309,27,2449,7,27
"1393","2020-05-15",80,16,274,186,6963,0.770644836995548,8295,32692,336,1652,27,6336,46,2495,9,46
"1394","2020-05-16",67,16,256,170,6963,0.770644836995548,8295,32692,336,1652,15,6351,31,2526,7,31
"1395","2020-05-17",62,16,230,168,6963,0.770644836995548,8295,32692,336,1652,24,6375,39,2565,8,39
"1396","2020-05-18",62,16,249,156,6963,0.770644836995548,8295,32692,336,1652,18,6393,31,2596,6,31
"1397","2020-05-19",57,16,232,144,6963,0.770644836995548,8295,32692,336,1652,27,6420,35,2631,5,35
"1398","2020-05-20",53,16,246,136,6963,0.770644836995548,8295,32692,336,1652,15,6435,27,2658,4,27
"1399","2020-05-21",50,16,245,136,6963,0.770644836995548,8295,32692,336,1652,16,6451,37,2695,4,37
"1400","2020-05-22",47,16,216,134,6963,0.770644836995548,8295,32692,336,1652,26,6477,43,2738,8,43
"1401","2020-05-23",44,16,204,131,6963,0.770644836995548,8295,32692,336,1652,23,6500,51,2789,10,51
"1402","2020-05-24",42,16,192,130,6963,0.770644836995548,8295,32692,336,1652,20,6520,32,2821,3,32
"1403","2020-05-25",37,16,187,124,6963,0.770644836995548,8295,32692,336,1652,16,6536,47,2868,3,47
"1404","2020-05-26",38,16,231,121,6963,0.770644836995548,8295,32692,336,1652,19,6555,33,2901,5,33
"1405","2020-05-27",34,16,233,122,6963,0.770644836995548,8295,32692,336,1652,8,6563,59,2960,4,59
"1406","2020-05-28",33,16,225,119,6963,0.770644836995548,8295,32692,336,1652,14,6577,49,3009,8,49
"1407","2020-05-29",35,16,211,115,6963,0.770644836995548,8295,32692,336,1652,14,6591,49,3058,4,49
"1408","2020-05-30",38,16,212,112,6963,0.770644836995548,8295,32692,336,1652,12,6603,43,3101,5,43
"1409","2020-05-31",37,16,222,108,6963,0.770644836995548,8295,32692,336,1652,10,6613,43,3144,1,43
"1410","2020-06-01",37,16,250,109,6963,0.770644836995548,8295,32692,336,1652,23,6636,48,3192,9,48
"1411","2020-06-02",34,16,260,98,6963,0.770644836995548,8295,32692,336,1652,11,6647,39,3231,2,39
"1412","2020-06-03",33,16,258,94,6963,0.770644836995548,8295,32692,336,1652,12,6659,48,3279,2,48
"1413","2020-06-04",33,16,234,85,6963,0.770644836995548,8295,32692,336,1652,10,6669,34,3313,3,34
"1414","2020-06-05",33,16,223,79,6963,0.770644836995548,8295,32692,336,1652,11,6680,32,3345,1,32
"1415","2020-06-06",28,16,232,73,6963,0.770644836995548,8295,32692,336,1652,8,6688,27,3372,4,27
"1416","2020-06-07",33,16,248,74,6963,0.770644836995548,8295,32692,336,1652,15,6703,24,3396,8,24
"1417","2020-03-13",7,17,158,160,7298,0.547821320909838,8190,36174,420,1714,28,64,29,113,21,29
"1418","2020-03-14",13,17,144,218,7298,0.547821320909838,8190,36174,420,1714,43,107,51,164,27,51
"1419","2020-03-15",37,17,124,293,7298,0.547821320909838,8190,36174,420,1714,37,144,57,221,29,57
"1420","2020-03-16",47,17,126,388,7298,0.547821320909838,8190,36174,420,1714,59,203,40,261,44,40
"1421","2020-03-17",53,17,125,466,7298,0.547821320909838,8190,36174,420,1714,70,273,56,317,52,56
"1422","2020-03-18",66,17,116,557,7298,0.547821320909838,8190,36174,420,1714,69,342,28,345,53,28
"1423","2020-03-19",93,17,122,625,7298,0.547821320909838,8190,36174,420,1714,61,403,34,379,47,34
"1424","2020-03-20",146,17,140,744,7298,0.547821320909838,8190,36174,420,1714,93,496,27,406,81,27
"1425","2020-03-21",197,17,200,855,7298,0.547821320909838,8190,36174,420,1714,111,607,20,426,104,20
"1426","2020-03-22",219,17,207,940,7298,0.547821320909838,8190,36174,420,1714,109,716,15,441,96,15
"1427","2020-03-23",225,17,231,1035,7298,0.547821320909838,8190,36174,420,1714,123,839,42,483,107,42
"1428","2020-03-24",237,17,218,1142,7298,0.547821320909838,8190,36174,420,1714,115,954,60,543,105,60
"1429","2020-03-25",276,17,204,1201,7298,0.547821320909838,8190,36174,420,1714,136,1090,64,607,128,64
"1430","2020-03-26",293,17,225,1275,7298,0.547821320909838,8190,36174,420,1714,153,1243,55,662,139,55
"1431","2020-03-27",395,17,273,1392,7298,0.547821320909838,8190,36174,420,1714,164,1407,26,688,158,26
"1432","2020-03-28",441,17,298,1490,7298,0.547821320909838,8190,36174,420,1714,171,1578,53,741,159,53
"1433","2020-03-29",444,17,307,1584,7298,0.547821320909838,8190,36174,420,1714,148,1726,61,802,139,61
"1434","2020-03-30",455,17,303,1684,7298,0.547821320909838,8190,36174,420,1714,172,1898,45,847,161,45
"1435","2020-03-31",475,17,289,1776,7298,0.547821320909838,8190,36174,420,1714,193,2091,18,865,185,18
"1436","2020-04-01",486,17,273,1817,7298,0.547821320909838,8190,36174,420,1714,178,2269,12,877,167,12
"1437","2020-04-02",514,17,271,1874,7298,0.547821320909838,8190,36174,420,1714,212,2481,18,895,197,18
"1438","2020-04-03",642,17,257,1902,7298,0.547821320909838,8190,36174,420,1714,221,2702,16,911,209,16
"1439","2020-04-04",645,17,232,1902,7298,0.547821320909838,8190,36174,420,1714,163,2865,13,924,152,13
"1440","2020-04-05",645,17,229,1902,7298,0.547821320909838,8190,36174,420,1714,151,3016,29,953,143,29
"1441","2020-04-06",655,17,222,1904,7298,0.547821320909838,8190,36174,420,1714,224,3240,15,968,214,15
"1442","2020-04-07",653,17,257,1900,7298,0.547821320909838,8190,36174,420,1714,190,3430,35,1003,182,35
"1443","2020-04-08",660,17,280,1843,7298,0.547821320909838,8190,36174,420,1714,200,3630,13,1016,198,13
"1444","2020-04-09",648,17,266,1832,7298,0.547821320909838,8190,36174,420,1714,215,3845,6,1022,202,6
"1445","2020-04-10",651,17,248,1766,7298,0.547821320909838,8190,36174,420,1714,163,4008,8,1030,150,8
"1446","2020-04-11",634,17,236,1727,7298,0.547821320909838,8190,36174,420,1714,169,4177,7,1037,164,7
"1447","2020-04-12",558,17,245,1688,7298,0.547821320909838,8190,36174,420,1714,186,4363,15,1052,180,15
"1448","2020-04-13",547,17,287,1600,7298,0.547821320909838,8190,36174,420,1714,136,4499,25,1077,126,25
"1449","2020-04-14",525,17,293,1550,7298,0.547821320909838,8190,36174,420,1714,146,4645,17,1094,142,17
"1450","2020-04-15",526,17,288,1505,7298,0.547821320909838,8190,36174,420,1714,131,4776,13,1107,124,13
"1451","2020-04-16",515,17,260,1455,7298,0.547821320909838,8190,36174,420,1714,106,4882,12,1119,100,12
"1452","2020-04-17",502,17,245,1423,7298,0.547821320909838,8190,36174,420,1714,135,5017,70,1189,133,70
"1453","2020-04-18",512,17,233,1339,7298,0.547821320909838,8190,36174,420,1714,123,5140,51,1240,115,51
"1454","2020-04-19",459,17,230,1278,7298,0.547821320909838,8190,36174,420,1714,118,5258,21,1261,111,21
"1455","2020-04-20",447,17,220,1236,7298,0.547821320909838,8190,36174,420,1714,85,5343,19,1280,82,19
"1456","2020-04-21",429,17,202,1196,7298,0.547821320909838,8190,36174,420,1714,66,5409,32,1312,60,32
"1457","2020-04-22",400,17,199,1129,7298,0.547821320909838,8190,36174,420,1714,81,5490,47,1359,74,47
"1458","2020-04-23",389,17,199,1087,7298,0.547821320909838,8190,36174,420,1714,78,5568,32,1391,73,32
"1459","2020-04-24",373,17,267,1023,7298,0.547821320909838,8190,36174,420,1714,74,5642,41,1432,65,41
"1460","2020-04-25",342,17,278,986,7298,0.547821320909838,8190,36174,420,1714,65,5707,21,1453,60,21
"1461","2020-04-26",321,17,266,945,7298,0.547821320909838,8190,36174,420,1714,57,5764,21,1474,54,21
"1462","2020-04-27",315,17,248,912,7298,0.547821320909838,8190,36174,420,1714,43,5807,13,1487,40,13
"1463","2020-04-28",318,17,255,868,7298,0.547821320909838,8190,36174,420,1714,35,5842,39,1526,30,39
"1464","2020-04-29",303,17,256,816,7298,0.547821320909838,8190,36174,420,1714,35,5877,32,1558,34,32
"1465","2020-04-30",296,17,296,777,7298,0.547821320909838,8190,36174,420,1714,30,5907,19,1577,26,19
"1466","2020-05-01",270,17,293,719,7298,0.547821320909838,8190,36174,420,1714,35,5942,23,1600,30,23
"1467","2020-05-02",271,17,309,678,7298,0.547821320909838,8190,36174,420,1714,32,5974,38,1638,27,38
"1468","2020-05-03",237,17,271,644,7298,0.547821320909838,8190,36174,420,1714,22,5996,57,1695,21,57
"1469","2020-05-04",213,17,262,620,7298,0.547821320909838,8190,36174,420,1714,30,6026,45,1740,27,45
"1470","2020-05-05",192,17,268,584,7298,0.547821320909838,8190,36174,420,1714,29,6055,20,1760,25,20
"1471","2020-05-06",192,17,253,559,7298,0.547821320909838,8190,36174,420,1714,16,6071,38,1798,11,38
"1472","2020-05-07",179,17,264,522,7298,0.547821320909838,8190,36174,420,1714,24,6095,26,1824,20,26
"1473","2020-05-08",167,17,259,497,7298,0.547821320909838,8190,36174,420,1714,24,6119,22,1846,21,22
"1474","2020-05-09",166,17,226,483,7298,0.547821320909838,8190,36174,420,1714,31,6150,16,1862,27,16
"1475","2020-05-10",160,17,218,463,7298,0.547821320909838,8190,36174,420,1714,19,6169,10,1872,14,10
"1476","2020-05-11",152,17,225,435,7298,0.547821320909838,8190,36174,420,1714,31,6200,18,1890,28,18
"1477","2020-05-12",151,17,248,409,7298,0.547821320909838,8190,36174,420,1714,26,6226,64,1954,22,64
"1478","2020-05-13",136,17,236,383,7298,0.547821320909838,8190,36174,420,1714,11,6237,66,2020,11,66
"1479","2020-05-14",133,17,208,368,7298,0.547821320909838,8190,36174,420,1714,10,6247,56,2076,7,56
"1480","2020-05-15",124,17,195,358,7298,0.547821320909838,8190,36174,420,1714,13,6260,28,2104,11,28
"1481","2020-05-16",118,17,191,343,7298,0.547821320909838,8190,36174,420,1714,16,6276,16,2120,14,16
"1482","2020-05-17",107,17,243,322,7298,0.547821320909838,8190,36174,420,1714,13,6289,17,2137,11,17
"1483","2020-05-18",99,17,247,295,7298,0.547821320909838,8190,36174,420,1714,12,6301,50,2187,9,50
"1484","2020-05-19",94,17,257,288,7298,0.547821320909838,8190,36174,420,1714,12,6313,35,2222,9,35
"1485","2020-05-20",91,17,232,285,7298,0.547821320909838,8190,36174,420,1714,14,6327,16,2238,8,16
"1486","2020-05-21",84,17,238,262,7298,0.547821320909838,8190,36174,420,1714,12,6339,38,2276,6,38
"1487","2020-05-22",96,17,267,243,7298,0.547821320909838,8190,36174,420,1714,11,6350,38,2314,8,38
"1488","2020-05-23",86,17,251,233,7298,0.547821320909838,8190,36174,420,1714,11,6361,19,2333,8,19
"1489","2020-05-24",87,17,237,224,7298,0.547821320909838,8190,36174,420,1714,10,6371,18,2351,8,18
"1490","2020-05-25",82,17,207,207,7298,0.547821320909838,8190,36174,420,1714,15,6386,52,2403,11,52
"1491","2020-05-26",74,17,185,198,7298,0.547821320909838,8190,36174,420,1714,6,6392,34,2437,5,34
"1492","2020-05-27",70,17,188,191,7298,0.547821320909838,8190,36174,420,1714,12,6404,15,2452,8,15
"1493","2020-05-28",70,17,190,179,7298,0.547821320909838,8190,36174,420,1714,5,6409,15,2467,2,15
"1494","2020-05-29",76,17,185,172,7298,0.547821320909838,8190,36174,420,1714,12,6421,18,2485,11,18
"1495","2020-05-30",81,17,196,159,7298,0.547821320909838,8190,36174,420,1714,7,6428,56,2541,6,56
"1496","2020-05-31",61,17,189,152,7298,0.547821320909838,8190,36174,420,1714,11,6439,39,2580,9,39
"1497","2020-06-01",60,17,185,150,7298,0.547821320909838,8190,36174,420,1714,5,6444,30,2610,4,30
"1498","2020-06-02",55,17,158,147,7298,0.547821320909838,8190,36174,420,1714,9,6453,47,2657,7,47
"1499","2020-06-03",53,17,141,142,7298,0.547821320909838,8190,36174,420,1714,5,6458,51,2708,2,51
"1500","2020-06-04",50,17,148,131,7298,0.547821320909838,8190,36174,420,1714,7,6465,34,2742,5,34
"1501","2020-06-05",51,17,175,133,7298,0.547821320909838,8190,36174,420,1714,3,6468,36,2778,2,36
"1502","2020-06-06",46,17,195,126,7298,0.547821320909838,8190,36174,420,1714,4,6472,27,2805,2,27
"1503","2020-06-07",39,17,188,125,7298,0.547821320909838,8190,36174,420,1714,8,6480,66,2871,7,66
"1504","2020-03-14",4,18,180,144,6816,0.747065727699531,8250,34066,374,2333,19,57,12,104,7,12
"1505","2020-03-15",17,18,180,203,6816,0.747065727699531,8250,34066,374,2333,10,67,5,109,4,5
"1506","2020-03-16",24,18,207,264,6816,0.747065727699531,8250,34066,374,2333,33,100,5,114,14,5
"1507","2020-03-17",31,18,199,349,6816,0.747065727699531,8250,34066,374,2333,29,129,45,159,21,45
"1508","2020-03-18",44,18,195,428,6816,0.747065727699531,8250,34066,374,2333,30,159,64,223,19,64
"1509","2020-03-19",54,18,177,501,6816,0.747065727699531,8250,34066,374,2333,52,211,18,241,31,18
"1510","2020-03-20",71,18,157,586,6816,0.747065727699531,8250,34066,374,2333,44,255,14,255,29,14
"1511","2020-03-21",126,18,145,697,6816,0.747065727699531,8250,34066,374,2333,57,312,16,271,41,16
"1512","2020-03-22",171,18,138,809,6816,0.747065727699531,8250,34066,374,2333,81,393,44,315,70,44
"1513","2020-03-23",170,18,133,916,6816,0.747065727699531,8250,34066,374,2333,70,463,20,335,60,20
"1514","2020-03-24",190,18,136,1025,6816,0.747065727699531,8250,34066,374,2333,74,537,19,354,59,19
"1515","2020-03-25",217,18,127,1125,6816,0.747065727699531,8250,34066,374,2333,86,623,49,403,69,49
"1516","2020-03-26",255,18,122,1218,6816,0.747065727699531,8250,34066,374,2333,98,721,26,429,81,26
"1517","2020-03-27",358,18,175,1342,6816,0.747065727699531,8250,34066,374,2333,127,848,11,440,117,11
"1518","2020-03-28",374,18,171,1461,6816,0.747065727699531,8250,34066,374,2333,101,949,31,471,85,31
"1519","2020-03-29",444,18,158,1547,6816,0.747065727699531,8250,34066,374,2333,151,1100,32,503,144,32
"1520","2020-03-30",478,18,165,1614,6816,0.747065727699531,8250,34066,374,2333,140,1240,21,524,134,21
"1521","2020-03-31",466,18,181,1699,6816,0.747065727699531,8250,34066,374,2333,152,1392,15,539,141,15
"1522","2020-04-01",507,18,171,1809,6816,0.747065727699531,8250,34066,374,2333,154,1546,15,554,137,15
"1523","2020-04-02",526,18,155,1860,6816,0.747065727699531,8250,34066,374,2333,177,1723,14,568,160,14
"1524","2020-04-03",650,18,155,1918,6816,0.747065727699531,8250,34066,374,2333,186,1909,14,582,170,14
"1525","2020-04-04",672,18,151,1973,6816,0.747065727699531,8250,34066,374,2333,199,2108,47,629,183,47
"1526","2020-04-05",626,18,140,2009,6816,0.747065727699531,8250,34066,374,2333,213,2321,64,693,202,64
"1527","2020-04-06",634,18,135,2006,6816,0.747065727699531,8250,34066,374,2333,210,2531,45,738,194,45
"1528","2020-04-07",642,18,134,2028,6816,0.747065727699531,8250,34066,374,2333,219,2750,74,812,203,74
"1529","2020-04-08",647,18,198,2020,6816,0.747065727699531,8250,34066,374,2333,225,2975,44,856,203,44
"1530","2020-04-09",642,18,237,2005,6816,0.747065727699531,8250,34066,374,2333,205,3180,46,902,191,46
"1531","2020-04-10",699,18,248,1935,6816,0.747065727699531,8250,34066,374,2333,208,3388,49,951,198,49
"1532","2020-04-11",698,18,269,1927,6816,0.747065727699531,8250,34066,374,2333,209,3597,31,982,193,31
"1533","2020-04-12",602,18,303,1845,6816,0.747065727699531,8250,34066,374,2333,176,3773,25,1007,162,25
"1534","2020-04-13",602,18,298,1755,6816,0.747065727699531,8250,34066,374,2333,163,3936,24,1031,156,24
"1535","2020-04-14",597,18,351,1700,6816,0.747065727699531,8250,34066,374,2333,177,4113,21,1052,166,21
"1536","2020-04-15",561,18,357,1652,6816,0.747065727699531,8250,34066,374,2333,168,4281,12,1064,161,12
"1537","2020-04-16",553,18,316,1589,6816,0.747065727699531,8250,34066,374,2333,152,4433,21,1085,143,21
"1538","2020-04-17",548,18,291,1514,6816,0.747065727699531,8250,34066,374,2333,139,4572,23,1108,126,23
"1539","2020-04-18",538,18,277,1445,6816,0.747065727699531,8250,34066,374,2333,134,4706,6,1114,124,6
"1540","2020-04-19",485,18,277,1370,6816,0.747065727699531,8250,34066,374,2333,117,4823,13,1127,109,13
"1541","2020-04-20",451,18,259,1329,6816,0.747065727699531,8250,34066,374,2333,91,4914,7,1134,87,7
"1542","2020-04-21",429,18,227,1221,6816,0.747065727699531,8250,34066,374,2333,107,5021,49,1183,103,49
"1543","2020-04-22",420,18,213,1123,6816,0.747065727699531,8250,34066,374,2333,83,5104,30,1213,74,30
"1544","2020-04-23",408,18,193,1045,6816,0.747065727699531,8250,34066,374,2333,78,5182,52,1265,66,52
"1545","2020-04-24",361,18,196,976,6816,0.747065727699531,8250,34066,374,2333,82,5264,35,1300,71,35
"1546","2020-04-25",341,18,221,918,6816,0.747065727699531,8250,34066,374,2333,76,5340,26,1326,64,26
"1547","2020-04-26",343,18,256,853,6816,0.747065727699531,8250,34066,374,2333,69,5409,48,1374,62,48
"1548","2020-04-27",322,18,286,802,6816,0.747065727699531,8250,34066,374,2333,76,5485,68,1442,58,68
"1549","2020-04-28",300,18,269,752,6816,0.747065727699531,8250,34066,374,2333,52,5537,42,1484,47,42
"1550","2020-04-29",288,18,270,714,6816,0.747065727699531,8250,34066,374,2333,45,5582,14,1498,40,14
"1551","2020-04-30",272,18,256,661,6816,0.747065727699531,8250,34066,374,2333,48,5630,15,1513,43,15
"1552","2020-05-01",254,18,251,627,6816,0.747065727699531,8250,34066,374,2333,51,5681,16,1529,46,16
"1553","2020-05-02",241,18,238,570,6816,0.747065727699531,8250,34066,374,2333,42,5723,33,1562,30,33
"1554","2020-05-03",202,18,233,531,6816,0.747065727699531,8250,34066,374,2333,50,5773,23,1585,39,23
"1555","2020-05-04",198,18,232,501,6816,0.747065727699531,8250,34066,374,2333,37,5810,12,1597,32,12
"1556","2020-05-05",181,18,202,467,6816,0.747065727699531,8250,34066,374,2333,37,5847,9,1606,33,9
"1557","2020-05-06",174,18,193,432,6816,0.747065727699531,8250,34066,374,2333,30,5877,4,1610,27,4
"1558","2020-05-07",159,18,173,429,6816,0.747065727699531,8250,34066,374,2333,31,5908,5,1615,23,5
"1559","2020-05-08",142,18,169,398,6816,0.747065727699531,8250,34066,374,2333,31,5939,7,1622,24,7
"1560","2020-05-09",140,18,181,373,6816,0.747065727699531,8250,34066,374,2333,19,5958,11,1633,14,11
"1561","2020-05-10",127,18,202,366,6816,0.747065727699531,8250,34066,374,2333,18,5976,32,1665,16,32
"1562","2020-05-11",122,18,253,341,6816,0.747065727699531,8250,34066,374,2333,14,5990,34,1699,11,34
"1563","2020-05-12",132,18,274,329,6816,0.747065727699531,8250,34066,374,2333,16,6006,40,1739,11,40
"1564","2020-05-13",123,18,303,324,6816,0.747065727699531,8250,34066,374,2333,20,6026,33,1772,15,33
"1565","2020-05-14",127,18,296,304,6816,0.747065727699531,8250,34066,374,2333,10,6036,50,1822,7,50
"1566","2020-05-15",114,18,275,298,6816,0.747065727699531,8250,34066,374,2333,12,6048,29,1851,8,29
"1567","2020-05-16",114,18,288,280,6816,0.747065727699531,8250,34066,374,2333,18,6066,8,1859,13,8
"1568","2020-05-17",109,18,285,270,6816,0.747065727699531,8250,34066,374,2333,24,6090,14,1873,16,14
"1569","2020-05-18",104,18,281,242,6816,0.747065727699531,8250,34066,374,2333,11,6101,11,1884,6,11
"1570","2020-05-19",92,18,244,230,6816,0.747065727699531,8250,34066,374,2333,16,6117,17,1901,11,17
"1571","2020-05-20",87,18,236,209,6816,0.747065727699531,8250,34066,374,2333,6,6123,11,1912,3,11
"1572","2020-05-21",81,18,203,194,6816,0.747065727699531,8250,34066,374,2333,11,6134,12,1924,7,12
"1573","2020-05-22",89,18,211,170,6816,0.747065727699531,8250,34066,374,2333,11,6145,35,1959,5,35
"1574","2020-05-23",77,18,208,162,6816,0.747065727699531,8250,34066,374,2333,16,6161,24,1983,12,24
"1575","2020-05-24",68,18,196,156,6816,0.747065727699531,8250,34066,374,2333,17,6178,33,2016,8,33
"1576","2020-05-25",61,18,258,143,6816,0.747065727699531,8250,34066,374,2333,7,6185,50,2066,7,50
"1577","2020-05-26",59,18,264,135,6816,0.747065727699531,8250,34066,374,2333,10,6195,25,2091,5,25
"1578","2020-05-27",57,18,253,137,6816,0.747065727699531,8250,34066,374,2333,9,6204,17,2108,6,17
"1579","2020-05-28",51,18,252,132,6816,0.747065727699531,8250,34066,374,2333,11,6215,41,2149,7,41
"1580","2020-05-29",42,18,230,137,6816,0.747065727699531,8250,34066,374,2333,7,6222,37,2186,5,37
"1581","2020-05-30",41,18,211,129,6816,0.747065727699531,8250,34066,374,2333,6,6228,28,2214,2,28
"1582","2020-05-31",45,18,210,124,6816,0.747065727699531,8250,34066,374,2333,6,6234,19,2233,4,19
"1583","2020-06-01",44,18,222,121,6816,0.747065727699531,8250,34066,374,2333,7,6241,28,2261,3,28
"1584","2020-06-02",41,18,231,119,6816,0.747065727699531,8250,34066,374,2333,5,6246,13,2274,2,13
"1585","2020-06-03",38,18,240,115,6816,0.747065727699531,8250,34066,374,2333,5,6251,24,2298,4,24
"1586","2020-06-04",38,18,229,112,6816,0.747065727699531,8250,34066,374,2333,6,6257,14,2312,3,14
"1587","2020-06-05",38,18,237,110,6816,0.747065727699531,8250,34066,374,2333,NA,NA,8,2320,NA,8
"1588","2020-06-06",38,18,220,106,6816,0.747065727699531,8250,34066,374,2333,8,6265,27,2347,6,27
"1589","2020-06-07",31,18,204,110,6816,0.747065727699531,8250,34066,374,2333,6,6271,17,2364,2,17
"1590","2020-03-13",4,19,113,147,6570,0.431963470319635,8250,36909,387,1075,95,209,26,145,17,26
"1591","2020-03-14",24,19,105,196,6570,0.431963470319635,8250,36909,387,1075,87,296,15,160,19,15
"1592","2020-03-15",24,19,93,258,6570,0.431963470319635,8250,36909,387,1075,90,386,9,169,35,9
"1593","2020-03-16",19,19,99,333,6570,0.431963470319635,8250,36909,387,1075,117,503,2,171,63,2
"1594","2020-03-17",25,19,116,406,6570,0.431963470319635,8250,36909,387,1075,117,620,12,183,70,12
"1595","2020-03-18",38,19,125,481,6570,0.431963470319635,8250,36909,387,1075,131,751,12,195,93,12
"1596","2020-03-19",61,19,146,554,6570,0.431963470319635,8250,36909,387,1075,156,907,5,200,111,5
"1597","2020-03-20",119,19,181,624,6570,0.431963470319635,8250,36909,387,1075,163,1070,11,211,120,11
"1598","2020-03-21",180,19,221,699,6570,0.431963470319635,8250,36909,387,1075,220,1290,10,221,171,10
"1599","2020-03-22",204,19,212,778,6570,0.431963470319635,8250,36909,387,1075,193,1483,59,280,133,59
"1600","2020-03-23",210,19,178,858,6570,0.431963470319635,8250,36909,387,1075,173,1656,51,331,131,51
"1601","2020-03-24",224,19,164,902,6570,0.431963470319635,8250,36909,387,1075,215,1871,74,405,166,74
"1602","2020-03-25",241,19,178,938,6570,0.431963470319635,8250,36909,387,1075,248,2119,43,448,208,43
"1603","2020-03-26",251,19,183,1001,6570,0.431963470319635,8250,36909,387,1075,230,2349,20,468,180,20
"1604","2020-03-27",329,19,163,1050,6570,0.431963470319635,8250,36909,387,1075,204,2553,8,476,165,8
"1605","2020-03-28",352,19,152,1061,6570,0.431963470319635,8250,36909,387,1075,222,2775,7,483,193,7
"1606","2020-03-29",344,19,184,1093,6570,0.431963470319635,8250,36909,387,1075,212,2987,5,488,173,5
"1607","2020-03-30",350,19,169,1117,6570,0.431963470319635,8250,36909,387,1075,221,3208,13,501,192,13
"1608","2020-03-31",360,19,157,1133,6570,0.431963470319635,8250,36909,387,1075,247,3455,14,515,195,14
"1609","2020-04-01",374,19,142,1163,6570,0.431963470319635,8250,36909,387,1075,183,3638,19,534,139,19
"1610","2020-04-02",393,19,153,1190,6570,0.431963470319635,8250,36909,387,1075,236,3874,18,552,189,18
"1611","2020-04-03",421,19,157,1201,6570,0.431963470319635,8250,36909,387,1075,187,4061,60,612,149,60
"1612","2020-04-04",433,19,150,1206,6570,0.431963470319635,8250,36909,387,1075,183,4244,94,706,147,94
"1613","2020-04-05",412,19,131,1184,6570,0.431963470319635,8250,36909,387,1075,218,4462,54,760,187,54
"1614","2020-04-06",401,19,141,1210,6570,0.431963470319635,8250,36909,387,1075,185,4647,32,792,148,32
"1615","2020-04-07",402,19,184,1256,6570,0.431963470319635,8250,36909,387,1075,160,4807,66,858,122,66
"1616","2020-04-08",396,19,205,1231,6570,0.431963470319635,8250,36909,387,1075,138,4945,88,946,100,88
"1617","2020-04-09",387,19,234,1243,6570,0.431963470319635,8250,36909,387,1075,123,5068,33,979,98,33
"1618","2020-04-10",426,19,261,1247,6570,0.431963470319635,8250,36909,387,1075,133,5201,40,1019,101,40
"1619","2020-04-11",406,19,247,1272,6570,0.431963470319635,8250,36909,387,1075,111,5312,29,1048,80,29
"1620","2020-04-12",379,19,247,1273,6570,0.431963470319635,8250,36909,387,1075,119,5431,14,1062,92,14
"1621","2020-04-13",374,19,223,1273,6570,0.431963470319635,8250,36909,387,1075,110,5541,4,1066,81,4
"1622","2020-04-14",390,19,243,1276,6570,0.431963470319635,8250,36909,387,1075,83,5624,4,1070,53,4
"1623","2020-04-15",391,19,230,1257,6570,0.431963470319635,8250,36909,387,1075,94,5718,14,1084,67,14
"1624","2020-04-16",397,19,230,1236,6570,0.431963470319635,8250,36909,387,1075,69,5787,32,1116,50,32
"1625","2020-04-17",423,19,247,1240,6570,0.431963470319635,8250,36909,387,1075,80,5867,23,1139,58,23
"1626","2020-04-18",426,19,234,1219,6570,0.431963470319635,8250,36909,387,1075,73,5940,24,1163,43,24
"1627","2020-04-19",409,19,225,1204,6570,0.431963470319635,8250,36909,387,1075,62,6002,56,1219,43,56
"1628","2020-04-20",413,19,230,1182,6570,0.431963470319635,8250,36909,387,1075,53,6055,36,1255,27,36
"1629","2020-04-21",390,19,247,1158,6570,0.431963470319635,8250,36909,387,1075,61,6116,50,1305,35,50
"1630","2020-04-22",388,19,263,1123,6570,0.431963470319635,8250,36909,387,1075,38,6154,38,1343,21,38
"1631","2020-04-23",375,19,227,1104,6570,0.431963470319635,8250,36909,387,1075,40,6194,35,1378,21,35
"1632","2020-04-24",372,19,222,1071,6570,0.431963470319635,8250,36909,387,1075,48,6242,20,1398,25,20
"1633","2020-04-25",374,19,238,1036,6570,0.431963470319635,8250,36909,387,1075,39,6281,8,1406,18,8
"1634","2020-04-26",343,19,237,988,6570,0.431963470319635,8250,36909,387,1075,46,6327,23,1429,24,23
"1635","2020-04-27",337,19,240,952,6570,0.431963470319635,8250,36909,387,1075,35,6362,51,1480,21,51
"1636","2020-04-28",331,19,224,934,6570,0.431963470319635,8250,36909,387,1075,39,6401,29,1509,18,29
"1637","2020-04-29",324,19,213,889,6570,0.431963470319635,8250,36909,387,1075,35,6436,14,1523,20,14
"1638","2020-04-30",317,19,228,886,6570,0.431963470319635,8250,36909,387,1075,29,6465,10,1533,11,10
"1639","2020-05-01",308,19,285,862,6570,0.431963470319635,8250,36909,387,1075,25,6490,69,1602,7,69
"1640","2020-05-02",296,19,261,833,6570,0.431963470319635,8250,36909,387,1075,21,6511,53,1655,7,53
"1641","2020-05-03",267,19,245,787,6570,0.431963470319635,8250,36909,387,1075,25,6536,42,1697,5,42
"1642","2020-05-04",241,19,240,779,6570,0.431963470319635,8250,36909,387,1075,32,6568,15,1712,10,15
"1643","2020-05-05",232,19,247,759,6570,0.431963470319635,8250,36909,387,1075,21,6589,52,1764,6,52
"1644","2020-05-06",222,19,238,737,6570,0.431963470319635,8250,36909,387,1075,30,6619,52,1816,12,52
"1645","2020-05-07",224,19,208,716,6570,0.431963470319635,8250,36909,387,1075,23,6642,58,1874,5,58
"1646","2020-05-08",234,19,218,694,6570,0.431963470319635,8250,36909,387,1075,20,6662,46,1920,7,46
"1647","2020-05-09",231,19,268,681,6570,0.431963470319635,8250,36909,387,1075,23,6685,44,1964,11,44
"1648","2020-05-10",228,19,271,662,6570,0.431963470319635,8250,36909,387,1075,16,6701,30,1994,7,30
"1649","2020-05-11",228,19,281,642,6570,0.431963470319635,8250,36909,387,1075,25,6726,21,2015,8,21
"1650","2020-05-12",218,19,240,624,6570,0.431963470319635,8250,36909,387,1075,18,6744,29,2044,5,29
"1651","2020-05-13",217,19,196,603,6570,0.431963470319635,8250,36909,387,1075,16,6760,12,2056,9,12
"1652","2020-05-14",212,19,195,567,6570,0.431963470319635,8250,36909,387,1075,14,6774,13,2069,7,13
"1653","2020-05-15",203,19,201,551,6570,0.431963470319635,8250,36909,387,1075,19,6793,13,2082,3,13
"1654","2020-05-16",200,19,210,540,6570,0.431963470319635,8250,36909,387,1075,17,6810,8,2090,5,8
"1655","2020-05-17",196,19,256,523,6570,0.431963470319635,8250,36909,387,1075,8,6818,10,2100,1,10
"1656","2020-05-18",193,19,251,480,6570,0.431963470319635,8250,36909,387,1075,9,6827,17,2117,1,17
"1657","2020-05-19",183,19,276,452,6570,0.431963470319635,8250,36909,387,1075,8,6835,9,2126,2,9
"1658","2020-05-20",183,19,277,428,6570,0.431963470319635,8250,36909,387,1075,10,6845,9,2135,NA,9
"1659","2020-05-21",169,19,248,390,6570,0.431963470319635,8250,36909,387,1075,10,6855,14,2149,1,14
"1660","2020-05-22",164,19,241,365,6570,0.431963470319635,8250,36909,387,1075,14,6869,29,2178,5,29
"1661","2020-05-23",152,19,252,363,6570,0.431963470319635,8250,36909,387,1075,11,6880,55,2233,2,55
"1662","2020-05-24",122,19,252,342,6570,0.431963470319635,8250,36909,387,1075,6,6886,35,2268,3,35
"1663","2020-05-25",113,19,249,327,6570,0.431963470319635,8250,36909,387,1075,16,6902,34,2302,5,34
"1664","2020-05-26",106,19,283,318,6570,0.431963470319635,8250,36909,387,1075,10,6912,26,2328,NA,26
"1665","2020-05-27",100,19,272,307,6570,0.431963470319635,8250,36909,387,1075,12,6924,44,2372,4,44
"1666","2020-05-28",105,19,251,303,6570,0.431963470319635,8250,36909,387,1075,13,6937,28,2400,2,28
"1667","2020-05-29",106,19,245,291,6570,0.431963470319635,8250,36909,387,1075,11,6948,14,2414,1,14
"1668","2020-05-30",107,19,232,276,6570,0.431963470319635,8250,36909,387,1075,7,6955,37,2451,1,37
"1669","2020-05-31",104,19,223,269,6570,0.431963470319635,8250,36909,387,1075,10,6965,37,2488,3,37
"1670","2020-06-01",101,19,219,252,6570,0.431963470319635,8250,36909,387,1075,11,6976,45,2533,5,45
"1671","2020-06-02",104,19,223,242,6570,0.431963470319635,8250,36909,387,1075,9,6985,31,2564,NA,31
"1672","2020-06-03",98,19,227,237,6570,0.431963470319635,8250,36909,387,1075,6,6991,61,2625,1,61
"1673","2020-06-04",88,19,204,223,6570,0.431963470319635,8250,36909,387,1075,10,7001,24,2649,1,24
"1674","2020-06-05",72,19,189,213,6570,0.431963470319635,8250,36909,387,1075,11,7012,18,2667,2,18
"1675","2020-06-06",79,19,182,186,6570,0.431963470319635,8250,36909,387,1075,8,7020,20,2687,2,20
"1676","2020-06-07",69,19,182,166,6570,0.431963470319635,8250,36909,387,1075,8,7028,17,2704,2,17
"1677","2020-03-14",3,20,274,76,6333,0.875098689404705,8385,33247,325,1750,29,95,28,73,10,28
"1678","2020-03-15",7,20,249,117,6333,0.875098689404705,8385,33247,325,1750,38,133,22,95,17,22
"1679","2020-03-16",8,20,223,152,6333,0.875098689404705,8385,33247,325,1750,44,177,21,116,17,21
"1680","2020-03-17",13,20,220,190,6333,0.875098689404705,8385,33247,325,1750,45,222,21,137,28,21
"1681","2020-03-18",20,20,236,259,6333,0.875098689404705,8385,33247,325,1750,55,277,21,158,38,21
"1682","2020-03-19",27,20,261,316,6333,0.875098689404705,8385,33247,325,1750,87,364,22,180,55,22
"1683","2020-03-20",50,20,249,367,6333,0.875098689404705,8385,33247,325,1750,66,430,48,228,39,48
"1684","2020-03-21",80,20,247,442,6333,0.875098689404705,8385,33247,325,1750,74,504,68,296,53,68
"1685","2020-03-22",100,20,219,521,6333,0.875098689404705,8385,33247,325,1750,79,583,69,365,61,69
"1686","2020-03-23",115,20,210,594,6333,0.875098689404705,8385,33247,325,1750,95,678,28,393,73,28
"1687","2020-03-24",117,20,175,699,6333,0.875098689404705,8385,33247,325,1750,111,789,41,434,91,41
"1688","2020-03-25",129,20,148,789,6333,0.875098689404705,8385,33247,325,1750,106,895,34,468,86,34
"1689","2020-03-26",141,20,161,872,6333,0.875098689404705,8385,33247,325,1750,131,1026,40,508,114,40
"1690","2020-03-27",202,20,159,958,6333,0.875098689404705,8385,33247,325,1750,114,1140,48,556,98,48
"1691","2020-03-28",228,20,160,1047,6333,0.875098689404705,8385,33247,325,1750,148,1288,50,606,127,50
"1692","2020-03-29",266,20,154,1139,6333,0.875098689404705,8385,33247,325,1750,142,1430,56,662,130,56
"1693","2020-03-30",275,20,137,1208,6333,0.875098689404705,8385,33247,325,1750,138,1568,45,707,115,45
"1694","2020-03-31",310,20,145,1257,6333,0.875098689404705,8385,33247,325,1750,167,1735,28,735,148,28
"1695","2020-04-01",329,20,194,1376,6333,0.875098689404705,8385,33247,325,1750,181,1916,28,763,151,28
"1696","2020-04-02",370,20,194,1481,6333,0.875098689404705,8385,33247,325,1750,173,2089,64,827,154,64
"1697","2020-04-03",479,20,195,1547,6333,0.875098689404705,8385,33247,325,1750,184,2273,57,884,163,57
"1698","2020-04-04",541,20,229,1621,6333,0.875098689404705,8385,33247,325,1750,163,2436,50,934,143,50
"1699","2020-04-05",505,20,268,1679,6333,0.875098689404705,8385,33247,325,1750,165,2601,66,1000,148,66
"1700","2020-04-06",516,20,320,1729,6333,0.875098689404705,8385,33247,325,1750,195,2796,53,1053,175,53
"1701","2020-04-07",532,20,313,1754,6333,0.875098689404705,8385,33247,325,1750,163,2959,60,1113,144,60
"1702","2020-04-08",554,20,304,1765,6333,0.875098689404705,8385,33247,325,1750,160,3119,39,1152,141,39
"1703","2020-04-09",565,20,259,1824,6333,0.875098689404705,8385,33247,325,1750,183,3302,54,1206,177,54
"1704","2020-04-10",660,20,231,1845,6333,0.875098689404705,8385,33247,325,1750,146,3448,45,1251,127,45
"1705","2020-04-11",628,20,209,1889,6333,0.875098689404705,8385,33247,325,1750,174,3622,40,1291,156,40
"1706","2020-04-12",591,20,208,1883,6333,0.875098689404705,8385,33247,325,1750,141,3763,50,1341,121,50
"1707","2020-04-13",601,20,201,1877,6333,0.875098689404705,8385,33247,325,1750,171,3934,43,1384,155,43
"1708","2020-04-14",593,20,215,1862,6333,0.875098689404705,8385,33247,325,1750,176,4110,37,1421,156,37
"1709","2020-04-15",594,20,237,1849,6333,0.875098689404705,8385,33247,325,1750,149,4259,68,1489,136,68
"1710","2020-04-16",600,20,254,1836,6333,0.875098689404705,8385,33247,325,1750,127,4386,41,1530,109,41
"1711","2020-04-17",620,20,258,1734,6333,0.875098689404705,8385,33247,325,1750,135,4521,63,1593,109,63
"1712","2020-04-18",624,20,283,1685,6333,0.875098689404705,8385,33247,325,1750,101,4622,36,1629,88,36
"1713","2020-04-19",563,20,271,1615,6333,0.875098689404705,8385,33247,325,1750,127,4749,30,1659,111,30
"1714","2020-04-20",540,20,238,1544,6333,0.875098689404705,8385,33247,325,1750,117,4866,19,1678,104,19
"1715","2020-04-21",543,20,240,1442,6333,0.875098689404705,8385,33247,325,1750,88,4954,21,1699,76,21
"1716","2020-04-22",530,20,213,1369,6333,0.875098689404705,8385,33247,325,1750,86,5040,13,1712,75,13
"1717","2020-04-23",491,20,227,1277,6333,0.875098689404705,8385,33247,325,1750,96,5136,39,1751,84,39
"1718","2020-04-24",445,20,266,1207,6333,0.875098689404705,8385,33247,325,1750,72,5208,32,1783,57,32
"1719","2020-04-25",447,20,270,1107,6333,0.875098689404705,8385,33247,325,1750,61,5269,51,1834,48,51
"1720","2020-04-26",412,20,263,1038,6333,0.875098689404705,8385,33247,325,1750,62,5331,45,1879,47,45
"1721","2020-04-27",397,20,238,962,6333,0.875098689404705,8385,33247,325,1750,60,5391,25,1904,48,25
"1722","2020-04-28",362,20,251,896,6333,0.875098689404705,8385,33247,325,1750,56,5447,43,1947,49,43
"1723","2020-04-29",351,20,280,809,6333,0.875098689404705,8385,33247,325,1750,43,5490,53,2000,34,53
"1724","2020-04-30",343,20,273,736,6333,0.875098689404705,8385,33247,325,1750,56,5546,38,2038,41,38
"1725","2020-05-01",323,20,285,677,6333,0.875098689404705,8385,33247,325,1750,51,5597,29,2067,36,29
"1726","2020-05-02",291,20,256,613,6333,0.875098689404705,8385,33247,325,1750,55,5652,50,2117,37,50
"1727","2020-05-03",257,20,236,559,6333,0.875098689404705,8385,33247,325,1750,46,5698,61,2178,34,61
"1728","2020-05-04",240,20,265,508,6333,0.875098689404705,8385,33247,325,1750,40,5738,63,2241,31,63
"1729","2020-05-05",217,20,318,463,6333,0.875098689404705,8385,33247,325,1750,26,5764,26,2267,18,26
"1730","2020-05-06",189,20,353,431,6333,0.875098689404705,8385,33247,325,1750,30,5794,38,2305,21,38
"1731","2020-05-07",178,20,334,410,6333,0.875098689404705,8385,33247,325,1750,29,5823,45,2350,22,45
"1732","2020-05-08",140,20,282,388,6333,0.875098689404705,8385,33247,325,1750,28,5851,32,2382,21,32
"1733","2020-05-09",141,20,269,361,6333,0.875098689404705,8385,33247,325,1750,29,5880,25,2407,25,25
"1734","2020-05-10",135,20,287,348,6333,0.875098689404705,8385,33247,325,1750,24,5904,25,2432,15,25
"1735","2020-05-11",113,20,294,342,6333,0.875098689404705,8385,33247,325,1750,20,5924,34,2466,11,34
"1736","2020-05-12",109,20,283,326,6333,0.875098689404705,8385,33247,325,1750,30,5954,43,2509,21,43
"1737","2020-05-13",113,20,328,292,6333,0.875098689404705,8385,33247,325,1750,20,5974,27,2536,13,27
"1738","2020-05-14",107,20,313,305,6333,0.875098689404705,8385,33247,325,1750,20,5994,41,2577,8,41
"1739","2020-05-15",111,20,319,289,6333,0.875098689404705,8385,33247,325,1750,13,6007,37,2614,7,37
"1740","2020-05-16",105,20,287,277,6333,0.875098689404705,8385,33247,325,1750,15,6022,30,2644,10,30
"1741","2020-05-17",93,20,251,266,6333,0.875098689404705,8385,33247,325,1750,19,6041,33,2677,9,33
"1742","2020-05-18",96,20,265,255,6333,0.875098689404705,8385,33247,325,1750,9,6050,47,2724,6,47
"1743","2020-05-19",88,20,250,250,6333,0.875098689404705,8385,33247,325,1750,15,6065,38,2762,7,38
"1744","2020-05-20",83,20,231,234,6333,0.875098689404705,8385,33247,325,1750,19,6084,37,2799,9,37
"1745","2020-05-21",78,20,193,222,6333,0.875098689404705,8385,33247,325,1750,11,6095,19,2818,4,19
"1746","2020-05-22",70,20,163,209,6333,0.875098689404705,8385,33247,325,1750,7,6102,30,2848,4,30
"1747","2020-05-23",60,20,145,198,6333,0.875098689404705,8385,33247,325,1750,5,6107,34,2882,1,34
"1748","2020-05-24",60,20,147,181,6333,0.875098689404705,8385,33247,325,1750,9,6116,35,2917,4,35
"1749","2020-05-25",55,20,153,171,6333,0.875098689404705,8385,33247,325,1750,12,6128,30,2947,5,30
"1750","2020-05-26",56,20,149,159,6333,0.875098689404705,8385,33247,325,1750,4,6132,39,2986,1,39
"1751","2020-05-27",55,20,161,154,6333,0.875098689404705,8385,33247,325,1750,10,6142,39,3025,3,39
"1752","2020-05-28",50,20,185,130,6333,0.875098689404705,8385,33247,325,1750,10,6152,24,3049,4,24
"1753","2020-05-29",50,20,177,126,6333,0.875098689404705,8385,33247,325,1750,4,6156,18,3067,3,18
"1754","2020-05-30",52,20,182,120,6333,0.875098689404705,8385,33247,325,1750,6,6162,33,3100,3,33
"1755","2020-05-31",49,20,231,120,6333,0.875098689404705,8385,33247,325,1750,7,6169,44,3144,2,44
"1756","2020-06-01",42,20,251,109,6333,0.875098689404705,8385,33247,325,1750,5,6174,38,3182,NA,38
"1757","2020-06-02",35,20,280,98,6333,0.875098689404705,8385,33247,325,1750,6,6180,28,3210,4,28
"1758","2020-06-03",31,20,282,95,6333,0.875098689404705,8385,33247,325,1750,8,6188,28,3238,3,28
"1759","2020-06-04",30,20,264,97,6333,0.875098689404705,8385,33247,325,1750,6,6194,23,3261,3,23
"1760","2020-06-05",27,20,278,90,6333,0.875098689404705,8385,33247,325,1750,5,6199,22,3283,2,22
"1761","2020-06-06",28,20,272,90,6333,0.875098689404705,8385,33247,325,1750,8,6207,14,3297,2,14
"1762","2020-06-07",29,20,238,87,6333,0.875098689404705,8385,33247,325,1750,5,6212,39,3336,2,39
