"","Date","Absents","Paramset","Infections_or_Exposed_per_day_Patient","Infections_or_Exposed_per_day_HCW","total_infections","nosocomial_proportion","PCR_pooled","LFD_pooled","HCW_symp_test","patient_symp_test","new_hcw_infs","cumulative_hcw_infs","new_pat_infs","cumulative_pats_infs","new_nosocomial_hcw_infs","new_nosocomial_pat_infs"
"1","2020-03-12",1,1,98,138,6786,0.768788682581786,0,0,635,285,68,138,28,64,5,28
"2","2020-03-13",7,1,112,212,6786,0.768788682581786,0,0,635,285,74,212,20,84,13,20
"3","2020-03-14",12,1,124,295,6786,0.768788682581786,0,0,635,285,83,295,22,106,32,22
"4","2020-03-15",24,1,142,388,6786,0.768788682581786,0,0,635,285,93,388,18,124,41,18
"5","2020-03-16",35,1,171,502,6786,0.768788682581786,0,0,635,285,115,503,42,166,61,42
"6","2020-03-17",47,1,189,648,6786,0.768788682581786,0,0,635,285,151,654,34,200,98,34
"7","2020-03-18",69,1,210,804,6786,0.768788682581786,0,0,635,285,171,825,52,252,122,52
"8","2020-03-19",94,1,206,973,6786,0.768788682581786,0,0,635,285,187,1012,36,288,135,36
"9","2020-03-20",127,1,225,1154,6786,0.768788682581786,0,0,635,285,210,1222,43,331,164,43
"10","2020-03-21",170,1,232,1325,6786,0.768788682581786,0,0,635,285,211,1433,43,374,169,43
"11","2020-03-22",212,1,206,1496,6786,0.768788682581786,0,0,635,285,210,1643,30,404,167,30
"12","2020-03-23",257,1,227,1665,6786,0.768788682581786,0,0,635,285,218,1861,47,451,188,47
"13","2020-03-24",312,1,232,1811,6786,0.768788682581786,0,0,635,285,212,2073,41,492,183,41
"14","2020-03-25",362,1,266,1958,6786,0.768788682581786,0,0,635,285,245,2318,65,557,213,65
"15","2020-03-26",391,1,257,2093,6786,0.768788682581786,0,0,635,285,266,2584,49,606,239,49
"16","2020-03-27",437,1,232,2224,6786,0.768788682581786,0,0,635,285,260,2844,38,644,225,38
"17","2020-03-28",476,1,203,2401,6786,0.768788682581786,0,0,635,285,310,3154,22,666,285,22
"18","2020-03-29",528,1,182,2473,6786,0.768788682581786,0,0,635,285,236,3390,19,685,209,19
"19","2020-03-30",565,1,186,2566,6786,0.768788682581786,0,0,635,285,240,3630,32,717,215,32
"20","2020-03-31",596,1,193,2677,6786,0.768788682581786,0,0,635,285,306,3936,30,747,274,30
"21","2020-04-01",642,1,176,2783,6786,0.768788682581786,0,0,635,285,299,4235,21,768,278,21
"22","2020-04-02",691,1,162,2772,6786,0.768788682581786,0,0,635,285,209,4444,17,785,192,17
"23","2020-04-03",714,1,143,2770,6786,0.768788682581786,0,0,635,285,225,4669,12,797,201,12
"24","2020-04-04",730,1,150,2676,6786,0.768788682581786,0,0,635,285,144,4813,40,837,130,40
"25","2020-04-05",752,1,150,2604,6786,0.768788682581786,0,0,635,285,166,4979,20,857,158,20
"26","2020-04-06",748,1,155,2529,6786,0.768788682581786,0,0,635,285,152,5131,34,891,140,34
"27","2020-04-07",734,1,149,2385,6786,0.768788682581786,0,0,635,285,123,5254,26,917,114,26
"28","2020-04-08",720,1,139,2256,6786,0.768788682581786,0,0,635,285,112,5366,19,936,95,19
"29","2020-04-09",715,1,132,2126,6786,0.768788682581786,0,0,635,285,125,5491,23,959,114,23
"30","2020-04-10",688,1,130,1961,6786,0.768788682581786,0,0,635,285,102,5593,23,982,89,23
"31","2020-04-11",663,1,137,1779,6786,0.768788682581786,0,0,635,285,77,5670,20,1002,69,20
"32","2020-04-12",634,1,136,1661,6786,0.768788682581786,0,0,635,285,69,5739,27,1029,60,27
"33","2020-04-13",615,1,134,1524,6786,0.768788682581786,0,0,635,285,84,5823,25,1054,76,25
"34","2020-04-14",582,1,125,1363,6786,0.768788682581786,0,0,635,285,47,5870,16,1070,43,16
"35","2020-04-15",519,1,138,1215,6786,0.768788682581786,0,0,635,285,39,5909,36,1106,34,36
"36","2020-04-16",478,1,151,1079,6786,0.768788682581786,0,0,635,285,53,5962,31,1137,50,31
"37","2020-04-17",435,1,155,957,6786,0.768788682581786,0,0,635,285,45,6007,35,1172,35,35
"38","2020-04-18",394,1,143,841,6786,0.768788682581786,0,0,635,285,31,6038,16,1188,27,16
"39","2020-04-19",324,1,136,759,6786,0.768788682581786,0,0,635,285,29,6067,26,1214,26,26
"40","2020-04-20",283,1,134,654,6786,0.768788682581786,0,0,635,285,19,6086,25,1239,16,25
"41","2020-04-21",264,1,135,589,6786,0.768788682581786,0,0,635,285,32,6118,28,1267,24,28
"42","2020-04-22",245,1,147,531,6786,0.768788682581786,0,0,635,285,27,6145,34,1301,21,34
"43","2020-04-23",206,1,135,473,6786,0.768788682581786,0,0,635,285,22,6167,14,1315,14,14
"44","2020-04-24",187,1,117,425,6786,0.768788682581786,0,0,635,285,20,6187,9,1324,17,9
"45","2020-04-25",166,1,103,377,6786,0.768788682581786,0,0,635,285,19,6206,9,1333,15,9
"46","2020-04-26",153,1,105,336,6786,0.768788682581786,0,0,635,285,17,6223,17,1350,12,17
"47","2020-04-27",141,1,95,304,6786,0.768788682581786,0,0,635,285,11,6234,15,1365,8,15
"48","2020-04-28",121,1,89,273,6786,0.768788682581786,0,0,635,285,11,6245,13,1378,9,13
"49","2020-04-29",107,1,85,241,6786,0.768788682581786,0,0,635,285,12,6257,16,1394,8,16
"50","2020-04-30",98,1,80,216,6786,0.768788682581786,0,0,635,285,10,6267,13,1407,7,13
"51","2020-05-01",87,1,83,198,6786,0.768788682581786,0,0,635,285,7,6274,13,1420,5,13
"52","2020-05-02",85,1,74,174,6786,0.768788682581786,0,0,635,285,5,6279,8,1428,3,8
"53","2020-05-03",74,1,67,154,6786,0.768788682581786,0,0,635,285,8,6287,6,1434,4,6
"54","2020-05-04",61,1,68,133,6786,0.768788682581786,0,0,635,285,11,6298,10,1444,7,10
"55","2020-05-05",54,1,71,119,6786,0.768788682581786,0,0,635,285,3,6301,13,1457,2,13
"56","2020-05-06",52,1,74,101,6786,0.768788682581786,0,0,635,285,7,6308,13,1470,3,13
"57","2020-05-07",47,1,68,96,6786,0.768788682581786,0,0,635,285,7,6315,12,1482,3,12
"58","2020-05-08",42,1,64,87,6786,0.768788682581786,0,0,635,285,4,6319,10,1492,4,10
"59","2020-05-09",30,1,65,83,6786,0.768788682581786,0,0,635,285,5,6324,11,1503,2,11
"60","2020-05-10",29,1,61,80,6786,0.768788682581786,0,0,635,285,5,6329,10,1513,1,10
"61","2020-05-11",28,1,56,76,6786,0.768788682581786,0,0,635,285,8,6337,5,1518,2,5
"62","2020-05-12",26,1,48,67,6786,0.768788682581786,0,0,635,285,4,6341,2,1520,3,2
"63","2020-05-13",23,1,36,66,6786,0.768788682581786,0,0,635,285,4,6345,1,1521,NA,1
"64","2020-05-14",21,1,31,59,6786,0.768788682581786,0,0,635,285,2,6347,1,1522,1,1
"65","2020-05-15",20,1,32,58,6786,0.768788682581786,0,0,635,285,5,6352,2,1524,2,2
"66","2020-05-16",21,1,29,52,6786,0.768788682581786,0,0,635,285,4,6356,2,1526,NA,2
"67","2020-05-17",21,1,26,48,6786,0.768788682581786,0,0,635,285,1,6357,3,1529,NA,3
"68","2020-05-18",21,1,22,48,6786,0.768788682581786,0,0,635,285,5,6362,2,1531,1,2
"69","2020-05-19",25,1,18,44,6786,0.768788682581786,0,0,635,285,2,6364,NA,NA,NA,NA
"70","2020-05-20",24,1,20,45,6786,0.768788682581786,0,0,635,285,7,6371,NA,NA,1,NA
"71","2020-05-21",25,1,19,45,6786,0.768788682581786,0,0,635,285,2,6373,1,1532,NA,1
"72","2020-05-22",24,1,21,43,6786,0.768788682581786,0,0,635,285,2,6375,3,1535,NA,3
"73","2020-05-23",22,1,19,37,6786,0.768788682581786,0,0,635,285,1,6376,1,1536,1,1
"74","2020-05-24",20,1,20,37,6786,0.768788682581786,0,0,635,285,4,6380,3,1539,NA,3
"75","2020-05-25",18,1,19,36,6786,0.768788682581786,0,0,635,285,3,6383,NA,NA,NA,NA
"76","2020-05-26",13,1,15,37,6786,0.768788682581786,0,0,635,285,3,6386,1,1540,NA,1
"77","2020-05-27",13,1,16,33,6786,0.768788682581786,0,0,635,285,1,6387,1,1541,NA,1
"78","2020-05-28",10,1,14,30,6786,0.768788682581786,0,0,635,285,3,6390,NA,NA,NA,NA
"79","2020-05-29",11,1,12,31,6786,0.768788682581786,0,0,635,285,4,6394,NA,NA,1,NA
"80","2020-05-30",13,1,12,32,6786,0.768788682581786,0,0,635,285,2,6396,NA,NA,NA,NA
"81","2020-05-31",11,1,12,34,6786,0.768788682581786,0,0,635,285,5,6401,NA,NA,2,NA
"82","2020-06-01",11,1,11,37,6786,0.768788682581786,0,0,635,285,6,6407,NA,NA,NA,NA
"83","2020-06-02",10,1,12,39,6786,0.768788682581786,0,0,635,285,5,6412,1,1542,1,1
"84","2020-06-03",11,1,11,39,6786,0.768788682581786,0,0,635,285,4,6416,NA,NA,NA,NA
"85","2020-06-04",10,1,10,41,6786,0.768788682581786,0,0,635,285,3,6419,NA,NA,1,NA
"86","2020-06-05",11,1,10,41,6786,0.768788682581786,0,0,635,285,5,6424,NA,NA,NA,NA
"87","2020-06-06",10,1,10,42,6786,0.768788682581786,0,0,635,285,2,6426,1,1543,NA,1
"88","2020-06-07",12,1,10,40,6786,0.768788682581786,0,0,635,285,3,6429,NA,NA,1,NA
"89","2020-03-12",2,2,135,85,3493,0.709991411394217,0,0,295,267,44,97,15,30,1,15
"90","2020-03-13",4,2,169,127,3493,0.709991411394217,0,0,295,267,73,170,43,73,8,43
"91","2020-03-14",7,2,174,170,3493,0.709991411394217,0,0,295,267,59,229,48,121,7,48
"92","2020-03-15",13,2,183,220,3493,0.709991411394217,0,0,295,267,60,289,59,180,18,59
"93","2020-03-16",21,2,194,266,3493,0.709991411394217,0,0,295,267,69,358,52,232,16,52
"94","2020-03-17",30,2,193,320,3493,0.709991411394217,0,0,295,267,62,420,70,302,21,70
"95","2020-03-18",46,2,200,399,3493,0.709991411394217,0,0,295,267,43,463,50,352,17,50
"96","2020-03-19",64,2,173,449,3493,0.709991411394217,0,0,295,267,57,520,39,391,22,39
"97","2020-03-20",80,2,159,488,3493,0.709991411394217,0,0,295,267,48,568,36,427,15,36
"98","2020-03-21",94,2,141,534,3493,0.709991411394217,0,0,295,267,63,631,41,468,21,41
"99","2020-03-22",113,2,161,575,3493,0.709991411394217,0,0,295,267,49,680,57,525,24,57
"100","2020-03-23",130,2,162,634,3493,0.709991411394217,0,0,295,267,47,727,45,570,18,45
"101","2020-03-24",151,2,169,654,3493,0.709991411394217,0,0,295,267,50,777,43,613,22,43
"102","2020-03-25",159,2,163,657,3493,0.709991411394217,0,0,295,267,50,827,34,647,15,34
"103","2020-03-26",162,2,160,660,3493,0.709991411394217,0,0,295,267,45,872,17,664,18,17
"104","2020-03-27",162,2,159,682,3493,0.709991411394217,0,0,295,267,40,912,23,687,12,23
"105","2020-03-28",180,2,139,696,3493,0.709991411394217,0,0,295,267,39,951,19,706,8,19
"106","2020-03-29",178,2,131,722,3493,0.709991411394217,0,0,295,267,35,986,24,730,13,24
"107","2020-03-30",177,2,150,725,3493,0.709991411394217,0,0,295,267,39,1025,52,782,13,52
"108","2020-03-31",189,2,162,711,3493,0.709991411394217,0,0,295,267,44,1069,44,826,21,44
"109","2020-04-01",192,2,177,706,3493,0.709991411394217,0,0,295,267,45,1114,28,854,15,28
"110","2020-04-02",202,2,159,701,3493,0.709991411394217,0,0,295,267,43,1157,30,884,14,30
"111","2020-04-03",218,2,164,710,3493,0.709991411394217,0,0,295,267,41,1198,33,917,13,33
"112","2020-04-04",206,2,164,714,3493,0.709991411394217,0,0,295,267,40,1238,22,939,15,22
"113","2020-04-05",208,2,150,718,3493,0.709991411394217,0,0,295,267,32,1270,19,958,15,19
"114","2020-04-06",216,2,156,697,3493,0.709991411394217,0,0,295,267,44,1314,21,979,19,21
"115","2020-04-07",202,2,146,692,3493,0.709991411394217,0,0,295,267,29,1343,17,996,8,17
"116","2020-04-08",202,2,129,680,3493,0.709991411394217,0,0,295,267,35,1378,20,1016,17,20
"117","2020-04-09",194,2,111,660,3493,0.709991411394217,0,0,295,267,29,1407,20,1036,12,20
"118","2020-04-10",189,2,108,644,3493,0.709991411394217,0,0,295,267,29,1436,8,1044,15,8
"119","2020-04-11",195,2,104,615,3493,0.709991411394217,0,0,295,267,34,1470,44,1088,12,44
"120","2020-04-12",199,2,115,618,3493,0.709991411394217,0,0,295,267,30,1500,18,1106,9,18
"121","2020-04-13",193,2,120,602,3493,0.709991411394217,0,0,295,267,24,1524,28,1134,10,28
"122","2020-04-14",189,2,103,592,3493,0.709991411394217,0,0,295,267,35,1559,20,1154,21,20
"123","2020-04-15",192,2,93,592,3493,0.709991411394217,0,0,295,267,18,1577,21,1175,10,21
"124","2020-04-16",195,2,76,571,3493,0.709991411394217,0,0,295,267,25,1602,16,1191,12,16
"125","2020-04-17",185,2,64,567,3493,0.709991411394217,0,0,295,267,21,1623,17,1208,14,17
"126","2020-04-18",189,2,60,543,3493,0.709991411394217,0,0,295,267,21,1644,23,1231,11,23
"127","2020-04-19",190,2,68,518,3493,0.709991411394217,0,0,295,267,30,1674,19,1250,20,19
"128","2020-04-20",178,2,62,512,3493,0.709991411394217,0,0,295,267,21,1695,16,1266,13,16
"129","2020-04-21",175,2,57,492,3493,0.709991411394217,0,0,295,267,27,1722,26,1292,11,26
"130","2020-04-22",169,2,48,483,3493,0.709991411394217,0,0,295,267,26,1748,19,1311,16,19
"131","2020-04-23",156,2,49,464,3493,0.709991411394217,0,0,295,267,33,1781,14,1325,15,14
"132","2020-04-24",152,2,58,437,3493,0.709991411394217,0,0,295,267,27,1808,20,1345,14,20
"133","2020-04-25",133,2,46,417,3493,0.709991411394217,0,0,295,267,19,1827,13,1358,13,13
"134","2020-04-26",118,2,43,410,3493,0.709991411394217,0,0,295,267,34,1861,21,1379,15,21
"135","2020-04-27",124,2,52,399,3493,0.709991411394217,0,0,295,267,19,1880,18,1397,10,18
"136","2020-04-28",121,2,47,401,3493,0.709991411394217,0,0,295,267,17,1897,16,1413,9,16
"137","2020-04-29",115,2,47,387,3493,0.709991411394217,0,0,295,267,23,1920,20,1433,11,20
"138","2020-04-30",114,2,40,385,3493,0.709991411394217,0,0,295,267,20,1940,16,1449,13,16
"139","2020-05-01",119,2,38,383,3493,0.709991411394217,0,0,295,267,29,1969,18,1467,18,18
"140","2020-05-02",117,2,40,383,3493,0.709991411394217,0,0,295,267,17,1986,12,1479,12,12
"141","2020-05-03",124,2,50,386,3493,0.709991411394217,0,0,295,267,16,2002,9,1488,5,9
"142","2020-05-04",117,2,50,373,3493,0.709991411394217,0,0,295,267,13,2015,9,1497,5,9
"143","2020-05-05",116,2,55,354,3493,0.709991411394217,0,0,295,267,19,2034,12,1509,9,12
"144","2020-05-06",110,2,46,334,3493,0.709991411394217,0,0,295,267,21,2055,8,1517,15,8
"145","2020-05-07",112,2,42,331,3493,0.709991411394217,0,0,295,267,12,2067,12,1529,9,12
"146","2020-05-08",104,2,40,325,3493,0.709991411394217,0,0,295,267,12,2079,9,1538,6,9
"147","2020-05-09",107,2,35,311,3493,0.709991411394217,0,0,295,267,17,2096,15,1553,11,15
"148","2020-05-10",100,2,37,291,3493,0.709991411394217,0,0,295,267,20,2116,5,1558,12,5
"149","2020-05-11",99,2,44,275,3493,0.709991411394217,0,0,295,267,22,2138,9,1567,8,9
"150","2020-05-12",91,2,40,275,3493,0.709991411394217,0,0,295,267,19,2157,8,1575,9,8
"151","2020-05-13",94,2,34,264,3493,0.709991411394217,0,0,295,267,19,2176,8,1583,7,8
"152","2020-05-14",86,2,33,260,3493,0.709991411394217,0,0,295,267,12,2188,3,1586,5,3
"153","2020-05-15",80,2,29,265,3493,0.709991411394217,0,0,295,267,20,2208,3,1589,11,3
"154","2020-05-16",78,2,28,254,3493,0.709991411394217,0,0,295,267,13,2221,3,1592,5,3
"155","2020-05-17",80,2,23,249,3493,0.709991411394217,0,0,295,267,18,2239,4,1596,9,4
"156","2020-05-18",76,2,22,235,3493,0.709991411394217,0,0,295,267,13,2252,2,1598,4,2
"157","2020-05-19",73,2,20,239,3493,0.709991411394217,0,0,295,267,20,2272,9,1607,10,9
"158","2020-05-20",68,2,19,239,3493,0.709991411394217,0,0,295,267,10,2282,3,1610,5,3
"159","2020-05-21",69,2,21,241,3493,0.709991411394217,0,0,295,267,15,2297,10,1620,8,10
"160","2020-05-22",70,2,26,244,3493,0.709991411394217,0,0,295,267,19,2316,5,1625,10,5
"161","2020-05-23",67,2,26,232,3493,0.709991411394217,0,0,295,267,15,2331,5,1630,4,5
"162","2020-05-24",62,2,26,222,3493,0.709991411394217,0,0,295,267,22,2353,3,1633,8,3
"163","2020-05-25",67,2,24,217,3493,0.709991411394217,0,0,295,267,19,2372,2,1635,7,2
"164","2020-05-26",71,2,31,211,3493,0.709991411394217,0,0,295,267,20,2392,3,1638,7,3
"165","2020-05-27",68,2,30,202,3493,0.709991411394217,0,0,295,267,13,2405,4,1642,9,4
"166","2020-05-28",68,2,30,194,3493,0.709991411394217,0,0,295,267,13,2418,1,1643,4,1
"167","2020-05-29",70,2,32,190,3493,0.709991411394217,0,0,295,267,21,2439,3,1646,6,3
"168","2020-05-30",68,2,25,190,3493,0.709991411394217,0,0,295,267,16,2455,2,1648,11,2
"169","2020-05-31",64,2,25,196,3493,0.709991411394217,0,0,295,267,12,2467,2,1650,7,2
"170","2020-06-01",56,2,25,185,3493,0.709991411394217,0,0,295,267,21,2488,2,1652,10,2
"171","2020-06-02",55,2,23,171,3493,0.709991411394217,0,0,295,267,17,2505,3,1655,12,3
"172","2020-06-03",57,2,21,166,3493,0.709991411394217,0,0,295,267,22,2527,4,1659,12,4
"173","2020-06-04",52,2,18,156,3493,0.709991411394217,0,0,295,267,19,2546,3,1662,9,3
"174","2020-06-05",55,2,12,149,3493,0.709991411394217,0,0,295,267,21,2567,2,1664,10,2
"175","2020-06-06",57,2,15,147,3493,0.709991411394217,0,0,295,267,12,2579,3,1667,7,3
"176","2020-06-07",53,2,14,148,3493,0.709991411394217,0,0,295,267,10,2589,1,1668,2,1
"177","2020-03-12",1,3,181,136,3394,0.47672362993518,0,0,278,785,38,66,35,69,23,35
"178","2020-03-13",4,3,294,187,3394,0.47672362993518,0,0,278,785,43,109,52,121,26,52
"179","2020-03-14",12,3,342,266,3394,0.47672362993518,0,0,278,785,47,156,36,157,37,36
"180","2020-03-15",19,3,358,318,3394,0.47672362993518,0,0,278,785,63,219,36,193,47,36
"181","2020-03-16",32,3,356,386,3394,0.47672362993518,0,0,278,785,73,292,53,246,54,53
"182","2020-03-17",50,3,342,446,3394,0.47672362993518,0,0,278,785,85,377,37,283,71,37
"183","2020-03-18",57,3,323,512,3394,0.47672362993518,0,0,278,785,83,460,46,329,69,46
"184","2020-03-19",80,3,339,588,3394,0.47672362993518,0,0,278,785,92,552,35,364,79,35
"185","2020-03-20",96,3,334,623,3394,0.47672362993518,0,0,278,785,112,664,50,414,103,50
"186","2020-03-21",113,3,320,668,3394,0.47672362993518,0,0,278,785,132,796,45,459,119,45
"187","2020-03-22",132,3,307,712,3394,0.47672362993518,0,0,278,785,139,935,22,481,128,22
"188","2020-03-23",145,3,299,735,3394,0.47672362993518,0,0,278,785,144,1079,34,515,136,34
"189","2020-03-24",154,3,289,782,3394,0.47672362993518,0,0,278,785,173,1252,20,535,156,20
"190","2020-03-25",184,3,271,786,3394,0.47672362993518,0,0,278,785,207,1459,16,551,197,16
"191","2020-03-26",187,3,268,790,3394,0.47672362993518,0,0,278,785,148,1607,33,584,139,33
"192","2020-03-27",203,3,282,779,3394,0.47672362993518,0,0,278,785,191,1798,28,612,181,28
"193","2020-03-28",210,3,256,767,3394,0.47672362993518,0,0,278,785,188,1986,27,639,185,27
"194","2020-03-29",215,3,228,753,3394,0.47672362993518,0,0,278,785,192,2178,44,683,188,44
"195","2020-03-30",216,3,228,750,3394,0.47672362993518,0,0,278,785,188,2366,44,727,179,44
"196","2020-03-31",215,3,221,742,3394,0.47672362993518,0,0,278,785,190,2556,31,758,180,31
"197","2020-04-01",207,3,205,721,3394,0.47672362993518,0,0,278,785,195,2751,26,784,189,26
"198","2020-04-02",216,3,204,725,3394,0.47672362993518,0,0,278,785,187,2938,22,806,184,22
"199","2020-04-03",201,3,226,711,3394,0.47672362993518,0,0,278,785,183,3121,9,815,180,9
"200","2020-04-04",194,3,249,689,3394,0.47672362993518,0,0,278,785,158,3279,18,833,155,18
"201","2020-04-05",186,3,267,658,3394,0.47672362993518,0,0,278,785,155,3434,30,863,148,30
"202","2020-04-06",191,3,269,611,3394,0.47672362993518,0,0,278,785,159,3593,28,891,154,28
"203","2020-04-07",198,3,287,617,3394,0.47672362993518,0,0,278,785,182,3775,21,912,177,21
"204","2020-04-08",197,3,288,608,3394,0.47672362993518,0,0,278,785,124,3899,53,965,122,53
"205","2020-04-09",183,3,270,592,3394,0.47672362993518,0,0,278,785,179,4078,36,1001,171,36
"206","2020-04-10",178,3,278,575,3394,0.47672362993518,0,0,278,785,161,4239,43,1044,160,43
"207","2020-04-11",172,3,304,551,3394,0.47672362993518,0,0,278,785,135,4374,46,1090,129,46
"208","2020-04-12",179,3,275,550,3394,0.47672362993518,0,0,278,785,146,4520,40,1130,141,40
"209","2020-04-13",171,3,266,532,3394,0.47672362993518,0,0,278,785,98,4618,34,1164,95,34
"210","2020-04-14",171,3,256,503,3394,0.47672362993518,0,0,278,785,105,4723,29,1193,101,29
"211","2020-04-15",169,3,249,491,3394,0.47672362993518,0,0,278,785,94,4817,22,1215,91,22
"212","2020-04-16",162,3,266,468,3394,0.47672362993518,0,0,278,785,77,4894,33,1248,76,33
"213","2020-04-17",162,3,258,458,3394,0.47672362993518,0,0,278,785,77,4971,22,1270,73,22
"214","2020-04-18",158,3,261,448,3394,0.47672362993518,0,0,278,785,64,5035,22,1292,64,22
"215","2020-04-19",152,3,252,427,3394,0.47672362993518,0,0,278,785,74,5109,29,1321,73,29
"216","2020-04-20",137,3,246,413,3394,0.47672362993518,0,0,278,785,73,5182,18,1339,71,18
"217","2020-04-21",123,3,240,399,3394,0.47672362993518,0,0,278,785,62,5244,30,1369,62,30
"218","2020-04-22",104,3,228,372,3394,0.47672362993518,0,0,278,785,52,5296,16,1385,50,16
"219","2020-04-23",103,3,233,356,3394,0.47672362993518,0,0,278,785,39,5335,30,1415,37,30
"220","2020-04-24",108,3,221,344,3394,0.47672362993518,0,0,278,785,48,5383,20,1435,46,20
"221","2020-04-25",105,3,225,331,3394,0.47672362993518,0,0,278,785,35,5418,27,1462,35,27
"222","2020-04-26",99,3,217,330,3394,0.47672362993518,0,0,278,785,42,5460,19,1481,39,19
"223","2020-04-27",107,3,200,320,3394,0.47672362993518,0,0,278,785,16,5476,23,1504,15,23
"224","2020-04-28",97,3,208,310,3394,0.47672362993518,0,0,278,785,30,5506,17,1521,28,17
"225","2020-04-29",105,3,204,304,3394,0.47672362993518,0,0,278,785,19,5525,10,1531,19,10
"226","2020-04-30",102,3,195,313,3394,0.47672362993518,0,0,278,785,34,5559,16,1547,34,16
"227","2020-05-01",93,3,177,309,3394,0.47672362993518,0,0,278,785,30,5589,14,1561,26,14
"228","2020-05-02",90,3,168,298,3394,0.47672362993518,0,0,278,785,17,5606,10,1571,17,10
"229","2020-05-03",88,3,167,291,3394,0.47672362993518,0,0,278,785,15,5621,14,1585,15,14
"230","2020-05-04",81,3,166,290,3394,0.47672362993518,0,0,278,785,16,5637,15,1600,16,15
"231","2020-05-05",83,3,171,288,3394,0.47672362993518,0,0,278,785,11,5648,7,1607,11,7
"232","2020-05-06",77,3,175,286,3394,0.47672362993518,0,0,278,785,14,5662,4,1611,14,4
"233","2020-05-07",77,3,180,278,3394,0.47672362993518,0,0,278,785,12,5674,6,1617,10,6
"234","2020-05-08",73,3,167,265,3394,0.47672362993518,0,0,278,785,10,5684,10,1627,9,10
"235","2020-05-09",78,3,171,245,3394,0.47672362993518,0,0,278,785,13,5697,8,1635,12,8
"236","2020-05-10",76,3,149,248,3394,0.47672362993518,0,0,278,785,10,5707,7,1642,9,7
"237","2020-05-11",75,3,152,243,3394,0.47672362993518,0,0,278,785,5,5712,6,1648,4,6
"238","2020-05-12",81,3,136,244,3394,0.47672362993518,0,0,278,785,5,5717,7,1655,3,7
"239","2020-05-13",78,3,128,230,3394,0.47672362993518,0,0,278,785,8,5725,5,1660,7,5
"240","2020-05-14",74,3,120,215,3394,0.47672362993518,0,0,278,785,3,5728,3,1663,3,3
"241","2020-05-15",76,3,114,208,3394,0.47672362993518,0,0,278,785,5,5733,1,1664,4,1
"242","2020-05-16",68,3,107,209,3394,0.47672362993518,0,0,278,785,4,5737,5,1669,3,5
"243","2020-05-17",62,3,94,200,3394,0.47672362993518,0,0,278,785,8,5745,2,1671,7,2
"244","2020-05-18",67,3,97,196,3394,0.47672362993518,0,0,278,785,9,5754,NA,NA,7,NA
"245","2020-05-19",56,3,98,186,3394,0.47672362993518,0,0,278,785,3,5757,3,1674,1,3
"246","2020-05-20",57,3,104,182,3394,0.47672362993518,0,0,278,785,5,5762,1,1675,4,1
"247","2020-05-21",56,3,97,183,3394,0.47672362993518,0,0,278,785,2,5764,1,1676,2,1
"248","2020-05-22",57,3,95,186,3394,0.47672362993518,0,0,278,785,3,5767,2,1678,2,2
"249","2020-05-23",60,3,97,198,3394,0.47672362993518,0,0,278,785,3,5770,1,1679,1,1
"250","2020-05-24",60,3,93,200,3394,0.47672362993518,0,0,278,785,2,5772,3,1682,1,3
"251","2020-05-25",55,3,94,201,3394,0.47672362993518,0,0,278,785,1,5773,3,1685,1,3
"252","2020-05-26",62,3,92,210,3394,0.47672362993518,0,0,278,785,1,5774,1,1686,NA,1
"253","2020-05-27",63,3,86,205,3394,0.47672362993518,0,0,278,785,2,5776,NA,NA,NA,NA
"254","2020-05-28",61,3,76,197,3394,0.47672362993518,0,0,278,785,5,5781,2,1688,4,2
"255","2020-05-29",59,3,77,202,3394,0.47672362993518,0,0,278,785,2,5783,3,1691,NA,3
"256","2020-05-30",59,3,78,195,3394,0.47672362993518,0,0,278,785,1,5784,3,1694,NA,3
"257","2020-05-31",64,3,90,197,3394,0.47672362993518,0,0,278,785,1,5785,1,1695,NA,1
"258","2020-06-01",63,3,96,186,3394,0.47672362993518,0,0,278,785,2,5787,2,1697,2,2
"259","2020-06-02",52,3,93,183,3394,0.47672362993518,0,0,278,785,NA,NA,NA,NA,NA,NA
"260","2020-06-03",52,3,96,178,3394,0.47672362993518,0,0,278,785,1,5788,NA,NA,NA,NA
"261","2020-06-04",59,3,88,171,3394,0.47672362993518,0,0,278,785,3,5791,1,1698,1,1
"262","2020-06-05",56,3,78,172,3394,0.47672362993518,0,0,278,785,4,5795,NA,NA,3,NA
"263","2020-06-06",55,3,78,162,3394,0.47672362993518,0,0,278,785,1,5796,NA,NA,1,NA
"264","2020-06-07",43,3,81,151,3394,0.47672362993518,0,0,278,785,2,5798,NA,NA,1,NA
"265","2020-03-13",2,4,212,120,3498,0.769296740994854,0,0,299,498,128,315,81,229,74,81
"266","2020-03-14",4,4,229,171,3498,0.769296740994854,0,0,299,498,164,479,85,314,116,85
"267","2020-03-15",12,4,272,217,3498,0.769296740994854,0,0,299,498,213,692,52,366,169,52
"268","2020-03-16",19,4,272,274,3498,0.769296740994854,0,0,299,498,383,1075,43,409,327,43
"269","2020-03-17",34,4,243,333,3498,0.769296740994854,0,0,299,498,430,1505,23,432,387,23
"270","2020-03-18",49,4,223,381,3498,0.769296740994854,0,0,299,498,491,1996,11,443,446,11
"271","2020-03-19",65,4,217,445,3498,0.769296740994854,0,0,299,498,524,2520,22,465,501,22
"272","2020-03-20",73,4,208,503,3498,0.769296740994854,0,0,299,498,610,3130,19,484,578,19
"273","2020-03-21",92,4,201,532,3498,0.769296740994854,0,0,299,498,651,3781,15,499,632,15
"274","2020-03-22",101,4,167,560,3498,0.769296740994854,0,0,299,498,719,4500,15,514,700,15
"275","2020-03-23",116,4,144,588,3498,0.769296740994854,0,0,299,498,741,5241,21,535,724,21
"276","2020-03-24",121,4,127,630,3498,0.769296740994854,0,0,299,498,501,5742,42,577,491,42
"277","2020-03-25",134,4,142,654,3498,0.769296740994854,0,0,299,498,414,6156,58,635,402,58
"278","2020-03-26",141,4,153,654,3498,0.769296740994854,0,0,299,498,366,6522,20,655,360,20
"279","2020-03-27",154,4,184,678,3498,0.769296740994854,0,0,299,498,322,6844,27,682,317,27
"280","2020-03-28",164,4,187,707,3498,0.769296740994854,0,0,299,498,287,7131,31,713,286,31
"281","2020-03-29",177,4,222,738,3498,0.769296740994854,0,0,299,498,155,7286,67,780,151,67
"282","2020-03-30",182,4,247,749,3498,0.769296740994854,0,0,299,498,122,7408,52,832,119,52
"283","2020-03-31",187,4,241,748,3498,0.769296740994854,0,0,299,498,95,7503,21,853,90,21
"284","2020-04-01",181,4,239,745,3498,0.769296740994854,0,0,299,498,93,7596,11,864,90,11
"285","2020-04-02",187,4,215,757,3498,0.769296740994854,0,0,299,498,67,7663,12,876,66,12
"286","2020-04-03",199,4,198,764,3498,0.769296740994854,0,0,299,498,33,7696,71,947,32,71
"287","2020-04-04",200,4,169,790,3498,0.769296740994854,0,0,299,498,30,7726,32,979,28,32
"288","2020-04-05",209,4,148,782,3498,0.769296740994854,0,0,299,498,14,7740,32,1011,13,32
"289","2020-04-06",218,4,152,767,3498,0.769296740994854,0,0,299,498,11,7751,21,1032,10,21
"290","2020-04-07",217,4,145,767,3498,0.769296740994854,0,0,299,498,13,7764,58,1090,13,58
"291","2020-04-08",224,4,128,786,3498,0.769296740994854,0,0,299,498,10,7774,73,1163,9,73
"292","2020-04-09",229,4,134,779,3498,0.769296740994854,0,0,299,498,6,7780,76,1239,5,76
"293","2020-04-10",219,4,146,775,3498,0.769296740994854,0,0,299,498,5,7785,42,1281,4,42
"294","2020-04-11",214,4,149,791,3498,0.769296740994854,0,0,299,498,4,7789,23,1304,4,23
"295","2020-04-12",207,4,129,777,3498,0.769296740994854,0,0,299,498,1,7790,22,1326,1,22
"296","2020-04-13",206,4,106,776,3498,0.769296740994854,0,0,299,498,6,7796,71,1397,6,71
"297","2020-04-14",226,4,106,750,3498,0.769296740994854,0,0,299,498,2,7798,42,1439,1,42
"298","2020-04-15",231,4,116,726,3498,0.769296740994854,0,0,299,498,NA,NA,31,1470,NA,31
"299","2020-04-16",228,4,123,692,3498,0.769296740994854,0,0,299,498,2,7800,51,1521,1,51
"300","2020-04-17",226,4,124,687,3498,0.769296740994854,0,0,299,498,1,7801,35,1556,1,35
"301","2020-04-18",236,4,116,674,3498,0.769296740994854,0,0,299,498,NA,NA,44,1600,NA,44
"302","2020-04-19",227,4,111,647,3498,0.769296740994854,0,0,299,498,1,7802,54,1654,1,54
"303","2020-04-20",217,4,100,624,3498,0.769296740994854,0,0,299,498,NA,NA,45,1699,NA,45
"304","2020-04-21",202,4,112,597,3498,0.769296740994854,0,0,299,498,3,7805,60,1759,1,60
"305","2020-04-22",196,4,115,563,3498,0.769296740994854,0,0,299,498,NA,NA,17,1776,NA,17
"306","2020-04-23",190,4,126,549,3498,0.769296740994854,0,0,299,498,1,7806,9,1785,NA,9
"307","2020-04-24",191,4,122,524,3498,0.769296740994854,0,0,299,498,1,7807,13,1798,NA,13
"308","2020-04-25",175,4,106,510,3498,0.769296740994854,0,0,299,498,NA,NA,35,1833,NA,35
"309","2020-04-26",170,4,93,496,3498,0.769296740994854,0,0,299,498,NA,NA,22,1855,NA,22
"310","2020-04-27",165,4,75,469,3498,0.769296740994854,0,0,299,498,NA,NA,29,1884,NA,29
"311","2020-04-28",156,4,68,458,3498,0.769296740994854,0,0,299,498,NA,NA,16,1900,NA,16
"312","2020-04-29",145,4,72,433,3498,0.769296740994854,0,0,299,498,NA,NA,30,1930,NA,30
"313","2020-04-30",139,4,71,414,3498,0.769296740994854,0,0,299,498,NA,NA,28,1958,NA,28
"314","2020-05-01",127,4,71,385,3498,0.769296740994854,0,0,299,498,NA,NA,32,1990,NA,32
"315","2020-05-02",133,4,53,366,3498,0.769296740994854,0,0,299,498,3,7810,29,2019,1,29
"316","2020-05-03",131,4,46,347,3498,0.769296740994854,0,0,299,498,1,7811,36,2055,1,36
"317","2020-05-04",121,4,49,334,3498,0.769296740994854,0,0,299,498,NA,NA,15,2070,NA,15
"318","2020-05-05",117,4,44,313,3498,0.769296740994854,0,0,299,498,1,7812,11,2081,1,11
"319","2020-05-06",107,4,46,305,3498,0.769296740994854,0,0,299,498,NA,NA,10,2091,NA,10
"320","2020-05-07",94,4,37,297,3498,0.769296740994854,0,0,299,498,NA,NA,17,2108,NA,17
"321","2020-05-08",91,4,51,275,3498,0.769296740994854,0,0,299,498,1,7813,4,2112,NA,4
"322","2020-05-09",75,4,52,258,3498,0.769296740994854,0,0,299,498,1,7814,1,2113,1,1
"323","2020-05-10",75,4,41,244,3498,0.769296740994854,0,0,299,498,NA,NA,3,2116,NA,3
"324","2020-05-11",75,4,37,235,3498,0.769296740994854,0,0,299,498,1,7815,7,2123,NA,7
"325","2020-05-12",67,4,33,229,3498,0.769296740994854,0,0,299,498,1,7816,4,2127,NA,4
"326","2020-05-13",77,4,27,228,3498,0.769296740994854,0,0,299,498,NA,NA,7,2134,NA,7
"327","2020-05-14",84,4,25,214,3498,0.769296740994854,0,0,299,498,NA,NA,4,2138,NA,4
"328","2020-05-15",83,4,25,207,3498,0.769296740994854,0,0,299,498,NA,NA,14,2152,NA,14
"329","2020-05-16",77,4,26,200,3498,0.769296740994854,0,0,299,498,NA,NA,4,2156,NA,4
"330","2020-05-17",72,4,25,186,3498,0.769296740994854,0,0,299,498,1,7817,3,2159,NA,3
"331","2020-05-18",70,4,22,179,3498,0.769296740994854,0,0,299,498,NA,NA,7,2166,NA,7
"332","2020-05-19",71,4,18,173,3498,0.769296740994854,0,0,299,498,NA,NA,NA,NA,NA,NA
"333","2020-05-20",62,4,20,168,3498,0.769296740994854,0,0,299,498,NA,NA,1,2167,NA,1
"334","2020-05-21",56,4,16,171,3498,0.769296740994854,0,0,299,498,NA,NA,1,2168,NA,1
"335","2020-05-22",56,4,14,159,3498,0.769296740994854,0,0,299,498,1,7818,1,2169,NA,1
"336","2020-05-23",60,4,12,147,3498,0.769296740994854,0,0,299,498,1,7819,2,2171,NA,2
"337","2020-05-24",58,4,11,143,3498,0.769296740994854,0,0,299,498,NA,NA,5,2176,NA,5
"338","2020-05-25",55,4,11,135,3498,0.769296740994854,0,0,299,498,NA,NA,3,2179,NA,3
"339","2020-05-26",51,4,11,123,3498,0.769296740994854,0,0,299,498,NA,NA,NA,NA,NA,NA
"340","2020-05-27",48,4,13,124,3498,0.769296740994854,0,0,299,498,2,7821,1,2180,NA,1
"341","2020-05-28",47,4,12,116,3498,0.769296740994854,0,0,299,498,1,7822,1,2181,NA,1
"342","2020-05-29",41,4,15,112,3498,0.769296740994854,0,0,299,498,1,7823,1,2182,NA,1
"343","2020-05-30",36,4,16,103,3498,0.769296740994854,0,0,299,498,1,7824,NA,NA,NA,NA
"344","2020-05-31",34,4,16,91,3498,0.769296740994854,0,0,299,498,NA,NA,NA,NA,NA,NA
"345","2020-06-01",34,4,14,85,3498,0.769296740994854,0,0,299,498,NA,NA,NA,NA,NA,NA
"346","2020-06-02",32,4,13,74,3498,0.769296740994854,0,0,299,498,1,7825,NA,NA,NA,NA
"347","2020-06-03",31,4,12,71,3498,0.769296740994854,0,0,299,498,1,7826,NA,NA,NA,NA
"348","2020-06-04",28,4,8,70,3498,0.769296740994854,0,0,299,498,NA,NA,3,2185,NA,3
"349","2020-06-05",32,4,8,72,3498,0.769296740994854,0,0,299,498,NA,NA,2,2187,NA,2
"350","2020-06-06",30,4,8,69,3498,0.769296740994854,0,0,299,498,NA,NA,NA,NA,NA,NA
"351","2020-06-07",24,4,7,64,3498,0.769296740994854,0,0,299,498,NA,NA,NA,NA,NA,NA
"352","2020-03-13",1,5,86,111,2556,0.518388106416275,0,0,198,238,12,50,57,120,2,57
"353","2020-03-14",6,5,96,159,2556,0.518388106416275,0,0,198,238,31,81,42,162,7,42
"354","2020-03-15",10,5,137,199,2556,0.518388106416275,0,0,198,238,28,109,29,191,10,29
"355","2020-03-16",21,5,162,228,2556,0.518388106416275,0,0,198,238,24,133,18,209,10,18
"356","2020-03-17",32,5,164,263,2556,0.518388106416275,0,0,198,238,36,169,65,274,15,65
"357","2020-03-18",46,5,192,298,2556,0.518388106416275,0,0,198,238,18,187,46,320,9,46
"358","2020-03-19",54,5,220,329,2556,0.518388106416275,0,0,198,238,20,207,28,348,14,28
"359","2020-03-20",71,5,222,371,2556,0.518388106416275,0,0,198,238,27,234,22,370,9,22
"360","2020-03-21",89,5,221,390,2556,0.518388106416275,0,0,198,238,30,264,25,395,11,25
"361","2020-03-22",102,5,223,407,2556,0.518388106416275,0,0,198,238,27,291,34,429,13,34
"362","2020-03-23",109,5,250,416,2556,0.518388106416275,0,0,198,238,34,325,33,462,19,33
"363","2020-03-24",115,5,242,430,2556,0.518388106416275,0,0,198,238,38,363,31,493,23,31
"364","2020-03-25",115,5,222,451,2556,0.518388106416275,0,0,198,238,19,382,26,519,13,26
"365","2020-03-26",131,5,182,443,2556,0.518388106416275,0,0,198,238,22,404,24,543,14,24
"366","2020-03-27",132,5,162,434,2556,0.518388106416275,0,0,198,238,24,428,50,593,15,50
"367","2020-03-28",126,5,165,440,2556,0.518388106416275,0,0,198,238,34,462,30,623,22,30
"368","2020-03-29",128,5,156,444,2556,0.518388106416275,0,0,198,238,18,480,35,658,11,35
"369","2020-03-30",127,5,163,450,2556,0.518388106416275,0,0,198,238,24,504,43,701,16,43
"370","2020-03-31",124,5,164,451,2556,0.518388106416275,0,0,198,238,32,536,70,771,21,70
"371","2020-04-01",130,5,143,442,2556,0.518388106416275,0,0,198,238,18,554,45,816,9,45
"372","2020-04-02",125,5,126,429,2556,0.518388106416275,0,0,198,238,27,581,44,860,18,44
"373","2020-04-03",118,5,122,432,2556,0.518388106416275,0,0,198,238,18,599,22,882,14,22
"374","2020-04-04",130,5,140,436,2556,0.518388106416275,0,0,198,238,24,623,22,904,18,22
"375","2020-04-05",127,5,147,425,2556,0.518388106416275,0,0,198,238,25,648,17,921,17,17
"376","2020-04-06",130,5,126,415,2556,0.518388106416275,0,0,198,238,27,675,36,957,17,36
"377","2020-04-07",130,5,114,406,2556,0.518388106416275,0,0,198,238,18,693,28,985,12,28
"378","2020-04-08",126,5,85,390,2556,0.518388106416275,0,0,198,238,28,721,32,1017,17,32
"379","2020-04-09",120,5,75,387,2556,0.518388106416275,0,0,198,238,24,745,52,1069,21,52
"380","2020-04-10",129,5,70,380,2556,0.518388106416275,0,0,198,238,26,771,33,1102,18,33
"381","2020-04-11",119,5,68,366,2556,0.518388106416275,0,0,198,238,21,792,31,1133,13,31
"382","2020-04-12",110,5,77,347,2556,0.518388106416275,0,0,198,238,24,816,10,1143,15,10
"383","2020-04-13",98,5,80,348,2556,0.518388106416275,0,0,198,238,29,845,19,1162,19,19
"384","2020-04-14",96,5,88,345,2556,0.518388106416275,0,0,198,238,19,864,17,1179,16,17
"385","2020-04-15",93,5,86,344,2556,0.518388106416275,0,0,198,238,19,883,18,1197,15,18
"386","2020-04-16",92,5,103,331,2556,0.518388106416275,0,0,198,238,23,906,29,1226,19,29
"387","2020-04-17",85,5,109,320,2556,0.518388106416275,0,0,198,238,34,940,32,1258,28,32
"388","2020-04-18",86,5,108,312,2556,0.518388106416275,0,0,198,238,22,962,17,1275,17,17
"389","2020-04-19",100,5,96,304,2556,0.518388106416275,0,0,198,238,23,985,20,1295,18,20
"390","2020-04-20",103,5,87,302,2556,0.518388106416275,0,0,198,238,34,1019,15,1310,30,15
"391","2020-04-21",103,5,85,296,2556,0.518388106416275,0,0,198,238,21,1040,10,1320,16,10
"392","2020-04-22",103,5,84,277,2556,0.518388106416275,0,0,198,238,20,1060,11,1331,17,11
"393","2020-04-23",99,5,88,275,2556,0.518388106416275,0,0,198,238,25,1085,8,1339,17,8
"394","2020-04-24",97,5,73,274,2556,0.518388106416275,0,0,198,238,18,1103,18,1357,15,18
"395","2020-04-25",92,5,55,260,2556,0.518388106416275,0,0,198,238,22,1125,20,1377,17,20
"396","2020-04-26",82,5,44,265,2556,0.518388106416275,0,0,198,238,34,1159,22,1399,30,22
"397","2020-04-27",79,5,37,264,2556,0.518388106416275,0,0,198,238,25,1184,19,1418,19,19
"398","2020-04-28",77,5,35,250,2556,0.518388106416275,0,0,198,238,17,1201,12,1430,16,12
"399","2020-04-29",79,5,32,245,2556,0.518388106416275,0,0,198,238,30,1231,20,1450,26,20
"400","2020-04-30",79,5,33,243,2556,0.518388106416275,0,0,198,238,24,1255,15,1465,23,15
"401","2020-05-01",82,5,26,233,2556,0.518388106416275,0,0,198,238,20,1275,16,1481,14,16
"402","2020-05-02",74,5,24,234,2556,0.518388106416275,0,0,198,238,17,1292,28,1509,13,28
"403","2020-05-03",73,5,30,228,2556,0.518388106416275,0,0,198,238,16,1308,15,1524,13,15
"404","2020-05-04",75,5,29,232,2556,0.518388106416275,0,0,198,238,21,1329,24,1548,13,24
"405","2020-05-05",70,5,32,227,2556,0.518388106416275,0,0,198,238,17,1346,12,1560,13,12
"406","2020-05-06",66,5,31,225,2556,0.518388106416275,0,0,198,238,23,1369,15,1575,20,15
"407","2020-05-07",64,5,37,226,2556,0.518388106416275,0,0,198,238,27,1396,11,1586,22,11
"408","2020-05-08",56,5,36,227,2556,0.518388106416275,0,0,198,238,20,1416,9,1595,17,9
"409","2020-05-09",55,5,34,231,2556,0.518388106416275,0,0,198,238,17,1433,14,1609,14,14
"410","2020-05-10",57,5,32,230,2556,0.518388106416275,0,0,198,238,29,1462,14,1623,22,14
"411","2020-05-11",54,5,43,244,2556,0.518388106416275,0,0,198,238,20,1482,7,1630,11,7
"412","2020-05-12",58,5,40,242,2556,0.518388106416275,0,0,198,238,22,1504,5,1635,15,5
"413","2020-05-13",52,5,34,238,2556,0.518388106416275,0,0,198,238,20,1524,13,1648,17,13
"414","2020-05-14",62,5,35,233,2556,0.518388106416275,0,0,198,238,24,1548,9,1657,24,9
"415","2020-05-15",63,5,34,233,2556,0.518388106416275,0,0,198,238,19,1567,3,1660,16,3
"416","2020-05-16",66,5,34,249,2556,0.518388106416275,0,0,198,238,34,1601,5,1665,27,5
"417","2020-05-17",62,5,35,239,2556,0.518388106416275,0,0,198,238,28,1629,2,1667,23,2
"418","2020-05-18",63,5,31,254,2556,0.518388106416275,0,0,198,238,37,1666,4,1671,33,4
"419","2020-05-19",67,5,36,249,2556,0.518388106416275,0,0,198,238,26,1692,2,1673,22,2
"420","2020-05-20",71,5,33,251,2556,0.518388106416275,0,0,198,238,33,1725,4,1677,29,4
"421","2020-05-21",64,5,33,249,2556,0.518388106416275,0,0,198,238,35,1760,5,1682,30,5
"422","2020-05-22",68,5,26,251,2556,0.518388106416275,0,0,198,238,40,1800,6,1688,38,6
"423","2020-05-23",67,5,29,252,2556,0.518388106416275,0,0,198,238,27,1827,7,1695,22,7
"424","2020-05-24",63,5,26,245,2556,0.518388106416275,0,0,198,238,29,1856,5,1700,28,5
"425","2020-05-25",64,5,29,245,2556,0.518388106416275,0,0,198,238,32,1888,7,1707,28,7
"426","2020-05-26",55,5,32,239,2556,0.518388106416275,0,0,198,238,31,1919,4,1711,30,4
"427","2020-05-27",59,5,27,240,2556,0.518388106416275,0,0,198,238,39,1958,7,1718,29,7
"428","2020-05-28",59,5,26,239,2556,0.518388106416275,0,0,198,238,33,1991,1,1719,31,1
"429","2020-05-29",56,5,22,238,2556,0.518388106416275,0,0,198,238,23,2014,6,1725,19,6
"430","2020-05-30",56,5,21,241,2556,0.518388106416275,0,0,198,238,42,2056,4,1729,38,4
"431","2020-05-31",60,5,24,233,2556,0.518388106416275,0,0,198,238,37,2093,7,1736,35,7
"432","2020-06-01",59,5,21,227,2556,0.518388106416275,0,0,198,238,26,2119,3,1739,24,3
"433","2020-06-02",68,5,21,232,2556,0.518388106416275,0,0,198,238,40,2159,6,1745,35,6
"434","2020-06-03",68,5,19,226,2556,0.518388106416275,0,0,198,238,27,2186,3,1748,23,3
"435","2020-06-04",65,5,23,237,2556,0.518388106416275,0,0,198,238,27,2213,5,1753,22,5
"436","2020-06-05",69,5,25,236,2556,0.518388106416275,0,0,198,238,36,2249,8,1761,35,8
"437","2020-06-06",69,5,25,237,2556,0.518388106416275,0,0,198,238,30,2279,7,1768,30,7
"438","2020-06-07",71,5,31,230,2556,0.518388106416275,0,0,198,238,28,2307,1,1769,21,1
"439","2020-03-13",4,6,185,187,7933,0.930291188705408,0,0,684,1031,45,112,37,175,1,37
"440","2020-03-14",10,6,181,294,7933,0.930291188705408,0,0,684,1031,38,150,59,234,3,59
"441","2020-03-15",18,6,178,428,7933,0.930291188705408,0,0,684,1031,35,185,44,278,1,44
"442","2020-03-16",34,6,230,627,7933,0.930291188705408,0,0,684,1031,25,210,31,309,3,31
"443","2020-03-17",49,6,214,835,7933,0.930291188705408,0,0,684,1031,31,241,65,374,4,65
"444","2020-03-18",74,6,197,1189,7933,0.930291188705408,0,0,684,1031,34,275,52,426,4,52
"445","2020-03-19",115,6,181,1522,7933,0.930291188705408,0,0,684,1031,43,318,33,459,5,33
"446","2020-03-20",162,6,148,1878,7933,0.930291188705408,0,0,684,1031,27,345,20,479,2,20
"447","2020-03-21",220,6,129,2357,7933,0.930291188705408,0,0,684,1031,30,375,10,489,8,10
"448","2020-03-22",297,6,113,2807,7933,0.930291188705408,0,0,684,1031,31,406,15,504,2,15
"449","2020-03-23",377,6,115,3241,7933,0.930291188705408,0,0,684,1031,45,451,40,544,16,40
"450","2020-03-24",464,6,102,3602,7933,0.930291188705408,0,0,684,1031,29,480,28,572,4,28
"451","2020-03-25",595,6,110,3950,7933,0.930291188705408,0,0,684,1031,31,511,31,603,10,31
"452","2020-03-26",716,6,148,4244,7933,0.930291188705408,0,0,684,1031,30,541,34,637,8,34
"453","2020-03-27",848,6,143,4459,7933,0.930291188705408,0,0,684,1031,29,570,30,667,10,30
"454","2020-03-28",957,6,147,4664,7933,0.930291188705408,0,0,684,1031,41,611,24,691,17,24
"455","2020-03-29",1062,6,203,4666,7933,0.930291188705408,0,0,684,1031,33,644,44,735,13,44
"456","2020-03-30",1176,6,213,4649,7933,0.930291188705408,0,0,684,1031,36,680,48,783,15,48
"457","2020-03-31",1237,6,200,4435,7933,0.930291188705408,0,0,684,1031,41,721,33,816,16,33
"458","2020-04-01",1283,6,191,4239,7933,0.930291188705408,0,0,684,1031,33,754,20,836,10,20
"459","2020-04-02",1279,6,175,3956,7933,0.930291188705408,0,0,684,1031,24,778,42,878,9,42
"460","2020-04-03",1249,6,144,3638,7933,0.930291188705408,0,0,684,1031,23,801,22,900,6,22
"461","2020-04-04",1222,6,133,3257,7933,0.930291188705408,0,0,684,1031,22,823,42,942,10,42
"462","2020-04-05",1159,6,127,2871,7933,0.930291188705408,0,0,684,1031,31,854,36,978,13,36
"463","2020-04-06",1061,6,108,2484,7933,0.930291188705408,0,0,684,1031,25,879,20,998,9,20
"464","2020-04-07",1005,6,130,2151,7933,0.930291188705408,0,0,684,1031,27,906,10,1008,11,10
"465","2020-04-08",896,6,165,1824,7933,0.930291188705408,0,0,684,1031,28,934,19,1027,12,19
"466","2020-04-09",828,6,158,1549,7933,0.930291188705408,0,0,684,1031,24,958,10,1037,11,10
"467","2020-04-10",733,6,144,1282,7933,0.930291188705408,0,0,684,1031,30,988,9,1046,11,9
"468","2020-04-11",636,6,142,1042,7933,0.930291188705408,0,0,684,1031,22,1010,12,1058,9,12
"469","2020-04-12",557,6,140,855,7933,0.930291188705408,0,0,684,1031,19,1029,29,1087,9,29
"470","2020-04-13",483,6,141,680,7933,0.930291188705408,0,0,684,1031,35,1064,14,1101,25,14
"471","2020-04-14",397,6,147,536,7933,0.930291188705408,0,0,684,1031,24,1088,26,1127,12,26
"472","2020-04-15",328,6,143,421,7933,0.930291188705408,0,0,684,1031,30,1118,17,1144,17,17
"473","2020-04-16",259,6,154,329,7933,0.930291188705408,0,0,684,1031,22,1140,14,1158,8,14
"474","2020-04-17",215,6,160,259,7933,0.930291188705408,0,0,684,1031,32,1172,14,1172,17,14
"475","2020-04-18",178,6,140,203,7933,0.930291188705408,0,0,684,1031,24,1196,31,1203,15,31
"476","2020-04-19",136,6,132,172,7933,0.930291188705408,0,0,684,1031,23,1219,25,1228,11,25
"477","2020-04-20",104,6,120,139,7933,0.930291188705408,0,0,684,1031,26,1245,23,1251,16,23
"478","2020-04-21",89,6,99,114,7933,0.930291188705408,0,0,684,1031,21,1266,34,1285,10,34
"479","2020-04-22",73,6,89,96,7933,0.930291188705408,0,0,684,1031,26,1292,20,1305,12,20
"480","2020-04-23",54,6,82,75,7933,0.930291188705408,0,0,684,1031,18,1310,28,1333,1,28
"481","2020-04-24",42,6,80,60,7933,0.930291188705408,0,0,684,1031,16,1326,42,1375,10,42
"482","2020-04-25",32,6,92,53,7933,0.930291188705408,0,0,684,1031,16,1342,29,1404,7,29
"483","2020-04-26",29,6,105,48,7933,0.930291188705408,0,0,684,1031,23,1365,30,1434,9,30
"484","2020-04-27",24,6,119,43,7933,0.930291188705408,0,0,684,1031,14,1379,41,1475,7,41
"485","2020-04-28",19,6,108,33,7933,0.930291188705408,0,0,684,1031,16,1395,33,1508,7,33
"486","2020-04-29",13,6,88,29,7933,0.930291188705408,0,0,684,1031,17,1412,27,1535,6,27
"487","2020-04-30",12,6,85,25,7933,0.930291188705408,0,0,684,1031,19,1431,21,1556,7,21
"488","2020-05-01",10,6,78,20,7933,0.930291188705408,0,0,684,1031,19,1450,14,1570,10,14
"489","2020-05-02",8,6,76,15,7933,0.930291188705408,0,0,684,1031,15,1465,15,1585,8,15
"490","2020-05-03",8,6,62,15,7933,0.930291188705408,0,0,684,1031,15,1480,14,1599,9,14
"491","2020-05-04",7,6,54,14,7933,0.930291188705408,0,0,684,1031,16,1496,7,1606,9,7
"492","2020-05-05",6,6,51,13,7933,0.930291188705408,0,0,684,1031,13,1509,14,1620,6,14
"493","2020-05-06",4,6,38,10,7933,0.930291188705408,0,0,684,1031,17,1526,20,1640,9,20
"494","2020-05-07",4,6,27,10,7933,0.930291188705408,0,0,684,1031,13,1539,10,1650,11,10
"495","2020-05-08",4,6,26,10,7933,0.930291188705408,0,0,684,1031,15,1554,7,1657,8,7
"496","2020-05-09",4,6,22,9,7933,0.930291188705408,0,0,684,1031,13,1567,11,1668,7,11
"497","2020-05-10",1,6,29,8,7933,0.930291188705408,0,0,684,1031,14,1581,4,1672,7,4
"498","2020-05-11",1,6,33,8,7933,0.930291188705408,0,0,684,1031,18,1599,9,1681,7,9
"499","2020-05-12",1,6,32,7,7933,0.930291188705408,0,0,684,1031,11,1610,6,1687,9,6
"500","2020-05-13",1,6,29,9,7933,0.930291188705408,0,0,684,1031,18,1628,6,1693,11,6
"501","2020-05-14",1,6,23,9,7933,0.930291188705408,0,0,684,1031,20,1648,3,1696,14,3
"502","2020-05-15",1,6,23,7,7933,0.930291188705408,0,0,684,1031,14,1662,11,1707,7,11
"503","2020-05-16",1,6,23,6,7933,0.930291188705408,0,0,684,1031,17,1679,6,1713,15,6
"504","2020-05-17",2,6,20,5,7933,0.930291188705408,0,0,684,1031,18,1697,2,1715,13,2
"505","2020-05-18",2,6,24,5,7933,0.930291188705408,0,0,684,1031,20,1717,1,1716,12,1
"506","2020-05-19",2,6,23,6,7933,0.930291188705408,0,0,684,1031,12,1729,4,1720,7,4
"507","2020-05-20",3,6,21,6,7933,0.930291188705408,0,0,684,1031,34,1763,2,1722,25,2
"508","2020-05-21",2,6,22,6,7933,0.930291188705408,0,0,684,1031,19,1782,4,1726,14,4
"509","2020-05-22",2,6,25,5,7933,0.930291188705408,0,0,684,1031,21,1803,2,1728,11,2
"510","2020-05-23",2,6,22,5,7933,0.930291188705408,0,0,684,1031,22,1825,NA,NA,16,NA
"511","2020-05-24",1,6,22,4,7933,0.930291188705408,0,0,684,1031,27,1852,2,1730,20,2
"512","2020-05-25",1,6,19,4,7933,0.930291188705408,0,0,684,1031,26,1878,9,1739,16,9
"513","2020-05-26",1,6,19,3,7933,0.930291188705408,0,0,684,1031,22,1900,4,1743,14,4
"514","2020-05-27",1,6,16,2,7933,0.930291188705408,0,0,684,1031,31,1931,4,1747,21,4
"515","2020-05-28",1,6,16,1,7933,0.930291188705408,0,0,684,1031,24,1955,NA,NA,15,NA
"516","2020-05-29",1,6,15,0,7933,0.930291188705408,0,0,684,1031,27,1982,4,1751,20,4
"517","2020-05-30",1,6,18,0,7933,0.930291188705408,0,0,684,1031,20,2002,4,1755,16,4
"518","2020-05-31",1,6,14,0,7933,0.930291188705408,0,0,684,1031,21,2023,7,1762,18,7
"519","2020-06-01",1,6,13,1,7933,0.930291188705408,0,0,684,1031,20,2043,1,1763,16,1
"520","2020-06-02",1,6,11,2,7933,0.930291188705408,0,0,684,1031,23,2066,4,1767,17,4
"521","2020-03-12",1,7,61,148,3051,0.329727958046542,0,0,279,205,29,53,24,78,3,24
"522","2020-03-13",4,7,72,208,3051,0.329727958046542,0,0,279,205,34,87,19,97,9,19
"523","2020-03-14",13,7,65,275,3051,0.329727958046542,0,0,279,205,38,125,11,108,18,11
"524","2020-03-15",22,7,113,333,3051,0.329727958046542,0,0,279,205,35,160,77,185,17,77
"525","2020-03-16",33,7,129,405,3051,0.329727958046542,0,0,279,205,38,198,75,260,18,75
"526","2020-03-17",49,7,140,477,3051,0.329727958046542,0,0,279,205,30,228,31,291,19,31
"527","2020-03-18",76,7,142,545,3051,0.329727958046542,0,0,279,205,30,258,28,319,20,28
"528","2020-03-19",105,7,152,615,3051,0.329727958046542,0,0,279,205,56,314,28,347,27,28
"529","2020-03-20",128,7,180,662,3051,0.329727958046542,0,0,279,205,39,353,19,366,25,19
"530","2020-03-21",152,7,195,697,3051,0.329727958046542,0,0,279,205,42,395,14,380,29,14
"531","2020-03-22",181,7,193,709,3051,0.329727958046542,0,0,279,205,32,427,10,390,28,10
"532","2020-03-23",199,7,200,722,3051,0.329727958046542,0,0,279,205,40,467,8,398,26,8
"533","2020-03-24",213,7,198,734,3051,0.329727958046542,0,0,279,205,34,501,10,408,21,10
"534","2020-03-25",212,7,213,741,3051,0.329727958046542,0,0,279,205,39,540,18,426,23,18
"535","2020-03-26",222,7,207,727,3051,0.329727958046542,0,0,279,205,40,580,7,433,24,7
"536","2020-03-27",225,7,197,725,3051,0.329727958046542,0,0,279,205,39,619,44,477,28,44
"537","2020-03-28",212,7,202,707,3051,0.329727958046542,0,0,279,205,48,667,40,517,36,40
"538","2020-03-29",205,7,214,690,3051,0.329727958046542,0,0,279,205,50,717,29,546,33,29
"539","2020-03-30",208,7,202,677,3051,0.329727958046542,0,0,279,205,48,765,13,559,34,13
"540","2020-03-31",199,7,196,663,3051,0.329727958046542,0,0,279,205,34,799,6,565,20,6
"541","2020-04-01",213,7,178,656,3051,0.329727958046542,0,0,279,205,34,833,8,573,21,8
"542","2020-04-02",198,7,195,607,3051,0.329727958046542,0,0,279,205,40,873,33,606,32,33
"543","2020-04-03",195,7,178,589,3051,0.329727958046542,0,0,279,205,28,901,37,643,21,37
"544","2020-04-04",211,7,164,575,3051,0.329727958046542,0,0,279,205,38,939,29,672,27,29
"545","2020-04-05",207,7,146,556,3051,0.329727958046542,0,0,279,205,38,977,28,700,25,28
"546","2020-04-06",193,7,148,530,3051,0.329727958046542,0,0,279,205,31,1008,36,736,22,36
"547","2020-04-07",188,7,149,520,3051,0.329727958046542,0,0,279,205,39,1047,12,748,32,12
"548","2020-04-08",165,7,158,492,3051,0.329727958046542,0,0,279,205,43,1090,17,765,32,17
"549","2020-04-09",161,7,155,504,3051,0.329727958046542,0,0,279,205,38,1128,40,805,30,40
"550","2020-04-10",158,7,149,494,3051,0.329727958046542,0,0,279,205,19,1147,22,827,14,22
"551","2020-04-11",148,7,142,481,3051,0.329727958046542,0,0,279,205,36,1183,16,843,25,16
"552","2020-04-12",134,7,144,459,3051,0.329727958046542,0,0,279,205,23,1206,38,881,19,38
"553","2020-04-13",135,7,134,448,3051,0.329727958046542,0,0,279,205,37,1243,39,920,27,39
"554","2020-04-14",138,7,120,416,3051,0.329727958046542,0,0,279,205,34,1277,41,961,29,41
"555","2020-04-15",133,7,110,405,3051,0.329727958046542,0,0,279,205,21,1298,13,974,19,13
"556","2020-04-16",137,7,107,397,3051,0.329727958046542,0,0,279,205,20,1318,29,1003,16,29
"557","2020-04-17",125,7,94,388,3051,0.329727958046542,0,0,279,205,24,1342,32,1035,20,32
"558","2020-04-18",119,7,92,366,3051,0.329727958046542,0,0,279,205,20,1362,45,1080,15,45
"559","2020-04-19",117,7,97,345,3051,0.329727958046542,0,0,279,205,23,1385,42,1122,18,42
"560","2020-04-20",111,7,95,345,3051,0.329727958046542,0,0,279,205,17,1402,21,1143,14,21
"561","2020-04-21",107,7,89,318,3051,0.329727958046542,0,0,279,205,20,1422,19,1162,13,19
"562","2020-04-22",106,7,77,299,3051,0.329727958046542,0,0,279,205,33,1455,27,1189,24,27
"563","2020-04-23",89,7,78,298,3051,0.329727958046542,0,0,279,205,19,1474,15,1204,9,15
"564","2020-04-24",92,7,69,297,3051,0.329727958046542,0,0,279,205,28,1502,13,1217,25,13
"565","2020-04-25",75,7,76,295,3051,0.329727958046542,0,0,279,205,19,1521,9,1226,16,9
"566","2020-04-26",82,7,70,290,3051,0.329727958046542,0,0,279,205,14,1535,3,1229,12,3
"567","2020-04-27",81,7,70,282,3051,0.329727958046542,0,0,279,205,23,1558,6,1235,18,6
"568","2020-04-28",80,7,72,291,3051,0.329727958046542,0,0,279,205,20,1578,2,1237,20,2
"569","2020-04-29",84,7,61,284,3051,0.329727958046542,0,0,279,205,24,1602,9,1246,19,9
"570","2020-04-30",84,7,50,277,3051,0.329727958046542,0,0,279,205,33,1635,10,1256,25,10
"571","2020-05-01",73,7,47,264,3051,0.329727958046542,0,0,279,205,22,1657,9,1265,19,9
"572","2020-05-02",77,7,41,250,3051,0.329727958046542,0,0,279,205,22,1679,2,1267,17,2
"573","2020-05-03",70,7,42,242,3051,0.329727958046542,0,0,279,205,28,1707,4,1271,26,4
"574","2020-05-04",65,7,45,243,3051,0.329727958046542,0,0,279,205,22,1729,8,1279,20,8
"575","2020-05-05",66,7,44,239,3051,0.329727958046542,0,0,279,205,38,1767,7,1286,32,7
"576","2020-05-06",62,7,50,224,3051,0.329727958046542,0,0,279,205,26,1793,14,1300,22,14
"577","2020-05-07",63,7,44,209,3051,0.329727958046542,0,0,279,205,29,1822,9,1309,27,9
"578","2020-05-08",72,7,43,200,3051,0.329727958046542,0,0,279,205,22,1844,10,1319,18,10
"579","2020-05-09",72,7,36,195,3051,0.329727958046542,0,0,279,205,22,1866,4,1323,20,4
"580","2020-05-10",68,7,28,199,3051,0.329727958046542,0,0,279,205,28,1894,7,1330,21,7
"581","2020-05-11",65,7,31,200,3051,0.329727958046542,0,0,279,205,29,1923,4,1334,25,4
"582","2020-05-12",54,7,27,187,3051,0.329727958046542,0,0,279,205,30,1953,5,1339,25,5
"583","2020-05-13",53,7,26,188,3051,0.329727958046542,0,0,279,205,29,1982,4,1343,26,4
"584","2020-05-14",53,7,24,195,3051,0.329727958046542,0,0,279,205,34,2016,5,1348,31,5
"585","2020-05-15",51,7,20,190,3051,0.329727958046542,0,0,279,205,27,2043,4,1352,22,4
"586","2020-05-16",50,7,20,197,3051,0.329727958046542,0,0,279,205,22,2065,7,1359,18,7
"587","2020-05-17",53,7,19,186,3051,0.329727958046542,0,0,279,205,21,2086,2,1361,17,2
"588","2020-05-18",55,7,26,180,3051,0.329727958046542,0,0,279,205,32,2118,2,1363,30,2
"589","2020-05-19",61,7,28,180,3051,0.329727958046542,0,0,279,205,34,2152,5,1368,31,5
"590","2020-05-20",56,7,25,178,3051,0.329727958046542,0,0,279,205,21,2173,4,1372,18,4
"591","2020-05-21",54,7,26,178,3051,0.329727958046542,0,0,279,205,28,2201,4,1376,21,4
"592","2020-05-22",53,7,21,181,3051,0.329727958046542,0,0,279,205,17,2218,NA,NA,17,NA
"593","2020-05-23",54,7,20,179,3051,0.329727958046542,0,0,279,205,34,2252,3,1379,31,3
"594","2020-05-24",55,7,25,180,3051,0.329727958046542,0,0,279,205,26,2278,2,1381,22,2
"595","2020-05-25",59,7,24,177,3051,0.329727958046542,0,0,279,205,27,2305,1,1382,26,1
"596","2020-05-26",54,7,21,177,3051,0.329727958046542,0,0,279,205,27,2332,NA,NA,22,NA
"597","2020-05-27",55,7,17,178,3051,0.329727958046542,0,0,279,205,36,2368,3,1385,32,3
"598","2020-05-28",53,7,21,175,3051,0.329727958046542,0,0,279,205,31,2399,NA,NA,25,NA
"599","2020-05-29",48,7,20,168,3051,0.329727958046542,0,0,279,205,25,2424,NA,NA,24,NA
"600","2020-05-30",53,7,16,173,3051,0.329727958046542,0,0,279,205,32,2456,1,1386,28,1
"601","2020-05-31",51,7,13,173,3051,0.329727958046542,0,0,279,205,28,2484,1,1387,26,1
"602","2020-06-01",47,7,13,164,3051,0.329727958046542,0,0,279,205,26,2510,1,1388,24,1
"603","2020-06-02",52,7,12,171,3051,0.329727958046542,0,0,279,205,40,2550,NA,NA,33,NA
"604","2020-06-03",53,7,11,168,3051,0.329727958046542,0,0,279,205,26,2576,NA,NA,18,NA
"605","2020-06-04",57,7,9,176,3051,0.329727958046542,0,0,279,205,29,2605,2,1390,26,2
"606","2020-06-05",58,7,10,181,3051,0.329727958046542,0,0,279,205,22,2627,2,1392,19,2
"607","2020-06-06",51,7,11,167,3051,0.329727958046542,0,0,279,205,35,2662,3,1395,30,3
"608","2020-06-07",50,7,9,164,3051,0.329727958046542,0,0,279,205,22,2684,NA,NA,21,NA
"609","2020-03-13",3,8,302,141,2909,0.488484015125473,0,0,251,946,33,105,26,100,3,26
"610","2020-03-14",4,8,353,193,2909,0.488484015125473,0,0,251,946,53,158,54,154,8,54
"611","2020-03-15",14,8,329,260,2909,0.488484015125473,0,0,251,946,39,197,54,208,8,54
"612","2020-03-16",19,8,320,304,2909,0.488484015125473,0,0,251,946,48,245,38,246,10,38
"613","2020-03-17",29,8,283,365,2909,0.488484015125473,0,0,251,946,41,286,34,280,11,34
"614","2020-03-18",43,8,263,423,2909,0.488484015125473,0,0,251,946,43,329,48,328,11,48
"615","2020-03-19",72,8,278,477,2909,0.488484015125473,0,0,251,946,52,381,36,364,15,36
"616","2020-03-20",89,8,276,514,2909,0.488484015125473,0,0,251,946,31,412,21,385,7,21
"617","2020-03-21",107,8,266,540,2909,0.488484015125473,0,0,251,946,35,447,36,421,11,36
"618","2020-03-22",124,8,269,564,2909,0.488484015125473,0,0,251,946,34,481,35,456,6,35
"619","2020-03-23",139,8,275,583,2909,0.488484015125473,0,0,251,946,43,524,38,494,14,38
"620","2020-03-24",150,8,289,605,2909,0.488484015125473,0,0,251,946,49,573,32,526,13,32
"621","2020-03-25",162,8,262,605,2909,0.488484015125473,0,0,251,946,27,600,14,540,7,14
"622","2020-03-26",160,8,237,609,2909,0.488484015125473,0,0,251,946,41,641,8,548,14,8
"623","2020-03-27",171,8,241,614,2909,0.488484015125473,0,0,251,946,36,677,12,560,6,12
"624","2020-03-28",174,8,241,616,2909,0.488484015125473,0,0,251,946,26,703,42,602,8,42
"625","2020-03-29",180,8,233,609,2909,0.488484015125473,0,0,251,946,34,737,30,632,11,30
"626","2020-03-30",177,8,215,614,2909,0.488484015125473,0,0,251,946,21,758,31,663,6,31
"627","2020-03-31",183,8,210,607,2909,0.488484015125473,0,0,251,946,39,797,45,708,15,45
"628","2020-04-01",189,8,215,579,2909,0.488484015125473,0,0,251,946,19,816,33,741,8,33
"629","2020-04-02",194,8,205,577,2909,0.488484015125473,0,0,251,946,30,846,26,767,10,26
"630","2020-04-03",191,8,205,574,2909,0.488484015125473,0,0,251,946,30,876,52,819,9,52
"631","2020-04-04",192,8,189,560,2909,0.488484015125473,0,0,251,946,26,902,30,849,6,30
"632","2020-04-05",179,8,210,562,2909,0.488484015125473,0,0,251,946,23,925,45,894,7,45
"633","2020-04-06",194,8,221,559,2909,0.488484015125473,0,0,251,946,29,954,23,917,11,23
"634","2020-04-07",186,8,263,550,2909,0.488484015125473,0,0,251,946,22,976,25,942,5,25
"635","2020-04-08",175,8,284,534,2909,0.488484015125473,0,0,251,946,25,1001,18,960,6,18
"636","2020-04-09",163,8,291,540,2909,0.488484015125473,0,0,251,946,19,1020,13,973,9,13
"637","2020-04-10",171,8,273,518,2909,0.488484015125473,0,0,251,946,20,1040,24,997,9,24
"638","2020-04-11",161,8,248,518,2909,0.488484015125473,0,0,251,946,23,1063,42,1039,12,42
"639","2020-04-12",163,8,261,510,2909,0.488484015125473,0,0,251,946,19,1082,24,1063,6,24
"640","2020-04-13",147,8,258,504,2909,0.488484015125473,0,0,251,946,11,1093,17,1080,2,17
"641","2020-04-14",144,8,247,475,2909,0.488484015125473,0,0,251,946,24,1117,13,1093,4,13
"642","2020-04-15",143,8,246,461,2909,0.488484015125473,0,0,251,946,26,1143,15,1108,9,15
"643","2020-04-16",143,8,252,448,2909,0.488484015125473,0,0,251,946,19,1162,19,1127,6,19
"644","2020-04-17",127,8,264,436,2909,0.488484015125473,0,0,251,946,21,1183,18,1145,11,18
"645","2020-04-18",128,8,267,420,2909,0.488484015125473,0,0,251,946,19,1202,27,1172,11,27
"646","2020-04-19",120,8,278,393,2909,0.488484015125473,0,0,251,946,20,1222,9,1181,10,9
"647","2020-04-20",120,8,254,377,2909,0.488484015125473,0,0,251,946,22,1244,10,1191,8,10
"648","2020-04-21",124,8,246,360,2909,0.488484015125473,0,0,251,946,17,1261,3,1194,6,3
"649","2020-04-22",116,8,241,335,2909,0.488484015125473,0,0,251,946,17,1278,4,1198,9,4
"650","2020-04-23",108,8,245,317,2909,0.488484015125473,0,0,251,946,20,1298,3,1201,12,3
"651","2020-04-24",101,8,239,294,2909,0.488484015125473,0,0,251,946,14,1312,7,1208,8,7
"652","2020-04-25",99,8,226,289,2909,0.488484015125473,0,0,251,946,23,1335,9,1217,15,9
"653","2020-04-26",100,8,214,281,2909,0.488484015125473,0,0,251,946,22,1357,4,1221,8,4
"654","2020-04-27",96,8,203,265,2909,0.488484015125473,0,0,251,946,14,1371,6,1227,10,6
"655","2020-04-28",85,8,203,260,2909,0.488484015125473,0,0,251,946,18,1389,3,1230,10,3
"656","2020-04-29",82,8,179,256,2909,0.488484015125473,0,0,251,946,28,1417,9,1239,18,9
"657","2020-04-30",75,8,174,246,2909,0.488484015125473,0,0,251,946,14,1431,9,1248,10,9
"658","2020-05-01",71,8,165,250,2909,0.488484015125473,0,0,251,946,14,1445,11,1259,7,11
"659","2020-05-02",67,8,150,249,2909,0.488484015125473,0,0,251,946,21,1466,12,1271,13,12
"660","2020-05-03",61,8,144,247,2909,0.488484015125473,0,0,251,946,16,1482,9,1280,12,9
"661","2020-05-04",61,8,140,249,2909,0.488484015125473,0,0,251,946,14,1496,11,1291,6,11
"662","2020-05-05",60,8,143,243,2909,0.488484015125473,0,0,251,946,12,1508,4,1295,8,4
"663","2020-05-06",63,8,129,241,2909,0.488484015125473,0,0,251,946,15,1523,14,1309,6,14
"664","2020-05-07",65,8,126,240,2909,0.488484015125473,0,0,251,946,14,1537,8,1317,7,8
"665","2020-05-08",67,8,141,237,2909,0.488484015125473,0,0,251,946,19,1556,1,1318,12,1
"666","2020-05-09",73,8,144,235,2909,0.488484015125473,0,0,251,946,14,1570,4,1322,11,4
"667","2020-05-10",79,8,146,241,2909,0.488484015125473,0,0,251,946,17,1587,2,1324,5,2
"668","2020-05-11",73,8,151,240,2909,0.488484015125473,0,0,251,946,16,1603,3,1327,8,3
"669","2020-05-12",74,8,162,231,2909,0.488484015125473,0,0,251,946,12,1615,6,1333,5,6
"670","2020-05-13",72,8,156,225,2909,0.488484015125473,0,0,251,946,18,1633,2,1335,12,2
"671","2020-05-14",70,8,154,216,2909,0.488484015125473,0,0,251,946,14,1647,5,1340,7,5
"672","2020-05-15",67,8,142,189,2909,0.488484015125473,0,0,251,946,16,1663,4,1344,11,4
"673","2020-05-16",60,8,137,170,2909,0.488484015125473,0,0,251,946,12,1675,7,1351,6,7
"674","2020-05-17",57,8,139,174,2909,0.488484015125473,0,0,251,946,8,1683,5,1356,4,5
"675","2020-05-18",60,8,113,175,2909,0.488484015125473,0,0,251,946,12,1695,4,1360,4,4
"676","2020-05-19",60,8,109,171,2909,0.488484015125473,0,0,251,946,9,1704,4,1364,3,4
"677","2020-05-20",56,8,100,166,2909,0.488484015125473,0,0,251,946,12,1716,2,1366,5,2
"678","2020-05-21",62,8,102,160,2909,0.488484015125473,0,0,251,946,20,1736,8,1374,8,8
"679","2020-05-22",58,8,88,162,2909,0.488484015125473,0,0,251,946,19,1755,1,1375,6,1
"680","2020-05-23",56,8,89,154,2909,0.488484015125473,0,0,251,946,15,1770,2,1377,9,2
"681","2020-05-24",50,8,87,158,2909,0.488484015125473,0,0,251,946,17,1787,6,1383,10,6
"682","2020-05-25",44,8,87,159,2909,0.488484015125473,0,0,251,946,16,1803,3,1386,7,3
"683","2020-05-26",42,8,88,156,2909,0.488484015125473,0,0,251,946,15,1818,2,1388,5,2
"684","2020-05-27",43,8,82,165,2909,0.488484015125473,0,0,251,946,18,1836,3,1391,10,3
"685","2020-05-28",37,8,78,175,2909,0.488484015125473,0,0,251,946,16,1852,2,1393,9,2
"686","2020-05-29",37,8,73,179,2909,0.488484015125473,0,0,251,946,9,1861,2,1395,4,2
"687","2020-05-30",35,8,74,179,2909,0.488484015125473,0,0,251,946,10,1871,1,1396,6,1
"688","2020-05-31",37,8,70,177,2909,0.488484015125473,0,0,251,946,16,1887,3,1399,12,3
"689","2020-06-01",40,8,74,173,2909,0.488484015125473,0,0,251,946,16,1903,2,1401,9,2
"690","2020-06-02",38,8,70,167,2909,0.488484015125473,0,0,251,946,12,1915,2,1403,9,2
"691","2020-06-03",37,8,67,168,2909,0.488484015125473,0,0,251,946,16,1931,2,1405,10,2
"692","2020-06-04",38,8,73,173,2909,0.488484015125473,0,0,251,946,9,1940,4,1409,5,4
"693","2020-06-05",42,8,76,180,2909,0.488484015125473,0,0,251,946,21,1961,1,1410,13,1
"694","2020-06-06",48,8,76,187,2909,0.488484015125473,0,0,251,946,17,1978,3,1413,10,3
"695","2020-06-07",46,8,78,188,2909,0.488484015125473,0,0,251,946,14,1992,6,1419,5,6
"696","2020-03-14",2,9,182,122,7507,0.978819768216331,0,0,674,573,21,90,92,262,15,92
"697","2020-03-15",7,9,220,186,7507,0.978819768216331,0,0,674,573,41,131,78,340,32,78
"698","2020-03-16",13,9,215,256,7507,0.978819768216331,0,0,674,573,39,170,45,385,34,45
"699","2020-03-17",24,9,212,345,7507,0.978819768216331,0,0,674,573,40,210,37,422,34,37
"700","2020-03-18",33,9,198,481,7507,0.978819768216331,0,0,674,573,45,255,25,447,38,25
"701","2020-03-19",55,9,203,637,7507,0.978819768216331,0,0,674,573,38,293,30,477,31,30
"702","2020-03-20",73,9,188,810,7507,0.978819768216331,0,0,674,573,53,346,10,487,47,10
"703","2020-03-21",93,9,194,993,7507,0.978819768216331,0,0,674,573,50,396,6,493,41,6
"704","2020-03-22",125,9,185,1254,7507,0.978819768216331,0,0,674,573,63,459,8,501,57,8
"705","2020-03-23",162,9,205,1539,7507,0.978819768216331,0,0,674,573,58,517,11,512,49,11
"706","2020-03-24",202,9,204,1846,7507,0.978819768216331,0,0,674,573,61,578,13,525,55,13
"707","2020-03-25",248,9,187,2183,7507,0.978819768216331,0,0,674,573,76,654,45,570,67,45
"708","2020-03-26",313,9,204,2460,7507,0.978819768216331,0,0,674,573,54,708,33,603,51,33
"709","2020-03-27",378,9,230,2846,7507,0.978819768216331,0,0,674,573,82,790,42,645,78,42
"710","2020-03-28",462,9,252,3115,7507,0.978819768216331,0,0,674,573,84,874,55,700,78,55
"711","2020-03-29",550,9,280,3440,7507,0.978819768216331,0,0,674,573,75,949,38,738,69,38
"712","2020-03-30",670,9,267,3784,7507,0.978819768216331,0,0,674,573,62,1011,15,753,59,15
"713","2020-03-31",764,9,263,3973,7507,0.978819768216331,0,0,674,573,73,1084,18,771,69,18
"714","2020-04-01",845,9,238,4101,7507,0.978819768216331,0,0,674,573,81,1165,20,791,78,20
"715","2020-04-02",923,9,214,4133,7507,0.978819768216331,0,0,674,573,78,1243,72,863,75,72
"716","2020-04-03",1034,9,200,4097,7507,0.978819768216331,0,0,674,573,68,1311,33,896,64,33
"717","2020-04-04",1096,9,191,3985,7507,0.978819768216331,0,0,674,573,69,1380,23,919,68,23
"718","2020-04-05",1165,9,176,3902,7507,0.978819768216331,0,0,674,573,82,1462,59,978,79,59
"719","2020-04-06",1155,9,150,3705,7507,0.978819768216331,0,0,674,573,80,1542,46,1024,75,46
"720","2020-04-07",1163,9,141,3397,7507,0.978819768216331,0,0,674,573,71,1613,43,1067,69,43
"721","2020-04-08",1172,9,142,3118,7507,0.978819768216331,0,0,674,573,61,1674,37,1104,59,37
"722","2020-04-09",1131,9,156,2811,7507,0.978819768216331,0,0,674,573,79,1753,46,1150,76,46
"723","2020-04-10",1061,9,151,2515,7507,0.978819768216331,0,0,674,573,78,1831,29,1179,75,29
"724","2020-04-11",993,9,130,2219,7507,0.978819768216331,0,0,674,573,74,1905,20,1199,71,20
"725","2020-04-12",901,9,109,1929,7507,0.978819768216331,0,0,674,573,82,1987,16,1215,79,16
"726","2020-04-13",821,9,97,1615,7507,0.978819768216331,0,0,674,573,86,2073,12,1227,85,12
"727","2020-04-14",734,9,86,1343,7507,0.978819768216331,0,0,674,573,76,2149,13,1240,73,13
"728","2020-04-15",649,9,74,1122,7507,0.978819768216331,0,0,674,573,70,2219,14,1254,67,14
"729","2020-04-16",569,9,69,941,7507,0.978819768216331,0,0,674,573,68,2287,27,1281,67,27
"730","2020-04-17",488,9,64,760,7507,0.978819768216331,0,0,674,573,77,2364,35,1316,71,35
"731","2020-04-18",413,9,68,619,7507,0.978819768216331,0,0,674,573,69,2433,23,1339,68,23
"732","2020-04-19",329,9,88,492,7507,0.978819768216331,0,0,674,573,67,2500,32,1371,64,32
"733","2020-04-20",276,9,111,395,7507,0.978819768216331,0,0,674,573,67,2567,27,1398,66,27
"734","2020-04-21",224,9,103,322,7507,0.978819768216331,0,0,674,573,63,2630,17,1415,62,17
"735","2020-04-22",176,9,100,262,7507,0.978819768216331,0,0,674,573,69,2699,29,1444,67,29
"736","2020-04-23",150,9,95,204,7507,0.978819768216331,0,0,674,573,68,2767,17,1461,66,17
"737","2020-04-24",117,9,92,167,7507,0.978819768216331,0,0,674,573,52,2819,20,1481,52,20
"738","2020-04-25",99,9,72,138,7507,0.978819768216331,0,0,674,573,64,2883,17,1498,64,17
"739","2020-04-26",85,9,63,114,7507,0.978819768216331,0,0,674,573,53,2936,14,1512,51,14
"740","2020-04-27",67,9,62,93,7507,0.978819768216331,0,0,674,573,58,2994,16,1528,53,16
"741","2020-04-28",58,9,56,79,7507,0.978819768216331,0,0,674,573,53,3047,16,1544,53,16
"742","2020-04-29",47,9,57,60,7507,0.978819768216331,0,0,674,573,55,3102,14,1558,54,14
"743","2020-04-30",34,9,58,45,7507,0.978819768216331,0,0,674,573,44,3146,21,1579,44,21
"744","2020-05-01",28,9,66,35,7507,0.978819768216331,0,0,674,573,44,3190,8,1587,43,8
"745","2020-05-02",21,9,56,22,7507,0.978819768216331,0,0,674,573,54,3244,11,1598,54,11
"746","2020-05-03",17,9,56,20,7507,0.978819768216331,0,0,674,573,48,3292,10,1608,45,10
"747","2020-05-04",15,9,45,18,7507,0.978819768216331,0,0,674,573,35,3327,7,1615,33,7
"748","2020-05-05",10,9,42,17,7507,0.978819768216331,0,0,674,573,41,3368,14,1629,40,14
"749","2020-05-06",11,9,55,15,7507,0.978819768216331,0,0,674,573,36,3404,7,1636,34,7
"750","2020-05-07",7,9,46,14,7507,0.978819768216331,0,0,674,573,32,3436,13,1649,32,13
"751","2020-05-08",3,9,55,14,7507,0.978819768216331,0,0,674,573,30,3466,6,1655,30,6
"752","2020-05-09",3,9,46,11,7507,0.978819768216331,0,0,674,573,38,3504,10,1665,38,10
"753","2020-05-10",3,9,39,11,7507,0.978819768216331,0,0,674,573,31,3535,7,1672,30,7
"754","2020-05-11",5,9,28,11,7507,0.978819768216331,0,0,674,573,24,3559,8,1680,22,8
"755","2020-05-12",5,9,35,10,7507,0.978819768216331,0,0,674,573,32,3591,5,1685,31,5
"756","2020-05-13",4,9,41,12,7507,0.978819768216331,0,0,674,573,24,3615,3,1688,22,3
"757","2020-05-14",4,9,37,11,7507,0.978819768216331,0,0,674,573,22,3637,1,1689,21,1
"758","2020-05-15",5,9,30,10,7507,0.978819768216331,0,0,674,573,23,3660,3,1692,22,3
"759","2020-05-16",5,9,26,7,7507,0.978819768216331,0,0,674,573,33,3693,8,1700,33,8
"760","2020-05-17",5,9,20,7,7507,0.978819768216331,0,0,674,573,19,3712,3,1703,17,3
"761","2020-05-18",4,9,23,6,7507,0.978819768216331,0,0,674,573,23,3735,4,1707,20,4
"762","2020-05-19",4,9,22,5,7507,0.978819768216331,0,0,674,573,12,3747,4,1711,11,4
"763","2020-05-20",3,9,21,4,7507,0.978819768216331,0,0,674,573,26,3773,3,1714,22,3
"764","2020-05-21",2,9,19,3,7507,0.978819768216331,0,0,674,573,23,3796,2,1716,21,2
"765","2020-05-22",1,9,15,2,7507,0.978819768216331,0,0,674,573,12,3808,NA,NA,11,NA
"766","2020-05-23",1,9,12,2,7507,0.978819768216331,0,0,674,573,19,3827,2,1718,17,2
"767","2020-05-24",1,9,13,2,7507,0.978819768216331,0,0,674,573,12,3839,3,1721,11,3
"768","2020-05-25",0,9,0,0,7507,0.978819768216331,0,0,674,573,14,3853,NA,NA,12,NA
"769","2020-05-26",0,9,0,0,7507,0.978819768216331,0,0,674,573,15,3868,1,1722,14,1
"770","2020-05-27",0,9,0,0,7507,0.978819768216331,0,0,674,573,9,3877,NA,NA,9,NA
"771","2020-05-28",0,9,0,0,7507,0.978819768216331,0,0,674,573,10,3887,NA,NA,9,NA
"772","2020-05-29",0,9,0,0,7507,0.978819768216331,0,0,674,573,15,3902,NA,NA,14,NA
"773","2020-05-30",1,9,7,1,7507,0.978819768216331,0,0,674,573,10,3912,NA,NA,9,NA
"774","2020-05-31",1,9,7,1,7507,0.978819768216331,0,0,674,573,16,3928,NA,NA,13,NA
"775","2020-06-01",1,9,7,1,7507,0.978819768216331,0,0,674,573,8,3936,NA,NA,7,NA
"776","2020-06-02",1,9,7,1,7507,0.978819768216331,0,0,674,573,13,3949,NA,NA,13,NA
"777","2020-06-03",1,9,12,1,7507,0.978819768216331,0,0,674,573,12,3961,NA,NA,10,NA
"778","2020-06-04",1,9,12,0,7507,0.978819768216331,0,0,674,573,6,3967,NA,NA,5,NA
"779","2020-06-05",1,9,10,1,7507,0.978819768216331,0,0,674,573,13,3980,NA,NA,12,NA
"780","2020-03-16",1,10,162,97,1677,0.768038163387001,0,0,150,562,47,268,37,265,26,37
"781","2020-03-17",4,10,149,115,1677,0.768038163387001,0,0,150,562,55,323,30,295,31,30
"782","2020-03-18",11,10,143,126,1677,0.768038163387001,0,0,150,562,80,403,37,332,50,37
"783","2020-03-19",19,10,139,140,1677,0.768038163387001,0,0,150,562,62,465,23,355,36,23
"784","2020-03-20",27,10,186,156,1677,0.768038163387001,0,0,150,562,55,520,10,365,27,10
"785","2020-03-21",30,10,227,171,1677,0.768038163387001,0,0,150,562,67,587,12,377,39,12
"786","2020-03-22",37,10,252,189,1677,0.768038163387001,0,0,150,562,65,652,42,419,50,42
"787","2020-03-23",44,10,222,197,1677,0.768038163387001,0,0,150,562,86,738,24,443,62,24
"788","2020-03-24",49,10,221,195,1677,0.768038163387001,0,0,150,562,62,800,44,487,40,44
"789","2020-03-25",52,10,189,204,1677,0.768038163387001,0,0,150,562,49,849,25,512,39,25
"790","2020-03-26",53,10,163,216,1677,0.768038163387001,0,0,150,562,68,917,27,539,50,27
"791","2020-03-27",56,10,162,213,1677,0.768038163387001,0,0,150,562,82,999,25,564,65,25
"792","2020-03-28",62,10,169,204,1677,0.768038163387001,0,0,150,562,58,1057,17,581,39,17
"793","2020-03-29",64,10,187,210,1677,0.768038163387001,0,0,150,562,72,1129,19,600,54,19
"794","2020-03-30",67,10,168,217,1677,0.768038163387001,0,0,150,562,70,1199,32,632,54,32
"795","2020-03-31",65,10,187,233,1677,0.768038163387001,0,0,150,562,58,1257,45,677,44,45
"796","2020-04-01",65,10,196,233,1677,0.768038163387001,0,0,150,562,62,1319,41,718,45,41
"797","2020-04-02",73,10,210,231,1677,0.768038163387001,0,0,150,562,55,1374,27,745,42,27
"798","2020-04-03",67,10,240,220,1677,0.768038163387001,0,0,150,562,72,1446,30,775,52,30
"799","2020-04-04",72,10,220,228,1677,0.768038163387001,0,0,150,562,58,1504,24,799,47,24
"800","2020-04-05",73,10,185,225,1677,0.768038163387001,0,0,150,562,66,1570,26,825,54,26
"801","2020-04-06",73,10,156,220,1677,0.768038163387001,0,0,150,562,50,1620,27,852,38,27
"802","2020-04-07",76,10,151,219,1677,0.768038163387001,0,0,150,562,68,1688,31,883,59,31
"803","2020-04-08",72,10,161,203,1677,0.768038163387001,0,0,150,562,61,1749,15,898,51,15
"804","2020-04-09",61,10,173,197,1677,0.768038163387001,0,0,150,562,53,1802,10,908,42,10
"805","2020-04-10",64,10,163,194,1677,0.768038163387001,0,0,150,562,49,1851,13,921,38,13
"806","2020-04-11",56,10,136,170,1677,0.768038163387001,0,0,150,562,47,1898,19,940,42,19
"807","2020-04-12",59,10,124,164,1677,0.768038163387001,0,0,150,562,58,1956,29,969,52,29
"808","2020-04-13",51,10,121,162,1677,0.768038163387001,0,0,150,562,52,2008,23,992,40,23
"809","2020-04-14",53,10,116,160,1677,0.768038163387001,0,0,150,562,40,2048,14,1006,32,14
"810","2020-04-15",59,10,110,160,1677,0.768038163387001,0,0,150,562,41,2089,9,1015,32,9
"811","2020-04-16",62,10,135,155,1677,0.768038163387001,0,0,150,562,47,2136,6,1021,40,6
"812","2020-04-17",59,10,133,156,1677,0.768038163387001,0,0,150,562,41,2177,3,1024,37,3
"813","2020-04-18",58,10,123,156,1677,0.768038163387001,0,0,150,562,41,2218,4,1028,33,4
"814","2020-04-19",50,10,108,153,1677,0.768038163387001,0,0,150,562,34,2252,19,1047,30,19
"815","2020-04-20",49,10,93,156,1677,0.768038163387001,0,0,150,562,45,2297,9,1056,36,9
"816","2020-04-21",47,10,91,170,1677,0.768038163387001,0,0,150,562,33,2330,5,1061,30,5
"817","2020-04-22",40,10,98,163,1677,0.768038163387001,0,0,150,562,38,2368,4,1065,30,4
"818","2020-04-23",39,10,96,161,1677,0.768038163387001,0,0,150,562,37,2405,9,1074,28,9
"819","2020-04-24",39,10,97,159,1677,0.768038163387001,0,0,150,562,28,2433,13,1087,21,13
"820","2020-04-25",42,10,97,149,1677,0.768038163387001,0,0,150,562,34,2467,1,1088,28,1
"821","2020-04-26",41,10,108,139,1677,0.768038163387001,0,0,150,562,31,2498,10,1098,26,10
"822","2020-04-27",47,10,113,128,1677,0.768038163387001,0,0,150,562,33,2531,12,1110,28,12
"823","2020-04-28",44,10,106,122,1677,0.768038163387001,0,0,150,562,46,2577,5,1115,38,5
"824","2020-04-29",46,10,107,116,1677,0.768038163387001,0,0,150,562,25,2602,5,1120,20,5
"825","2020-04-30",39,10,102,116,1677,0.768038163387001,0,0,150,562,43,2645,3,1123,38,3
"826","2020-05-01",39,10,87,113,1677,0.768038163387001,0,0,150,562,34,2679,7,1130,27,7
"827","2020-05-02",36,10,70,116,1677,0.768038163387001,0,0,150,562,32,2711,7,1137,26,7
"828","2020-05-03",38,10,62,117,1677,0.768038163387001,0,0,150,562,34,2745,14,1151,29,14
"829","2020-05-04",38,10,51,115,1677,0.768038163387001,0,0,150,562,28,2773,10,1161,19,10
"830","2020-05-05",35,10,41,106,1677,0.768038163387001,0,0,150,562,26,2799,11,1172,18,11
"831","2020-05-06",35,10,40,103,1677,0.768038163387001,0,0,150,562,21,2820,4,1176,17,4
"832","2020-05-07",42,10,41,109,1677,0.768038163387001,0,0,150,562,23,2843,4,1180,18,4
"833","2020-05-08",43,10,35,105,1677,0.768038163387001,0,0,150,562,33,2876,4,1184,27,4
"834","2020-05-09",44,10,31,106,1677,0.768038163387001,0,0,150,562,23,2899,4,1188,19,4
"835","2020-05-10",43,10,27,120,1677,0.768038163387001,0,0,150,562,15,2914,9,1197,11,9
"836","2020-05-11",37,10,28,124,1677,0.768038163387001,0,0,150,562,19,2933,10,1207,12,10
"837","2020-05-12",37,10,31,125,1677,0.768038163387001,0,0,150,562,26,2959,3,1210,20,3
"838","2020-05-13",38,10,34,133,1677,0.768038163387001,0,0,150,562,20,2979,1,1211,15,1
"839","2020-05-14",36,10,34,134,1677,0.768038163387001,0,0,150,562,18,2997,4,1215,14,4
"840","2020-05-15",37,10,27,144,1677,0.768038163387001,0,0,150,562,28,3025,4,1219,15,4
"841","2020-05-16",36,10,28,152,1677,0.768038163387001,0,0,150,562,23,3048,5,1224,15,5
"842","2020-05-17",34,10,24,151,1677,0.768038163387001,0,0,150,562,22,3070,4,1228,15,4
"843","2020-05-18",32,10,17,159,1677,0.768038163387001,0,0,150,562,19,3089,2,1230,13,2
"844","2020-05-19",37,10,18,172,1677,0.768038163387001,0,0,150,562,22,3111,1,1231,19,1
"845","2020-05-20",39,10,19,188,1677,0.768038163387001,0,0,150,562,22,3133,3,1234,16,3
"846","2020-05-21",39,10,16,192,1677,0.768038163387001,0,0,150,562,24,3157,3,1237,17,3
"847","2020-05-22",34,10,17,200,1677,0.768038163387001,0,0,150,562,28,3185,8,1245,21,8
"848","2020-05-23",43,10,14,211,1677,0.768038163387001,0,0,150,562,9,3194,5,1250,8,5
"849","2020-05-24",49,10,14,232,1677,0.768038163387001,0,0,150,562,11,3205,5,1255,10,5
"850","2020-05-25",56,10,13,243,1677,0.768038163387001,0,0,150,562,23,3228,3,1258,16,3
"851","2020-05-26",57,10,13,264,1677,0.768038163387001,0,0,150,562,19,3247,7,1265,11,7
"852","2020-05-27",56,10,15,272,1677,0.768038163387001,0,0,150,562,11,3258,5,1270,7,5
"853","2020-05-28",60,10,17,296,1677,0.768038163387001,0,0,150,562,19,3277,4,1274,16,4
"854","2020-05-29",69,10,16,311,1677,0.768038163387001,0,0,150,562,15,3292,5,1279,14,5
"855","2020-05-30",69,10,18,316,1677,0.768038163387001,0,0,150,562,11,3303,3,1282,8,3
"856","2020-05-31",72,10,23,328,1677,0.768038163387001,0,0,150,562,26,3329,4,1286,20,4
"857","2020-06-01",78,10,26,335,1677,0.768038163387001,0,0,150,562,10,3339,2,1288,8,2
"858","2020-06-02",86,10,25,337,1677,0.768038163387001,0,0,150,562,11,3350,1,1289,11,1
"859","2020-06-03",91,10,26,349,1677,0.768038163387001,0,0,150,562,10,3360,NA,NA,7,NA
"860","2020-06-04",95,10,29,362,1677,0.768038163387001,0,0,150,562,12,3372,1,1290,11,1
"861","2020-06-05",100,10,29,365,1677,0.768038163387001,0,0,150,562,10,3382,1,1291,7,1
"862","2020-06-06",99,10,27,355,1677,0.768038163387001,0,0,150,562,11,3393,3,1294,8,3
"863","2020-06-07",107,10,29,347,1677,0.768038163387001,0,0,150,562,14,3407,2,1296,6,2
"864","2020-03-12",1,11,182,74,2791,0.541741311357936,0,0,249,493,64,136,52,96,3,52
"865","2020-03-13",1,11,173,130,2791,0.541741311357936,0,0,249,493,51,187,75,171,10,75
"866","2020-03-14",2,11,162,174,2791,0.541741311357936,0,0,249,493,79,266,82,253,18,82
"867","2020-03-15",6,11,150,216,2791,0.541741311357936,0,0,249,493,52,318,64,317,16,64
"868","2020-03-16",14,11,126,267,2791,0.541741311357936,0,0,249,493,69,387,42,359,21,42
"869","2020-03-17",32,11,126,312,2791,0.541741311357936,0,0,249,493,61,448,55,414,17,55
"870","2020-03-18",44,11,111,353,2791,0.541741311357936,0,0,249,493,78,526,39,453,32,39
"871","2020-03-19",65,11,93,382,2791,0.541741311357936,0,0,249,493,95,621,64,517,45,64
"872","2020-03-20",81,11,119,403,2791,0.541741311357936,0,0,249,493,62,683,54,571,27,54
"873","2020-03-21",96,11,178,442,2791,0.541741311357936,0,0,249,493,72,755,45,616,39,45
"874","2020-03-22",113,11,185,478,2791,0.541741311357936,0,0,249,493,74,829,33,649,35,33
"875","2020-03-23",126,11,194,496,2791,0.541741311357936,0,0,249,493,64,893,39,688,30,39
"876","2020-03-24",130,11,181,522,2791,0.541741311357936,0,0,249,493,103,996,31,719,63,31
"877","2020-03-25",131,11,186,536,2791,0.541741311357936,0,0,249,493,64,1060,28,747,37,28
"878","2020-03-26",122,11,203,523,2791,0.541741311357936,0,0,249,493,61,1121,51,798,36,51
"879","2020-03-27",125,11,218,529,2791,0.541741311357936,0,0,249,493,51,1172,45,843,25,45
"880","2020-03-28",132,11,230,523,2791,0.541741311357936,0,0,249,493,55,1227,36,879,32,36
"881","2020-03-29",139,11,218,514,2791,0.541741311357936,0,0,249,493,50,1277,25,904,28,25
"882","2020-03-30",137,11,193,510,2791,0.541741311357936,0,0,249,493,69,1346,34,938,42,34
"883","2020-03-31",137,11,164,514,2791,0.541741311357936,0,0,249,493,65,1411,26,964,40,26
"884","2020-04-01",151,11,165,528,2791,0.541741311357936,0,0,249,493,58,1469,21,985,29,21
"885","2020-04-02",158,11,213,524,2791,0.541741311357936,0,0,249,493,61,1530,28,1013,33,28
"886","2020-04-03",151,11,227,511,2791,0.541741311357936,0,0,249,493,57,1587,45,1058,34,45
"887","2020-04-04",152,11,221,494,2791,0.541741311357936,0,0,249,493,48,1635,52,1110,23,52
"888","2020-04-05",147,11,189,461,2791,0.541741311357936,0,0,249,493,46,1681,53,1163,28,53
"889","2020-04-06",144,11,172,460,2791,0.541741311357936,0,0,249,493,42,1723,45,1208,23,45
"890","2020-04-07",142,11,175,444,2791,0.541741311357936,0,0,249,493,52,1775,61,1269,27,61
"891","2020-04-08",135,11,158,422,2791,0.541741311357936,0,0,249,493,59,1834,41,1310,40,41
"892","2020-04-09",133,11,151,421,2791,0.541741311357936,0,0,249,493,45,1879,34,1344,23,34
"893","2020-04-10",140,11,141,418,2791,0.541741311357936,0,0,249,493,43,1922,49,1393,28,49
"894","2020-04-11",135,11,113,422,2791,0.541741311357936,0,0,249,493,42,1964,60,1453,27,60
"895","2020-04-12",129,11,112,417,2791,0.541741311357936,0,0,249,493,43,2007,42,1495,21,42
"896","2020-04-13",129,11,139,401,2791,0.541741311357936,0,0,249,493,37,2044,36,1531,22,36
"897","2020-04-14",130,11,130,384,2791,0.541741311357936,0,0,249,493,25,2069,33,1564,18,33
"898","2020-04-15",122,11,120,360,2791,0.541741311357936,0,0,249,493,40,2109,46,1610,29,46
"899","2020-04-16",118,11,139,352,2791,0.541741311357936,0,0,249,493,36,2145,55,1665,24,55
"900","2020-04-17",112,11,130,346,2791,0.541741311357936,0,0,249,493,38,2183,39,1704,20,39
"901","2020-04-18",111,11,144,328,2791,0.541741311357936,0,0,249,493,35,2218,45,1749,20,45
"902","2020-04-19",108,11,162,320,2791,0.541741311357936,0,0,249,493,31,2249,42,1791,20,42
"903","2020-04-20",109,11,141,305,2791,0.541741311357936,0,0,249,493,24,2273,40,1831,17,40
"904","2020-04-21",106,11,130,296,2791,0.541741311357936,0,0,249,493,32,2305,33,1864,19,33
"905","2020-04-22",102,11,107,294,2791,0.541741311357936,0,0,249,493,24,2329,33,1897,12,33
"906","2020-04-23",99,11,83,289,2791,0.541741311357936,0,0,249,493,29,2358,41,1938,16,41
"907","2020-04-24",100,11,79,286,2791,0.541741311357936,0,0,249,493,23,2381,31,1969,16,31
"908","2020-04-25",90,11,65,291,2791,0.541741311357936,0,0,249,493,32,2413,43,2012,21,43
"909","2020-04-26",86,11,63,301,2791,0.541741311357936,0,0,249,493,27,2440,31,2043,10,31
"910","2020-04-27",85,11,61,289,2791,0.541741311357936,0,0,249,493,29,2469,23,2066,15,23
"911","2020-04-28",75,11,62,284,2791,0.541741311357936,0,0,249,493,22,2491,42,2108,9,42
"912","2020-04-29",78,11,68,282,2791,0.541741311357936,0,0,249,493,26,2517,26,2134,13,26
"913","2020-04-30",76,11,70,289,2791,0.541741311357936,0,0,249,493,36,2553,26,2160,16,26
"914","2020-05-01",75,11,68,296,2791,0.541741311357936,0,0,249,493,27,2580,19,2179,16,19
"915","2020-05-02",75,11,69,287,2791,0.541741311357936,0,0,249,493,18,2598,17,2196,9,17
"916","2020-05-03",74,11,74,276,2791,0.541741311357936,0,0,249,493,28,2626,33,2229,14,33
"917","2020-05-04",70,11,62,275,2791,0.541741311357936,0,0,249,493,25,2651,26,2255,17,26
"918","2020-05-05",75,11,59,264,2791,0.541741311357936,0,0,249,493,27,2678,30,2285,21,30
"919","2020-05-06",72,11,57,263,2791,0.541741311357936,0,0,249,493,23,2701,26,2311,12,26
"920","2020-05-07",76,11,57,260,2791,0.541741311357936,0,0,249,493,18,2719,35,2346,13,35
"921","2020-05-08",69,11,63,266,2791,0.541741311357936,0,0,249,493,23,2742,21,2367,14,21
"922","2020-05-09",74,11,62,257,2791,0.541741311357936,0,0,249,493,13,2755,27,2394,5,27
"923","2020-05-10",76,11,59,258,2791,0.541741311357936,0,0,249,493,23,2778,22,2416,10,22
"924","2020-05-11",73,11,43,252,2791,0.541741311357936,0,0,249,493,18,2796,19,2435,10,19
"925","2020-05-12",72,11,40,247,2791,0.541741311357936,0,0,249,493,20,2816,14,2449,11,14
"926","2020-05-13",74,11,36,249,2791,0.541741311357936,0,0,249,493,7,2823,13,2462,3,13
"927","2020-05-14",73,11,31,245,2791,0.541741311357936,0,0,249,493,14,2837,13,2475,6,13
"928","2020-05-15",74,11,28,233,2791,0.541741311357936,0,0,249,493,17,2854,14,2489,11,14
"929","2020-05-16",71,11,26,247,2791,0.541741311357936,0,0,249,493,18,2872,12,2501,8,12
"930","2020-05-17",66,11,23,235,2791,0.541741311357936,0,0,249,493,19,2891,13,2514,12,13
"931","2020-05-18",66,11,22,244,2791,0.541741311357936,0,0,249,493,18,2909,16,2530,9,16
"932","2020-05-19",64,11,26,240,2791,0.541741311357936,0,0,249,493,15,2924,19,2549,6,19
"933","2020-05-20",65,11,30,248,2791,0.541741311357936,0,0,249,493,17,2941,13,2562,9,13
"934","2020-05-21",58,11,30,235,2791,0.541741311357936,0,0,249,493,19,2960,11,2573,8,11
"935","2020-05-22",58,11,28,242,2791,0.541741311357936,0,0,249,493,16,2976,10,2583,7,10
"936","2020-05-23",53,11,24,236,2791,0.541741311357936,0,0,249,493,22,2998,11,2594,9,11
"937","2020-05-24",57,11,24,246,2791,0.541741311357936,0,0,249,493,27,3025,10,2604,11,10
"938","2020-05-25",56,11,24,239,2791,0.541741311357936,0,0,249,493,12,3037,15,2619,8,15
"939","2020-05-26",63,11,19,243,2791,0.541741311357936,0,0,249,493,21,3058,7,2626,12,7
"940","2020-05-27",62,11,19,235,2791,0.541741311357936,0,0,249,493,18,3076,4,2630,11,4
"941","2020-05-28",66,11,18,231,2791,0.541741311357936,0,0,249,493,15,3091,5,2635,4,5
"942","2020-05-29",68,11,19,229,2791,0.541741311357936,0,0,249,493,18,3109,10,2645,3,10
"943","2020-05-30",74,11,16,224,2791,0.541741311357936,0,0,249,493,13,3122,10,2655,3,10
"944","2020-05-31",75,11,16,219,2791,0.541741311357936,0,0,249,493,17,3139,16,2671,7,16
"945","2020-06-01",79,11,16,220,2791,0.541741311357936,0,0,249,493,14,3153,18,2689,7,18
"946","2020-06-02",69,11,12,213,2791,0.541741311357936,0,0,249,493,15,3168,10,2699,7,10
"947","2020-06-03",65,11,12,204,2791,0.541741311357936,0,0,249,493,12,3180,14,2713,7,14
"948","2020-06-04",63,11,10,207,2791,0.541741311357936,0,0,249,493,13,3193,7,2720,7,7
"949","2020-06-05",65,11,8,220,2791,0.541741311357936,0,0,249,493,18,3211,6,2726,9,6
"950","2020-06-06",60,11,12,217,2791,0.541741311357936,0,0,249,493,16,3227,10,2736,7,10
"951","2020-06-07",57,11,14,222,2791,0.541741311357936,0,0,249,493,12,3239,15,2751,4,15
"952","2020-03-12",1,12,68,97,2668,0.386056971514243,0,0,246,503,30,66,41,118,9,41
"953","2020-03-13",5,12,131,170,2668,0.386056971514243,0,0,246,503,54,120,66,184,23,66
"954","2020-03-14",9,12,171,229,2668,0.386056971514243,0,0,246,503,51,171,45,229,22,45
"955","2020-03-15",16,12,216,289,2668,0.386056971514243,0,0,246,503,46,217,70,299,25,70
"956","2020-03-16",30,12,238,358,2668,0.386056971514243,0,0,246,503,57,274,39,338,31,39
"957","2020-03-17",48,12,263,419,2668,0.386056971514243,0,0,246,503,61,335,22,360,40,22
"958","2020-03-18",61,12,271,451,2668,0.386056971514243,0,0,246,503,59,394,19,379,41,19
"959","2020-03-19",70,12,257,498,2668,0.386056971514243,0,0,246,503,69,463,28,407,57,28
"960","2020-03-20",94,12,238,521,2668,0.386056971514243,0,0,246,503,73,536,21,428,59,21
"961","2020-03-21",109,12,230,557,2668,0.386056971514243,0,0,246,503,51,587,23,451,35,23
"962","2020-03-22",123,12,251,579,2668,0.386056971514243,0,0,246,503,54,641,13,464,39,13
"963","2020-03-23",141,12,251,593,2668,0.386056971514243,0,0,246,503,64,705,16,480,44,16
"964","2020-03-24",146,12,234,602,2668,0.386056971514243,0,0,246,503,78,783,8,488,55,8
"965","2020-03-25",152,12,203,574,2668,0.386056971514243,0,0,246,503,73,856,37,525,54,37
"966","2020-03-26",162,12,185,574,2668,0.386056971514243,0,0,246,503,61,917,28,553,45,28
"967","2020-03-27",161,12,167,563,2668,0.386056971514243,0,0,246,503,71,988,50,603,59,50
"968","2020-03-28",174,12,155,542,2668,0.386056971514243,0,0,246,503,69,1057,35,638,54,35
"969","2020-03-29",176,12,146,529,2668,0.386056971514243,0,0,246,503,83,1140,61,699,68,61
"970","2020-03-30",167,12,182,513,2668,0.386056971514243,0,0,246,503,73,1213,63,762,58,63
"971","2020-03-31",164,12,201,514,2668,0.386056971514243,0,0,246,503,61,1274,35,797,51,35
"972","2020-04-01",161,12,175,514,2668,0.386056971514243,0,0,246,503,72,1346,48,845,65,48
"973","2020-04-02",154,12,181,514,2668,0.386056971514243,0,0,246,503,80,1426,31,876,67,31
"974","2020-04-03",150,12,184,499,2668,0.386056971514243,0,0,246,503,70,1496,16,892,56,16
"975","2020-04-04",135,12,172,487,2668,0.386056971514243,0,0,246,503,69,1565,16,908,59,16
"976","2020-04-05",129,12,165,463,2668,0.386056971514243,0,0,246,503,70,1635,20,928,57,20
"977","2020-04-06",120,12,155,458,2668,0.386056971514243,0,0,246,503,77,1712,31,959,64,31
"978","2020-04-07",118,12,148,445,2668,0.386056971514243,0,0,246,503,68,1780,11,970,59,11
"979","2020-04-08",118,12,136,443,2668,0.386056971514243,0,0,246,503,77,1857,14,984,68,14
"980","2020-04-09",123,12,132,426,2668,0.386056971514243,0,0,246,503,75,1932,25,1009,66,25
"981","2020-04-10",120,12,119,404,2668,0.386056971514243,0,0,246,503,61,1993,36,1045,51,36
"982","2020-04-11",117,12,145,405,2668,0.386056971514243,0,0,246,503,78,2071,28,1073,72,28
"983","2020-04-12",117,12,134,387,2668,0.386056971514243,0,0,246,503,69,2140,16,1089,58,16
"984","2020-04-13",113,12,133,364,2668,0.386056971514243,0,0,246,503,55,2195,4,1093,50,4
"985","2020-04-14",113,12,129,351,2668,0.386056971514243,0,0,246,503,48,2243,20,1113,40,20
"986","2020-04-15",108,12,130,332,2668,0.386056971514243,0,0,246,503,52,2295,28,1141,44,28
"987","2020-04-16",97,12,122,319,2668,0.386056971514243,0,0,246,503,47,2342,31,1172,38,31
"988","2020-04-17",93,12,119,308,2668,0.386056971514243,0,0,246,503,57,2399,24,1196,51,24
"989","2020-04-18",90,12,125,298,2668,0.386056971514243,0,0,246,503,61,2460,12,1208,53,12
"990","2020-04-19",79,12,127,293,2668,0.386056971514243,0,0,246,503,53,2513,16,1224,46,16
"991","2020-04-20",83,12,122,290,2668,0.386056971514243,0,0,246,503,44,2557,11,1235,38,11
"992","2020-04-21",75,12,119,285,2668,0.386056971514243,0,0,246,503,41,2598,18,1253,31,18
"993","2020-04-22",79,12,123,281,2668,0.386056971514243,0,0,246,503,42,2640,25,1278,37,25
"994","2020-04-23",89,12,104,284,2668,0.386056971514243,0,0,246,503,41,2681,32,1310,36,32
"995","2020-04-24",82,12,105,278,2668,0.386056971514243,0,0,246,503,40,2721,24,1334,36,24
"996","2020-04-25",84,12,91,270,2668,0.386056971514243,0,0,246,503,25,2746,11,1345,22,11
"997","2020-04-26",92,12,101,279,2668,0.386056971514243,0,0,246,503,42,2788,8,1353,36,8
"998","2020-04-27",86,12,104,270,2668,0.386056971514243,0,0,246,503,33,2821,5,1358,29,5
"999","2020-04-28",90,12,98,265,2668,0.386056971514243,0,0,246,503,29,2850,6,1364,27,6
"1000","2020-04-29",84,12,107,266,2668,0.386056971514243,0,0,246,503,28,2878,16,1380,23,16
"1001","2020-04-30",82,12,104,265,2668,0.386056971514243,0,0,246,503,30,2908,12,1392,22,12
"1002","2020-05-01",82,12,102,263,2668,0.386056971514243,0,0,246,503,28,2936,11,1403,22,11
"1003","2020-05-02",81,12,92,252,2668,0.386056971514243,0,0,246,503,30,2966,1,1404,27,1
"1004","2020-05-03",76,12,74,244,2668,0.386056971514243,0,0,246,503,25,2991,3,1407,21,3
"1005","2020-05-04",78,12,64,229,2668,0.386056971514243,0,0,246,503,21,3012,12,1419,17,12
"1006","2020-05-05",79,12,64,225,2668,0.386056971514243,0,0,246,503,22,3034,8,1427,20,8
"1007","2020-05-06",76,12,64,228,2668,0.386056971514243,0,0,246,503,30,3064,4,1431,23,4
"1008","2020-05-07",67,12,68,214,2668,0.386056971514243,0,0,246,503,26,3090,2,1433,24,2
"1009","2020-05-08",64,12,70,211,2668,0.386056971514243,0,0,246,503,10,3100,15,1448,10,15
"1010","2020-05-09",59,12,73,202,2668,0.386056971514243,0,0,246,503,25,3125,6,1454,22,6
"1011","2020-05-10",55,12,61,196,2668,0.386056971514243,0,0,246,503,21,3146,2,1456,17,2
"1012","2020-05-11",56,12,58,200,2668,0.386056971514243,0,0,246,503,15,3161,4,1460,9,4
"1013","2020-05-12",46,12,58,195,2668,0.386056971514243,0,0,246,503,15,3176,4,1464,14,4
"1014","2020-05-13",51,12,54,197,2668,0.386056971514243,0,0,246,503,17,3193,2,1466,13,2
"1015","2020-05-14",53,12,49,187,2668,0.386056971514243,0,0,246,503,12,3205,2,1468,10,2
"1016","2020-05-15",55,12,45,186,2668,0.386056971514243,0,0,246,503,13,3218,3,1471,11,3
"1017","2020-05-16",53,12,43,181,2668,0.386056971514243,0,0,246,503,16,3234,5,1476,7,5
"1018","2020-05-17",54,12,40,189,2668,0.386056971514243,0,0,246,503,11,3245,3,1479,9,3
"1019","2020-05-18",51,12,39,188,2668,0.386056971514243,0,0,246,503,12,3257,2,1481,7,2
"1020","2020-05-19",59,12,45,187,2668,0.386056971514243,0,0,246,503,16,3273,NA,NA,13,NA
"1021","2020-05-20",52,12,41,178,2668,0.386056971514243,0,0,246,503,13,3286,2,1483,8,2
"1022","2020-05-21",53,12,45,169,2668,0.386056971514243,0,0,246,503,19,3305,1,1484,10,1
"1023","2020-05-22",52,12,45,176,2668,0.386056971514243,0,0,246,503,7,3312,NA,NA,4,NA
"1024","2020-05-23",55,12,45,180,2668,0.386056971514243,0,0,246,503,7,3319,NA,NA,6,NA
"1025","2020-05-24",56,12,41,186,2668,0.386056971514243,0,0,246,503,10,3329,NA,NA,8,NA
"1026","2020-05-25",61,12,36,187,2668,0.386056971514243,0,0,246,503,12,3341,1,1485,7,1
"1027","2020-05-26",58,12,33,196,2668,0.386056971514243,0,0,246,503,7,3348,NA,NA,5,NA
"1028","2020-05-27",64,12,37,182,2668,0.386056971514243,0,0,246,503,10,3358,2,1487,8,2
"1029","2020-05-28",66,12,31,181,2668,0.386056971514243,0,0,246,503,8,3366,NA,NA,5,NA
"1030","2020-05-29",70,12,33,189,2668,0.386056971514243,0,0,246,503,8,3374,4,1491,7,4
"1031","2020-05-30",65,12,29,190,2668,0.386056971514243,0,0,246,503,6,3380,1,1492,3,1
"1032","2020-05-31",61,12,28,188,2668,0.386056971514243,0,0,246,503,3,3383,NA,NA,1,NA
"1033","2020-06-01",54,12,27,191,2668,0.386056971514243,0,0,246,503,5,3388,NA,NA,2,NA
"1034","2020-06-02",48,12,32,190,2668,0.386056971514243,0,0,246,503,4,3392,NA,NA,4,NA
"1035","2020-06-03",50,12,32,190,2668,0.386056971514243,0,0,246,503,8,3400,NA,NA,4,NA
"1036","2020-06-04",47,12,31,186,2668,0.386056971514243,0,0,246,503,4,3404,NA,NA,2,NA
"1037","2020-06-05",43,12,30,195,2668,0.386056971514243,0,0,246,503,10,3414,NA,NA,6,NA
"1038","2020-06-06",48,12,30,184,2668,0.386056971514243,0,0,246,503,2,3416,NA,NA,1,NA
"1039","2020-06-07",50,12,29,172,2668,0.386056971514243,0,0,246,503,5,3421,NA,NA,3,NA
"1040","2020-03-12",1,13,89,25,1642,0.672959805115713,0,0,176,458,28,73,35,51,3,35
"1041","2020-03-13",3,13,142,44,1642,0.672959805115713,0,0,176,458,38,111,17,68,7,17
"1042","2020-03-14",5,13,177,65,1642,0.672959805115713,0,0,176,458,48,159,7,75,9,7
"1043","2020-03-15",6,13,189,85,1642,0.672959805115713,0,0,176,458,40,199,45,120,7,45
"1044","2020-03-16",11,13,195,106,1642,0.672959805115713,0,0,176,458,30,229,49,169,7,49
"1045","2020-03-17",15,13,255,128,1642,0.672959805115713,0,0,176,458,38,267,28,197,11,28
"1046","2020-03-18",20,13,277,147,1642,0.672959805115713,0,0,176,458,39,306,55,252,13,55
"1047","2020-03-19",24,13,299,160,1642,0.672959805115713,0,0,176,458,44,350,47,299,12,47
"1048","2020-03-20",25,13,329,175,1642,0.672959805115713,0,0,176,458,50,400,44,343,12,44
"1049","2020-03-21",28,13,326,181,1642,0.672959805115713,0,0,176,458,34,434,42,385,10,42
"1050","2020-03-22",33,13,319,188,1642,0.672959805115713,0,0,176,458,30,464,49,434,14,49
"1051","2020-03-23",34,13,300,202,1642,0.672959805115713,0,0,176,458,35,499,58,492,14,58
"1052","2020-03-24",38,13,298,195,1642,0.672959805115713,0,0,176,458,49,548,41,533,11,41
"1053","2020-03-25",43,13,293,194,1642,0.672959805115713,0,0,176,458,48,596,18,551,21,18
"1054","2020-03-26",47,13,296,190,1642,0.672959805115713,0,0,176,458,35,631,13,564,7,13
"1055","2020-03-27",63,13,272,185,1642,0.672959805115713,0,0,176,458,37,668,23,587,14,23
"1056","2020-03-28",67,13,250,194,1642,0.672959805115713,0,0,176,458,42,710,31,618,16,31
"1057","2020-03-29",70,13,239,193,1642,0.672959805115713,0,0,176,458,36,746,30,648,18,30
"1058","2020-03-30",73,13,246,189,1642,0.672959805115713,0,0,176,458,43,789,31,679,21,31
"1059","2020-03-31",70,13,237,187,1642,0.672959805115713,0,0,176,458,40,829,33,712,18,33
"1060","2020-04-01",68,13,215,187,1642,0.672959805115713,0,0,176,458,37,866,12,724,20,12
"1061","2020-04-02",65,13,208,185,1642,0.672959805115713,0,0,176,458,41,907,11,735,21,11
"1062","2020-04-03",52,13,212,182,1642,0.672959805115713,0,0,176,458,46,953,12,747,28,12
"1063","2020-04-04",48,13,208,181,1642,0.672959805115713,0,0,176,458,31,984,33,780,19,33
"1064","2020-04-05",49,13,212,175,1642,0.672959805115713,0,0,176,458,24,1008,25,805,10,25
"1065","2020-04-06",51,13,221,178,1642,0.672959805115713,0,0,176,458,42,1050,13,818,24,13
"1066","2020-04-07",51,13,215,175,1642,0.672959805115713,0,0,176,458,30,1080,11,829,19,11
"1067","2020-04-08",50,13,193,170,1642,0.672959805115713,0,0,176,458,33,1113,7,836,22,7
"1068","2020-04-09",49,13,187,171,1642,0.672959805115713,0,0,176,458,34,1147,5,841,22,5
"1069","2020-04-10",51,13,190,168,1642,0.672959805115713,0,0,176,458,31,1178,8,849,21,8
"1070","2020-04-11",54,13,189,175,1642,0.672959805115713,0,0,176,458,29,1207,8,857,16,8
"1071","2020-04-12",52,13,209,167,1642,0.672959805115713,0,0,176,458,22,1229,17,874,11,17
"1072","2020-04-13",49,13,198,163,1642,0.672959805115713,0,0,176,458,33,1262,14,888,19,14
"1073","2020-04-14",53,13,195,152,1642,0.672959805115713,0,0,176,458,32,1294,21,909,19,21
"1074","2020-04-15",48,13,198,154,1642,0.672959805115713,0,0,176,458,28,1322,14,923,18,14
"1075","2020-04-16",51,13,196,146,1642,0.672959805115713,0,0,176,458,26,1348,29,952,15,29
"1076","2020-04-17",50,13,190,144,1642,0.672959805115713,0,0,176,458,24,1372,22,974,17,22
"1077","2020-04-18",53,13,187,139,1642,0.672959805115713,0,0,176,458,19,1391,16,990,12,16
"1078","2020-04-19",52,13,186,132,1642,0.672959805115713,0,0,176,458,21,1412,17,1007,10,17
"1079","2020-04-20",47,13,191,129,1642,0.672959805115713,0,0,176,458,29,1441,14,1021,13,14
"1080","2020-04-21",42,13,178,122,1642,0.672959805115713,0,0,176,458,27,1468,15,1036,17,15
"1081","2020-04-22",46,13,176,122,1642,0.672959805115713,0,0,176,458,19,1487,13,1049,8,13
"1082","2020-04-23",43,13,160,128,1642,0.672959805115713,0,0,176,458,20,1507,20,1069,8,20
"1083","2020-04-24",42,13,157,118,1642,0.672959805115713,0,0,176,458,26,1533,11,1080,17,11
"1084","2020-04-25",40,13,148,115,1642,0.672959805115713,0,0,176,458,21,1554,3,1083,9,3
"1085","2020-04-26",40,13,147,111,1642,0.672959805115713,0,0,176,458,26,1580,3,1086,17,3
"1086","2020-04-27",43,13,151,101,1642,0.672959805115713,0,0,176,458,23,1603,3,1089,16,3
"1087","2020-04-28",44,13,149,102,1642,0.672959805115713,0,0,176,458,19,1622,5,1094,12,5
"1088","2020-04-29",43,13,149,105,1642,0.672959805115713,0,0,176,458,21,1643,1,1095,15,1
"1089","2020-04-30",40,13,133,108,1642,0.672959805115713,0,0,176,458,17,1660,3,1098,8,3
"1090","2020-05-01",37,13,123,106,1642,0.672959805115713,0,0,176,458,15,1675,2,1100,12,2
"1091","2020-05-02",31,13,104,113,1642,0.672959805115713,0,0,176,458,28,1703,2,1102,18,2
"1092","2020-05-03",31,13,100,119,1642,0.672959805115713,0,0,176,458,17,1720,9,1111,8,9
"1093","2020-05-04",29,13,94,121,1642,0.672959805115713,0,0,176,458,24,1744,7,1118,16,7
"1094","2020-05-05",31,13,100,129,1642,0.672959805115713,0,0,176,458,19,1763,6,1124,9,6
"1095","2020-05-06",30,13,94,128,1642,0.672959805115713,0,0,176,458,23,1786,4,1128,15,4
"1096","2020-05-07",36,13,94,126,1642,0.672959805115713,0,0,176,458,26,1812,8,1136,15,8
"1097","2020-05-08",36,13,92,143,1642,0.672959805115713,0,0,176,458,21,1833,6,1142,13,6
"1098","2020-05-09",39,13,91,145,1642,0.672959805115713,0,0,176,458,20,1853,3,1145,17,3
"1099","2020-05-10",35,13,75,146,1642,0.672959805115713,0,0,176,458,20,1873,4,1149,11,4
"1100","2020-05-11",40,13,69,141,1642,0.672959805115713,0,0,176,458,33,1906,13,1162,23,13
"1101","2020-05-12",37,13,67,145,1642,0.672959805115713,0,0,176,458,20,1926,7,1169,13,7
"1102","2020-05-13",40,13,63,149,1642,0.672959805115713,0,0,176,458,15,1941,2,1171,11,2
"1103","2020-05-14",41,13,68,151,1642,0.672959805115713,0,0,176,458,20,1961,7,1178,15,7
"1104","2020-05-15",47,13,72,156,1642,0.672959805115713,0,0,176,458,29,1990,4,1182,20,4
"1105","2020-05-16",49,13,68,163,1642,0.672959805115713,0,0,176,458,33,2023,6,1188,26,6
"1106","2020-05-17",50,13,71,166,1642,0.672959805115713,0,0,176,458,16,2039,6,1194,10,6
"1107","2020-05-18",43,13,70,173,1642,0.672959805115713,0,0,176,458,28,2067,6,1200,22,6
"1108","2020-05-19",45,13,67,176,1642,0.672959805115713,0,0,176,458,19,2086,8,1208,15,8
"1109","2020-05-20",47,13,61,192,1642,0.672959805115713,0,0,176,458,22,2108,3,1211,16,3
"1110","2020-05-21",42,13,65,198,1642,0.672959805115713,0,0,176,458,20,2128,5,1216,12,5
"1111","2020-05-22",39,13,61,213,1642,0.672959805115713,0,0,176,458,23,2151,2,1218,21,2
"1112","2020-05-23",38,13,57,230,1642,0.672959805115713,0,0,176,458,25,2176,6,1224,21,6
"1113","2020-05-24",43,13,52,242,1642,0.672959805115713,0,0,176,458,26,2202,3,1227,13,3
"1114","2020-05-25",51,13,54,237,1642,0.672959805115713,0,0,176,458,21,2223,8,1235,16,8
"1115","2020-05-26",55,13,56,254,1642,0.672959805115713,0,0,176,458,20,2243,5,1240,17,5
"1116","2020-05-27",54,13,57,273,1642,0.672959805115713,0,0,176,458,24,2267,2,1242,18,2
"1117","2020-05-28",58,13,59,298,1642,0.672959805115713,0,0,176,458,20,2287,3,1245,14,3
"1118","2020-05-29",61,13,63,314,1642,0.672959805115713,0,0,176,458,25,2312,1,1246,17,1
"1119","2020-05-30",66,13,70,317,1642,0.672959805115713,0,0,176,458,30,2342,3,1249,22,3
"1120","2020-05-31",73,13,73,338,1642,0.672959805115713,0,0,176,458,15,2357,5,1254,11,5
"1121","2020-06-01",78,13,78,331,1642,0.672959805115713,0,0,176,458,19,2376,1,1255,14,1
"1122","2020-06-02",84,13,56,350,1642,0.672959805115713,0,0,176,458,24,2400,2,1257,23,2
"1123","2020-06-03",89,13,55,367,1642,0.672959805115713,0,0,176,458,16,2416,NA,NA,10,NA
"1124","2020-06-04",98,13,56,366,1642,0.672959805115713,0,0,176,458,28,2444,4,1261,22,4
"1125","2020-06-05",95,13,57,362,1642,0.672959805115713,0,0,176,458,21,2465,2,1263,16,2
"1126","2020-06-06",104,13,57,362,1642,0.672959805115713,0,0,176,458,21,2486,5,1268,14,5
"1127","2020-06-07",108,13,61,377,1642,0.672959805115713,0,0,176,458,15,2501,8,1276,11,8
"1128","2020-03-12",1,14,130,66,5942,0.927297206327836,0,0,520,645,55,100,23,88,30,23
"1129","2020-03-13",1,14,170,109,5942,0.927297206327836,0,0,520,645,87,187,18,106,60,18
"1130","2020-03-14",3,14,207,156,5942,0.927297206327836,0,0,520,645,107,294,14,120,76,14
"1131","2020-03-15",7,14,205,218,5942,0.927297206327836,0,0,520,645,134,428,23,143,111,23
"1132","2020-03-16",14,14,249,291,5942,0.927297206327836,0,0,520,645,199,627,45,188,172,45
"1133","2020-03-17",30,14,236,374,5942,0.927297206327836,0,0,520,645,210,837,23,211,193,23
"1134","2020-03-18",36,14,267,453,5942,0.927297206327836,0,0,520,645,360,1197,11,222,343,11
"1135","2020-03-19",49,14,257,536,5942,0.927297206327836,0,0,520,645,348,1545,10,232,329,10
"1136","2020-03-20",71,14,267,634,5942,0.927297206327836,0,0,520,645,387,1932,2,234,379,2
"1137","2020-03-21",92,14,266,752,5942,0.927297206327836,0,0,520,645,512,2444,6,240,498,7
"1138","2020-03-22",119,14,230,871,5942,0.927297206327836,0,0,520,645,506,2950,NA,NA,494,NA
"1139","2020-03-23",145,14,225,970,5942,0.927297206327836,0,0,520,645,517,3467,NA,NA,504,NA
"1140","2020-03-24",166,14,193,1106,5942,0.927297206327836,0,0,520,645,473,3940,3,243,465,3
"1141","2020-03-25",209,14,182,1257,5942,0.927297206327836,0,0,520,645,497,4437,10,253,489,10
"1142","2020-03-26",245,14,190,1339,5942,0.927297206327836,0,0,520,645,441,4878,37,290,432,37
"1143","2020-03-27",289,14,202,1468,5942,0.927297206327836,0,0,520,645,410,5288,24,314,406,24
"1144","2020-03-28",321,14,195,1586,5942,0.927297206327836,0,0,520,645,447,5735,11,325,443,11
"1145","2020-03-29",358,14,215,1659,5942,0.927297206327836,0,0,520,645,310,6045,58,383,298,58
"1146","2020-03-30",380,14,220,1749,5942,0.927297206327836,0,0,520,645,344,6389,45,428,337,45
"1147","2020-03-31",416,14,211,1834,5942,0.927297206327836,0,0,520,645,211,6600,29,457,210,29
"1148","2020-04-01",445,14,203,1899,5942,0.927297206327836,0,0,520,645,220,6820,25,482,219,25
"1149","2020-04-02",484,14,184,1937,5942,0.927297206327836,0,0,520,645,143,6963,8,490,139,8
"1150","2020-04-03",487,14,157,1975,5942,0.927297206327836,0,0,520,645,119,7082,3,493,116,3
"1151","2020-04-04",520,14,158,1979,5942,0.927297206327836,0,0,520,645,94,7176,11,504,93,11
"1152","2020-04-05",526,14,166,1945,5942,0.927297206327836,0,0,520,645,76,7252,9,513,74,9
"1153","2020-04-06",535,14,167,1911,5942,0.927297206327836,0,0,520,645,54,7306,13,526,53,13
"1154","2020-04-07",533,14,166,1918,5942,0.927297206327836,0,0,520,645,47,7353,19,545,47,19
"1155","2020-04-08",521,14,205,1869,5942,0.927297206327836,0,0,520,645,34,7387,54,599,34,54
"1156","2020-04-09",518,14,213,1854,5942,0.927297206327836,0,0,520,645,31,7418,25,624,29,25
"1157","2020-04-10",520,14,220,1830,5942,0.927297206327836,0,0,520,645,33,7451,14,638,29,14
"1158","2020-04-11",518,14,234,1799,5942,0.927297206327836,0,0,520,645,16,7467,13,651,15,13
"1159","2020-04-12",516,14,224,1798,5942,0.927297206327836,0,0,520,645,10,7477,25,676,10,25
"1160","2020-04-13",532,14,221,1735,5942,0.927297206327836,0,0,520,645,6,7483,15,691,5,15
"1161","2020-04-14",535,14,202,1649,5942,0.927297206327836,0,0,520,645,11,7494,29,720,11,29
"1162","2020-04-15",539,14,197,1539,5942,0.927297206327836,0,0,520,645,8,7502,18,738,5,18
"1163","2020-04-16",520,14,191,1450,5942,0.927297206327836,0,0,520,645,5,7507,36,774,4,36
"1164","2020-04-17",517,14,183,1371,5942,0.927297206327836,0,0,520,645,11,7518,37,811,11,37
"1165","2020-04-18",472,14,181,1266,5942,0.927297206327836,0,0,520,645,5,7523,14,825,5,14
"1166","2020-04-19",455,14,188,1181,5942,0.927297206327836,0,0,520,645,4,7527,10,835,3,10
"1167","2020-04-20",426,14,163,1102,5942,0.927297206327836,0,0,520,645,3,7530,22,857,2,22
"1168","2020-04-21",394,14,161,1014,5942,0.927297206327836,0,0,520,645,NA,NA,10,867,NA,10
"1169","2020-04-22",364,14,141,952,5942,0.927297206327836,0,0,520,645,2,7532,6,873,2,6
"1170","2020-04-23",339,14,148,876,5942,0.927297206327836,0,0,520,645,2,7534,10,883,2,10
"1171","2020-04-24",316,14,149,807,5942,0.927297206327836,0,0,520,645,2,7536,7,890,2,7
"1172","2020-04-25",312,14,148,724,5942,0.927297206327836,0,0,520,645,2,7538,16,906,2,16
"1173","2020-04-26",294,14,144,675,5942,0.927297206327836,0,0,520,645,3,7541,35,941,1,35
"1174","2020-04-27",270,14,144,601,5942,0.927297206327836,0,0,520,645,NA,NA,29,970,NA,29
"1175","2020-04-28",248,14,134,535,5942,0.927297206327836,0,0,520,645,1,7542,17,987,1,17
"1176","2020-04-29",226,14,126,477,5942,0.927297206327836,0,0,520,645,1,7543,8,995,NA,8
"1177","2020-04-30",201,14,115,455,5942,0.927297206327836,0,0,520,645,NA,NA,9,1004,NA,9
"1178","2020-05-01",172,14,112,426,5942,0.927297206327836,0,0,520,645,NA,NA,8,1012,NA,8
"1179","2020-05-02",150,14,103,390,5942,0.927297206327836,0,0,520,645,NA,NA,3,1015,NA,3
"1180","2020-05-03",128,14,107,348,5942,0.927297206327836,0,0,520,645,1,7544,1,1016,NA,1
"1181","2020-05-04",122,14,106,327,5942,0.927297206327836,0,0,520,645,4,7548,2,1018,3,2
"1182","2020-05-05",114,14,96,286,5942,0.927297206327836,0,0,520,645,NA,NA,4,1022,NA,4
"1183","2020-05-06",105,14,84,266,5942,0.927297206327836,0,0,520,645,1,7549,3,1025,NA,3
"1184","2020-05-07",97,14,74,238,5942,0.927297206327836,0,0,520,645,NA,NA,1,1026,NA,1
"1185","2020-05-08",90,14,72,210,5942,0.927297206327836,0,0,520,645,1,7550,4,1030,1,4
"1186","2020-05-09",83,14,69,192,5942,0.927297206327836,0,0,520,645,1,7551,3,1033,NA,3
"1187","2020-05-10",77,14,69,181,5942,0.927297206327836,0,0,520,645,NA,NA,6,1039,NA,6
"1188","2020-05-11",61,14,71,164,5942,0.927297206327836,0,0,520,645,NA,NA,8,1047,NA,8
"1189","2020-05-12",61,14,70,143,5942,0.927297206327836,0,0,520,645,NA,NA,2,1049,NA,2
"1190","2020-05-13",62,14,71,126,5942,0.927297206327836,0,0,520,645,2,7553,3,1052,1,3
"1191","2020-05-14",64,14,63,110,5942,0.927297206327836,0,0,520,645,NA,NA,2,1054,NA,2
"1192","2020-05-15",59,14,56,92,5942,0.927297206327836,0,0,520,645,NA,NA,4,1058,NA,4
"1193","2020-05-16",53,14,53,92,5942,0.927297206327836,0,0,520,645,NA,NA,2,1060,NA,2
"1194","2020-05-17",46,14,47,85,5942,0.927297206327836,0,0,520,645,1,7554,2,1062,NA,2
"1195","2020-05-18",46,14,46,80,5942,0.927297206327836,0,0,520,645,1,7555,3,1065,NA,3
"1196","2020-05-19",37,14,45,71,5942,0.927297206327836,0,0,520,645,1,7556,2,1067,1,2
"1197","2020-05-20",28,14,45,69,5942,0.927297206327836,0,0,520,645,NA,NA,2,1069,NA,2
"1198","2020-05-21",18,14,42,64,5942,0.927297206327836,0,0,520,645,NA,NA,3,1072,NA,3
"1199","2020-05-22",16,14,41,58,5942,0.927297206327836,0,0,520,645,NA,NA,5,1077,NA,5
"1200","2020-05-23",17,14,39,54,5942,0.927297206327836,0,0,520,645,NA,NA,2,1079,NA,2
"1201","2020-05-24",15,14,41,50,5942,0.927297206327836,0,0,520,645,NA,NA,2,1081,NA,2
"1202","2020-05-25",15,14,43,45,5942,0.927297206327836,0,0,520,645,NA,NA,NA,NA,NA,NA
"1203","2020-05-26",15,14,42,39,5942,0.927297206327836,0,0,520,645,NA,NA,3,1084,NA,3
"1204","2020-05-27",17,14,40,33,5942,0.927297206327836,0,0,520,645,NA,NA,2,1086,NA,2
"1205","2020-05-28",19,14,42,32,5942,0.927297206327836,0,0,520,645,NA,NA,2,1088,NA,2
"1206","2020-05-29",19,14,44,33,5942,0.927297206327836,0,0,520,645,NA,NA,1,1089,NA,1
"1207","2020-05-30",17,14,43,30,5942,0.927297206327836,0,0,520,645,NA,NA,3,1092,NA,3
"1208","2020-05-31",18,14,41,26,5942,0.927297206327836,0,0,520,645,NA,NA,NA,NA,NA,NA
"1209","2020-06-01",14,14,41,22,5942,0.927297206327836,0,0,520,645,1,7557,NA,NA,NA,NA
"1210","2020-06-02",11,14,40,20,5942,0.927297206327836,0,0,520,645,1,7558,1,1093,NA,1
"1211","2020-06-03",9,14,40,18,5942,0.927297206327836,0,0,520,645,NA,NA,1,1094,NA,1
"1212","2020-06-04",7,14,39,19,5942,0.927297206327836,0,0,520,645,NA,NA,2,1096,NA,2
"1213","2020-06-05",5,14,38,22,5942,0.927297206327836,0,0,520,645,NA,NA,NA,NA,NA,NA
"1214","2020-06-06",6,14,35,21,5942,0.927297206327836,0,0,520,645,1,7559,1,1097,NA,1
"1215","2020-06-07",6,14,36,23,5942,0.927297206327836,0,0,520,645,NA,NA,2,1099,NA,2
"1216","2020-03-12",1,15,225,187,8455,0.882554701360142,0,0,783,954,73,148,13,36,1,13
"1217","2020-03-13",6,15,319,315,8455,0.882554701360142,0,0,783,954,60,208,10,46,6,10
"1218","2020-03-14",15,15,377,479,8455,0.882554701360142,0,0,783,954,67,275,10,56,12,10
"1219","2020-03-15",34,15,377,692,8455,0.882554701360142,0,0,783,954,59,334,42,98,15,42
"1220","2020-03-16",50,15,348,1075,8455,0.882554701360142,0,0,783,954,72,406,31,129,23,31
"1221","2020-03-17",91,15,323,1501,8455,0.882554701360142,0,0,783,954,73,479,20,149,29,20
"1222","2020-03-18",135,15,263,1981,8455,0.882554701360142,0,0,783,954,77,556,31,180,22,31
"1223","2020-03-19",193,15,236,2484,8455,0.882554701360142,0,0,783,954,82,638,28,208,27,28
"1224","2020-03-20",280,15,224,3058,8455,0.882554701360142,0,0,783,954,72,710,43,251,21,43
"1225","2020-03-21",379,15,208,3651,8455,0.882554701360142,0,0,783,954,65,775,46,297,20,46
"1226","2020-03-22",471,15,189,4283,8455,0.882554701360142,0,0,783,954,52,827,41,338,16,41
"1227","2020-03-23",623,15,189,4882,8455,0.882554701360142,0,0,783,954,58,885,27,365,23,27
"1228","2020-03-24",772,15,228,5224,8455,0.882554701360142,0,0,783,954,58,943,32,397,27,32
"1229","2020-03-25",970,15,252,5419,8455,0.882554701360142,0,0,783,954,77,1020,41,438,33,41
"1230","2020-03-26",1153,15,231,5462,8455,0.882554701360142,0,0,783,954,55,1075,27,465,22,27
"1231","2020-03-27",1284,15,217,5485,8455,0.882554701360142,0,0,783,954,65,1140,31,496,26,31
"1232","2020-03-28",1393,15,227,5378,8455,0.882554701360142,0,0,783,954,44,1184,46,542,18,46
"1233","2020-03-29",1504,15,269,5099,8455,0.882554701360142,0,0,783,954,57,1241,46,588,20,46
"1234","2020-03-30",1550,15,289,4710,8455,0.882554701360142,0,0,783,954,47,1288,38,626,19,38
"1235","2020-03-31",1559,15,269,4238,8455,0.882554701360142,0,0,783,954,46,1334,34,660,14,34
"1236","2020-04-01",1506,15,227,3798,8455,0.882554701360142,0,0,783,954,52,1386,19,679,14,19
"1237","2020-04-02",1394,15,213,3307,8455,0.882554701360142,0,0,783,954,28,1414,39,718,11,39
"1238","2020-04-03",1313,15,263,2801,8455,0.882554701360142,0,0,783,954,40,1454,31,749,16,31
"1239","2020-04-04",1217,15,244,2353,8455,0.882554701360142,0,0,783,954,52,1506,20,769,16,20
"1240","2020-04-05",1075,15,236,1904,8455,0.882554701360142,0,0,783,954,42,1548,14,783,18,14
"1241","2020-04-06",936,15,219,1540,8455,0.882554701360142,0,0,783,954,45,1593,32,815,19,32
"1242","2020-04-07",795,15,241,1253,8455,0.882554701360142,0,0,783,954,43,1636,26,841,14,26
"1243","2020-04-08",655,15,270,1009,8455,0.882554701360142,0,0,783,954,37,1673,38,879,10,38
"1244","2020-04-09",568,15,302,787,8455,0.882554701360142,0,0,783,954,48,1721,31,910,16,31
"1245","2020-04-10",446,15,289,625,8455,0.882554701360142,0,0,783,954,40,1761,22,932,23,22
"1246","2020-04-11",357,15,253,471,8455,0.882554701360142,0,0,783,954,36,1797,25,957,18,25
"1247","2020-04-12",289,15,221,364,8455,0.882554701360142,0,0,783,954,20,1817,27,984,7,27
"1248","2020-04-13",232,15,256,301,8455,0.882554701360142,0,0,783,954,33,1850,26,1010,16,26
"1249","2020-04-14",178,15,250,214,8455,0.882554701360142,0,0,783,954,30,1880,20,1030,15,20
"1250","2020-04-15",136,15,235,153,8455,0.882554701360142,0,0,783,954,31,1911,18,1048,15,18
"1251","2020-04-16",97,15,244,114,8455,0.882554701360142,0,0,783,954,26,1937,9,1057,6,9
"1252","2020-04-17",79,15,238,83,8455,0.882554701360142,0,0,783,954,26,1963,13,1070,7,13
"1253","2020-04-18",50,15,234,65,8455,0.882554701360142,0,0,783,954,29,1992,8,1078,10,8
"1254","2020-04-19",40,15,245,50,8455,0.882554701360142,0,0,783,954,26,2018,20,1098,10,20
"1255","2020-04-20",23,15,243,43,8455,0.882554701360142,0,0,783,954,26,2044,19,1117,13,19
"1256","2020-04-21",19,15,257,32,8455,0.882554701360142,0,0,783,954,20,2064,14,1131,9,14
"1257","2020-04-22",14,15,215,26,8455,0.882554701360142,0,0,783,954,21,2085,11,1142,8,11
"1258","2020-04-23",11,15,180,25,8455,0.882554701360142,0,0,783,954,36,2121,9,1151,12,9
"1259","2020-04-24",11,15,160,20,8455,0.882554701360142,0,0,783,954,32,2153,10,1161,18,10
"1260","2020-04-25",9,15,160,16,8455,0.882554701360142,0,0,783,954,28,2181,18,1179,15,18
"1261","2020-04-26",9,15,154,12,8455,0.882554701360142,0,0,783,954,18,2199,14,1193,7,14
"1262","2020-04-27",8,15,159,11,8455,0.882554701360142,0,0,783,954,22,2221,12,1205,11,12
"1263","2020-04-28",8,15,144,11,8455,0.882554701360142,0,0,783,954,29,2250,12,1217,15,12
"1264","2020-04-29",6,15,142,8,8455,0.882554701360142,0,0,783,954,19,2269,7,1224,7,7
"1265","2020-04-30",5,15,130,6,8455,0.882554701360142,0,0,783,954,18,2287,4,1228,8,4
"1266","2020-05-01",3,15,140,4,8455,0.882554701360142,0,0,783,954,17,2304,8,1236,7,8
"1267","2020-05-02",2,15,152,7,8455,0.882554701360142,0,0,783,954,23,2327,4,1240,7,4
"1268","2020-05-03",0,15,0,0,8455,0.882554701360142,0,0,783,954,21,2348,8,1248,7,8
"1269","2020-05-04",0,15,0,0,8455,0.882554701360142,0,0,783,954,21,2369,13,1261,7,13
"1270","2020-05-05",0,15,0,0,8455,0.882554701360142,0,0,783,954,19,2388,5,1266,12,5
"1271","2020-05-06",0,15,0,0,8455,0.882554701360142,0,0,783,954,13,2401,15,1281,5,15
"1272","2020-05-07",0,15,0,0,8455,0.882554701360142,0,0,783,954,13,2414,6,1287,2,6
"1273","2020-05-08",0,15,0,0,8455,0.882554701360142,0,0,783,954,13,2427,7,1294,6,7
"1274","2020-05-09",0,15,0,0,8455,0.882554701360142,0,0,783,954,18,2445,3,1297,8,3
"1275","2020-05-10",0,15,0,0,8455,0.882554701360142,0,0,783,954,20,2465,3,1300,7,3
"1276","2020-05-11",1,15,49,6,8455,0.882554701360142,0,0,783,954,20,2485,8,1308,12,8
"1277","2020-05-12",2,15,47,7,8455,0.882554701360142,0,0,783,954,12,2497,3,1311,3,3
"1278","2020-05-13",3,15,44,5,8455,0.882554701360142,0,0,783,954,21,2518,2,1313,5,2
"1279","2020-05-14",5,15,40,4,8455,0.882554701360142,0,0,783,954,23,2541,1,1314,6,1
"1280","2020-05-15",5,15,45,4,8455,0.882554701360142,0,0,783,954,9,2550,3,1317,3,3
"1281","2020-05-16",5,15,43,4,8455,0.882554701360142,0,0,783,954,26,2576,2,1319,7,2
"1282","2020-05-17",5,15,38,5,8455,0.882554701360142,0,0,783,954,7,2583,2,1321,5,2
"1283","2020-05-18",4,15,35,5,8455,0.882554701360142,0,0,783,954,13,2596,6,1327,4,6
"1284","2020-05-19",3,15,30,5,8455,0.882554701360142,0,0,783,954,13,2609,3,1330,6,3
"1285","2020-05-20",2,15,28,5,8455,0.882554701360142,0,0,783,954,14,2623,3,1333,3,3
"1286","2020-05-21",0,15,0,0,8455,0.882554701360142,0,0,783,954,18,2641,4,1337,11,4
"1287","2020-05-22",0,15,0,0,8455,0.882554701360142,0,0,783,954,15,2656,1,1338,7,1
"1288","2020-05-23",0,15,0,0,8455,0.882554701360142,0,0,783,954,16,2672,4,1342,5,4
"1289","2020-05-24",0,15,0,0,8455,0.882554701360142,0,0,783,954,15,2687,7,1349,5,7
"1290","2020-05-25",0,15,0,0,8455,0.882554701360142,0,0,783,954,16,2703,3,1352,7,3
"1291","2020-05-26",0,15,0,0,8455,0.882554701360142,0,0,783,954,16,2719,NA,NA,3,NA
"1292","2020-05-27",0,15,0,0,8455,0.882554701360142,0,0,783,954,14,2733,NA,NA,3,NA
"1293","2020-05-28",0,15,0,0,8455,0.882554701360142,0,0,783,954,19,2752,5,1357,7,5
"1294","2020-05-29",0,15,0,0,8455,0.882554701360142,0,0,783,954,13,2765,1,1358,5,1
"1295","2020-05-30",0,15,0,0,8455,0.882554701360142,0,0,783,954,18,2783,NA,NA,7,NA
"1296","2020-05-31",1,15,10,7,8455,0.882554701360142,0,0,783,954,12,2795,NA,NA,4,NA
"1297","2020-06-01",3,15,9,7,8455,0.882554701360142,0,0,783,954,12,2807,NA,NA,4,NA
"1298","2020-06-02",3,15,8,8,8455,0.882554701360142,0,0,783,954,21,2828,NA,NA,9,NA
"1299","2020-06-03",5,15,8,9,8455,0.882554701360142,0,0,783,954,12,2840,NA,NA,3,NA
"1300","2020-06-04",5,15,12,9,8455,0.882554701360142,0,0,783,954,16,2856,1,1359,5,1
"1301","2020-06-05",5,15,11,7,8455,0.882554701360142,0,0,783,954,15,2871,NA,NA,5,NA
"1302","2020-06-06",5,15,11,7,8455,0.882554701360142,0,0,783,954,14,2885,NA,NA,5,NA
"1303","2020-06-07",4,15,10,7,8455,0.882554701360142,0,0,783,954,19,2904,NA,NA,9,NA
"1304","2020-03-13",1,16,199,50,2333,0.730818688384055,0,0,217,544,50,141,68,214,6,68
"1305","2020-03-14",3,16,207,81,2333,0.730818688384055,0,0,217,544,52,193,73,287,11,73
"1306","2020-03-15",5,16,212,109,2333,0.730818688384055,0,0,217,544,67,260,45,332,19,45
"1307","2020-03-16",10,16,205,133,2333,0.730818688384055,0,0,217,544,45,305,35,367,15,35
"1308","2020-03-17",17,16,239,168,2333,0.730818688384055,0,0,217,544,62,367,31,398,25,31
"1309","2020-03-18",26,16,254,185,2333,0.730818688384055,0,0,217,544,67,434,26,424,31,26
"1310","2020-03-19",34,16,243,200,2333,0.730818688384055,0,0,217,544,65,499,51,475,29,51
"1311","2020-03-20",43,16,221,217,2333,0.730818688384055,0,0,217,544,54,553,35,510,16,35
"1312","2020-03-21",48,16,231,240,2333,0.730818688384055,0,0,217,544,51,604,32,542,25,32
"1313","2020-03-22",52,16,244,250,2333,0.730818688384055,0,0,217,544,61,665,34,576,25,34
"1314","2020-03-23",55,16,222,263,2333,0.730818688384055,0,0,217,544,48,713,38,614,25,38
"1315","2020-03-24",56,16,229,277,2333,0.730818688384055,0,0,217,544,54,767,48,662,21,48
"1316","2020-03-25",54,16,213,277,2333,0.730818688384055,0,0,217,544,54,821,40,702,27,40
"1317","2020-03-26",59,16,200,283,2333,0.730818688384055,0,0,217,544,53,874,31,733,25,31
"1318","2020-03-27",60,16,229,286,2333,0.730818688384055,0,0,217,544,45,919,44,777,25,44
"1319","2020-03-28",65,16,216,296,2333,0.730818688384055,0,0,217,544,61,980,36,813,33,36
"1320","2020-03-29",71,16,228,284,2333,0.730818688384055,0,0,217,544,52,1032,32,845,28,32
"1321","2020-03-30",78,16,235,284,2333,0.730818688384055,0,0,217,544,61,1093,28,873,34,28
"1322","2020-03-31",80,16,270,282,2333,0.730818688384055,0,0,217,544,53,1146,29,902,25,29
"1323","2020-04-01",80,16,270,272,2333,0.730818688384055,0,0,217,544,39,1185,28,930,20,28
"1324","2020-04-02",74,16,262,279,2333,0.730818688384055,0,0,217,544,51,1236,30,960,32,30
"1325","2020-04-03",80,16,227,264,2333,0.730818688384055,0,0,217,544,55,1291,30,990,30,30
"1326","2020-04-04",78,16,206,270,2333,0.730818688384055,0,0,217,544,44,1335,24,1014,25,24
"1327","2020-04-05",81,16,188,268,2333,0.730818688384055,0,0,217,544,53,1388,60,1074,35,60
"1328","2020-04-06",77,16,187,267,2333,0.730818688384055,0,0,217,544,49,1437,41,1115,28,41
"1329","2020-04-07",75,16,177,255,2333,0.730818688384055,0,0,217,544,44,1481,59,1174,31,59
"1330","2020-04-08",72,16,190,265,2333,0.730818688384055,0,0,217,544,39,1520,56,1230,28,56
"1331","2020-04-09",75,16,212,262,2333,0.730818688384055,0,0,217,544,52,1572,64,1294,25,64
"1332","2020-04-10",68,16,191,269,2333,0.730818688384055,0,0,217,544,34,1606,40,1334,15,40
"1333","2020-04-11",68,16,183,264,2333,0.730818688384055,0,0,217,544,43,1649,30,1364,24,30
"1334","2020-04-12",60,16,152,260,2333,0.730818688384055,0,0,217,544,42,1691,60,1424,23,60
"1335","2020-04-13",58,16,142,265,2333,0.730818688384055,0,0,217,544,40,1731,43,1467,23,43
"1336","2020-04-14",58,16,130,257,2333,0.730818688384055,0,0,217,544,33,1764,41,1508,20,41
"1337","2020-04-15",78,16,129,245,2333,0.730818688384055,0,0,217,544,36,1800,33,1541,21,33
"1338","2020-04-16",79,16,143,241,2333,0.730818688384055,0,0,217,544,32,1832,60,1601,13,60
"1339","2020-04-17",80,16,156,256,2333,0.730818688384055,0,0,217,544,28,1860,53,1654,16,53
"1340","2020-04-18",87,16,142,257,2333,0.730818688384055,0,0,217,544,32,1892,59,1713,21,59
"1341","2020-04-19",89,16,123,264,2333,0.730818688384055,0,0,217,544,25,1917,50,1763,13,50
"1342","2020-04-20",84,16,118,270,2333,0.730818688384055,0,0,217,544,22,1939,38,1801,14,38
"1343","2020-04-21",85,16,113,269,2333,0.730818688384055,0,0,217,544,25,1964,44,1845,18,44
"1344","2020-04-22",70,16,103,268,2333,0.730818688384055,0,0,217,544,28,1992,43,1888,15,43
"1345","2020-04-23",68,16,95,272,2333,0.730818688384055,0,0,217,544,19,2011,46,1934,13,46
"1346","2020-04-24",72,16,100,263,2333,0.730818688384055,0,0,217,544,25,2036,41,1975,16,41
"1347","2020-04-25",69,16,104,257,2333,0.730818688384055,0,0,217,544,24,2060,43,2018,20,43
"1348","2020-04-26",70,16,115,268,2333,0.730818688384055,0,0,217,544,23,2083,35,2053,10,35
"1349","2020-04-27",74,16,112,271,2333,0.730818688384055,0,0,217,544,17,2100,36,2089,9,36
"1350","2020-04-28",73,16,96,267,2333,0.730818688384055,0,0,217,544,23,2123,32,2121,10,32
"1351","2020-04-29",75,16,95,275,2333,0.730818688384055,0,0,217,544,19,2142,21,2142,12,21
"1352","2020-04-30",76,16,95,262,2333,0.730818688384055,0,0,217,544,20,2162,22,2164,10,22
"1353","2020-05-01",72,16,102,257,2333,0.730818688384055,0,0,217,544,29,2191,18,2182,14,18
"1354","2020-05-02",65,16,109,244,2333,0.730818688384055,0,0,217,544,25,2216,22,2204,11,22
"1355","2020-05-03",68,16,116,233,2333,0.730818688384055,0,0,217,544,21,2237,26,2230,11,26
"1356","2020-05-04",74,16,117,231,2333,0.730818688384055,0,0,217,544,25,2262,20,2250,13,20
"1357","2020-05-05",71,16,112,223,2333,0.730818688384055,0,0,217,544,20,2282,23,2273,17,23
"1358","2020-05-06",76,16,104,231,2333,0.730818688384055,0,0,217,544,23,2305,18,2291,14,18
"1359","2020-05-07",74,16,94,237,2333,0.730818688384055,0,0,217,544,25,2330,11,2302,20,11
"1360","2020-05-08",75,16,89,227,2333,0.730818688384055,0,0,217,544,17,2347,30,2332,8,30
"1361","2020-05-09",80,16,84,225,2333,0.730818688384055,0,0,217,544,20,2367,24,2356,9,24
"1362","2020-05-10",80,16,87,240,2333,0.730818688384055,0,0,217,544,22,2389,23,2379,8,23
"1363","2020-05-11",75,16,82,238,2333,0.730818688384055,0,0,217,544,21,2410,23,2402,12,23
"1364","2020-05-12",82,16,74,240,2333,0.730818688384055,0,0,217,544,12,2422,32,2434,7,32
"1365","2020-05-13",81,16,75,236,2333,0.730818688384055,0,0,217,544,19,2441,21,2455,12,21
"1366","2020-05-14",77,16,68,235,2333,0.730818688384055,0,0,217,544,15,2456,24,2479,7,24
"1367","2020-05-15",75,16,61,234,2333,0.730818688384055,0,0,217,544,9,2465,16,2495,7,16
"1368","2020-05-16",76,16,56,252,2333,0.730818688384055,0,0,217,544,11,2476,23,2518,9,23
"1369","2020-05-17",75,16,43,257,2333,0.730818688384055,0,0,217,544,19,2495,21,2539,9,21
"1370","2020-05-18",73,16,43,273,2333,0.730818688384055,0,0,217,544,13,2508,6,2545,8,6
"1371","2020-05-19",68,16,39,272,2333,0.730818688384055,0,0,217,544,13,2521,12,2557,6,12
"1372","2020-05-20",59,16,41,283,2333,0.730818688384055,0,0,217,544,15,2536,8,2565,9,8
"1373","2020-05-21",61,16,45,295,2333,0.730818688384055,0,0,217,544,15,2551,18,2583,6,18
"1374","2020-05-22",65,16,45,318,2333,0.730818688384055,0,0,217,544,18,2569,7,2590,9,7
"1375","2020-05-23",64,16,43,319,2333,0.730818688384055,0,0,217,544,11,2580,15,2605,5,15
"1376","2020-05-24",66,16,45,322,2333,0.730818688384055,0,0,217,544,18,2598,9,2614,13,9
"1377","2020-05-25",77,16,47,330,2333,0.730818688384055,0,0,217,544,13,2611,9,2623,5,9
"1378","2020-05-26",86,16,47,336,2333,0.730818688384055,0,0,217,544,12,2623,11,2634,7,11
"1379","2020-05-27",93,16,50,339,2333,0.730818688384055,0,0,217,544,21,2644,4,2638,11,4
"1380","2020-05-28",105,16,42,336,2333,0.730818688384055,0,0,217,544,18,2662,4,2642,10,4
"1381","2020-05-29",101,16,40,329,2333,0.730818688384055,0,0,217,544,19,2681,3,2645,11,3
"1382","2020-05-30",105,16,42,348,2333,0.730818688384055,0,0,217,544,17,2698,7,2652,12,7
"1383","2020-05-31",108,16,40,350,2333,0.730818688384055,0,0,217,544,18,2716,4,2656,12,4
"1384","2020-06-01",95,16,43,344,2333,0.730818688384055,0,0,217,544,11,2727,10,2666,5,10
"1385","2020-06-02",94,16,46,356,2333,0.730818688384055,0,0,217,544,14,2741,5,2671,4,5
"1386","2020-06-03",106,16,39,353,2333,0.730818688384055,0,0,217,544,14,2755,6,2677,9,6
"1387","2020-06-04",101,16,34,353,2333,0.730818688384055,0,0,217,544,19,2774,10,2687,12,10
"1388","2020-06-05",103,16,40,344,2333,0.730818688384055,0,0,217,544,25,2799,12,2699,17,12
"1389","2020-06-06",104,16,44,346,2333,0.730818688384055,0,0,217,544,19,2818,7,2706,7,7
"1390","2020-06-07",98,16,39,337,2333,0.730818688384055,0,0,217,544,12,2830,9,2715,8,9
"1391","2020-03-13",2,17,233,112,2235,0.43579418344519,0,0,203,534,42,81,16,126,33,16
"1392","2020-03-14",2,17,265,150,2235,0.43579418344519,0,0,203,534,41,122,31,157,40,31
"1393","2020-03-15",10,17,276,185,2235,0.43579418344519,0,0,203,534,64,186,64,221,58,64
"1394","2020-03-16",20,17,280,210,2235,0.43579418344519,0,0,203,534,70,256,32,253,60,32
"1395","2020-03-17",30,17,304,240,2235,0.43579418344519,0,0,203,534,90,346,24,277,84,24
"1396","2020-03-18",39,17,316,271,2235,0.43579418344519,0,0,203,534,140,486,17,294,134,17
"1397","2020-03-19",53,17,293,309,2235,0.43579418344519,0,0,203,534,163,649,36,330,160,36
"1398","2020-03-20",61,17,250,324,2235,0.43579418344519,0,0,203,534,181,830,23,353,173,23
"1399","2020-03-21",76,17,213,336,2235,0.43579418344519,0,0,203,534,200,1030,29,382,196,29
"1400","2020-03-22",82,17,181,347,2235,0.43579418344519,0,0,203,534,278,1308,21,403,272,21
"1401","2020-03-23",93,17,201,372,2235,0.43579418344519,0,0,203,534,325,1633,47,450,321,47
"1402","2020-03-24",101,17,206,373,2235,0.43579418344519,0,0,203,534,350,1983,32,482,343,32
"1403","2020-03-25",108,17,221,371,2235,0.43579418344519,0,0,203,534,407,2390,15,497,402,15
"1404","2020-03-26",110,17,217,367,2235,0.43579418344519,0,0,203,534,362,2752,35,532,360,35
"1405","2020-03-27",110,17,208,351,2235,0.43579418344519,0,0,203,534,494,3246,53,585,489,53
"1406","2020-03-28",104,17,183,360,2235,0.43579418344519,0,0,203,534,402,3648,55,640,399,55
"1407","2020-03-29",107,17,198,359,2235,0.43579418344519,0,0,203,534,472,4120,61,701,471,61
"1408","2020-03-30",97,17,233,363,2235,0.43579418344519,0,0,203,534,489,4609,28,729,488,28
"1409","2020-03-31",98,17,211,370,2235,0.43579418344519,0,0,203,534,388,4997,43,772,386,43
"1410","2020-04-01",94,17,205,370,2235,0.43579418344519,0,0,203,534,373,5370,40,812,370,40
"1411","2020-04-02",86,17,222,374,2235,0.43579418344519,0,0,203,534,316,5686,24,836,316,24
"1412","2020-04-03",94,17,204,370,2235,0.43579418344519,0,0,203,534,252,5938,28,864,251,28
"1413","2020-04-04",110,17,215,359,2235,0.43579418344519,0,0,203,534,236,6174,25,889,235,25
"1414","2020-04-05",109,17,201,338,2235,0.43579418344519,0,0,203,534,278,6452,16,905,277,16
"1415","2020-04-06",111,17,201,325,2235,0.43579418344519,0,0,203,534,156,6608,15,920,155,15
"1416","2020-04-07",107,17,158,318,2235,0.43579418344519,0,0,203,534,122,6730,18,938,122,18
"1417","2020-04-08",110,17,127,309,2235,0.43579418344519,0,0,203,534,126,6856,20,958,126,20
"1418","2020-04-09",111,17,103,304,2235,0.43579418344519,0,0,203,534,90,6946,32,990,90,32
"1419","2020-04-10",106,17,96,307,2235,0.43579418344519,0,0,203,534,74,7020,24,1014,73,24
"1420","2020-04-11",96,17,107,307,2235,0.43579418344519,0,0,203,534,71,7091,12,1026,70,12
"1421","2020-04-12",91,17,110,291,2235,0.43579418344519,0,0,203,534,47,7138,7,1033,47,7
"1422","2020-04-13",87,17,119,290,2235,0.43579418344519,0,0,203,534,35,7173,4,1037,35,4
"1423","2020-04-14",80,17,116,274,2235,0.43579418344519,0,0,203,534,39,7212,10,1047,38,10
"1424","2020-04-15",75,17,108,277,2235,0.43579418344519,0,0,203,534,15,7227,5,1052,15,5
"1425","2020-04-16",75,17,108,274,2235,0.43579418344519,0,0,203,534,20,7247,5,1057,20,5
"1426","2020-04-17",74,17,99,286,2235,0.43579418344519,0,0,203,534,14,7261,6,1063,14,6
"1427","2020-04-18",70,17,119,286,2235,0.43579418344519,0,0,203,534,14,7275,8,1071,14,8
"1428","2020-04-19",74,17,123,285,2235,0.43579418344519,0,0,203,534,7,7282,23,1094,7,23
"1429","2020-04-20",81,17,123,277,2235,0.43579418344519,0,0,203,534,11,7293,28,1122,11,28
"1430","2020-04-21",83,17,148,277,2235,0.43579418344519,0,0,203,534,5,7298,17,1139,5,17
"1431","2020-04-22",84,17,141,270,2235,0.43579418344519,0,0,203,534,3,7301,19,1158,3,19
"1432","2020-04-23",85,17,157,267,2235,0.43579418344519,0,0,203,534,5,7306,15,1173,4,15
"1433","2020-04-24",90,17,177,260,2235,0.43579418344519,0,0,203,534,5,7311,9,1182,5,9
"1434","2020-04-25",88,17,176,255,2235,0.43579418344519,0,0,203,534,4,7315,4,1186,3,4
"1435","2020-04-26",82,17,171,255,2235,0.43579418344519,0,0,203,534,3,7318,3,1189,3,3
"1436","2020-04-27",72,17,174,240,2235,0.43579418344519,0,0,203,534,2,7320,5,1194,1,5
"1437","2020-04-28",72,17,184,226,2235,0.43579418344519,0,0,203,534,1,7321,1,1195,1,1
"1438","2020-04-29",72,17,174,213,2235,0.43579418344519,0,0,203,534,NA,NA,13,1208,NA,13
"1439","2020-04-30",67,17,154,216,2235,0.43579418344519,0,0,203,534,NA,NA,8,1216,NA,8
"1440","2020-05-01",61,17,131,211,2235,0.43579418344519,0,0,203,534,2,7323,17,1233,2,17
"1441","2020-05-02",60,17,119,202,2235,0.43579418344519,0,0,203,534,NA,NA,5,1238,NA,5
"1442","2020-05-03",60,17,107,190,2235,0.43579418344519,0,0,203,534,2,7325,11,1249,2,11
"1443","2020-05-04",59,17,90,193,2235,0.43579418344519,0,0,203,534,1,7326,1,1250,1,1
"1444","2020-05-05",56,17,82,192,2235,0.43579418344519,0,0,203,534,1,7327,10,1260,1,10
"1445","2020-05-06",55,17,85,184,2235,0.43579418344519,0,0,203,534,NA,NA,13,1273,NA,13
"1446","2020-05-07",66,17,74,178,2235,0.43579418344519,0,0,203,534,3,7330,3,1276,2,3
"1447","2020-05-08",61,17,66,177,2235,0.43579418344519,0,0,203,534,1,7331,14,1290,1,14
"1448","2020-05-09",62,17,61,169,2235,0.43579418344519,0,0,203,534,NA,NA,2,1292,NA,2
"1449","2020-05-10",61,17,48,170,2235,0.43579418344519,0,0,203,534,2,7333,4,1296,NA,4
"1450","2020-05-11",61,17,52,168,2235,0.43579418344519,0,0,203,534,NA,NA,1,1297,NA,1
"1451","2020-05-12",68,17,44,169,2235,0.43579418344519,0,0,203,534,NA,NA,9,1306,NA,9
"1452","2020-05-13",67,17,41,174,2235,0.43579418344519,0,0,203,534,2,7335,8,1314,1,8
"1453","2020-05-14",56,17,39,176,2235,0.43579418344519,0,0,203,534,NA,NA,4,1318,NA,4
"1454","2020-05-15",61,17,44,167,2235,0.43579418344519,0,0,203,534,NA,NA,4,1322,NA,4
"1455","2020-05-16",60,17,42,172,2235,0.43579418344519,0,0,203,534,NA,NA,3,1325,NA,3
"1456","2020-05-17",55,17,39,176,2235,0.43579418344519,0,0,203,534,NA,NA,NA,NA,NA,NA
"1457","2020-05-18",56,17,33,177,2235,0.43579418344519,0,0,203,534,NA,NA,3,1328,NA,3
"1458","2020-05-19",48,17,29,172,2235,0.43579418344519,0,0,203,534,1,7336,4,1332,1,4
"1459","2020-05-20",44,17,23,191,2235,0.43579418344519,0,0,203,534,1,7337,1,1333,1,1
"1460","2020-05-21",46,17,19,194,2235,0.43579418344519,0,0,203,534,NA,NA,1,1334,NA,1
"1461","2020-05-22",41,17,20,203,2235,0.43579418344519,0,0,203,534,NA,NA,NA,NA,NA,NA
"1462","2020-05-23",39,17,16,211,2235,0.43579418344519,0,0,203,534,NA,NA,NA,NA,NA,NA
"1463","2020-05-24",41,17,18,218,2235,0.43579418344519,0,0,203,534,NA,NA,NA,NA,NA,NA
"1464","2020-05-25",40,17,25,219,2235,0.43579418344519,0,0,203,534,NA,NA,3,1337,NA,3
"1465","2020-05-26",44,17,24,232,2235,0.43579418344519,0,0,203,534,NA,NA,2,1339,NA,2
"1466","2020-05-27",47,17,27,241,2235,0.43579418344519,0,0,203,534,NA,NA,1,1340,NA,1
"1467","2020-05-28",47,17,24,249,2235,0.43579418344519,0,0,203,534,NA,NA,1,1341,NA,1
"1468","2020-05-29",49,17,23,257,2235,0.43579418344519,0,0,203,534,NA,NA,NA,NA,NA,NA
"1469","2020-05-30",54,17,27,257,2235,0.43579418344519,0,0,203,534,NA,NA,NA,NA,NA,NA
"1470","2020-05-31",63,17,35,254,2235,0.43579418344519,0,0,203,534,NA,NA,NA,NA,NA,NA
"1471","2020-06-01",71,17,33,253,2235,0.43579418344519,0,0,203,534,NA,NA,NA,NA,NA,NA
"1472","2020-06-02",68,17,34,254,2235,0.43579418344519,0,0,203,534,NA,NA,NA,NA,NA,NA
"1473","2020-06-03",70,17,33,261,2235,0.43579418344519,0,0,203,534,NA,NA,2,1343,NA,2
"1474","2020-06-04",71,17,29,265,2235,0.43579418344519,0,0,203,534,NA,NA,1,1344,NA,1
"1475","2020-06-05",72,17,26,255,2235,0.43579418344519,0,0,203,534,1,7338,1,1345,NA,1
"1476","2020-06-06",76,17,32,262,2235,0.43579418344519,0,0,203,534,1,7339,NA,NA,1,NA
"1477","2020-06-07",79,17,36,265,2235,0.43579418344519,0,0,203,534,NA,NA,NA,NA,NA,NA
"1478","2020-03-13",2,18,175,87,2721,0.741271591326718,0,0,235,1033,23,43,23,80,5,23
"1479","2020-03-14",5,18,170,125,2721,0.741271591326718,0,0,235,1033,13,56,48,128,3,48
"1480","2020-03-15",8,18,261,160,2721,0.741271591326718,0,0,235,1033,20,76,23,151,10,23
"1481","2020-03-16",16,18,314,198,2721,0.741271591326718,0,0,235,1033,21,97,11,162,11,11
"1482","2020-03-17",20,18,298,226,2721,0.741271591326718,0,0,235,1033,18,115,10,172,7,10
"1483","2020-03-18",26,18,290,253,2721,0.741271591326718,0,0,235,1033,13,128,4,176,7,4
"1484","2020-03-19",36,18,267,301,2721,0.741271591326718,0,0,235,1033,15,143,16,192,9,16
"1485","2020-03-20",45,18,245,326,2721,0.741271591326718,0,0,235,1033,23,166,44,236,13,44
"1486","2020-03-21",53,18,220,356,2721,0.741271591326718,0,0,235,1033,20,186,63,299,12,63
"1487","2020-03-22",62,18,190,369,2721,0.741271591326718,0,0,235,1033,28,214,48,347,20,48
"1488","2020-03-23",71,18,172,390,2721,0.741271591326718,0,0,235,1033,13,227,23,370,3,23
"1489","2020-03-24",85,18,166,406,2721,0.741271591326718,0,0,235,1033,17,244,21,391,11,21
"1490","2020-03-25",99,18,146,420,2721,0.741271591326718,0,0,235,1033,21,265,7,398,10,7
"1491","2020-03-26",109,18,136,413,2721,0.741271591326718,0,0,235,1033,22,287,8,406,13,8
"1492","2020-03-27",110,18,181,410,2721,0.741271591326718,0,0,235,1033,17,304,28,434,14,28
"1493","2020-03-28",112,18,220,421,2721,0.741271591326718,0,0,235,1033,13,317,21,455,10,21
"1494","2020-03-29",116,18,207,434,2721,0.741271591326718,0,0,235,1033,24,341,36,491,17,36
"1495","2020-03-30",121,18,177,448,2721,0.741271591326718,0,0,235,1033,30,371,23,514,20,23
"1496","2020-03-31",123,18,148,437,2721,0.741271591326718,0,0,235,1033,28,399,45,559,18,45
"1497","2020-04-01",119,18,136,447,2721,0.741271591326718,0,0,235,1033,24,423,42,601,17,42
"1498","2020-04-02",114,18,163,439,2721,0.741271591326718,0,0,235,1033,15,438,31,632,8,31
"1499","2020-04-03",121,18,177,431,2721,0.741271591326718,0,0,235,1033,15,453,47,679,10,47
"1500","2020-04-04",125,18,188,417,2721,0.741271591326718,0,0,235,1033,31,484,26,705,19,26
"1501","2020-04-05",126,18,185,413,2721,0.741271591326718,0,0,235,1033,14,498,21,726,7,21
"1502","2020-04-06",124,18,192,408,2721,0.741271591326718,0,0,235,1033,12,510,14,740,4,14
"1503","2020-04-07",118,18,161,406,2721,0.741271591326718,0,0,235,1033,15,525,6,746,11,6
"1504","2020-04-08",125,18,148,416,2721,0.741271591326718,0,0,235,1033,11,536,27,773,11,27
"1505","2020-04-09",125,18,177,424,2721,0.741271591326718,0,0,235,1033,16,552,24,797,9,24
"1506","2020-04-10",111,18,162,396,2721,0.741271591326718,0,0,235,1033,13,565,26,823,12,26
"1507","2020-04-11",109,18,160,385,2721,0.741271591326718,0,0,235,1033,9,574,26,849,6,26
"1508","2020-04-12",105,18,178,378,2721,0.741271591326718,0,0,235,1033,19,593,8,857,9,8
"1509","2020-04-13",101,18,192,366,2721,0.741271591326718,0,0,235,1033,16,609,25,882,8,25
"1510","2020-04-14",108,18,190,368,2721,0.741271591326718,0,0,235,1033,10,619,16,898,7,16
"1511","2020-04-15",93,18,161,354,2721,0.741271591326718,0,0,235,1033,17,636,12,910,13,12
"1512","2020-04-16",97,18,162,334,2721,0.741271591326718,0,0,235,1033,15,651,35,945,12,35
"1513","2020-04-17",100,18,167,317,2721,0.741271591326718,0,0,235,1033,20,671,25,970,17,25
"1514","2020-04-18",96,18,191,301,2721,0.741271591326718,0,0,235,1033,10,681,17,987,7,17
"1515","2020-04-19",107,18,204,291,2721,0.741271591326718,0,0,235,1033,12,693,13,1000,5,13
"1516","2020-04-20",102,18,175,270,2721,0.741271591326718,0,0,235,1033,10,703,4,1004,7,4
"1517","2020-04-21",89,18,166,264,2721,0.741271591326718,0,0,235,1033,25,728,5,1009,20,5
"1518","2020-04-22",90,18,163,265,2721,0.741271591326718,0,0,235,1033,13,741,17,1026,8,17
"1519","2020-04-23",83,18,153,265,2721,0.741271591326718,0,0,235,1033,16,757,18,1044,11,18
"1520","2020-04-24",90,18,138,261,2721,0.741271591326718,0,0,235,1033,11,768,12,1056,11,12
"1521","2020-04-25",87,18,114,252,2721,0.741271591326718,0,0,235,1033,8,776,21,1077,6,21
"1522","2020-04-26",71,18,106,240,2721,0.741271591326718,0,0,235,1033,8,784,28,1105,5,28
"1523","2020-04-27",66,18,72,229,2721,0.741271591326718,0,0,235,1033,6,790,25,1130,6,25
"1524","2020-04-28",65,18,61,225,2721,0.741271591326718,0,0,235,1033,10,800,13,1143,10,13
"1525","2020-04-29",61,18,57,231,2721,0.741271591326718,0,0,235,1033,8,808,22,1165,5,22
"1526","2020-04-30",60,18,51,239,2721,0.741271591326718,0,0,235,1033,13,821,8,1173,6,8
"1527","2020-05-01",54,18,54,246,2721,0.741271591326718,0,0,235,1033,7,828,11,1184,6,11
"1528","2020-05-02",57,18,49,254,2721,0.741271591326718,0,0,235,1033,11,839,4,1188,8,4
"1529","2020-05-03",60,18,43,261,2721,0.741271591326718,0,0,235,1033,11,850,7,1195,8,7
"1530","2020-05-04",63,18,43,258,2721,0.741271591326718,0,0,235,1033,11,861,3,1198,11,3
"1531","2020-05-05",64,18,40,271,2721,0.741271591326718,0,0,235,1033,7,868,1,1199,7,1
"1532","2020-05-06",65,18,53,265,2721,0.741271591326718,0,0,235,1033,12,880,3,1202,11,3
"1533","2020-05-07",63,18,55,269,2721,0.741271591326718,0,0,235,1033,13,893,8,1210,11,8
"1534","2020-05-08",67,18,50,269,2721,0.741271591326718,0,0,235,1033,8,901,2,1212,8,2
"1535","2020-05-09",65,18,44,267,2721,0.741271591326718,0,0,235,1033,11,912,2,1214,10,2
"1536","2020-05-10",63,18,42,286,2721,0.741271591326718,0,0,235,1033,17,929,3,1217,14,3
"1537","2020-05-11",67,18,33,289,2721,0.741271591326718,0,0,235,1033,14,943,5,1222,11,5
"1538","2020-05-12",71,18,33,291,2721,0.741271591326718,0,0,235,1033,14,957,6,1228,11,6
"1539","2020-05-13",76,18,30,290,2721,0.741271591326718,0,0,235,1033,16,973,7,1235,14,7
"1540","2020-05-14",79,18,30,297,2721,0.741271591326718,0,0,235,1033,12,985,6,1241,11,6
"1541","2020-05-15",78,18,32,304,2721,0.741271591326718,0,0,235,1033,22,1007,NA,NA,20,NA
"1542","2020-05-16",90,18,33,293,2721,0.741271591326718,0,0,235,1033,19,1026,3,1244,17,3
"1543","2020-05-17",95,18,26,291,2721,0.741271591326718,0,0,235,1033,14,1040,2,1246,14,2
"1544","2020-05-18",100,18,25,286,2721,0.741271591326718,0,0,235,1033,22,1062,1,1247,22,1
"1545","2020-05-19",97,18,25,295,2721,0.741271591326718,0,0,235,1033,21,1083,1,1248,20,1
"1546","2020-05-20",97,18,24,290,2721,0.741271591326718,0,0,235,1033,28,1111,2,1250,26,2
"1547","2020-05-21",97,18,22,295,2721,0.741271591326718,0,0,235,1033,19,1130,1,1251,19,1
"1548","2020-05-22",97,18,19,286,2721,0.741271591326718,0,0,235,1033,21,1151,3,1254,21,3
"1549","2020-05-23",91,18,20,297,2721,0.741271591326718,0,0,235,1033,21,1172,1,1255,19,1
"1550","2020-05-24",85,18,17,293,2721,0.741271591326718,0,0,235,1033,34,1206,2,1257,33,2
"1551","2020-05-25",76,18,14,289,2721,0.741271591326718,0,0,235,1033,30,1236,NA,NA,30,NA
"1552","2020-05-26",76,18,12,289,2721,0.741271591326718,0,0,235,1033,35,1271,3,1260,34,3
"1553","2020-05-27",72,18,10,292,2721,0.741271591326718,0,0,235,1033,36,1307,3,1263,35,3
"1554","2020-05-28",69,18,10,295,2721,0.741271591326718,0,0,235,1033,39,1346,3,1266,36,3
"1555","2020-05-29",70,18,10,297,2721,0.741271591326718,0,0,235,1033,34,1380,2,1268,32,2
"1556","2020-05-30",66,18,12,301,2721,0.741271591326718,0,0,235,1033,23,1403,5,1273,21,5
"1557","2020-05-31",69,18,10,293,2721,0.741271591326718,0,0,235,1033,33,1436,5,1278,33,5
"1558","2020-06-01",67,18,11,292,2721,0.741271591326718,0,0,235,1033,34,1470,4,1282,29,4
"1559","2020-06-02",68,18,9,310,2721,0.741271591326718,0,0,235,1033,35,1505,5,1287,33,5
"1560","2020-06-03",79,18,7,303,2721,0.741271591326718,0,0,235,1033,40,1545,4,1291,39,4
"1561","2020-06-04",86,18,9,310,2721,0.741271591326718,0,0,235,1033,40,1585,5,1296,39,5
"1562","2020-06-05",80,18,9,312,2721,0.741271591326718,0,0,235,1033,33,1618,3,1299,29,3
"1563","2020-06-06",81,18,13,319,2721,0.741271591326718,0,0,235,1033,22,1640,6,1305,21,6
"1564","2020-06-07",80,18,10,313,2721,0.741271591326718,0,0,235,1033,25,1665,6,1311,22,6
"1565","2020-03-13",1,19,136,105,2035,0.367567567567568,0,0,173,348,56,130,19,153,6,19
"1566","2020-03-14",2,19,190,158,2035,0.367567567567568,0,0,173,348,44,174,15,168,6,15
"1567","2020-03-15",7,19,205,196,2035,0.367567567567568,0,0,173,348,42,216,4,172,10,4
"1568","2020-03-16",9,19,214,244,2035,0.367567567567568,0,0,173,348,53,269,6,178,24,6
"1569","2020-03-17",18,19,211,283,2035,0.367567567567568,0,0,173,348,45,314,7,185,12,7
"1570","2020-03-18",33,19,247,322,2035,0.367567567567568,0,0,173,348,45,359,5,190,22,5
"1571","2020-03-19",51,19,221,364,2035,0.367567567567568,0,0,173,348,45,404,6,196,22,6
"1572","2020-03-20",67,19,191,381,2035,0.367567567567568,0,0,173,348,35,439,20,216,15,20
"1573","2020-03-21",84,19,197,400,2035,0.367567567567568,0,0,173,348,50,489,74,290,28,74
"1574","2020-03-22",96,19,201,412,2035,0.367567567567568,0,0,173,348,57,546,35,325,25,35
"1575","2020-03-23",122,19,195,434,2035,0.367567567567568,0,0,173,348,46,592,33,358,15,33
"1576","2020-03-24",130,19,196,450,2035,0.367567567567568,0,0,173,348,60,652,30,388,29,30
"1577","2020-03-25",136,19,170,443,2035,0.367567567567568,0,0,173,348,58,710,22,410,25,22
"1578","2020-03-26",138,19,152,452,2035,0.367567567567568,0,0,173,348,40,750,41,451,20,41
"1579","2020-03-27",150,19,129,437,2035,0.367567567567568,0,0,173,348,41,791,37,488,17,37
"1580","2020-03-28",149,19,152,424,2035,0.367567567567568,0,0,173,348,50,841,47,535,25,47
"1581","2020-03-29",144,19,156,423,2035,0.367567567567568,0,0,173,348,43,884,28,563,15,28
"1582","2020-03-30",127,19,167,401,2035,0.367567567567568,0,0,173,348,44,928,20,583,16,20
"1583","2020-03-31",120,19,190,391,2035,0.367567567567568,0,0,173,348,45,973,10,593,24,10
"1584","2020-04-01",117,19,198,366,2035,0.367567567567568,0,0,173,348,59,1032,15,608,36,15
"1585","2020-04-02",111,19,201,351,2035,0.367567567567568,0,0,173,348,47,1079,64,672,26,64
"1586","2020-04-03",94,19,220,351,2035,0.367567567567568,0,0,173,348,35,1114,59,731,16,59
"1587","2020-04-04",87,19,195,343,2035,0.367567567567568,0,0,173,348,28,1142,32,763,13,32
"1588","2020-04-05",94,19,199,336,2035,0.367567567567568,0,0,173,348,33,1175,17,780,18,17
"1589","2020-04-06",101,19,196,329,2035,0.367567567567568,0,0,173,348,43,1218,23,803,27,23
"1590","2020-04-07",100,19,177,309,2035,0.367567567567568,0,0,173,348,31,1249,27,830,19,27
"1591","2020-04-08",90,19,157,305,2035,0.367567567567568,0,0,173,348,33,1282,17,847,18,17
"1592","2020-04-09",90,19,142,285,2035,0.367567567567568,0,0,173,348,38,1320,17,864,24,17
"1593","2020-04-10",89,19,141,280,2035,0.367567567567568,0,0,173,348,38,1358,13,877,23,13
"1594","2020-04-11",89,19,154,268,2035,0.367567567567568,0,0,173,348,40,1398,10,887,24,10
"1595","2020-04-12",77,19,152,254,2035,0.367567567567568,0,0,173,348,40,1438,11,898,26,11
"1596","2020-04-13",75,19,127,234,2035,0.367567567567568,0,0,173,348,24,1462,35,933,11,35
"1597","2020-04-14",77,19,119,223,2035,0.367567567567568,0,0,173,348,25,1487,16,949,12,16
"1598","2020-04-15",83,19,111,232,2035,0.367567567567568,0,0,173,348,22,1509,16,965,15,16
"1599","2020-04-16",77,19,99,229,2035,0.367567567567568,0,0,173,348,27,1536,36,1001,20,36
"1600","2020-04-17",74,19,98,228,2035,0.367567567567568,0,0,173,348,25,1561,25,1026,15,25
"1601","2020-04-18",75,19,117,215,2035,0.367567567567568,0,0,173,348,23,1584,40,1066,11,40
"1602","2020-04-19",73,19,96,216,2035,0.367567567567568,0,0,173,348,24,1608,43,1109,17,43
"1603","2020-04-20",70,19,92,212,2035,0.367567567567568,0,0,173,348,24,1632,10,1119,12,10
"1604","2020-04-21",69,19,68,215,2035,0.367567567567568,0,0,173,348,27,1659,20,1139,11,20
"1605","2020-04-22",61,19,60,212,2035,0.367567567567568,0,0,173,348,25,1684,5,1144,13,5
"1606","2020-04-23",65,19,56,213,2035,0.367567567567568,0,0,173,348,29,1713,6,1150,20,6
"1607","2020-04-24",59,19,50,214,2035,0.367567567567568,0,0,173,348,26,1739,14,1164,18,14
"1608","2020-04-25",53,19,57,217,2035,0.367567567567568,0,0,173,348,35,1774,4,1168,20,4
"1609","2020-04-26",59,19,49,223,2035,0.367567567567568,0,0,173,348,36,1810,10,1178,29,10
"1610","2020-04-27",57,19,47,211,2035,0.367567567567568,0,0,173,348,15,1825,11,1189,12,11
"1611","2020-04-28",53,19,39,206,2035,0.367567567567568,0,0,173,348,23,1848,8,1197,17,8
"1612","2020-04-29",57,19,41,212,2035,0.367567567567568,0,0,173,348,22,1870,10,1207,13,10
"1613","2020-04-30",52,19,46,203,2035,0.367567567567568,0,0,173,348,31,1901,17,1224,20,17
"1614","2020-05-01",56,19,51,199,2035,0.367567567567568,0,0,173,348,30,1931,10,1234,17,10
"1615","2020-05-02",58,19,53,202,2035,0.367567567567568,0,0,173,348,22,1953,16,1250,13,16
"1616","2020-05-03",59,19,49,197,2035,0.367567567567568,0,0,173,348,23,1976,15,1265,19,15
"1617","2020-05-04",57,19,52,189,2035,0.367567567567568,0,0,173,348,25,2001,10,1275,19,10
"1618","2020-05-05",60,19,51,185,2035,0.367567567567568,0,0,173,348,24,2025,7,1282,13,7
"1619","2020-05-06",57,19,58,183,2035,0.367567567567568,0,0,173,348,21,2046,10,1292,17,10
"1620","2020-05-07",53,19,53,176,2035,0.367567567567568,0,0,173,348,23,2069,10,1302,17,10
"1621","2020-05-08",56,19,40,179,2035,0.367567567567568,0,0,173,348,30,2099,8,1310,22,8
"1622","2020-05-09",58,19,40,175,2035,0.367567567567568,0,0,173,348,18,2117,12,1322,15,12
"1623","2020-05-10",55,19,29,169,2035,0.367567567567568,0,0,173,348,26,2143,7,1329,21,7
"1624","2020-05-11",51,19,24,172,2035,0.367567567567568,0,0,173,348,14,2157,2,1331,7,2
"1625","2020-05-12",45,19,26,166,2035,0.367567567567568,0,0,173,348,21,2178,5,1336,13,5
"1626","2020-05-13",46,19,27,167,2035,0.367567567567568,0,0,173,348,23,2201,3,1339,19,3
"1627","2020-05-14",48,19,29,166,2035,0.367567567567568,0,0,173,348,23,2224,2,1341,19,2
"1628","2020-05-15",47,19,24,164,2035,0.367567567567568,0,0,173,348,16,2240,3,1344,11,3
"1629","2020-05-16",48,19,26,158,2035,0.367567567567568,0,0,173,348,26,2266,1,1345,18,1
"1630","2020-05-17",43,19,28,150,2035,0.367567567567568,0,0,173,348,19,2285,2,1347,15,2
"1631","2020-05-18",49,19,30,140,2035,0.367567567567568,0,0,173,348,24,2309,4,1351,15,4
"1632","2020-05-19",49,19,31,142,2035,0.367567567567568,0,0,173,348,26,2335,5,1356,19,5
"1633","2020-05-20",50,19,31,141,2035,0.367567567567568,0,0,173,348,30,2365,6,1362,23,6
"1634","2020-05-21",53,19,30,143,2035,0.367567567567568,0,0,173,348,13,2378,6,1368,12,6
"1635","2020-05-22",49,19,25,147,2035,0.367567567567568,0,0,173,348,27,2405,2,1370,19,2
"1636","2020-05-23",45,19,24,152,2035,0.367567567567568,0,0,173,348,18,2423,NA,NA,14,NA
"1637","2020-05-24",50,19,26,158,2035,0.367567567567568,0,0,173,348,25,2448,3,1373,19,3
"1638","2020-05-25",44,19,26,165,2035,0.367567567567568,0,0,173,348,17,2465,2,1375,14,2
"1639","2020-05-26",45,19,25,165,2035,0.367567567567568,0,0,173,348,25,2490,NA,NA,23,NA
"1640","2020-05-27",42,19,22,167,2035,0.367567567567568,0,0,173,348,19,2509,1,1376,13,1
"1641","2020-05-28",40,19,24,172,2035,0.367567567567568,0,0,173,348,14,2523,1,1377,10,1
"1642","2020-05-29",41,19,19,162,2035,0.367567567567568,0,0,173,348,22,2545,2,1379,17,2
"1643","2020-05-30",46,19,16,160,2035,0.367567567567568,0,0,173,348,16,2561,1,1380,11,1
"1644","2020-05-31",42,19,14,158,2035,0.367567567567568,0,0,173,348,22,2583,2,1382,16,2
"1645","2020-06-01",39,19,14,162,2035,0.367567567567568,0,0,173,348,24,2607,4,1386,13,4
"1646","2020-06-02",40,19,14,162,2035,0.367567567567568,0,0,173,348,12,2619,NA,NA,12,NA
"1647","2020-06-03",38,19,15,161,2035,0.367567567567568,0,0,173,348,14,2633,NA,NA,6,NA
"1648","2020-06-04",36,19,14,151,2035,0.367567567567568,0,0,173,348,24,2657,1,1387,11,1
"1649","2020-06-05",36,19,14,157,2035,0.367567567567568,0,0,173,348,27,2684,2,1389,20,2
"1650","2020-06-06",30,19,16,153,2035,0.367567567567568,0,0,173,348,28,2712,2,1391,21,2
"1651","2020-06-07",33,19,20,155,2035,0.367567567567568,0,0,173,348,22,2734,5,1396,16,5
"1652","2020-03-13",1,20,187,69,4035,0.933333333333333,0,0,334,611,19,44,51,109,1,51
"1653","2020-03-14",4,20,274,90,4035,0.933333333333333,0,0,334,611,21,65,56,165,2,56
"1654","2020-03-15",7,20,321,131,4035,0.933333333333333,0,0,334,611,20,85,41,206,3,41
"1655","2020-03-16",16,20,310,170,4035,0.933333333333333,0,0,334,611,21,106,37,243,5,37
"1656","2020-03-17",21,20,311,209,4035,0.933333333333333,0,0,334,611,22,128,75,318,9,75
"1657","2020-03-18",29,20,283,250,4035,0.933333333333333,0,0,334,611,19,147,76,394,7,76
"1658","2020-03-19",39,20,249,283,4035,0.933333333333333,0,0,334,611,16,163,64,458,6,64
"1659","2020-03-20",55,20,233,330,4035,0.933333333333333,0,0,334,611,23,186,79,537,12,79
"1660","2020-03-21",70,20,205,372,4035,0.933333333333333,0,0,334,611,14,200,67,604,3,67
"1661","2020-03-22",81,20,170,418,4035,0.933333333333333,0,0,334,611,15,215,57,661,3,57
"1662","2020-03-23",87,20,148,458,4035,0.933333333333333,0,0,334,611,24,239,40,701,8,40
"1663","2020-03-24",100,20,150,494,4035,0.933333333333333,0,0,334,611,16,255,42,743,7,42
"1664","2020-03-25",111,20,165,540,4035,0.933333333333333,0,0,334,611,19,274,52,795,9,52
"1665","2020-03-26",119,20,184,572,4035,0.933333333333333,0,0,334,611,12,286,47,842,5,47
"1666","2020-03-27",132,20,211,611,4035,0.933333333333333,0,0,334,611,12,298,38,880,7,38
"1667","2020-03-28",138,20,216,645,4035,0.933333333333333,0,0,334,611,24,322,35,915,10,35
"1668","2020-03-29",150,20,219,673,4035,0.933333333333333,0,0,334,611,12,334,50,965,5,50
"1669","2020-03-30",159,20,190,689,4035,0.933333333333333,0,0,334,611,15,349,45,1010,8,45
"1670","2020-03-31",169,20,176,715,4035,0.933333333333333,0,0,334,611,15,364,39,1049,3,39
"1671","2020-04-01",178,20,180,747,4035,0.933333333333333,0,0,334,611,13,377,27,1076,8,27
"1672","2020-04-02",190,20,234,765,4035,0.933333333333333,0,0,334,611,21,398,34,1110,10,34
"1673","2020-04-03",190,20,217,774,4035,0.933333333333333,0,0,334,611,12,410,40,1150,4,40
"1674","2020-04-04",197,20,205,778,4035,0.933333333333333,0,0,334,611,16,426,33,1183,4,33
"1675","2020-04-05",204,20,229,785,4035,0.933333333333333,0,0,334,611,18,444,45,1228,9,45
"1676","2020-04-06",216,20,236,797,4035,0.933333333333333,0,0,334,611,19,463,49,1277,10,49
"1677","2020-04-07",220,20,230,814,4035,0.933333333333333,0,0,334,611,13,476,33,1310,9,33
"1678","2020-04-08",225,20,208,802,4035,0.933333333333333,0,0,334,611,9,485,33,1343,5,33
"1679","2020-04-09",230,20,233,809,4035,0.933333333333333,0,0,334,611,14,499,30,1373,11,30
"1680","2020-04-10",225,20,223,810,4035,0.933333333333333,0,0,334,611,17,516,37,1410,10,37
"1681","2020-04-11",222,20,186,798,4035,0.933333333333333,0,0,334,611,19,535,31,1441,11,31
"1682","2020-04-12",217,20,175,808,4035,0.933333333333333,0,0,334,611,13,548,50,1491,5,50
"1683","2020-04-13",210,20,146,820,4035,0.933333333333333,0,0,334,611,7,555,30,1521,5,30
"1684","2020-04-14",208,20,116,807,4035,0.933333333333333,0,0,334,611,8,563,26,1547,5,26
"1685","2020-04-15",202,20,111,805,4035,0.933333333333333,0,0,334,611,14,577,34,1581,4,34
"1686","2020-04-16",207,20,120,795,4035,0.933333333333333,0,0,334,611,11,588,34,1615,8,34
"1687","2020-04-17",216,20,127,815,4035,0.933333333333333,0,0,334,611,14,602,24,1639,5,24
"1688","2020-04-18",224,20,137,815,4035,0.933333333333333,0,0,334,611,13,615,31,1670,9,31
"1689","2020-04-19",233,20,138,814,4035,0.933333333333333,0,0,334,611,10,625,33,1703,9,33
"1690","2020-04-20",236,20,133,798,4035,0.933333333333333,0,0,334,611,7,632,40,1743,6,40
"1691","2020-04-21",231,20,129,795,4035,0.933333333333333,0,0,334,611,8,640,20,1763,4,20
"1692","2020-04-22",237,20,140,786,4035,0.933333333333333,0,0,334,611,13,653,33,1796,7,33
"1693","2020-04-23",224,20,122,770,4035,0.933333333333333,0,0,334,611,14,667,20,1816,8,20
"1694","2020-04-24",221,20,120,756,4035,0.933333333333333,0,0,334,611,8,675,17,1833,7,17
"1695","2020-04-25",209,20,118,738,4035,0.933333333333333,0,0,334,611,10,685,26,1859,10,26
"1696","2020-04-26",199,20,105,708,4035,0.933333333333333,0,0,334,611,8,693,17,1876,5,17
"1697","2020-04-27",213,20,99,699,4035,0.933333333333333,0,0,334,611,6,699,22,1898,2,22
"1698","2020-04-28",229,20,98,687,4035,0.933333333333333,0,0,334,611,9,708,27,1925,5,27
"1699","2020-04-29",227,20,91,684,4035,0.933333333333333,0,0,334,611,12,720,21,1946,9,21
"1700","2020-04-30",232,20,96,655,4035,0.933333333333333,0,0,334,611,11,731,16,1962,7,16
"1701","2020-05-01",223,20,92,637,4035,0.933333333333333,0,0,334,611,12,743,13,1975,10,13
"1702","2020-05-02",216,20,85,617,4035,0.933333333333333,0,0,334,611,16,759,7,1982,8,7
"1703","2020-05-03",207,20,73,595,4035,0.933333333333333,0,0,334,611,17,776,9,1991,13,9
"1704","2020-05-04",186,20,70,574,4035,0.933333333333333,0,0,334,611,8,784,13,2004,5,13
"1705","2020-05-05",172,20,65,547,4035,0.933333333333333,0,0,334,611,11,795,13,2017,9,13
"1706","2020-05-06",161,20,52,505,4035,0.933333333333333,0,0,334,611,13,808,13,2030,8,13
"1707","2020-05-07",157,20,55,490,4035,0.933333333333333,0,0,334,611,10,818,12,2042,6,12
"1708","2020-05-08",152,20,52,468,4035,0.933333333333333,0,0,334,611,22,840,8,2050,22,8
"1709","2020-05-09",152,20,48,449,4035,0.933333333333333,0,0,334,611,14,854,16,2066,10,16
"1710","2020-05-10",160,20,47,437,4035,0.933333333333333,0,0,334,611,13,867,4,2070,12,4
"1711","2020-05-11",153,20,47,414,4035,0.933333333333333,0,0,334,611,12,879,9,2079,10,9
"1712","2020-05-12",147,20,47,397,4035,0.933333333333333,0,0,334,611,15,894,6,2085,11,6
"1713","2020-05-13",144,20,42,376,4035,0.933333333333333,0,0,334,611,17,911,9,2094,14,9
"1714","2020-05-14",135,20,25,357,4035,0.933333333333333,0,0,334,611,13,924,11,2105,10,11
"1715","2020-05-15",130,20,25,330,4035,0.933333333333333,0,0,334,611,17,941,14,2119,12,14
"1716","2020-05-16",125,20,27,317,4035,0.933333333333333,0,0,334,611,21,962,8,2127,18,8
"1717","2020-05-17",110,20,25,309,4035,0.933333333333333,0,0,334,611,17,979,12,2139,12,12
"1718","2020-05-18",105,20,25,294,4035,0.933333333333333,0,0,334,611,16,995,9,2148,15,9
"1719","2020-05-19",94,20,24,280,4035,0.933333333333333,0,0,334,611,19,1014,10,2158,15,10
"1720","2020-05-20",95,20,21,269,4035,0.933333333333333,0,0,334,611,24,1038,7,2165,22,7
"1721","2020-05-21",88,20,19,261,4035,0.933333333333333,0,0,334,611,23,1061,6,2171,16,6
"1722","2020-05-22",84,20,17,247,4035,0.933333333333333,0,0,334,611,31,1092,8,2179,28,8
"1723","2020-05-23",83,20,16,237,4035,0.933333333333333,0,0,334,611,33,1125,3,2182,32,3
"1724","2020-05-24",82,20,19,223,4035,0.933333333333333,0,0,334,611,23,1148,4,2186,20,4
"1725","2020-05-25",79,20,18,213,4035,0.933333333333333,0,0,334,611,20,1168,3,2189,19,3
"1726","2020-05-26",80,20,14,197,4035,0.933333333333333,0,0,334,611,41,1209,5,2194,40,5
"1727","2020-05-27",71,20,9,187,4035,0.933333333333333,0,0,334,611,35,1244,5,2199,31,5
"1728","2020-05-28",66,20,7,181,4035,0.933333333333333,0,0,334,611,45,1289,7,2206,40,7
"1729","2020-05-29",67,20,7,175,4035,0.933333333333333,0,0,334,611,35,1324,8,2214,30,8
"1730","2020-05-30",62,20,6,166,4035,0.933333333333333,0,0,334,611,29,1353,11,2225,29,11
"1731","2020-05-31",57,20,6,163,4035,0.933333333333333,0,0,334,611,48,1401,8,2233,43,8
"1732","2020-06-01",54,20,5,150,4035,0.933333333333333,0,0,334,611,21,1422,11,2244,17,11
"1733","2020-06-02",51,20,4,143,4035,0.933333333333333,0,0,334,611,37,1459,1,2245,36,1
"1734","2020-06-03",48,20,5,135,4035,0.933333333333333,0,0,334,611,38,1497,2,2247,35,2
"1735","2020-06-04",48,20,5,123,4035,0.933333333333333,0,0,334,611,37,1534,6,2253,35,6
"1736","2020-06-05",45,20,4,120,4035,0.933333333333333,0,0,334,611,32,1566,8,2261,30,8
"1737","2020-06-06",43,20,4,120,4035,0.933333333333333,0,0,334,611,31,1597,3,2264,27,3
"1738","2020-06-07",43,20,4,121,4035,0.933333333333333,0,0,334,611,34,1631,8,2272,31,8
