"","Date","Absents","Paramset","Infections_or_Exposed_per_day_Patient","Infections_or_Exposed_per_day_HCW","total_infections","nosocomial_proportion","PCR_pooled","LFD_pooled","HCW_symp_test","patient_symp_test","new_hcw_infs","cumulative_hcw_infs","new_pat_infs","cumulative_pats_infs","new_nosocomial_hcw_infs","new_nosocomial_pat_infs"
"1","2020-03-12",1,1,87,180,9174,0.569326357096141,0,0,785,885,101,180,28,64,10,28
"2","2020-03-13",4,1,102,280,9174,0.569326357096141,0,0,785,885,100,280,22,86,20,22
"3","2020-03-14",14,1,136,382,9174,0.569326357096141,0,0,785,885,102,382,41,127,30,41
"4","2020-03-15",26,1,147,513,9174,0.569326357096141,0,0,785,885,131,513,22,149,48,22
"5","2020-03-16",46,1,132,688,9174,0.569326357096141,0,0,785,885,176,689,17,166,86,17
"6","2020-03-17",69,1,128,874,9174,0.569326357096141,0,0,785,885,190,879,23,189,94,23
"7","2020-03-18",99,1,123,1078,9174,0.569326357096141,0,0,785,885,210,1089,13,202,126,13
"8","2020-03-19",135,1,157,1277,9174,0.569326357096141,0,0,785,885,224,1313,41,243,139,41
"9","2020-03-20",180,1,162,1505,9174,0.569326357096141,0,0,785,885,266,1579,27,270,190,27
"10","2020-03-21",226,1,150,1718,9174,0.569326357096141,0,0,785,885,256,1835,22,292,170,22
"11","2020-03-22",289,1,144,1970,9174,0.569326357096141,0,0,785,885,300,2135,26,318,235,26
"12","2020-03-23",346,1,179,2141,9174,0.569326357096141,0,0,785,885,236,2371,49,367,180,49
"13","2020-03-24",407,1,193,2361,9174,0.569326357096141,0,0,785,885,311,2682,41,408,247,41
"14","2020-03-25",466,1,219,2555,9174,0.569326357096141,0,0,785,885,302,2984,50,458,233,50
"15","2020-03-26",525,1,211,2793,9174,0.569326357096141,0,0,785,885,383,3367,32,490,323,32
"16","2020-03-27",584,1,207,2964,9174,0.569326357096141,0,0,785,885,331,3698,33,523,279,33
"17","2020-03-28",636,1,217,3136,9174,0.569326357096141,0,0,785,885,344,4042,44,567,289,44
"18","2020-03-29",671,1,229,3206,9174,0.569326357096141,0,0,785,885,274,4316,35,602,225,35
"19","2020-03-30",731,1,202,3278,9174,0.569326357096141,0,0,785,885,298,4614,21,623,243,21
"20","2020-03-31",771,1,189,3317,9174,0.569326357096141,0,0,785,885,253,4867,17,640,212,17
"21","2020-04-01",831,1,211,3310,9174,0.569326357096141,0,0,785,885,221,5088,40,680,184,40
"22","2020-04-02",864,1,220,3251,9174,0.569326357096141,0,0,785,885,203,5291,44,724,161,44
"23","2020-04-03",895,1,223,3149,9174,0.569326357096141,0,0,785,885,205,5496,32,756,168,32
"24","2020-04-04",914,1,231,3026,9174,0.569326357096141,0,0,785,885,165,5661,39,795,128,39
"25","2020-04-05",910,1,243,2957,9174,0.569326357096141,0,0,785,885,201,5862,56,851,166,56
"26","2020-04-06",883,1,242,2824,9174,0.569326357096141,0,0,785,885,158,6020,39,890,120,39
"27","2020-04-07",866,1,239,2674,9174,0.569326357096141,0,0,785,885,129,6149,27,917,93,27
"28","2020-04-08",805,1,248,2501,9174,0.569326357096141,0,0,785,885,109,6258,39,956,78,39
"29","2020-04-09",783,1,257,2319,9174,0.569326357096141,0,0,785,885,110,6368,50,1006,84,50
"30","2020-04-10",738,1,250,2152,9174,0.569326357096141,0,0,785,885,79,6447,33,1039,61,33
"31","2020-04-11",692,1,272,1979,9174,0.569326357096141,0,0,785,885,63,6510,61,1100,39,61
"32","2020-04-12",645,1,296,1813,9174,0.569326357096141,0,0,785,885,80,6590,63,1163,62,63
"33","2020-04-13",612,1,278,1644,9174,0.569326357096141,0,0,785,885,59,6649,33,1196,43,33
"34","2020-04-14",573,1,257,1525,9174,0.569326357096141,0,0,785,885,64,6713,25,1221,44,25
"35","2020-04-15",546,1,238,1414,9174,0.569326357096141,0,0,785,885,50,6763,34,1255,26,34
"36","2020-04-16",481,1,248,1310,9174,0.569326357096141,0,0,785,885,63,6826,36,1291,39,36
"37","2020-04-17",442,1,244,1194,9174,0.569326357096141,0,0,785,885,38,6864,35,1326,18,35
"38","2020-04-18",398,1,252,1068,9174,0.569326357096141,0,0,785,885,39,6903,36,1362,19,36
"39","2020-04-19",374,1,240,963,9174,0.569326357096141,0,0,785,885,33,6936,22,1384,13,22
"40","2020-04-20",332,1,214,872,9174,0.569326357096141,0,0,785,885,32,6968,21,1405,13,21
"41","2020-04-21",289,1,222,785,9174,0.569326357096141,0,0,785,885,27,6995,27,1432,16,27
"42","2020-04-22",249,1,211,701,9174,0.569326357096141,0,0,785,885,36,7031,25,1457,16,25
"43","2020-04-23",226,1,213,632,9174,0.569326357096141,0,0,785,885,31,7062,32,1489,17,32
"44","2020-04-24",197,1,227,587,9174,0.569326357096141,0,0,785,885,28,7090,36,1525,11,36
"45","2020-04-25",172,1,254,547,9174,0.569326357096141,0,0,785,885,29,7119,50,1575,9,50
"46","2020-04-26",157,1,271,519,9174,0.569326357096141,0,0,785,885,31,7150,43,1618,16,43
"47","2020-04-27",138,1,240,496,9174,0.569326357096141,0,0,785,885,23,7173,20,1638,10,20
"48","2020-04-28",129,1,223,451,9174,0.569326357096141,0,0,785,885,19,7192,25,1663,4,25
"49","2020-04-29",124,1,239,425,9174,0.569326357096141,0,0,785,885,18,7210,32,1695,4,32
"50","2020-04-30",119,1,241,395,9174,0.569326357096141,0,0,785,885,23,7233,38,1733,9,38
"51","2020-05-01",104,1,248,371,9174,0.569326357096141,0,0,785,885,19,7252,35,1768,6,35
"52","2020-05-02",111,1,233,360,9174,0.569326357096141,0,0,785,885,23,7275,17,1785,10,17
"53","2020-05-03",99,1,220,343,9174,0.569326357096141,0,0,785,885,19,7294,22,1807,10,22
"54","2020-05-04",91,1,252,326,9174,0.569326357096141,0,0,785,885,22,7316,47,1854,4,47
"55","2020-05-05",83,1,272,301,9174,0.569326357096141,0,0,785,885,14,7330,51,1905,3,51
"56","2020-05-06",74,1,260,282,9174,0.569326357096141,0,0,785,885,8,7338,32,1937,3,32
"57","2020-05-07",71,1,276,274,9174,0.569326357096141,0,0,785,885,21,7359,45,1982,7,45
"58","2020-05-08",70,1,305,258,9174,0.569326357096141,0,0,785,885,20,7379,50,2032,6,50
"59","2020-05-09",64,1,301,244,9174,0.569326357096141,0,0,785,885,12,7391,50,2082,2,50
"60","2020-05-10",68,1,299,234,9174,0.569326357096141,0,0,785,885,15,7406,45,2127,6,45
"61","2020-05-11",68,1,275,225,9174,0.569326357096141,0,0,785,885,13,7419,26,2153,2,26
"62","2020-05-12",68,1,264,218,9174,0.569326357096141,0,0,785,885,16,7435,20,2173,2,20
"63","2020-05-13",64,1,256,207,9174,0.569326357096141,0,0,785,885,9,7444,24,2197,1,24
"64","2020-05-14",61,1,249,199,9174,0.569326357096141,0,0,785,885,7,7451,24,2221,1,24
"65","2020-05-15",60,1,275,191,9174,0.569326357096141,0,0,785,885,12,7463,52,2273,4,52
"66","2020-05-16",58,1,304,179,9174,0.569326357096141,0,0,785,885,10,7473,59,2332,3,59
"67","2020-05-17",49,1,334,167,9174,0.569326357096141,0,0,785,885,7,7480,73,2405,2,73
"68","2020-05-18",46,1,353,161,9174,0.569326357096141,0,0,785,885,12,7492,62,2467,2,62
"69","2020-05-19",43,1,344,151,9174,0.569326357096141,0,0,785,885,6,7498,62,2529,1,62
"70","2020-05-20",45,1,328,138,9174,0.569326357096141,0,0,785,885,7,7505,35,2564,1,35
"71","2020-05-21",41,1,285,126,9174,0.569326357096141,0,0,785,885,7,7512,27,2591,2,27
"72","2020-05-22",42,1,257,118,9174,0.569326357096141,0,0,785,885,4,7516,16,2607,2,16
"73","2020-05-23",35,1,229,116,9174,0.569326357096141,0,0,785,885,10,7526,16,2623,2,16
"74","2020-05-24",35,1,213,112,9174,0.569326357096141,0,0,785,885,7,7533,18,2641,1,18
"75","2020-05-25",33,1,255,107,9174,0.569326357096141,0,0,785,885,6,7539,59,2700,1,59
"76","2020-05-26",35,1,265,99,9174,0.569326357096141,0,0,785,885,6,7545,30,2730,1,30
"77","2020-05-27",35,1,262,96,9174,0.569326357096141,0,0,785,885,7,7552,39,2769,1,39
"78","2020-05-28",35,1,262,90,9174,0.569326357096141,0,0,785,885,8,7560,37,2806,2,37
"79","2020-05-29",30,1,253,84,9174,0.569326357096141,0,0,785,885,5,7565,22,2828,1,22
"80","2020-05-30",27,1,239,79,9174,0.569326357096141,0,0,785,885,4,7569,25,2853,1,25
"81","2020-05-31",25,1,229,69,9174,0.569326357096141,0,0,785,885,1,7570,26,2879,NA,26
"82","2020-06-01",23,1,213,64,9174,0.569326357096141,0,0,785,885,1,7571,19,2898,NA,19
"83","2020-06-02",19,1,200,59,9174,0.569326357096141,0,0,785,885,2,7573,17,2915,NA,17
"84","2020-06-03",15,1,191,53,9174,0.569326357096141,0,0,785,885,NA,NA,14,2929,NA,14
"85","2020-06-04",12,1,210,47,9174,0.569326357096141,0,0,785,885,1,7574,42,2971,NA,42
"86","2020-06-05",11,1,220,44,9174,0.569326357096141,0,0,785,885,3,7577,44,3015,NA,44
"87","2020-06-06",11,1,208,36,9174,0.569326357096141,0,0,785,885,1,7578,22,3037,1,22
"88","2020-06-07",11,1,192,34,9174,0.569326357096141,0,0,785,885,2,7580,25,3062,1,25
"89","2020-03-14",2,2,89,192,6249,0.507121139382301,0,0,577,916,78,258,14,57,9,14
"90","2020-03-15",6,2,90,255,6249,0.507121139382301,0,0,577,916,77,335,16,73,15,16
"91","2020-03-16",18,2,93,317,6249,0.507121139382301,0,0,577,916,81,416,13,86,22,13
"92","2020-03-17",32,2,83,405,6249,0.507121139382301,0,0,577,916,96,512,32,118,26,32
"93","2020-03-18",48,2,86,488,6249,0.507121139382301,0,0,577,916,78,590,26,144,24,26
"94","2020-03-19",68,2,75,563,6249,0.507121139382301,0,0,577,916,91,681,19,163,29,19
"95","2020-03-20",90,2,72,650,6249,0.507121139382301,0,0,577,916,108,789,25,188,35,25
"96","2020-03-21",119,2,67,733,6249,0.507121139382301,0,0,577,916,120,909,25,213,36,25
"97","2020-03-22",140,2,89,819,6249,0.507121139382301,0,0,577,916,78,987,35,248,28,35
"98","2020-03-23",163,2,125,907,6249,0.507121139382301,0,0,577,916,113,1100,33,281,36,33
"99","2020-03-24",184,2,141,994,6249,0.507121139382301,0,0,577,916,103,1203,31,312,40,31
"100","2020-03-25",210,2,134,1042,6249,0.507121139382301,0,0,577,916,89,1292,53,365,30,53
"101","2020-03-26",226,2,129,1116,6249,0.507121139382301,0,0,577,916,81,1373,41,406,22,41
"102","2020-03-27",244,2,150,1179,6249,0.507121139382301,0,0,577,916,101,1474,28,434,40,28
"103","2020-03-28",258,2,151,1242,6249,0.507121139382301,0,0,577,916,94,1568,44,478,31,44
"104","2020-03-29",296,2,193,1274,6249,0.507121139382301,0,0,577,916,99,1667,37,515,26,37
"105","2020-03-30",317,2,189,1295,6249,0.507121139382301,0,0,577,916,115,1782,34,549,46,34
"106","2020-03-31",326,2,169,1315,6249,0.507121139382301,0,0,577,916,101,1883,21,570,31,21
"107","2020-04-01",326,2,164,1313,6249,0.507121139382301,0,0,577,916,75,1958,51,621,26,51
"108","2020-04-02",348,2,152,1334,6249,0.507121139382301,0,0,577,916,94,2052,36,657,22,36
"109","2020-04-03",356,2,151,1348,6249,0.507121139382301,0,0,577,916,115,2167,56,713,36,56
"110","2020-04-04",364,2,181,1322,6249,0.507121139382301,0,0,577,916,96,2263,56,769,34,56
"111","2020-04-05",356,2,217,1321,6249,0.507121139382301,0,0,577,916,97,2360,54,823,34,54
"112","2020-04-06",348,2,245,1317,6249,0.507121139382301,0,0,577,916,99,2459,47,870,26,47
"113","2020-04-07",355,2,227,1313,6249,0.507121139382301,0,0,577,916,87,2546,32,902,18,32
"114","2020-04-08",365,2,217,1268,6249,0.507121139382301,0,0,577,916,73,2619,33,935,19,33
"115","2020-04-09",349,2,206,1235,6249,0.507121139382301,0,0,577,916,91,2710,25,960,15,25
"116","2020-04-10",364,2,201,1238,6249,0.507121139382301,0,0,577,916,85,2795,29,989,18,29
"117","2020-04-11",362,2,185,1233,6249,0.507121139382301,0,0,577,916,88,2883,22,1011,14,22
"118","2020-04-12",345,2,158,1203,6249,0.507121139382301,0,0,577,916,91,2974,28,1039,27,28
"119","2020-04-13",347,2,143,1189,6249,0.507121139382301,0,0,577,916,83,3057,56,1095,18,56
"120","2020-04-14",346,2,150,1173,6249,0.507121139382301,0,0,577,916,81,3138,41,1136,21,41
"121","2020-04-15",334,2,174,1158,6249,0.507121139382301,0,0,577,916,70,3208,27,1163,14,27
"122","2020-04-16",348,2,180,1130,6249,0.507121139382301,0,0,577,916,86,3294,27,1190,15,27
"123","2020-04-17",326,2,194,1102,6249,0.507121139382301,0,0,577,916,101,3395,27,1217,19,27
"124","2020-04-18",310,2,205,1086,6249,0.507121139382301,0,0,577,916,71,3466,41,1258,18,41
"125","2020-04-19",311,2,221,1059,6249,0.507121139382301,0,0,577,916,69,3535,50,1308,23,50
"126","2020-04-20",306,2,252,1031,6249,0.507121139382301,0,0,577,916,89,3624,53,1361,18,53
"127","2020-04-21",304,2,231,1004,6249,0.507121139382301,0,0,577,916,82,3706,42,1403,21,42
"128","2020-04-22",310,2,211,980,6249,0.507121139382301,0,0,577,916,75,3781,34,1437,16,34
"129","2020-04-23",296,2,203,954,6249,0.507121139382301,0,0,577,916,78,3859,44,1481,9,44
"130","2020-04-24",289,2,184,952,6249,0.507121139382301,0,0,577,916,83,3942,29,1510,16,29
"131","2020-04-25",293,2,197,904,6249,0.507121139382301,0,0,577,916,73,4015,42,1552,12,42
"132","2020-04-26",285,2,222,873,6249,0.507121139382301,0,0,577,916,79,4094,33,1585,10,33
"133","2020-04-27",279,2,218,831,6249,0.507121139382301,0,0,577,916,73,4167,33,1618,13,33
"134","2020-04-28",268,2,213,778,6249,0.507121139382301,0,0,577,916,82,4249,33,1651,24,33
"135","2020-04-29",249,2,203,758,6249,0.507121139382301,0,0,577,916,70,4319,39,1690,9,39
"136","2020-04-30",241,2,203,726,6249,0.507121139382301,0,0,577,916,60,4379,37,1727,5,37
"137","2020-05-01",234,2,243,704,6249,0.507121139382301,0,0,577,916,59,4438,39,1766,6,39
"138","2020-05-02",219,2,238,680,6249,0.507121139382301,0,0,577,916,47,4485,29,1795,8,29
"139","2020-05-03",211,2,277,660,6249,0.507121139382301,0,0,577,916,61,4546,35,1830,11,35
"140","2020-05-04",196,2,250,640,6249,0.507121139382301,0,0,577,916,62,4608,20,1850,11,20
"141","2020-05-05",189,2,260,610,6249,0.507121139382301,0,0,577,916,66,4674,38,1888,8,38
"142","2020-05-06",178,2,273,593,6249,0.507121139382301,0,0,577,916,56,4730,32,1920,8,32
"143","2020-05-07",168,2,248,578,6249,0.507121139382301,0,0,577,916,50,4780,18,1938,9,18
"144","2020-05-08",163,2,240,553,6249,0.507121139382301,0,0,577,916,61,4841,12,1950,9,12
"145","2020-05-09",162,2,269,550,6249,0.507121139382301,0,0,577,916,64,4905,28,1978,6,28
"146","2020-05-10",165,2,301,525,6249,0.507121139382301,0,0,577,916,60,4965,32,2010,12,32
"147","2020-05-11",156,2,290,509,6249,0.507121139382301,0,0,577,916,43,5008,58,2068,8,58
"148","2020-05-12",146,2,298,517,6249,0.507121139382301,0,0,577,916,39,5047,33,2101,8,33
"149","2020-05-13",156,2,261,505,6249,0.507121139382301,0,0,577,916,41,5088,61,2162,5,61
"150","2020-05-14",154,2,257,493,6249,0.507121139382301,0,0,577,916,35,5123,36,2198,7,36
"151","2020-05-15",149,2,247,486,6249,0.507121139382301,0,0,577,916,38,5161,26,2224,9,26
"152","2020-05-16",138,2,246,463,6249,0.507121139382301,0,0,577,916,35,5196,32,2256,9,32
"153","2020-05-17",132,2,243,458,6249,0.507121139382301,0,0,577,916,56,5252,41,2297,10,41
"154","2020-05-18",133,2,207,431,6249,0.507121139382301,0,0,577,916,40,5292,38,2335,9,38
"155","2020-05-19",122,2,179,415,6249,0.507121139382301,0,0,577,916,27,5319,34,2369,4,34
"156","2020-05-20",114,2,164,391,6249,0.507121139382301,0,0,577,916,20,5339,16,2385,5,16
"157","2020-05-21",101,2,180,391,6249,0.507121139382301,0,0,577,916,30,5369,17,2402,4,17
"158","2020-05-22",100,2,175,359,6249,0.507121139382301,0,0,577,916,28,5397,44,2446,7,44
"159","2020-05-23",108,2,168,355,6249,0.507121139382301,0,0,577,916,33,5430,26,2472,7,26
"160","2020-05-24",99,2,164,333,6249,0.507121139382301,0,0,577,916,22,5452,24,2496,2,24
"161","2020-05-25",106,2,141,325,6249,0.507121139382301,0,0,577,916,25,5477,15,2511,2,15
"162","2020-05-26",108,2,129,309,6249,0.507121139382301,0,0,577,916,25,5502,20,2531,5,20
"163","2020-05-27",107,2,129,292,6249,0.507121139382301,0,0,577,916,21,5523,27,2558,1,27
"164","2020-05-28",111,2,142,287,6249,0.507121139382301,0,0,577,916,24,5547,37,2595,3,37
"165","2020-05-29",108,2,150,264,6249,0.507121139382301,0,0,577,916,18,5565,23,2618,1,23
"166","2020-05-30",101,2,149,257,6249,0.507121139382301,0,0,577,916,21,5586,38,2656,3,38
"167","2020-05-31",96,2,157,246,6249,0.507121139382301,0,0,577,916,20,5606,43,2699,3,43
"168","2020-06-01",83,2,143,237,6249,0.507121139382301,0,0,577,916,20,5626,34,2733,3,34
"169","2020-06-02",81,2,143,221,6249,0.507121139382301,0,0,577,916,18,5644,23,2756,4,23
"170","2020-06-03",74,2,138,217,6249,0.507121139382301,0,0,577,916,15,5659,24,2780,6,24
"171","2020-06-04",71,2,136,213,6249,0.507121139382301,0,0,577,916,17,5676,17,2797,6,17
"172","2020-06-05",66,2,144,198,6249,0.507121139382301,0,0,577,916,24,5700,21,2818,6,21
"173","2020-06-06",59,2,145,187,6249,0.507121139382301,0,0,577,916,14,5714,28,2846,1,28
"174","2020-06-07",61,2,148,182,6249,0.507121139382301,0,0,577,916,14,5728,21,2867,3,21
"175","2020-03-13",3,3,147,254,7501,0.271563791494467,0,0,629,1655,45,103,43,92,20,43
"176","2020-03-14",10,3,197,345,7501,0.271563791494467,0,0,629,1655,49,152,40,132,25,40
"177","2020-03-15",29,3,225,426,7501,0.271563791494467,0,0,629,1655,59,211,33,165,36,33
"178","2020-03-16",39,3,280,514,7501,0.271563791494467,0,0,629,1655,66,277,26,191,50,26
"179","2020-03-17",63,3,272,622,7501,0.271563791494467,0,0,629,1655,84,361,15,206,63,15
"180","2020-03-18",88,3,341,723,7501,0.271563791494467,0,0,629,1655,96,457,18,224,72,18
"181","2020-03-19",117,3,357,826,7501,0.271563791494467,0,0,629,1655,96,553,20,244,71,20
"182","2020-03-20",143,3,345,891,7501,0.271563791494467,0,0,629,1655,125,678,40,284,99,40
"183","2020-03-21",168,3,329,953,7501,0.271563791494467,0,0,629,1655,122,800,32,316,91,32
"184","2020-03-22",191,3,313,1024,7501,0.271563791494467,0,0,629,1655,141,941,58,374,122,58
"185","2020-03-23",221,3,295,1080,7501,0.271563791494467,0,0,629,1655,133,1074,36,410,111,36
"186","2020-03-24",234,3,292,1115,7501,0.271563791494467,0,0,629,1655,158,1232,35,445,133,35
"187","2020-03-25",251,3,264,1144,7501,0.271563791494467,0,0,629,1655,188,1420,39,484,165,39
"188","2020-03-26",258,3,274,1175,7501,0.271563791494467,0,0,629,1655,219,1639,35,519,195,35
"189","2020-03-27",268,3,268,1187,7501,0.271563791494467,0,0,629,1655,160,1799,37,556,136,37
"190","2020-03-28",293,3,294,1209,7501,0.271563791494467,0,0,629,1655,220,2019,33,589,198,33
"191","2020-03-29",293,3,292,1205,7501,0.271563791494467,0,0,629,1655,180,2199,26,615,156,26
"192","2020-03-30",305,3,326,1231,7501,0.271563791494467,0,0,629,1655,192,2391,19,634,177,19
"193","2020-03-31",312,3,341,1261,7501,0.271563791494467,0,0,629,1655,210,2601,20,654,189,20
"194","2020-04-01",312,3,331,1268,7501,0.271563791494467,0,0,629,1655,233,2834,12,666,224,12
"195","2020-04-02",344,3,312,1305,7501,0.271563791494467,0,0,629,1655,213,3047,26,692,194,26
"196","2020-04-03",359,3,317,1325,7501,0.271563791494467,0,0,629,1655,219,3266,51,743,205,51
"197","2020-04-04",358,3,323,1319,7501,0.271563791494467,0,0,629,1655,223,3489,56,799,207,56
"198","2020-04-05",353,3,325,1326,7501,0.271563791494467,0,0,629,1655,187,3676,44,843,175,44
"199","2020-04-06",346,3,318,1341,7501,0.271563791494467,0,0,629,1655,198,3874,25,868,184,25
"200","2020-04-07",358,3,297,1330,7501,0.271563791494467,0,0,629,1655,199,4073,25,893,178,25
"201","2020-04-08",367,3,310,1321,7501,0.271563791494467,0,0,629,1655,197,4270,29,922,179,29
"202","2020-04-09",350,3,336,1291,7501,0.271563791494467,0,0,629,1655,162,4432,27,949,146,27
"203","2020-04-10",340,3,310,1308,7501,0.271563791494467,0,0,629,1655,124,4556,24,973,111,24
"204","2020-04-11",319,3,291,1270,7501,0.271563791494467,0,0,629,1655,183,4739,24,997,163,24
"205","2020-04-12",335,3,288,1254,7501,0.271563791494467,0,0,629,1655,116,4855,27,1024,105,27
"206","2020-04-13",338,3,279,1245,7501,0.271563791494467,0,0,629,1655,122,4977,53,1077,110,53
"207","2020-04-14",326,3,291,1225,7501,0.271563791494467,0,0,629,1655,135,5112,44,1121,118,44
"208","2020-04-15",327,3,297,1205,7501,0.271563791494467,0,0,629,1655,101,5213,35,1156,94,35
"209","2020-04-16",327,3,296,1192,7501,0.271563791494467,0,0,629,1655,91,5304,38,1194,84,38
"210","2020-04-17",325,3,300,1193,7501,0.271563791494467,0,0,629,1655,71,5375,30,1224,58,30
"211","2020-04-18",326,3,282,1180,7501,0.271563791494467,0,0,629,1655,86,5461,46,1270,78,46
"212","2020-04-19",318,3,301,1162,7501,0.271563791494467,0,0,629,1655,67,5528,44,1314,56,44
"213","2020-04-20",311,3,293,1143,7501,0.271563791494467,0,0,629,1655,82,5610,43,1357,68,43
"214","2020-04-21",322,3,281,1108,7501,0.271563791494467,0,0,629,1655,70,5680,34,1391,53,34
"215","2020-04-22",316,3,298,1120,7501,0.271563791494467,0,0,629,1655,66,5746,35,1426,56,35
"216","2020-04-23",314,3,297,1085,7501,0.271563791494467,0,0,629,1655,58,5804,30,1456,46,30
"217","2020-04-24",310,3,316,1068,7501,0.271563791494467,0,0,629,1655,60,5864,29,1485,52,29
"218","2020-04-25",317,3,306,1040,7501,0.271563791494467,0,0,629,1655,42,5906,35,1520,38,35
"219","2020-04-26",314,3,298,1040,7501,0.271563791494467,0,0,629,1655,49,5955,43,1563,37,43
"220","2020-04-27",307,3,304,1037,7501,0.271563791494467,0,0,629,1655,48,6003,38,1601,40,38
"221","2020-04-28",296,3,304,1024,7501,0.271563791494467,0,0,629,1655,29,6032,32,1633,23,32
"222","2020-04-29",286,3,318,1004,7501,0.271563791494467,0,0,629,1655,43,6075,28,1661,29,28
"223","2020-04-30",280,3,310,982,7501,0.271563791494467,0,0,629,1655,38,6113,40,1701,26,40
"224","2020-05-01",291,3,336,953,7501,0.271563791494467,0,0,629,1655,41,6154,30,1731,30,30
"225","2020-05-02",281,3,358,938,7501,0.271563791494467,0,0,629,1655,43,6197,27,1758,35,27
"226","2020-05-03",263,3,330,901,7501,0.271563791494467,0,0,629,1655,22,6219,34,1792,11,34
"227","2020-05-04",262,3,311,872,7501,0.271563791494467,0,0,629,1655,38,6257,20,1812,23,20
"228","2020-05-05",251,3,299,855,7501,0.271563791494467,0,0,629,1655,26,6283,34,1846,16,34
"229","2020-05-06",248,3,324,816,7501,0.271563791494467,0,0,629,1655,36,6319,28,1874,25,28
"230","2020-05-07",249,3,330,787,7501,0.271563791494467,0,0,629,1655,22,6341,33,1907,18,33
"231","2020-05-08",227,3,323,763,7501,0.271563791494467,0,0,629,1655,28,6369,36,1943,20,36
"232","2020-05-09",218,3,312,748,7501,0.271563791494467,0,0,629,1655,24,6393,54,1997,14,54
"233","2020-05-10",220,3,304,730,7501,0.271563791494467,0,0,629,1655,24,6417,49,2046,17,49
"234","2020-05-11",214,3,327,713,7501,0.271563791494467,0,0,629,1655,20,6437,39,2085,14,39
"235","2020-05-12",198,3,366,682,7501,0.271563791494467,0,0,629,1655,25,6462,33,2118,16,33
"236","2020-05-13",185,3,352,654,7501,0.271563791494467,0,0,629,1655,11,6473,29,2147,8,29
"237","2020-05-14",165,3,336,641,7501,0.271563791494467,0,0,629,1655,24,6497,23,2170,14,23
"238","2020-05-15",168,3,333,598,7501,0.271563791494467,0,0,629,1655,14,6511,40,2210,8,40
"239","2020-05-16",159,3,321,583,7501,0.271563791494467,0,0,629,1655,19,6530,22,2232,12,22
"240","2020-05-17",155,3,336,562,7501,0.271563791494467,0,0,629,1655,11,6541,44,2276,6,44
"241","2020-05-18",148,3,319,532,7501,0.271563791494467,0,0,629,1655,14,6555,61,2337,10,61
"242","2020-05-19",148,3,326,518,7501,0.271563791494467,0,0,629,1655,12,6567,52,2389,6,52
"243","2020-05-20",150,3,344,489,7501,0.271563791494467,0,0,629,1655,6,6573,35,2424,3,35
"244","2020-05-21",157,3,352,464,7501,0.271563791494467,0,0,629,1655,16,6589,38,2462,13,38
"245","2020-05-22",147,3,343,444,7501,0.271563791494467,0,0,629,1655,5,6594,28,2490,2,28
"246","2020-05-23",140,3,341,418,7501,0.271563791494467,0,0,629,1655,14,6608,17,2507,9,17
"247","2020-05-24",137,3,344,400,7501,0.271563791494467,0,0,629,1655,4,6612,38,2545,2,38
"248","2020-05-25",127,3,359,388,7501,0.271563791494467,0,0,629,1655,15,6627,19,2564,11,19
"249","2020-05-26",123,3,341,370,7501,0.271563791494467,0,0,629,1655,6,6633,23,2587,2,23
"250","2020-05-27",116,3,357,353,7501,0.271563791494467,0,0,629,1655,11,6644,25,2612,7,25
"251","2020-05-28",92,3,386,343,7501,0.271563791494467,0,0,629,1655,10,6654,49,2661,5,49
"252","2020-05-29",83,3,369,330,7501,0.271563791494467,0,0,629,1655,5,6659,27,2688,4,27
"253","2020-05-30",85,3,352,316,7501,0.271563791494467,0,0,629,1655,7,6666,60,2748,5,60
"254","2020-05-31",86,3,347,296,7501,0.271563791494467,0,0,629,1655,8,6674,41,2789,4,41
"255","2020-06-01",83,3,313,286,7501,0.271563791494467,0,0,629,1655,5,6679,35,2824,5,35
"256","2020-06-02",91,3,309,271,7501,0.271563791494467,0,0,629,1655,8,6687,45,2869,6,45
"257","2020-06-03",89,3,301,250,7501,0.271563791494467,0,0,629,1655,8,6695,46,2915,5,46
"258","2020-06-04",89,3,294,239,7501,0.271563791494467,0,0,629,1655,7,6702,29,2944,6,29
"259","2020-06-05",86,3,293,229,7501,0.271563791494467,0,0,629,1655,7,6709,29,2973,3,29
"260","2020-06-06",82,3,285,217,7501,0.271563791494467,0,0,629,1655,9,6718,31,3004,7,31
"261","2020-06-07",70,3,290,200,7501,0.271563791494467,0,0,629,1655,7,6725,28,3032,4,28
"262","2020-03-15",9,4,83,216,6158,0.583306268268919,0,0,531,1167,258,793,21,301,189,21
"263","2020-03-16",19,4,81,274,6158,0.583306268268919,0,0,531,1167,332,1125,26,327,274,26
"264","2020-03-17",26,4,83,342,6158,0.583306268268919,0,0,531,1167,493,1618,28,355,423,28
"265","2020-03-18",34,4,95,419,6158,0.583306268268919,0,0,531,1167,475,2093,24,379,419,24
"266","2020-03-19",47,4,93,498,6158,0.583306268268919,0,0,531,1167,540,2633,35,414,492,35
"267","2020-03-20",63,4,122,556,6158,0.583306268268919,0,0,531,1167,658,3291,45,459,607,45
"268","2020-03-21",76,4,138,628,6158,0.583306268268919,0,0,531,1167,556,3847,30,489,504,30
"269","2020-03-22",91,4,165,688,6158,0.583306268268919,0,0,531,1167,745,4592,18,507,707,18
"270","2020-03-23",115,4,167,771,6158,0.583306268268919,0,0,531,1167,708,5300,31,538,679,31
"271","2020-03-24",137,4,151,834,6158,0.583306268268919,0,0,531,1167,510,5810,25,563,487,25
"272","2020-03-25",164,4,136,902,6158,0.583306268268919,0,0,531,1167,484,6294,27,590,459,27
"273","2020-03-26",185,4,132,949,6158,0.583306268268919,0,0,531,1167,387,6681,15,605,362,15
"274","2020-03-27",201,4,165,1012,6158,0.583306268268919,0,0,531,1167,281,6962,26,631,261,26
"275","2020-03-28",226,4,187,1043,6158,0.583306268268919,0,0,531,1167,239,7201,57,688,226,57
"276","2020-03-29",248,4,219,1075,6158,0.583306268268919,0,0,531,1167,170,7371,32,720,161,32
"277","2020-03-30",261,4,231,1098,6158,0.583306268268919,0,0,531,1167,138,7509,25,745,135,25
"278","2020-03-31",292,4,219,1130,6158,0.583306268268919,0,0,531,1167,89,7598,10,755,78,10
"279","2020-04-01",299,4,218,1153,6158,0.583306268268919,0,0,531,1167,57,7655,24,779,54,24
"280","2020-04-02",310,4,215,1160,6158,0.583306268268919,0,0,531,1167,49,7704,41,820,44,41
"281","2020-04-03",328,4,201,1185,6158,0.583306268268919,0,0,531,1167,34,7738,41,861,33,41
"282","2020-04-04",335,4,168,1193,6158,0.583306268268919,0,0,531,1167,28,7766,29,890,27,29
"283","2020-04-05",326,4,154,1216,6158,0.583306268268919,0,0,531,1167,15,7781,46,936,11,46
"284","2020-04-06",326,4,176,1246,6158,0.583306268268919,0,0,531,1167,13,7794,20,956,10,20
"285","2020-04-07",311,4,229,1233,6158,0.583306268268919,0,0,531,1167,16,7810,38,994,13,38
"286","2020-04-08",322,4,281,1231,6158,0.583306268268919,0,0,531,1167,16,7826,35,1029,11,35
"287","2020-04-09",319,4,322,1227,6158,0.583306268268919,0,0,531,1167,8,7834,25,1054,6,25
"288","2020-04-10",326,4,306,1221,6158,0.583306268268919,0,0,531,1167,7,7841,24,1078,5,24
"289","2020-04-11",318,4,288,1219,6158,0.583306268268919,0,0,531,1167,7,7848,24,1102,5,24
"290","2020-04-12",326,4,288,1224,6158,0.583306268268919,0,0,531,1167,7,7855,16,1118,3,16
"291","2020-04-13",323,4,259,1223,6158,0.583306268268919,0,0,531,1167,2,7857,15,1133,NA,15
"292","2020-04-14",325,4,251,1244,6158,0.583306268268919,0,0,531,1167,5,7862,10,1143,4,10
"293","2020-04-15",325,4,250,1224,6158,0.583306268268919,0,0,531,1167,3,7865,14,1157,1,14
"294","2020-04-16",342,4,221,1223,6158,0.583306268268919,0,0,531,1167,8,7873,10,1167,3,10
"295","2020-04-17",331,4,199,1185,6158,0.583306268268919,0,0,531,1167,4,7877,18,1185,NA,18
"296","2020-04-18",347,4,181,1145,6158,0.583306268268919,0,0,531,1167,6,7883,26,1211,NA,26
"297","2020-04-19",353,4,205,1109,6158,0.583306268268919,0,0,531,1167,1,7884,52,1263,1,52
"298","2020-04-20",364,4,217,1055,6158,0.583306268268919,0,0,531,1167,2,7886,21,1284,1,21
"299","2020-04-21",360,4,223,1052,6158,0.583306268268919,0,0,531,1167,1,7887,11,1295,1,11
"300","2020-04-22",336,4,239,1024,6158,0.583306268268919,0,0,531,1167,2,7889,16,1311,2,16
"301","2020-04-23",315,4,260,993,6158,0.583306268268919,0,0,531,1167,3,7892,10,1321,2,10
"302","2020-04-24",313,4,244,930,6158,0.583306268268919,0,0,531,1167,4,7896,28,1349,1,28
"303","2020-04-25",298,4,221,887,6158,0.583306268268919,0,0,531,1167,4,7900,18,1367,2,18
"304","2020-04-26",286,4,196,877,6158,0.583306268268919,0,0,531,1167,3,7903,28,1395,NA,28
"305","2020-04-27",260,4,190,851,6158,0.583306268268919,0,0,531,1167,3,7906,20,1415,NA,20
"306","2020-04-28",258,4,173,827,6158,0.583306268268919,0,0,531,1167,1,7907,29,1444,1,29
"307","2020-04-29",266,4,188,816,6158,0.583306268268919,0,0,531,1167,NA,NA,17,1461,NA,17
"308","2020-04-30",254,4,174,791,6158,0.583306268268919,0,0,531,1167,4,7911,14,1475,1,14
"309","2020-05-01",225,4,186,776,6158,0.583306268268919,0,0,531,1167,3,7914,17,1492,NA,17
"310","2020-05-02",214,4,222,758,6158,0.583306268268919,0,0,531,1167,2,7916,17,1509,NA,17
"311","2020-05-03",210,4,270,745,6158,0.583306268268919,0,0,531,1167,2,7918,4,1513,1,4
"312","2020-05-04",204,4,262,715,6158,0.583306268268919,0,0,531,1167,2,7920,10,1523,2,10
"313","2020-05-05",187,4,242,700,6158,0.583306268268919,0,0,531,1167,4,7924,9,1532,2,9
"314","2020-05-06",176,4,284,680,6158,0.583306268268919,0,0,531,1167,NA,NA,21,1553,NA,21
"315","2020-05-07",173,4,334,669,6158,0.583306268268919,0,0,531,1167,2,7926,35,1588,NA,35
"316","2020-05-08",182,4,370,655,6158,0.583306268268919,0,0,531,1167,1,7927,19,1607,1,19
"317","2020-05-09",189,4,392,640,6158,0.583306268268919,0,0,531,1167,3,7930,18,1625,1,18
"318","2020-05-10",181,4,356,606,6158,0.583306268268919,0,0,531,1167,1,7931,17,1642,NA,17
"319","2020-05-11",184,4,329,592,6158,0.583306268268919,0,0,531,1167,NA,NA,52,1694,NA,52
"320","2020-05-12",175,4,321,566,6158,0.583306268268919,0,0,531,1167,NA,NA,31,1725,NA,31
"321","2020-05-13",171,4,323,538,6158,0.583306268268919,0,0,531,1167,NA,NA,20,1745,NA,20
"322","2020-05-14",169,4,308,526,6158,0.583306268268919,0,0,531,1167,NA,NA,37,1782,NA,37
"323","2020-05-15",174,4,284,514,6158,0.583306268268919,0,0,531,1167,1,7932,47,1829,1,47
"324","2020-05-16",158,4,314,498,6158,0.583306268268919,0,0,531,1167,NA,NA,40,1869,NA,40
"325","2020-05-17",149,4,343,488,6158,0.583306268268919,0,0,531,1167,2,7934,27,1896,2,27
"326","2020-05-18",144,4,344,460,6158,0.583306268268919,0,0,531,1167,1,7935,25,1921,NA,25
"327","2020-05-19",147,4,311,443,6158,0.583306268268919,0,0,531,1167,1,7936,14,1935,NA,14
"328","2020-05-20",136,4,274,425,6158,0.583306268268919,0,0,531,1167,1,7937,19,1954,1,19
"329","2020-05-21",132,4,246,407,6158,0.583306268268919,0,0,531,1167,1,7938,12,1966,NA,12
"330","2020-05-22",117,4,216,391,6158,0.583306268268919,0,0,531,1167,1,7939,15,1981,1,15
"331","2020-05-23",114,4,196,366,6158,0.583306268268919,0,0,531,1167,NA,NA,18,1999,NA,18
"332","2020-05-24",108,4,185,349,6158,0.583306268268919,0,0,531,1167,1,7940,10,2009,NA,10
"333","2020-05-25",101,4,216,337,6158,0.583306268268919,0,0,531,1167,2,7942,11,2020,1,11
"334","2020-05-26",98,4,232,324,6158,0.583306268268919,0,0,531,1167,NA,NA,19,2039,NA,19
"335","2020-05-27",99,4,220,309,6158,0.583306268268919,0,0,531,1167,1,7943,21,2060,1,21
"336","2020-05-28",92,4,216,290,6158,0.583306268268919,0,0,531,1167,NA,NA,9,2069,NA,9
"337","2020-05-29",88,4,220,286,6158,0.583306268268919,0,0,531,1167,2,7945,11,2080,NA,11
"338","2020-05-30",86,4,218,253,6158,0.583306268268919,0,0,531,1167,NA,NA,19,2099,NA,19
"339","2020-05-31",82,4,209,236,6158,0.583306268268919,0,0,531,1167,NA,NA,19,2118,NA,19
"340","2020-06-01",75,4,229,231,6158,0.583306268268919,0,0,531,1167,2,7947,21,2139,NA,21
"341","2020-06-02",71,4,255,217,6158,0.583306268268919,0,0,531,1167,2,7949,23,2162,1,23
"342","2020-06-03",68,4,283,218,6158,0.583306268268919,0,0,531,1167,NA,NA,12,2174,NA,12
"343","2020-06-04",61,4,296,205,6158,0.583306268268919,0,0,531,1167,NA,NA,51,2225,NA,51
"344","2020-06-05",60,4,269,195,6158,0.583306268268919,0,0,531,1167,1,7950,65,2290,NA,65
"345","2020-06-06",54,4,240,175,6158,0.583306268268919,0,0,531,1167,1,7951,35,2325,NA,35
"346","2020-06-07",51,4,232,177,6158,0.583306268268919,0,0,531,1167,NA,NA,15,2340,NA,15
"347","2020-03-13",1,5,70,165,5748,0.283054975643702,0,0,498,646,31,88,52,142,2,52
"348","2020-03-14",12,5,75,208,5748,0.283054975643702,0,0,498,646,31,119,55,197,8,55
"349","2020-03-15",19,5,89,278,5748,0.283054975643702,0,0,498,646,47,166,34,231,16,34
"350","2020-03-16",27,5,88,331,5748,0.283054975643702,0,0,498,646,36,202,44,275,20,44
"351","2020-03-17",43,5,83,404,5748,0.283054975643702,0,0,498,646,50,252,39,314,21,39
"352","2020-03-18",56,5,73,477,5748,0.283054975643702,0,0,498,646,52,304,29,343,23,29
"353","2020-03-19",70,5,76,547,5748,0.283054975643702,0,0,498,646,48,352,40,383,24,40
"354","2020-03-20",93,5,71,596,5748,0.283054975643702,0,0,498,646,64,416,43,426,26,43
"355","2020-03-21",104,5,70,664,5748,0.283054975643702,0,0,498,646,37,453,36,462,21,36
"356","2020-03-22",119,5,68,709,5748,0.283054975643702,0,0,498,646,50,503,39,501,26,39
"357","2020-03-23",140,5,81,758,5748,0.283054975643702,0,0,498,646,46,549,35,536,22,35
"358","2020-03-24",159,5,100,825,5748,0.283054975643702,0,0,498,646,43,592,62,598,17,62
"359","2020-03-25",184,5,100,861,5748,0.283054975643702,0,0,498,646,42,634,30,628,20,30
"360","2020-03-26",201,5,126,880,5748,0.283054975643702,0,0,498,646,52,686,28,656,24,28
"361","2020-03-27",207,5,142,895,5748,0.283054975643702,0,0,498,646,62,748,30,686,35,30
"362","2020-03-28",225,5,154,914,5748,0.283054975643702,0,0,498,646,40,788,29,715,13,29
"363","2020-03-29",246,5,188,940,5748,0.283054975643702,0,0,498,646,28,816,24,739,11,24
"364","2020-03-30",255,5,212,952,5748,0.283054975643702,0,0,498,646,57,873,20,759,22,20
"365","2020-03-31",252,5,210,951,5748,0.283054975643702,0,0,498,646,50,923,19,778,24,19
"366","2020-04-01",248,5,200,940,5748,0.283054975643702,0,0,498,646,52,975,21,799,19,21
"367","2020-04-02",244,5,170,922,5748,0.283054975643702,0,0,498,646,63,1038,27,826,26,27
"368","2020-04-03",250,5,154,925,5748,0.283054975643702,0,0,498,646,62,1100,11,837,34,11
"369","2020-04-04",250,5,144,921,5748,0.283054975643702,0,0,498,646,53,1153,36,873,29,36
"370","2020-04-05",241,5,129,911,5748,0.283054975643702,0,0,498,646,45,1198,34,907,19,34
"371","2020-04-06",244,5,118,933,5748,0.283054975643702,0,0,498,646,62,1260,51,958,34,51
"372","2020-04-07",252,5,131,941,5748,0.283054975643702,0,0,498,646,65,1325,61,1019,33,61
"373","2020-04-08",257,5,129,916,5748,0.283054975643702,0,0,498,646,65,1390,42,1061,28,42
"374","2020-04-09",265,5,141,920,5748,0.283054975643702,0,0,498,646,68,1458,63,1124,29,63
"375","2020-04-10",256,5,154,905,5748,0.283054975643702,0,0,498,646,59,1517,41,1165,24,41
"376","2020-04-11",250,5,164,902,5748,0.283054975643702,0,0,498,646,50,1567,36,1201,21,36
"377","2020-04-12",259,5,192,893,5748,0.283054975643702,0,0,498,646,60,1627,37,1238,21,37
"378","2020-04-13",248,5,203,907,5748,0.283054975643702,0,0,498,646,65,1692,33,1271,34,33
"379","2020-04-14",243,5,193,907,5748,0.283054975643702,0,0,498,646,55,1747,54,1325,27,54
"380","2020-04-15",239,5,200,905,5748,0.283054975643702,0,0,498,646,68,1815,53,1378,30,53
"381","2020-04-16",242,5,241,889,5748,0.283054975643702,0,0,498,646,54,1869,54,1432,18,54
"382","2020-04-17",238,5,226,870,5748,0.283054975643702,0,0,498,646,47,1916,28,1460,24,28
"383","2020-04-18",240,5,198,861,5748,0.283054975643702,0,0,498,646,42,1958,20,1480,14,20
"384","2020-04-19",232,5,182,841,5748,0.283054975643702,0,0,498,646,59,2017,28,1508,28,28
"385","2020-04-20",244,5,192,835,5748,0.283054975643702,0,0,498,646,54,2071,25,1533,18,25
"386","2020-04-21",237,5,239,831,5748,0.283054975643702,0,0,498,646,54,2125,21,1554,26,21
"387","2020-04-22",236,5,257,830,5748,0.283054975643702,0,0,498,646,52,2177,41,1595,23,41
"388","2020-04-23",238,5,252,824,5748,0.283054975643702,0,0,498,646,56,2233,52,1647,18,52
"389","2020-04-24",243,5,235,824,5748,0.283054975643702,0,0,498,646,50,2283,29,1676,23,29
"390","2020-04-25",234,5,230,819,5748,0.283054975643702,0,0,498,646,59,2342,29,1705,18,29
"391","2020-04-26",226,5,203,812,5748,0.283054975643702,0,0,498,646,46,2388,27,1732,18,27
"392","2020-04-27",215,5,189,819,5748,0.283054975643702,0,0,498,646,65,2453,41,1773,35,41
"393","2020-04-28",210,5,205,812,5748,0.283054975643702,0,0,498,646,44,2497,38,1811,15,38
"394","2020-04-29",202,5,231,794,5748,0.283054975643702,0,0,498,646,50,2547,24,1835,22,24
"395","2020-04-30",201,5,221,796,5748,0.283054975643702,0,0,498,646,56,2603,24,1859,21,24
"396","2020-05-01",211,5,218,776,5748,0.283054975643702,0,0,498,646,44,2647,30,1889,14,30
"397","2020-05-02",228,5,208,771,5748,0.283054975643702,0,0,498,646,44,2691,14,1903,21,14
"398","2020-05-03",225,5,192,736,5748,0.283054975643702,0,0,498,646,47,2738,19,1922,17,19
"399","2020-05-04",222,5,182,747,5748,0.283054975643702,0,0,498,646,44,2782,16,1938,13,16
"400","2020-05-05",231,5,175,724,5748,0.283054975643702,0,0,498,646,42,2824,20,1958,17,20
"401","2020-05-06",242,5,150,685,5748,0.283054975643702,0,0,498,646,59,2883,36,1994,30,36
"402","2020-05-07",233,5,151,682,5748,0.283054975643702,0,0,498,646,54,2937,40,2034,28,40
"403","2020-05-08",227,5,146,678,5748,0.283054975643702,0,0,498,646,46,2983,32,2066,21,32
"404","2020-05-09",205,5,167,669,5748,0.283054975643702,0,0,498,646,41,3024,23,2089,18,23
"405","2020-05-10",205,5,196,642,5748,0.283054975643702,0,0,498,646,36,3060,43,2132,12,43
"406","2020-05-11",198,5,180,630,5748,0.283054975643702,0,0,498,646,48,3108,44,2176,20,44
"407","2020-05-12",191,5,231,604,5748,0.283054975643702,0,0,498,646,41,3149,30,2206,19,30
"408","2020-05-13",171,5,262,583,5748,0.283054975643702,0,0,498,646,40,3189,34,2240,16,34
"409","2020-05-14",160,5,276,579,5748,0.283054975643702,0,0,498,646,41,3230,26,2266,21,26
"410","2020-05-15",151,5,257,559,5748,0.283054975643702,0,0,498,646,36,3266,34,2300,14,34
"411","2020-05-16",143,5,255,537,5748,0.283054975643702,0,0,498,646,32,3298,28,2328,10,28
"412","2020-05-17",131,5,241,525,5748,0.283054975643702,0,0,498,646,31,3329,38,2366,12,38
"413","2020-05-18",136,5,245,508,5748,0.283054975643702,0,0,498,646,40,3369,32,2398,18,32
"414","2020-05-19",140,5,234,490,5748,0.283054975643702,0,0,498,646,38,3407,33,2431,19,33
"415","2020-05-20",133,5,249,493,5748,0.283054975643702,0,0,498,646,34,3441,22,2453,15,22
"416","2020-05-21",136,5,278,476,5748,0.283054975643702,0,0,498,646,31,3472,34,2487,17,34
"417","2020-05-22",134,5,313,452,5748,0.283054975643702,0,0,498,646,27,3499,25,2512,8,25
"418","2020-05-23",137,5,285,440,5748,0.283054975643702,0,0,498,646,27,3526,43,2555,11,43
"419","2020-05-24",146,5,284,424,5748,0.283054975643702,0,0,498,646,32,3558,25,2580,15,25
"420","2020-05-25",135,5,286,407,5748,0.283054975643702,0,0,498,646,30,3588,30,2610,10,30
"421","2020-05-26",120,5,245,378,5748,0.283054975643702,0,0,498,646,27,3615,49,2659,14,49
"422","2020-05-27",124,5,224,349,5748,0.283054975643702,0,0,498,646,29,3644,47,2706,21,47
"423","2020-05-28",114,5,195,336,5748,0.283054975643702,0,0,498,646,24,3668,74,2780,11,74
"424","2020-05-29",102,5,175,322,5748,0.283054975643702,0,0,498,646,31,3699,59,2839,12,59
"425","2020-05-30",94,5,173,307,5748,0.283054975643702,0,0,498,646,38,3737,55,2894,21,55
"426","2020-05-31",78,5,157,274,5748,0.283054975643702,0,0,498,646,22,3759,44,2938,13,44
"427","2020-06-01",70,5,145,264,5748,0.283054975643702,0,0,498,646,22,3781,43,2981,8,43
"428","2020-06-02",66,5,138,261,5748,0.283054975643702,0,0,498,646,19,3800,33,3014,9,33
"429","2020-06-03",59,5,140,249,5748,0.283054975643702,0,0,498,646,19,3819,39,3053,8,39
"430","2020-06-04",60,5,165,242,5748,0.283054975643702,0,0,498,646,17,3836,31,3084,12,31
"431","2020-06-05",65,5,184,237,5748,0.283054975643702,0,0,498,646,19,3855,33,3117,8,33
"432","2020-06-06",66,5,168,232,5748,0.283054975643702,0,0,498,646,20,3875,43,3160,11,43
"433","2020-06-07",67,5,169,222,5748,0.283054975643702,0,0,498,646,10,3885,37,3197,5,37
"434","2020-03-13",1,6,111,196,8721,0.839353285173719,0,0,875,1779,46,147,48,89,4,48
"435","2020-03-14",8,6,118,303,8721,0.839353285173719,0,0,875,1779,58,205,32,121,4,32
"436","2020-03-15",16,6,102,426,8721,0.839353285173719,0,0,875,1779,63,268,48,169,18,48
"437","2020-03-16",32,6,112,578,8721,0.839353285173719,0,0,875,1779,70,338,57,226,16,57
"438","2020-03-17",53,6,169,734,8721,0.839353285173719,0,0,875,1779,64,402,25,251,18,25
"439","2020-03-18",77,6,182,968,8721,0.839353285173719,0,0,875,1779,66,468,24,275,16,24
"440","2020-03-19",104,6,214,1239,8721,0.839353285173719,0,0,875,1779,64,532,72,347,21,72
"441","2020-03-20",150,6,201,1548,8721,0.839353285173719,0,0,875,1779,68,600,50,397,9,50
"442","2020-03-21",198,6,188,1955,8721,0.839353285173719,0,0,875,1779,71,671,25,422,8,25
"443","2020-03-22",251,6,166,2398,8721,0.839353285173719,0,0,875,1779,43,714,18,440,5,18
"444","2020-03-23",321,6,155,2848,8721,0.839353285173719,0,0,875,1779,70,784,13,453,6,13
"445","2020-03-24",404,6,153,3273,8721,0.839353285173719,0,0,875,1779,84,868,31,484,22,31
"446","2020-03-25",498,6,154,3798,8721,0.839353285173719,0,0,875,1779,44,912,28,512,8,28
"447","2020-03-26",604,6,169,4223,8721,0.839353285173719,0,0,875,1779,58,970,44,556,22,44
"448","2020-03-27",714,6,179,4525,8721,0.839353285173719,0,0,875,1779,81,1051,35,591,22,35
"449","2020-03-28",841,6,250,4744,8721,0.839353285173719,0,0,875,1779,63,1114,48,639,18,48
"450","2020-03-29",996,6,301,4792,8721,0.839353285173719,0,0,875,1779,70,1184,35,674,14,35
"451","2020-03-30",1114,6,316,4802,8721,0.839353285173719,0,0,875,1779,72,1256,25,699,20,25
"452","2020-03-31",1213,6,327,4824,8721,0.839353285173719,0,0,875,1779,63,1319,51,750,19,51
"453","2020-04-01",1293,6,280,4669,8721,0.839353285173719,0,0,875,1779,70,1389,66,816,27,66
"454","2020-04-02",1315,6,249,4438,8721,0.839353285173719,0,0,875,1779,56,1445,48,864,17,48
"455","2020-04-03",1348,6,262,4137,8721,0.839353285173719,0,0,875,1779,68,1513,30,894,16,30
"456","2020-04-04",1347,6,283,3786,8721,0.839353285173719,0,0,875,1779,73,1586,30,924,22,30
"457","2020-04-05",1295,6,279,3418,8721,0.839353285173719,0,0,875,1779,65,1651,22,946,9,22
"458","2020-04-06",1221,6,253,3069,8721,0.839353285173719,0,0,875,1779,59,1710,17,963,13,17
"459","2020-04-07",1144,6,279,2671,8721,0.839353285173719,0,0,875,1779,75,1785,14,977,16,14
"460","2020-04-08",1049,6,284,2292,8721,0.839353285173719,0,0,875,1779,79,1864,47,1024,22,47
"461","2020-04-09",981,6,254,1947,8721,0.839353285173719,0,0,875,1779,64,1928,33,1057,12,33
"462","2020-04-10",876,6,238,1636,8721,0.839353285173719,0,0,875,1779,63,1991,15,1072,13,15
"463","2020-04-11",751,6,217,1350,8721,0.839353285173719,0,0,875,1779,62,2053,38,1110,11,38
"464","2020-04-12",633,6,224,1115,8721,0.839353285173719,0,0,875,1779,67,2120,24,1134,16,24
"465","2020-04-13",538,6,222,908,8721,0.839353285173719,0,0,875,1779,67,2187,24,1158,19,24
"466","2020-04-14",433,6,203,743,8721,0.839353285173719,0,0,875,1779,75,2262,18,1176,15,18
"467","2020-04-15",347,6,193,586,8721,0.839353285173719,0,0,875,1779,80,2342,14,1190,20,14
"468","2020-04-16",275,6,193,468,8721,0.839353285173719,0,0,875,1779,75,2417,9,1199,7,9
"469","2020-04-17",208,6,222,370,8721,0.839353285173719,0,0,875,1779,66,2483,13,1212,13,13
"470","2020-04-18",163,6,216,309,8721,0.839353285173719,0,0,875,1779,63,2546,15,1227,17,15
"471","2020-04-19",127,6,193,242,8721,0.839353285173719,0,0,875,1779,51,2597,14,1241,7,14
"472","2020-04-20",103,6,195,214,8721,0.839353285173719,0,0,875,1779,72,2669,21,1262,14,21
"473","2020-04-21",91,6,184,176,8721,0.839353285173719,0,0,875,1779,84,2753,20,1282,18,20
"474","2020-04-22",81,6,178,148,8721,0.839353285173719,0,0,875,1779,66,2819,16,1298,15,16
"475","2020-04-23",72,6,201,133,8721,0.839353285173719,0,0,875,1779,68,2887,17,1315,13,17
"476","2020-04-24",59,6,217,121,8721,0.839353285173719,0,0,875,1779,78,2965,52,1367,15,52
"477","2020-04-25",52,6,203,107,8721,0.839353285173719,0,0,875,1779,60,3025,27,1394,9,27
"478","2020-04-26",43,6,230,92,8721,0.839353285173719,0,0,875,1779,74,3099,12,1406,16,12
"479","2020-04-27",33,6,231,80,8721,0.839353285173719,0,0,875,1779,66,3165,15,1421,11,15
"480","2020-04-28",27,6,224,72,8721,0.839353285173719,0,0,875,1779,70,3235,34,1455,9,34
"481","2020-04-29",22,6,200,65,8721,0.839353285173719,0,0,875,1779,52,3287,33,1488,9,33
"482","2020-04-30",19,6,209,65,8721,0.839353285173719,0,0,875,1779,50,3337,25,1513,6,25
"483","2020-05-01",15,6,261,54,8721,0.839353285173719,0,0,875,1779,61,3398,19,1532,10,19
"484","2020-05-02",14,6,251,53,8721,0.839353285173719,0,0,875,1779,67,3465,12,1544,6,12
"485","2020-05-03",16,6,236,51,8721,0.839353285173719,0,0,875,1779,77,3542,27,1571,17,27
"486","2020-05-04",18,6,236,47,8721,0.839353285173719,0,0,875,1779,56,3598,20,1591,10,20
"487","2020-05-05",19,6,219,45,8721,0.839353285173719,0,0,875,1779,57,3655,23,1614,14,23
"488","2020-05-06",18,6,211,43,8721,0.839353285173719,0,0,875,1779,49,3704,16,1630,6,16
"489","2020-05-07",17,6,190,46,8721,0.839353285173719,0,0,875,1779,53,3757,19,1649,6,19
"490","2020-05-08",19,6,222,35,8721,0.839353285173719,0,0,875,1779,64,3821,11,1660,10,11
"491","2020-05-09",16,6,262,35,8721,0.839353285173719,0,0,875,1779,51,3872,15,1675,8,15
"492","2020-05-10",16,6,263,35,8721,0.839353285173719,0,0,875,1779,48,3920,32,1707,10,32
"493","2020-05-11",17,6,232,34,8721,0.839353285173719,0,0,875,1779,45,3965,41,1748,6,41
"494","2020-05-12",14,6,210,29,8721,0.839353285173719,0,0,875,1779,34,3999,28,1776,10,28
"495","2020-05-13",14,6,203,30,8721,0.839353285173719,0,0,875,1779,43,4042,17,1793,6,17
"496","2020-05-14",12,6,232,26,8721,0.839353285173719,0,0,875,1779,37,4079,36,1829,10,36
"497","2020-05-15",9,6,223,23,8721,0.839353285173719,0,0,875,1779,33,4112,28,1857,7,28
"498","2020-05-16",11,6,207,24,8721,0.839353285173719,0,0,875,1779,29,4141,33,1890,9,33
"499","2020-05-17",9,6,207,25,8721,0.839353285173719,0,0,875,1779,50,4191,21,1911,12,21
"500","2020-05-18",7,6,225,23,8721,0.839353285173719,0,0,875,1779,43,4234,15,1926,10,15
"501","2020-05-19",6,6,220,23,8721,0.839353285173719,0,0,875,1779,39,4273,46,1972,5,46
"502","2020-05-20",5,6,216,21,8721,0.839353285173719,0,0,875,1779,28,4301,54,2026,3,54
"503","2020-05-21",5,6,202,19,8721,0.839353285173719,0,0,875,1779,39,4340,42,2068,3,42
"504","2020-05-22",5,6,193,16,8721,0.839353285173719,0,0,875,1779,31,4371,23,2091,4,23
"505","2020-05-23",3,6,197,12,8721,0.839353285173719,0,0,875,1779,28,4399,46,2137,7,46
"506","2020-05-24",2,6,199,11,8721,0.839353285173719,0,0,875,1779,36,4435,33,2170,7,33
"507","2020-05-25",0,6,0,0,8721,0.839353285173719,0,0,875,1779,39,4474,25,2195,8,25
"508","2020-05-26",1,6,190,10,8721,0.839353285173719,0,0,875,1779,29,4503,11,2206,5,11
"509","2020-05-27",1,6,211,11,8721,0.839353285173719,0,0,875,1779,36,4539,15,2221,4,15
"510","2020-05-28",1,6,213,12,8721,0.839353285173719,0,0,875,1779,27,4566,45,2266,8,45
"511","2020-05-29",1,6,262,14,8721,0.839353285173719,0,0,875,1779,17,4583,37,2303,6,37
"512","2020-05-30",1,6,301,14,8721,0.839353285173719,0,0,875,1779,25,4608,50,2353,4,50
"513","2020-05-31",1,6,290,15,8721,0.839353285173719,0,0,875,1779,30,4638,56,2409,10,56
"514","2020-06-01",3,6,261,16,8721,0.839353285173719,0,0,875,1779,24,4662,32,2441,4,32
"515","2020-06-02",2,6,230,17,8721,0.839353285173719,0,0,875,1779,11,4673,49,2490,5,49
"516","2020-06-03",2,6,196,16,8721,0.839353285173719,0,0,875,1779,17,4690,66,2556,NA,66
"517","2020-06-04",3,6,188,15,8721,0.839353285173719,0,0,875,1779,16,4706,23,2579,4,23
"518","2020-06-05",4,6,216,14,8721,0.839353285173719,0,0,875,1779,16,4722,36,2615,1,36
"519","2020-06-06",6,6,214,13,8721,0.839353285173719,0,0,875,1779,14,4736,26,2641,1,26
"520","2020-06-07",7,6,190,12,8721,0.839353285173719,0,0,875,1779,17,4753,12,2653,6,12
"521","2020-03-13",5,7,81,301,7717,0.195801477258002,0,0,596,725,41,98,12,104,9,12
"522","2020-03-14",8,7,76,389,7717,0.195801477258002,0,0,596,725,29,127,7,111,8,7
"523","2020-03-15",24,7,99,496,7717,0.195801477258002,0,0,596,725,42,169,9,120,16,9
"524","2020-03-16",37,7,123,607,7717,0.195801477258002,0,0,596,725,45,214,16,136,16,16
"525","2020-03-17",73,7,142,717,7717,0.195801477258002,0,0,596,725,53,267,47,183,30,47
"526","2020-03-18",97,7,125,828,7717,0.195801477258002,0,0,596,725,41,308,28,211,16,28
"527","2020-03-19",127,7,130,930,7717,0.195801477258002,0,0,596,725,46,354,17,228,20,17
"528","2020-03-20",156,7,150,998,7717,0.195801477258002,0,0,596,725,53,407,7,235,27,7
"529","2020-03-21",191,7,150,1055,7717,0.195801477258002,0,0,596,725,43,450,35,270,22,35
"530","2020-03-22",226,7,154,1146,7717,0.195801477258002,0,0,596,725,46,496,21,291,26,21
"531","2020-03-23",255,7,149,1201,7717,0.195801477258002,0,0,596,725,61,557,16,307,34,16
"532","2020-03-24",266,7,130,1233,7717,0.195801477258002,0,0,596,725,51,608,29,336,24,29
"533","2020-03-25",287,7,143,1248,7717,0.195801477258002,0,0,596,725,60,668,19,355,29,19
"534","2020-03-26",314,7,163,1271,7717,0.195801477258002,0,0,596,725,64,732,56,411,34,56
"535","2020-03-27",329,7,155,1293,7717,0.195801477258002,0,0,596,725,61,793,52,463,26,52
"536","2020-03-28",331,7,140,1298,7717,0.195801477258002,0,0,596,725,63,856,48,511,39,48
"537","2020-03-29",338,7,128,1316,7717,0.195801477258002,0,0,596,725,68,924,32,543,36,32
"538","2020-03-30",340,7,108,1352,7717,0.195801477258002,0,0,596,725,54,978,27,570,28,27
"539","2020-03-31",334,7,100,1372,7717,0.195801477258002,0,0,596,725,74,1052,20,590,42,20
"540","2020-04-01",351,7,105,1380,7717,0.195801477258002,0,0,596,725,55,1107,14,604,31,14
"541","2020-04-02",345,7,107,1373,7717,0.195801477258002,0,0,596,725,67,1174,11,615,39,11
"542","2020-04-03",342,7,114,1356,7717,0.195801477258002,0,0,596,725,59,1233,11,626,36,11
"543","2020-04-04",350,7,96,1329,7717,0.195801477258002,0,0,596,725,78,1311,10,636,46,10
"544","2020-04-05",342,7,103,1320,7717,0.195801477258002,0,0,596,725,63,1374,4,640,38,4
"545","2020-04-06",341,7,108,1325,7717,0.195801477258002,0,0,596,725,60,1434,10,650,41,10
"546","2020-04-07",361,7,136,1310,7717,0.195801477258002,0,0,596,725,56,1490,10,660,31,10
"547","2020-04-08",342,7,152,1315,7717,0.195801477258002,0,0,596,725,71,1561,11,671,36,11
"548","2020-04-09",329,7,149,1294,7717,0.195801477258002,0,0,596,725,72,1633,42,713,39,42
"549","2020-04-10",329,7,141,1306,7717,0.195801477258002,0,0,596,725,78,1711,38,751,40,38
"550","2020-04-11",335,7,133,1277,7717,0.195801477258002,0,0,596,725,59,1770,15,766,27,15
"551","2020-04-12",322,7,137,1263,7717,0.195801477258002,0,0,596,725,53,1823,8,774,20,8
"552","2020-04-13",315,7,144,1253,7717,0.195801477258002,0,0,596,725,58,1881,24,798,26,24
"553","2020-04-14",292,7,138,1216,7717,0.195801477258002,0,0,596,725,53,1934,15,813,36,15
"554","2020-04-15",302,7,152,1210,7717,0.195801477258002,0,0,596,725,57,1991,14,827,27,14
"555","2020-04-16",317,7,190,1195,7717,0.195801477258002,0,0,596,725,57,2048,15,842,33,15
"556","2020-04-17",311,7,229,1190,7717,0.195801477258002,0,0,596,725,66,2114,18,860,27,18
"557","2020-04-18",307,7,228,1144,7717,0.195801477258002,0,0,596,725,48,2162,6,866,26,6
"558","2020-04-19",312,7,257,1130,7717,0.195801477258002,0,0,596,725,61,2223,9,875,30,9
"559","2020-04-20",313,7,247,1104,7717,0.195801477258002,0,0,596,725,60,2283,1,876,36,1
"560","2020-04-21",319,7,264,1097,7717,0.195801477258002,0,0,596,725,65,2348,21,897,32,21
"561","2020-04-22",307,7,284,1073,7717,0.195801477258002,0,0,596,725,68,2416,15,912,27,15
"562","2020-04-23",296,7,264,1049,7717,0.195801477258002,0,0,596,725,57,2473,14,926,23,14
"563","2020-04-24",295,7,248,1042,7717,0.195801477258002,0,0,596,725,62,2535,33,959,36,33
"564","2020-04-25",288,7,271,1001,7717,0.195801477258002,0,0,596,725,53,2588,20,979,20,20
"565","2020-04-26",281,7,276,979,7717,0.195801477258002,0,0,596,725,52,2640,15,994,22,15
"566","2020-04-27",285,7,257,956,7717,0.195801477258002,0,0,596,725,52,2692,12,1006,27,12
"567","2020-04-28",278,7,239,933,7717,0.195801477258002,0,0,596,725,46,2738,20,1026,26,20
"568","2020-04-29",276,7,218,910,7717,0.195801477258002,0,0,596,725,55,2793,31,1057,28,31
"569","2020-04-30",278,7,188,879,7717,0.195801477258002,0,0,596,725,64,2857,11,1068,34,11
"570","2020-05-01",278,7,173,858,7717,0.195801477258002,0,0,596,725,45,2902,47,1115,23,47
"571","2020-05-02",273,7,175,845,7717,0.195801477258002,0,0,596,725,55,2957,45,1160,24,45
"572","2020-05-03",262,7,214,825,7717,0.195801477258002,0,0,596,725,42,2999,21,1181,21,21
"573","2020-05-04",245,7,237,812,7717,0.195801477258002,0,0,596,725,59,3058,21,1202,28,21
"574","2020-05-05",239,7,233,800,7717,0.195801477258002,0,0,596,725,44,3102,15,1217,24,15
"575","2020-05-06",234,7,204,783,7717,0.195801477258002,0,0,596,725,45,3147,17,1234,18,17
"576","2020-05-07",222,7,192,777,7717,0.195801477258002,0,0,596,725,41,3188,13,1247,21,13
"577","2020-05-08",209,7,172,758,7717,0.195801477258002,0,0,596,725,40,3228,16,1263,18,16
"578","2020-05-09",201,7,161,746,7717,0.195801477258002,0,0,596,725,45,3273,13,1276,15,13
"579","2020-05-10",197,7,148,732,7717,0.195801477258002,0,0,596,725,34,3307,7,1283,9,7
"580","2020-05-11",196,7,130,710,7717,0.195801477258002,0,0,596,725,38,3345,8,1291,21,8
"581","2020-05-12",199,7,131,694,7717,0.195801477258002,0,0,596,725,41,3386,8,1299,23,8
"582","2020-05-13",193,7,127,665,7717,0.195801477258002,0,0,596,725,31,3417,19,1318,16,19
"583","2020-05-14",184,7,121,633,7717,0.195801477258002,0,0,596,725,35,3452,38,1356,19,38
"584","2020-05-15",176,7,129,590,7717,0.195801477258002,0,0,596,725,28,3480,25,1381,14,25
"585","2020-05-16",171,7,155,578,7717,0.195801477258002,0,0,596,725,39,3519,14,1395,22,14
"586","2020-05-17",171,7,188,565,7717,0.195801477258002,0,0,596,725,45,3564,33,1428,16,33
"587","2020-05-18",169,7,225,550,7717,0.195801477258002,0,0,596,725,24,3588,39,1467,15,39
"588","2020-05-19",157,7,271,533,7717,0.195801477258002,0,0,596,725,35,3623,47,1514,17,47
"589","2020-05-20",146,7,258,508,7717,0.195801477258002,0,0,596,725,29,3652,25,1539,14,25
"590","2020-05-21",141,7,253,489,7717,0.195801477258002,0,0,596,725,23,3675,18,1557,6,18
"591","2020-05-22",140,7,244,470,7717,0.195801477258002,0,0,596,725,40,3715,39,1596,23,39
"592","2020-05-23",129,7,255,461,7717,0.195801477258002,0,0,596,725,25,3740,24,1620,13,24
"593","2020-05-24",129,7,265,440,7717,0.195801477258002,0,0,596,725,27,3767,13,1633,8,13
"594","2020-05-25",123,7,284,406,7717,0.195801477258002,0,0,596,725,31,3798,14,1647,13,14
"595","2020-05-26",120,7,292,394,7717,0.195801477258002,0,0,596,725,28,3826,10,1657,8,10
"596","2020-05-27",115,7,260,375,7717,0.195801477258002,0,0,596,725,28,3854,6,1663,14,6
"597","2020-05-28",115,7,260,355,7717,0.195801477258002,0,0,596,725,26,3880,25,1688,13,25
"598","2020-05-29",106,7,239,331,7717,0.195801477258002,0,0,596,725,27,3907,60,1748,12,60
"599","2020-05-30",106,7,215,314,7717,0.195801477258002,0,0,596,725,17,3924,34,1782,12,34
"600","2020-05-31",101,7,206,308,7717,0.195801477258002,0,0,596,725,22,3946,19,1801,11,19
"601","2020-06-01",99,7,189,302,7717,0.195801477258002,0,0,596,725,15,3961,22,1823,8,22
"602","2020-06-02",91,7,175,289,7717,0.195801477258002,0,0,596,725,26,3987,34,1857,15,34
"603","2020-06-03",93,7,165,272,7717,0.195801477258002,0,0,596,725,22,4009,35,1892,8,35
"604","2020-06-04",90,7,158,245,7717,0.195801477258002,0,0,596,725,25,4034,24,1916,14,24
"605","2020-06-05",92,7,148,230,7717,0.195801477258002,0,0,596,725,18,4052,18,1934,8,18
"606","2020-06-06",87,7,135,221,7717,0.195801477258002,0,0,596,725,12,4064,9,1943,6,9
"607","2020-06-07",78,7,129,226,7717,0.195801477258002,0,0,596,725,22,4086,11,1954,10,11
"608","2020-03-12",1,8,99,125,6611,0.29450915141431,0,0,569,1205,46,100,42,69,1,42
"609","2020-03-13",7,8,106,192,6611,0.29450915141431,0,0,569,1205,52,152,43,112,2,43
"610","2020-03-14",11,8,146,249,6611,0.29450915141431,0,0,569,1205,45,197,51,163,9,51
"611","2020-03-15",17,8,198,330,6611,0.29450915141431,0,0,569,1205,61,258,36,199,8,36
"612","2020-03-16",25,8,215,406,6611,0.29450915141431,0,0,569,1205,58,316,34,233,13,34
"613","2020-03-17",39,8,276,499,6611,0.29450915141431,0,0,569,1205,61,377,22,255,8,22
"614","2020-03-18",56,8,295,577,6611,0.29450915141431,0,0,569,1205,58,435,35,290,8,35
"615","2020-03-19",80,8,314,627,6611,0.29450915141431,0,0,569,1205,56,491,21,311,13,21
"616","2020-03-20",99,8,294,700,6611,0.29450915141431,0,0,569,1205,56,547,17,328,10,17
"617","2020-03-21",113,8,296,784,6611,0.29450915141431,0,0,569,1205,64,611,10,338,20,10
"618","2020-03-22",131,8,296,833,6611,0.29450915141431,0,0,569,1205,63,674,12,350,12,12
"619","2020-03-23",153,8,286,886,6611,0.29450915141431,0,0,569,1205,62,736,20,370,18,20
"620","2020-03-24",183,8,301,941,6611,0.29450915141431,0,0,569,1205,69,805,18,388,16,18
"621","2020-03-25",215,8,286,985,6611,0.29450915141431,0,0,569,1205,59,864,16,404,13,16
"622","2020-03-26",231,8,269,1006,6611,0.29450915141431,0,0,569,1205,82,946,22,426,27,22
"623","2020-03-27",248,8,252,1030,6611,0.29450915141431,0,0,569,1205,68,1014,41,467,22,41
"624","2020-03-28",282,8,253,1048,6611,0.29450915141431,0,0,569,1205,77,1091,39,506,27,39
"625","2020-03-29",304,8,250,1067,6611,0.29450915141431,0,0,569,1205,55,1146,21,527,15,21
"626","2020-03-30",317,8,253,1076,6611,0.29450915141431,0,0,569,1205,73,1219,18,545,11,18
"627","2020-03-31",314,8,245,1103,6611,0.29450915141431,0,0,569,1205,66,1285,57,602,8,57
"628","2020-04-01",296,8,254,1113,6611,0.29450915141431,0,0,569,1205,81,1366,47,649,19,47
"629","2020-04-02",305,8,265,1105,6611,0.29450915141431,0,0,569,1205,67,1433,34,683,11,34
"630","2020-04-03",311,8,231,1093,6611,0.29450915141431,0,0,569,1205,70,1503,22,705,24,22
"631","2020-04-04",295,8,243,1113,6611,0.29450915141431,0,0,569,1205,80,1583,15,720,15,15
"632","2020-04-05",281,8,226,1121,6611,0.29450915141431,0,0,569,1205,75,1658,48,768,18,48
"633","2020-04-06",283,8,259,1134,6611,0.29450915141431,0,0,569,1205,73,1731,45,813,17,45
"634","2020-04-07",283,8,270,1116,6611,0.29450915141431,0,0,569,1205,73,1804,38,851,8,38
"635","2020-04-08",306,8,266,1123,6611,0.29450915141431,0,0,569,1205,66,1870,41,892,17,41
"636","2020-04-09",300,8,271,1127,6611,0.29450915141431,0,0,569,1205,73,1943,36,928,20,36
"637","2020-04-10",291,8,272,1133,6611,0.29450915141431,0,0,569,1205,76,2019,36,964,7,36
"638","2020-04-11",301,8,265,1149,6611,0.29450915141431,0,0,569,1205,81,2100,18,982,20,18
"639","2020-04-12",310,8,258,1153,6611,0.29450915141431,0,0,569,1205,62,2162,39,1021,8,39
"640","2020-04-13",308,8,279,1130,6611,0.29450915141431,0,0,569,1205,77,2239,24,1045,11,24
"641","2020-04-14",310,8,285,1103,6611,0.29450915141431,0,0,569,1205,55,2294,18,1063,9,18
"642","2020-04-15",299,8,275,1090,6611,0.29450915141431,0,0,569,1205,75,2369,43,1106,18,43
"643","2020-04-16",300,8,275,1114,6611,0.29450915141431,0,0,569,1205,69,2438,24,1130,12,24
"644","2020-04-17",309,8,301,1133,6611,0.29450915141431,0,0,569,1205,71,2509,76,1206,10,76
"645","2020-04-18",308,8,306,1096,6611,0.29450915141431,0,0,569,1205,68,2577,20,1226,9,20
"646","2020-04-19",315,8,301,1088,6611,0.29450915141431,0,0,569,1205,77,2654,17,1243,13,17
"647","2020-04-20",316,8,281,1079,6611,0.29450915141431,0,0,569,1205,71,2725,15,1258,18,15
"648","2020-04-21",310,8,302,1053,6611,0.29450915141431,0,0,569,1205,66,2791,13,1271,15,13
"649","2020-04-22",305,8,306,1052,6611,0.29450915141431,0,0,569,1205,53,2844,17,1288,10,17
"650","2020-04-23",295,8,304,1014,6611,0.29450915141431,0,0,569,1205,79,2923,16,1304,17,16
"651","2020-04-24",282,8,317,984,6611,0.29450915141431,0,0,569,1205,70,2993,20,1324,15,20
"652","2020-04-25",269,8,301,958,6611,0.29450915141431,0,0,569,1205,71,3064,22,1346,16,22
"653","2020-04-26",262,8,318,941,6611,0.29450915141431,0,0,569,1205,67,3131,21,1367,15,21
"654","2020-04-27",247,8,339,923,6611,0.29450915141431,0,0,569,1205,70,3201,18,1385,16,18
"655","2020-04-28",243,8,327,903,6611,0.29450915141431,0,0,569,1205,79,3280,21,1406,15,21
"656","2020-04-29",241,8,329,882,6611,0.29450915141431,0,0,569,1205,64,3344,18,1424,13,18
"657","2020-04-30",235,8,326,855,6611,0.29450915141431,0,0,569,1205,60,3404,20,1444,8,20
"658","2020-05-01",236,8,347,824,6611,0.29450915141431,0,0,569,1205,56,3460,20,1464,10,20
"659","2020-05-02",242,8,336,791,6611,0.29450915141431,0,0,569,1205,59,3519,50,1514,16,50
"660","2020-05-03",226,8,324,781,6611,0.29450915141431,0,0,569,1205,57,3576,63,1577,13,63
"661","2020-05-04",237,8,314,761,6611,0.29450915141431,0,0,569,1205,56,3632,60,1637,13,60
"662","2020-05-05",226,8,323,738,6611,0.29450915141431,0,0,569,1205,47,3679,31,1668,6,31
"663","2020-05-06",221,8,327,724,6611,0.29450915141431,0,0,569,1205,64,3743,24,1692,16,24
"664","2020-05-07",222,8,326,719,6611,0.29450915141431,0,0,569,1205,66,3809,45,1737,8,45
"665","2020-05-08",205,8,321,706,6611,0.29450915141431,0,0,569,1205,40,3849,41,1778,5,41
"666","2020-05-09",192,8,318,676,6611,0.29450915141431,0,0,569,1205,47,3896,22,1800,5,22
"667","2020-05-10",191,8,327,670,6611,0.29450915141431,0,0,569,1205,43,3939,41,1841,4,41
"668","2020-05-11",173,8,314,632,6611,0.29450915141431,0,0,569,1205,47,3986,30,1871,6,30
"669","2020-05-12",176,8,312,599,6611,0.29450915141431,0,0,569,1205,56,4042,37,1908,7,37
"670","2020-05-13",171,8,326,563,6611,0.29450915141431,0,0,569,1205,44,4086,17,1925,6,17
"671","2020-05-14",164,8,311,566,6611,0.29450915141431,0,0,569,1205,38,4124,9,1934,7,9
"672","2020-05-15",159,8,327,552,6611,0.29450915141431,0,0,569,1205,30,4154,11,1945,5,11
"673","2020-05-16",158,8,328,532,6611,0.29450915141431,0,0,569,1205,29,4183,50,1995,4,50
"674","2020-05-17",153,8,316,519,6611,0.29450915141431,0,0,569,1205,50,4233,49,2044,10,49
"675","2020-05-18",151,8,315,503,6611,0.29450915141431,0,0,569,1205,38,4271,27,2071,2,27
"676","2020-05-19",146,8,329,488,6611,0.29450915141431,0,0,569,1205,37,4308,34,2105,6,34
"677","2020-05-20",144,8,317,475,6611,0.29450915141431,0,0,569,1205,39,4347,54,2159,7,54
"678","2020-05-21",141,8,335,456,6611,0.29450915141431,0,0,569,1205,33,4380,42,2201,5,42
"679","2020-05-22",142,8,315,436,6611,0.29450915141431,0,0,569,1205,31,4411,39,2240,3,39
"680","2020-05-23",128,8,309,427,6611,0.29450915141431,0,0,569,1205,23,4434,53,2293,3,53
"681","2020-05-24",122,8,312,406,6611,0.29450915141431,0,0,569,1205,26,4460,62,2355,3,62
"682","2020-05-25",114,8,332,395,6611,0.29450915141431,0,0,569,1205,30,4490,31,2386,5,31
"683","2020-05-26",108,8,327,383,6611,0.29450915141431,0,0,569,1205,31,4521,30,2416,7,30
"684","2020-05-27",98,8,322,365,6611,0.29450915141431,0,0,569,1205,21,4542,18,2434,2,18
"685","2020-05-28",92,8,296,340,6611,0.29450915141431,0,0,569,1205,25,4567,31,2465,6,31
"686","2020-05-29",90,8,296,333,6611,0.29450915141431,0,0,569,1205,15,4582,24,2489,2,24
"687","2020-05-30",92,8,300,309,6611,0.29450915141431,0,0,569,1205,18,4600,24,2513,1,24
"688","2020-05-31",89,8,285,290,6611,0.29450915141431,0,0,569,1205,17,4617,15,2528,1,15
"689","2020-06-01",91,8,273,283,6611,0.29450915141431,0,0,569,1205,28,4645,20,2548,3,20
"690","2020-06-02",94,8,261,261,6611,0.29450915141431,0,0,569,1205,24,4669,11,2559,5,11
"691","2020-06-03",89,8,289,254,6611,0.29450915141431,0,0,569,1205,21,4690,10,2569,4,10
"692","2020-06-04",85,8,288,254,6611,0.29450915141431,0,0,569,1205,22,4712,6,2575,4,6
"693","2020-06-05",85,8,287,251,6611,0.29450915141431,0,0,569,1205,19,4731,10,2585,2,10
"694","2020-06-06",78,8,298,243,6611,0.29450915141431,0,0,569,1205,16,4747,7,2592,2,7
"695","2020-06-07",76,8,331,238,6611,0.29450915141431,0,0,569,1205,12,4759,12,2604,3,12
"696","2020-03-14",2,9,174,115,7734,0.93625549521593,0,0,678,1319,26,77,31,138,12,31
"697","2020-03-15",10,9,142,159,7734,0.93625549521593,0,0,678,1319,32,109,63,201,27,63
"698","2020-03-16",15,9,122,224,7734,0.93625549521593,0,0,678,1319,41,150,62,263,29,62
"699","2020-03-17",24,9,104,296,7734,0.93625549521593,0,0,678,1319,29,179,24,287,23,24
"700","2020-03-18",34,9,115,379,7734,0.93625549521593,0,0,678,1319,36,215,37,324,23,37
"701","2020-03-19",46,9,147,498,7734,0.93625549521593,0,0,678,1319,49,264,65,389,41,65
"702","2020-03-20",67,9,199,656,7734,0.93625549521593,0,0,678,1319,39,303,47,436,29,47
"703","2020-03-21",88,9,207,859,7734,0.93625549521593,0,0,678,1319,53,356,31,467,44,31
"704","2020-03-22",102,9,193,1024,7734,0.93625549521593,0,0,678,1319,59,415,45,512,45,45
"705","2020-03-23",128,9,222,1214,7734,0.93625549521593,0,0,678,1319,66,481,53,565,57,53
"706","2020-03-24",163,9,263,1422,7734,0.93625549521593,0,0,678,1319,58,539,27,592,45,27
"707","2020-03-25",210,9,240,1730,7734,0.93625549521593,0,0,678,1319,74,613,16,608,66,16
"708","2020-03-26",268,9,236,2017,7734,0.93625549521593,0,0,678,1319,60,673,66,674,49,66
"709","2020-03-27",338,9,216,2414,7734,0.93625549521593,0,0,678,1319,86,759,33,707,64,33
"710","2020-03-28",413,9,189,2788,7734,0.93625549521593,0,0,678,1319,74,833,27,734,59,27
"711","2020-03-29",496,9,168,3071,7734,0.93625549521593,0,0,678,1319,77,910,12,746,66,12
"712","2020-03-30",579,9,175,3443,7734,0.93625549521593,0,0,678,1319,76,986,17,763,67,17
"713","2020-03-31",648,9,166,3699,7734,0.93625549521593,0,0,678,1319,84,1070,17,780,65,17
"714","2020-04-01",742,9,151,3859,7734,0.93625549521593,0,0,678,1319,90,1160,13,793,80,13
"715","2020-04-02",837,9,149,3910,7734,0.93625549521593,0,0,678,1319,74,1234,11,804,65,11
"716","2020-04-03",906,9,146,4018,7734,0.93625549521593,0,0,678,1319,98,1332,14,818,80,14
"717","2020-04-04",964,9,158,3951,7734,0.93625549521593,0,0,678,1319,77,1409,45,863,66,45
"718","2020-04-05",1032,9,160,3869,7734,0.93625549521593,0,0,678,1319,119,1528,47,910,101,47
"719","2020-04-06",1073,9,148,3704,7734,0.93625549521593,0,0,678,1319,91,1619,75,985,77,75
"720","2020-04-07",1100,9,150,3467,7734,0.93625549521593,0,0,678,1319,110,1729,35,1020,94,35
"721","2020-04-08",1120,9,143,3218,7734,0.93625549521593,0,0,678,1319,84,1813,19,1039,66,19
"722","2020-04-09",1084,9,140,2997,7734,0.93625549521593,0,0,678,1319,90,1903,23,1062,79,23
"723","2020-04-10",1047,9,140,2715,7734,0.93625549521593,0,0,678,1319,102,2005,16,1078,87,16
"724","2020-04-11",1013,9,208,2399,7734,0.93625549521593,0,0,678,1319,89,2094,11,1089,75,11
"725","2020-04-12",943,9,266,2134,7734,0.93625549521593,0,0,678,1319,97,2191,17,1106,87,17
"726","2020-04-13",867,9,254,1885,7734,0.93625549521593,0,0,678,1319,90,2281,11,1117,77,11
"727","2020-04-14",798,9,236,1652,7734,0.93625549521593,0,0,678,1319,92,2373,15,1132,82,15
"728","2020-04-15",688,9,234,1433,7734,0.93625549521593,0,0,678,1319,88,2461,8,1140,78,8
"729","2020-04-16",630,9,263,1247,7734,0.93625549521593,0,0,678,1319,104,2565,45,1185,94,45
"730","2020-04-17",550,9,251,1045,7734,0.93625549521593,0,0,678,1319,101,2666,26,1211,91,26
"731","2020-04-18",463,9,276,915,7734,0.93625549521593,0,0,678,1319,88,2754,46,1257,79,46
"732","2020-04-19",393,9,269,792,7734,0.93625549521593,0,0,678,1319,77,2831,32,1289,66,32
"733","2020-04-20",347,9,255,678,7734,0.93625549521593,0,0,678,1319,91,2922,13,1302,76,13
"734","2020-04-21",303,9,266,594,7734,0.93625549521593,0,0,678,1319,74,2996,15,1317,64,15
"735","2020-04-22",274,9,260,505,7734,0.93625549521593,0,0,678,1319,75,3071,38,1355,64,38
"736","2020-04-23",222,9,232,419,7734,0.93625549521593,0,0,678,1319,83,3154,24,1379,71,24
"737","2020-04-24",196,9,214,346,7734,0.93625549521593,0,0,678,1319,63,3217,16,1395,49,16
"738","2020-04-25",175,9,239,306,7734,0.93625549521593,0,0,678,1319,92,3309,22,1417,85,22
"739","2020-04-26",148,9,249,259,7734,0.93625549521593,0,0,678,1319,78,3387,34,1451,68,34
"740","2020-04-27",121,9,236,222,7734,0.93625549521593,0,0,678,1319,76,3463,51,1502,60,51
"741","2020-04-28",97,9,229,193,7734,0.93625549521593,0,0,678,1319,65,3528,23,1525,55,23
"742","2020-04-29",73,9,222,174,7734,0.93625549521593,0,0,678,1319,57,3585,22,1547,52,22
"743","2020-04-30",65,9,194,156,7734,0.93625549521593,0,0,678,1319,77,3662,29,1576,70,29
"744","2020-05-01",56,9,181,134,7734,0.93625549521593,0,0,678,1319,54,3716,21,1597,47,21
"745","2020-05-02",47,9,217,117,7734,0.93625549521593,0,0,678,1319,61,3777,11,1608,53,11
"746","2020-05-03",47,9,231,107,7734,0.93625549521593,0,0,678,1319,58,3835,23,1631,50,23
"747","2020-05-04",43,9,284,96,7734,0.93625549521593,0,0,678,1319,45,3880,9,1640,39,9
"748","2020-05-05",46,9,280,89,7734,0.93625549521593,0,0,678,1319,47,3927,22,1662,35,22
"749","2020-05-06",41,9,279,86,7734,0.93625549521593,0,0,678,1319,47,3974,35,1697,39,35
"750","2020-05-07",33,9,270,82,7734,0.93625549521593,0,0,678,1319,51,4025,49,1746,41,49
"751","2020-05-08",27,9,247,71,7734,0.93625549521593,0,0,678,1319,50,4075,28,1774,41,28
"752","2020-05-09",25,9,239,68,7734,0.93625549521593,0,0,678,1319,36,4111,16,1790,32,16
"753","2020-05-10",22,9,250,60,7734,0.93625549521593,0,0,678,1319,45,4156,67,1857,38,67
"754","2020-05-11",22,9,234,54,7734,0.93625549521593,0,0,678,1319,46,4202,40,1897,39,40
"755","2020-05-12",17,9,203,54,7734,0.93625549521593,0,0,678,1319,47,4249,41,1938,40,41
"756","2020-05-13",16,9,182,51,7734,0.93625549521593,0,0,678,1319,43,4292,54,1992,35,54
"757","2020-05-14",14,9,187,44,7734,0.93625549521593,0,0,678,1319,34,4326,28,2020,22,28
"758","2020-05-15",13,9,232,46,7734,0.93625549521593,0,0,678,1319,31,4357,20,2040,26,20
"759","2020-05-16",12,9,233,43,7734,0.93625549521593,0,0,678,1319,32,4389,20,2060,28,20
"760","2020-05-17",11,9,216,40,7734,0.93625549521593,0,0,678,1319,27,4416,36,2096,15,36
"761","2020-05-18",11,9,241,40,7734,0.93625549521593,0,0,678,1319,36,4452,48,2144,27,48
"762","2020-05-19",13,9,241,33,7734,0.93625549521593,0,0,678,1319,43,4495,55,2199,35,55
"763","2020-05-20",12,9,227,32,7734,0.93625549521593,0,0,678,1319,21,4516,29,2228,16,29
"764","2020-05-21",13,9,262,30,7734,0.93625549521593,0,0,678,1319,21,4537,33,2261,17,33
"765","2020-05-22",13,9,297,34,7734,0.93625549521593,0,0,678,1319,28,4565,28,2289,22,28
"766","2020-05-23",11,9,285,34,7734,0.93625549521593,0,0,678,1319,23,4588,20,2309,18,20
"767","2020-05-24",10,9,287,33,7734,0.93625549521593,0,0,678,1319,30,4618,21,2330,26,21
"768","2020-05-25",10,9,300,32,7734,0.93625549521593,0,0,678,1319,24,4642,12,2342,17,12
"769","2020-05-26",9,9,297,37,7734,0.93625549521593,0,0,678,1319,25,4667,10,2352,23,10
"770","2020-05-27",9,9,266,36,7734,0.93625549521593,0,0,678,1319,20,4687,16,2368,17,16
"771","2020-05-28",9,9,243,37,7734,0.93625549521593,0,0,678,1319,21,4708,50,2418,17,50
"772","2020-05-29",10,9,222,37,7734,0.93625549521593,0,0,678,1319,20,4728,25,2443,15,25
"773","2020-05-30",12,9,219,41,7734,0.93625549521593,0,0,678,1319,15,4743,47,2490,10,47
"774","2020-05-31",13,9,188,42,7734,0.93625549521593,0,0,678,1319,19,4762,51,2541,14,51
"775","2020-06-01",13,9,185,45,7734,0.93625549521593,0,0,678,1319,19,4781,68,2609,15,68
"776","2020-06-02",13,9,189,42,7734,0.93625549521593,0,0,678,1319,23,4804,58,2667,20,58
"777","2020-06-03",14,9,200,42,7734,0.93625549521593,0,0,678,1319,13,4817,67,2734,10,67
"778","2020-06-04",12,9,205,46,7734,0.93625549521593,0,0,678,1319,14,4831,31,2765,7,31
"779","2020-06-05",12,9,231,44,7734,0.93625549521593,0,0,678,1319,17,4848,16,2781,14,16
"780","2020-06-06",11,9,225,40,7734,0.93625549521593,0,0,678,1319,9,4857,83,2864,7,83
"781","2020-06-07",10,9,218,35,7734,0.93625549521593,0,0,678,1319,15,4872,54,2918,14,54
"782","2020-03-13",1,10,60,49,2655,0.443691148775895,0,0,238,1428,60,140,18,92,13,18
"783","2020-03-14",2,10,100,66,2655,0.443691148775895,0,0,238,1428,52,192,7,99,16,7
"784","2020-03-15",6,10,149,86,2655,0.443691148775895,0,0,238,1428,63,255,13,112,23,13
"785","2020-03-16",11,10,160,115,2655,0.443691148775895,0,0,238,1428,63,318,19,131,26,19
"786","2020-03-17",11,10,184,144,2655,0.443691148775895,0,0,238,1428,89,407,13,144,54,13
"787","2020-03-18",15,10,177,171,2655,0.443691148775895,0,0,238,1428,87,494,12,156,49,12
"788","2020-03-19",23,10,202,195,2655,0.443691148775895,0,0,238,1428,90,584,7,163,48,7
"789","2020-03-20",29,10,203,216,2655,0.443691148775895,0,0,238,1428,110,694,8,171,66,8
"790","2020-03-21",41,10,221,241,2655,0.443691148775895,0,0,238,1428,104,798,8,179,63,8
"791","2020-03-22",47,10,218,267,2655,0.443691148775895,0,0,238,1428,102,900,26,205,63,26
"792","2020-03-23",51,10,232,275,2655,0.443691148775895,0,0,238,1428,123,1023,38,243,84,38
"793","2020-03-24",60,10,237,289,2655,0.443691148775895,0,0,238,1428,130,1153,32,275,79,32
"794","2020-03-25",68,10,226,297,2655,0.443691148775895,0,0,238,1428,112,1265,16,291,67,16
"795","2020-03-26",74,10,222,308,2655,0.443691148775895,0,0,238,1428,132,1397,13,304,87,13
"796","2020-03-27",82,10,237,308,2655,0.443691148775895,0,0,238,1428,117,1514,45,349,82,45
"797","2020-03-28",84,10,199,307,2655,0.443691148775895,0,0,238,1428,135,1649,19,368,93,19
"798","2020-03-29",90,10,188,310,2655,0.443691148775895,0,0,238,1428,120,1769,56,424,87,56
"799","2020-03-30",92,10,213,334,2655,0.443691148775895,0,0,238,1428,112,1881,42,466,77,42
"800","2020-03-31",95,10,234,340,2655,0.443691148775895,0,0,238,1428,117,1998,21,487,79,21
"801","2020-04-01",89,10,214,346,2655,0.443691148775895,0,0,238,1428,108,2106,23,510,65,23
"802","2020-04-02",89,10,210,344,2655,0.443691148775895,0,0,238,1428,127,2233,21,531,88,21
"803","2020-04-03",87,10,200,346,2655,0.443691148775895,0,0,238,1428,134,2367,21,552,85,21
"804","2020-04-04",89,10,196,348,2655,0.443691148775895,0,0,238,1428,88,2455,42,594,63,42
"805","2020-04-05",87,10,188,347,2655,0.443691148775895,0,0,238,1428,116,2571,61,655,79,61
"806","2020-04-06",84,10,187,341,2655,0.443691148775895,0,0,238,1428,118,2689,45,700,77,45
"807","2020-04-07",85,10,172,328,2655,0.443691148775895,0,0,238,1428,101,2790,38,738,68,38
"808","2020-04-08",92,10,198,317,2655,0.443691148775895,0,0,238,1428,91,2881,36,774,53,36
"809","2020-04-09",91,10,205,321,2655,0.443691148775895,0,0,238,1428,88,2969,29,803,55,29
"810","2020-04-10",97,10,202,318,2655,0.443691148775895,0,0,238,1428,109,3078,22,825,73,22
"811","2020-04-11",90,10,202,324,2655,0.443691148775895,0,0,238,1428,107,3185,15,840,64,15
"812","2020-04-12",93,10,226,321,2655,0.443691148775895,0,0,238,1428,96,3281,9,849,64,9
"813","2020-04-13",97,10,214,313,2655,0.443691148775895,0,0,238,1428,91,3372,4,853,57,4
"814","2020-04-14",93,10,190,299,2655,0.443691148775895,0,0,238,1428,102,3474,22,875,67,22
"815","2020-04-15",95,10,180,298,2655,0.443691148775895,0,0,238,1428,95,3569,45,920,62,45
"816","2020-04-16",90,10,167,309,2655,0.443691148775895,0,0,238,1428,83,3652,29,949,56,29
"817","2020-04-17",85,10,173,315,2655,0.443691148775895,0,0,238,1428,91,3743,42,991,50,42
"818","2020-04-18",94,10,175,313,2655,0.443691148775895,0,0,238,1428,94,3837,47,1038,53,47
"819","2020-04-19",92,10,178,322,2655,0.443691148775895,0,0,238,1428,74,3911,27,1065,39,27
"820","2020-04-20",87,10,177,330,2655,0.443691148775895,0,0,238,1428,77,3988,53,1118,29,53
"821","2020-04-21",89,10,186,338,2655,0.443691148775895,0,0,238,1428,72,4060,42,1160,38,42
"822","2020-04-22",86,10,171,352,2655,0.443691148775895,0,0,238,1428,71,4131,14,1174,37,14
"823","2020-04-23",91,10,188,348,2655,0.443691148775895,0,0,238,1428,51,4182,9,1183,24,9
"824","2020-04-24",89,10,166,357,2655,0.443691148775895,0,0,238,1428,84,4266,13,1196,40,13
"825","2020-04-25",85,10,171,369,2655,0.443691148775895,0,0,238,1428,61,4327,38,1234,29,38
"826","2020-04-26",83,10,170,371,2655,0.443691148775895,0,0,238,1428,58,4385,49,1283,28,49
"827","2020-04-27",93,10,159,358,2655,0.443691148775895,0,0,238,1428,47,4432,28,1311,30,28
"828","2020-04-28",98,10,145,357,2655,0.443691148775895,0,0,238,1428,51,4483,37,1348,24,37
"829","2020-04-29",109,10,137,372,2655,0.443691148775895,0,0,238,1428,62,4545,14,1362,28,14
"830","2020-04-30",105,10,129,381,2655,0.443691148775895,0,0,238,1428,44,4589,35,1397,17,35
"831","2020-05-01",112,10,139,384,2655,0.443691148775895,0,0,238,1428,51,4640,60,1457,15,60
"832","2020-05-02",112,10,164,383,2655,0.443691148775895,0,0,238,1428,60,4700,40,1497,26,40
"833","2020-05-03",118,10,154,391,2655,0.443691148775895,0,0,238,1428,44,4744,65,1562,20,65
"834","2020-05-04",105,10,168,399,2655,0.443691148775895,0,0,238,1428,43,4787,24,1586,18,24
"835","2020-05-05",104,10,238,415,2655,0.443691148775895,0,0,238,1428,35,4822,56,1642,7,56
"836","2020-05-06",100,10,275,432,2655,0.443691148775895,0,0,238,1428,52,4874,52,1694,27,52
"837","2020-05-07",111,10,277,438,2655,0.443691148775895,0,0,238,1428,42,4916,23,1717,15,23
"838","2020-05-08",106,10,264,434,2655,0.443691148775895,0,0,238,1428,36,4952,31,1748,14,31
"839","2020-05-09",113,10,239,427,2655,0.443691148775895,0,0,238,1428,41,4993,62,1810,15,62
"840","2020-05-10",116,10,220,432,2655,0.443691148775895,0,0,238,1428,31,5024,64,1874,12,64
"841","2020-05-11",134,10,230,439,2655,0.443691148775895,0,0,238,1428,40,5064,41,1915,15,41
"842","2020-05-12",138,10,230,427,2655,0.443691148775895,0,0,238,1428,48,5112,51,1966,20,51
"843","2020-05-13",136,10,207,412,2655,0.443691148775895,0,0,238,1428,45,5157,25,1991,17,25
"844","2020-05-14",134,10,199,399,2655,0.443691148775895,0,0,238,1428,35,5192,42,2033,13,42
"845","2020-05-15",133,10,209,390,2655,0.443691148775895,0,0,238,1428,40,5232,39,2072,19,39
"846","2020-05-16",120,10,199,388,2655,0.443691148775895,0,0,238,1428,33,5265,43,2115,10,43
"847","2020-05-17",112,10,206,376,2655,0.443691148775895,0,0,238,1428,25,5290,31,2146,14,31
"848","2020-05-18",112,10,195,364,2655,0.443691148775895,0,0,238,1428,23,5313,13,2159,11,13
"849","2020-05-19",106,10,173,345,2655,0.443691148775895,0,0,238,1428,27,5340,13,2172,11,13
"850","2020-05-20",104,10,170,345,2655,0.443691148775895,0,0,238,1428,32,5372,18,2190,11,18
"851","2020-05-21",98,10,162,355,2655,0.443691148775895,0,0,238,1428,37,5409,27,2217,14,27
"852","2020-05-22",92,10,178,347,2655,0.443691148775895,0,0,238,1428,22,5431,26,2243,6,26
"853","2020-05-23",96,10,193,337,2655,0.443691148775895,0,0,238,1428,26,5457,17,2260,13,17
"854","2020-05-24",96,10,198,324,2655,0.443691148775895,0,0,238,1428,20,5477,16,2276,8,16
"855","2020-05-25",85,10,179,317,2655,0.443691148775895,0,0,238,1428,25,5502,9,2285,11,9
"856","2020-05-26",91,10,204,313,2655,0.443691148775895,0,0,238,1428,17,5519,3,2288,6,3
"857","2020-05-27",85,10,237,291,2655,0.443691148775895,0,0,238,1428,19,5538,15,2303,6,15
"858","2020-05-28",88,10,270,285,2655,0.443691148775895,0,0,238,1428,22,5560,24,2327,9,24
"859","2020-05-29",93,10,266,267,2655,0.443691148775895,0,0,238,1428,13,5573,19,2346,4,19
"860","2020-05-30",93,10,234,261,2655,0.443691148775895,0,0,238,1428,18,5591,25,2371,7,25
"861","2020-05-31",87,10,241,257,2655,0.443691148775895,0,0,238,1428,17,5608,18,2389,9,18
"862","2020-06-01",89,10,234,242,2655,0.443691148775895,0,0,238,1428,18,5626,7,2396,6,7
"863","2020-06-02",79,10,244,234,2655,0.443691148775895,0,0,238,1428,10,5636,26,2422,4,26
"864","2020-06-03",79,10,228,215,2655,0.443691148775895,0,0,238,1428,20,5656,13,2435,7,13
"865","2020-06-04",79,10,217,211,2655,0.443691148775895,0,0,238,1428,16,5672,17,2452,1,17
"866","2020-06-05",79,10,210,200,2655,0.443691148775895,0,0,238,1428,20,5692,30,2482,12,30
"867","2020-06-06",76,10,212,191,2655,0.443691148775895,0,0,238,1428,12,5704,22,2504,3,22
"868","2020-06-07",74,10,199,186,2655,0.443691148775895,0,0,238,1428,10,5714,18,2522,2,18
"869","2020-03-13",3,11,97,160,6053,0.259540723608128,0,0,509,1405,91,254,24,97,9,24
"870","2020-03-14",7,11,88,236,6053,0.259540723608128,0,0,509,1405,91,345,62,159,20,62
"871","2020-03-15",14,11,91,307,6053,0.259540723608128,0,0,509,1405,81,426,43,202,24,43
"872","2020-03-16",22,11,141,377,6053,0.259540723608128,0,0,509,1405,89,515,74,276,31,74
"873","2020-03-17",32,11,170,467,6053,0.259540723608128,0,0,509,1405,112,627,38,314,35,38
"874","2020-03-18",56,11,218,567,6053,0.259540723608128,0,0,509,1405,111,738,71,385,34,71
"875","2020-03-19",69,11,209,639,6053,0.259540723608128,0,0,509,1405,126,864,71,456,49,71
"876","2020-03-20",89,11,204,709,6053,0.259540723608128,0,0,509,1405,97,961,48,504,40,48
"877","2020-03-21",110,11,207,744,6053,0.259540723608128,0,0,509,1405,102,1063,49,553,32,49
"878","2020-03-22",145,11,237,786,6053,0.259540723608128,0,0,509,1405,106,1169,45,598,49,45
"879","2020-03-23",173,11,234,829,6053,0.259540723608128,0,0,509,1405,104,1273,36,634,39,36
"880","2020-03-24",198,11,233,858,6053,0.259540723608128,0,0,509,1405,101,1374,39,673,44,39
"881","2020-03-25",208,11,269,890,6053,0.259540723608128,0,0,509,1405,127,1501,41,714,62,41
"882","2020-03-26",234,11,297,900,6053,0.259540723608128,0,0,509,1405,112,1613,30,744,52,30
"883","2020-03-27",236,11,273,890,6053,0.259540723608128,0,0,509,1405,113,1726,36,780,60,36
"884","2020-03-28",246,11,262,913,6053,0.259540723608128,0,0,509,1405,124,1850,53,833,49,53
"885","2020-03-29",247,11,237,912,6053,0.259540723608128,0,0,509,1405,105,1955,37,870,40,37
"886","2020-03-30",243,11,211,901,6053,0.259540723608128,0,0,509,1405,122,2077,58,928,53,58
"887","2020-03-31",241,11,181,891,6053,0.259540723608128,0,0,509,1405,135,2212,58,986,49,58
"888","2020-04-01",241,11,170,898,6053,0.259540723608128,0,0,509,1405,102,2314,41,1027,51,41
"889","2020-04-02",230,11,216,937,6053,0.259540723608128,0,0,509,1405,134,2448,45,1072,53,45
"890","2020-04-03",235,11,255,949,6053,0.259540723608128,0,0,509,1405,111,2559,40,1112,37,40
"891","2020-04-04",230,11,248,965,6053,0.259540723608128,0,0,509,1405,104,2663,49,1161,42,49
"892","2020-04-05",223,11,230,964,6053,0.259540723608128,0,0,509,1405,123,2786,45,1206,51,45
"893","2020-04-06",220,11,226,987,6053,0.259540723608128,0,0,509,1405,115,2901,44,1250,44,44
"894","2020-04-07",224,11,252,1009,6053,0.259540723608128,0,0,509,1405,112,3013,34,1284,39,34
"895","2020-04-08",224,11,257,987,6053,0.259540723608128,0,0,509,1405,117,3130,39,1323,43,39
"896","2020-04-09",240,11,234,958,6053,0.259540723608128,0,0,509,1405,78,3208,52,1375,29,52
"897","2020-04-10",249,11,210,983,6053,0.259540723608128,0,0,509,1405,114,3322,37,1412,42,37
"898","2020-04-11",255,11,215,983,6053,0.259540723608128,0,0,509,1405,76,3398,28,1440,28,28
"899","2020-04-12",263,11,207,973,6053,0.259540723608128,0,0,509,1405,107,3505,42,1482,42,42
"900","2020-04-13",276,11,225,972,6053,0.259540723608128,0,0,509,1405,103,3608,27,1509,39,27
"901","2020-04-14",279,11,215,950,6053,0.259540723608128,0,0,509,1405,94,3702,40,1549,34,40
"902","2020-04-15",272,11,267,951,6053,0.259540723608128,0,0,509,1405,95,3797,39,1588,29,39
"903","2020-04-16",270,11,296,956,6053,0.259540723608128,0,0,509,1405,94,3891,34,1622,27,34
"904","2020-04-17",268,11,310,955,6053,0.259540723608128,0,0,509,1405,99,3990,34,1656,32,34
"905","2020-04-18",270,11,334,958,6053,0.259540723608128,0,0,509,1405,82,4072,38,1694,25,38
"906","2020-04-19",268,11,314,964,6053,0.259540723608128,0,0,509,1405,94,4166,33,1727,23,33
"907","2020-04-20",262,11,330,941,6053,0.259540723608128,0,0,509,1405,84,4250,29,1756,20,29
"908","2020-04-21",259,11,343,946,6053,0.259540723608128,0,0,509,1405,75,4325,37,1793,29,37
"909","2020-04-22",272,11,319,919,6053,0.259540723608128,0,0,509,1405,98,4423,41,1834,32,41
"910","2020-04-23",266,11,289,884,6053,0.259540723608128,0,0,509,1405,73,4496,32,1866,26,32
"911","2020-04-24",262,11,271,891,6053,0.259540723608128,0,0,509,1405,81,4577,36,1902,15,36
"912","2020-04-25",264,11,294,873,6053,0.259540723608128,0,0,509,1405,72,4649,32,1934,17,32
"913","2020-04-26",256,11,276,882,6053,0.259540723608128,0,0,509,1405,88,4737,32,1966,21,32
"914","2020-04-27",249,11,234,878,6053,0.259540723608128,0,0,509,1405,85,4822,27,1993,18,27
"915","2020-04-28",257,11,219,869,6053,0.259540723608128,0,0,509,1405,69,4891,40,2033,14,40
"916","2020-04-29",262,11,189,850,6053,0.259540723608128,0,0,509,1405,80,4971,37,2070,28,37
"917","2020-04-30",249,11,180,842,6053,0.259540723608128,0,0,509,1405,69,5040,35,2105,21,35
"918","2020-05-01",247,11,200,836,6053,0.259540723608128,0,0,509,1405,54,5094,34,2139,16,34
"919","2020-05-02",238,11,202,819,6053,0.259540723608128,0,0,509,1405,61,5155,42,2181,14,42
"920","2020-05-03",225,11,247,790,6053,0.259540723608128,0,0,509,1405,63,5218,30,2211,12,30
"921","2020-05-04",229,11,254,754,6053,0.259540723608128,0,0,509,1405,42,5260,26,2237,6,26
"922","2020-05-05",221,11,235,747,6053,0.259540723608128,0,0,509,1405,61,5321,40,2277,19,40
"923","2020-05-06",210,11,220,734,6053,0.259540723608128,0,0,509,1405,53,5374,40,2317,18,40
"924","2020-05-07",209,11,217,727,6053,0.259540723608128,0,0,509,1405,47,5421,49,2366,10,49
"925","2020-05-08",207,11,270,700,6053,0.259540723608128,0,0,509,1405,58,5479,43,2409,13,43
"926","2020-05-09",209,11,293,672,6053,0.259540723608128,0,0,509,1405,57,5536,29,2438,8,29
"927","2020-05-10",203,11,286,655,6053,0.259540723608128,0,0,509,1405,46,5582,25,2463,9,25
"928","2020-05-11",199,11,274,646,6053,0.259540723608128,0,0,509,1405,58,5640,35,2498,18,35
"929","2020-05-12",186,11,259,624,6053,0.259540723608128,0,0,509,1405,36,5676,58,2556,8,58
"930","2020-05-13",177,11,224,585,6053,0.259540723608128,0,0,509,1405,40,5716,48,2604,6,48
"931","2020-05-14",174,11,235,578,6053,0.259540723608128,0,0,509,1405,38,5754,33,2637,11,33
"932","2020-05-15",170,11,244,566,6053,0.259540723608128,0,0,509,1405,34,5788,38,2675,6,38
"933","2020-05-16",156,11,231,545,6053,0.259540723608128,0,0,509,1405,46,5834,32,2707,13,32
"934","2020-05-17",166,11,215,528,6053,0.259540723608128,0,0,509,1405,27,5861,35,2742,5,35
"935","2020-05-18",160,11,187,518,6053,0.259540723608128,0,0,509,1405,28,5889,34,2776,7,34
"936","2020-05-19",153,11,204,485,6053,0.259540723608128,0,0,509,1405,34,5923,41,2817,5,41
"937","2020-05-20",153,11,193,461,6053,0.259540723608128,0,0,509,1405,29,5952,48,2865,9,48
"938","2020-05-21",145,11,178,439,6053,0.259540723608128,0,0,509,1405,26,5978,45,2910,8,45
"939","2020-05-22",145,11,162,425,6053,0.259540723608128,0,0,509,1405,28,6006,39,2949,6,39
"940","2020-05-23",142,11,160,426,6053,0.259540723608128,0,0,509,1405,26,6032,42,2991,5,42
"941","2020-05-24",131,11,156,421,6053,0.259540723608128,0,0,509,1405,25,6057,48,3039,4,48
"942","2020-05-25",125,11,133,407,6053,0.259540723608128,0,0,509,1405,30,6087,46,3085,2,46
"943","2020-05-26",132,11,129,378,6053,0.259540723608128,0,0,509,1405,25,6112,37,3122,1,37
"944","2020-05-27",112,11,126,367,6053,0.259540723608128,0,0,509,1405,19,6131,44,3166,6,44
"945","2020-05-28",116,11,130,360,6053,0.259540723608128,0,0,509,1405,25,6156,66,3232,2,66
"946","2020-05-29",108,11,226,338,6053,0.259540723608128,0,0,509,1405,18,6174,61,3293,3,61
"947","2020-05-30",102,11,247,322,6053,0.259540723608128,0,0,509,1405,26,6200,42,3335,5,42
"948","2020-05-31",101,11,248,311,6053,0.259540723608128,0,0,509,1405,14,6214,39,3374,5,39
"949","2020-06-01",96,11,260,295,6053,0.259540723608128,0,0,509,1405,13,6227,36,3410,3,36
"950","2020-06-02",82,11,288,285,6053,0.259540723608128,0,0,509,1405,10,6237,39,3449,2,39
"951","2020-06-03",93,11,291,265,6053,0.259540723608128,0,0,509,1405,10,6247,35,3484,1,35
"952","2020-06-04",92,11,281,262,6053,0.259540723608128,0,0,509,1405,23,6270,37,3521,4,37
"953","2020-06-05",81,11,264,242,6053,0.259540723608128,0,0,509,1405,15,6285,37,3558,2,37
"954","2020-06-06",83,11,261,229,6053,0.259540723608128,0,0,509,1405,9,6294,30,3588,3,30
"955","2020-06-07",75,11,244,219,6053,0.259540723608128,0,0,509,1405,8,6302,38,3626,2,38
"956","2020-03-11",1,12,20,60,6601,0.201939100136343,0,0,565,1066,27,27,50,61,2,50
"957","2020-03-12",1,12,61,119,6601,0.201939100136343,0,0,565,1066,31,58,15,76,4,15
"958","2020-03-13",2,12,76,180,6601,0.201939100136343,0,0,565,1066,38,96,8,84,10,8
"959","2020-03-14",5,12,77,258,6601,0.201939100136343,0,0,565,1066,61,157,4,88,22,4
"960","2020-03-15",11,12,78,335,6601,0.201939100136343,0,0,565,1066,59,216,5,93,21,5
"961","2020-03-16",25,12,89,416,6601,0.201939100136343,0,0,565,1066,58,274,6,99,27,6
"962","2020-03-17",40,12,121,505,6601,0.201939100136343,0,0,565,1066,70,344,12,111,44,12
"963","2020-03-18",53,12,118,574,6601,0.201939100136343,0,0,565,1066,80,424,12,123,50,12
"964","2020-03-19",80,12,134,648,6601,0.201939100136343,0,0,565,1066,92,516,11,134,57,11
"965","2020-03-20",100,12,139,731,6601,0.201939100136343,0,0,565,1066,72,588,43,177,46,43
"966","2020-03-21",132,12,141,822,6601,0.201939100136343,0,0,565,1066,91,679,31,208,58,31
"967","2020-03-22",160,12,158,859,6601,0.201939100136343,0,0,565,1066,85,764,39,247,51,39
"968","2020-03-23",179,12,159,940,6601,0.201939100136343,0,0,565,1066,108,872,31,278,64,31
"969","2020-03-24",201,12,165,991,6601,0.201939100136343,0,0,565,1066,102,974,18,296,60,18
"970","2020-03-25",243,12,193,1025,6601,0.201939100136343,0,0,565,1066,111,1085,17,313,82,17
"971","2020-03-26",260,12,201,1024,6601,0.201939100136343,0,0,565,1066,106,1191,23,336,77,23
"972","2020-03-27",280,12,196,1050,6601,0.201939100136343,0,0,565,1066,124,1315,30,366,92,30
"973","2020-03-28",275,12,208,1054,6601,0.201939100136343,0,0,565,1066,102,1417,40,406,79,40
"974","2020-03-29",273,12,220,1082,6601,0.201939100136343,0,0,565,1066,106,1523,57,463,73,57
"975","2020-03-30",281,12,215,1117,6601,0.201939100136343,0,0,565,1066,105,1628,38,501,77,38
"976","2020-03-31",295,12,200,1121,6601,0.201939100136343,0,0,565,1066,111,1739,30,531,83,30
"977","2020-04-01",286,12,230,1100,6601,0.201939100136343,0,0,565,1066,106,1845,40,571,79,40
"978","2020-04-02",290,12,220,1085,6601,0.201939100136343,0,0,565,1066,100,1945,28,599,71,28
"979","2020-04-03",292,12,240,1111,6601,0.201939100136343,0,0,565,1066,104,2049,23,622,69,23
"980","2020-04-04",305,12,275,1100,6601,0.201939100136343,0,0,565,1066,109,2158,7,629,78,7
"981","2020-04-05",312,12,292,1107,6601,0.201939100136343,0,0,565,1066,119,2277,22,651,79,22
"982","2020-04-06",326,12,275,1101,6601,0.201939100136343,0,0,565,1066,119,2396,26,677,89,26
"983","2020-04-07",332,12,263,1104,6601,0.201939100136343,0,0,565,1066,100,2496,76,753,69,76
"984","2020-04-08",326,12,253,1087,6601,0.201939100136343,0,0,565,1066,98,2594,79,832,64,79
"985","2020-04-09",315,12,233,1099,6601,0.201939100136343,0,0,565,1066,110,2704,73,905,71,73
"986","2020-04-10",315,12,229,1111,6601,0.201939100136343,0,0,565,1066,106,2810,37,942,78,37
"987","2020-04-11",310,12,203,1107,6601,0.201939100136343,0,0,565,1066,116,2926,24,966,76,24
"988","2020-04-12",308,12,202,1095,6601,0.201939100136343,0,0,565,1066,113,3039,54,1020,79,54
"989","2020-04-13",280,12,231,1077,6601,0.201939100136343,0,0,565,1066,106,3145,22,1042,68,22
"990","2020-04-14",275,12,235,1062,6601,0.201939100136343,0,0,565,1066,121,3266,27,1069,88,27
"991","2020-04-15",278,12,237,1028,6601,0.201939100136343,0,0,565,1066,95,3361,40,1109,61,40
"992","2020-04-16",273,12,220,1019,6601,0.201939100136343,0,0,565,1066,104,3465,21,1130,68,21
"993","2020-04-17",270,12,214,1016,6601,0.201939100136343,0,0,565,1066,80,3545,7,1137,47,7
"994","2020-04-18",263,12,237,1001,6601,0.201939100136343,0,0,565,1066,68,3613,16,1153,47,17
"995","2020-04-19",263,12,245,975,6601,0.201939100136343,0,0,565,1066,77,3690,44,1197,42,44
"996","2020-04-20",271,12,280,974,6601,0.201939100136343,0,0,565,1066,63,3753,36,1233,43,36
"997","2020-04-21",257,12,279,966,6601,0.201939100136343,0,0,565,1066,93,3846,31,1264,63,31
"998","2020-04-22",250,12,285,952,6601,0.201939100136343,0,0,565,1066,82,3928,43,1307,47,43
"999","2020-04-23",259,12,277,940,6601,0.201939100136343,0,0,565,1066,69,3997,59,1366,39,59
"1000","2020-04-24",260,12,256,933,6601,0.201939100136343,0,0,565,1066,55,4052,37,1403,27,37
"1001","2020-04-25",276,12,256,931,6601,0.201939100136343,0,0,565,1066,60,4112,20,1423,38,20
"1002","2020-04-26",278,12,262,925,6601,0.201939100136343,0,0,565,1066,72,4184,9,1432,48,9
"1003","2020-04-27",280,12,242,920,6601,0.201939100136343,0,0,565,1066,73,4257,11,1443,49,11
"1004","2020-04-28",278,12,249,925,6601,0.201939100136343,0,0,565,1066,61,4318,19,1462,35,19
"1005","2020-04-29",277,12,257,922,6601,0.201939100136343,0,0,565,1066,75,4393,20,1482,51,20
"1006","2020-04-30",265,12,267,914,6601,0.201939100136343,0,0,565,1066,58,4451,18,1500,29,18
"1007","2020-05-01",262,12,278,892,6601,0.201939100136343,0,0,565,1066,65,4516,29,1529,33,29
"1008","2020-05-02",248,12,267,861,6601,0.201939100136343,0,0,565,1066,53,4569,63,1592,27,63
"1009","2020-05-03",250,12,267,843,6601,0.201939100136343,0,0,565,1066,53,4622,59,1651,33,59
"1010","2020-05-04",235,12,249,827,6601,0.201939100136343,0,0,565,1066,49,4671,39,1690,24,39
"1011","2020-05-05",232,12,266,813,6601,0.201939100136343,0,0,565,1066,52,4723,24,1714,26,24
"1012","2020-05-06",229,12,267,784,6601,0.201939100136343,0,0,565,1066,55,4778,65,1779,25,65
"1013","2020-05-07",231,12,259,754,6601,0.201939100136343,0,0,565,1066,51,4829,72,1851,27,72
"1014","2020-05-08",228,12,219,751,6601,0.201939100136343,0,0,565,1066,49,4878,84,1935,25,84
"1015","2020-05-09",215,12,219,732,6601,0.201939100136343,0,0,565,1066,61,4939,78,2013,38,78
"1016","2020-05-10",200,12,220,727,6601,0.201939100136343,0,0,565,1066,33,4972,44,2057,25,44
"1017","2020-05-11",203,12,267,705,6601,0.201939100136343,0,0,565,1066,48,5020,47,2104,30,47
"1018","2020-05-12",205,12,257,676,6601,0.201939100136343,0,0,565,1066,43,5063,40,2144,22,40
"1019","2020-05-13",190,12,295,649,6601,0.201939100136343,0,0,565,1066,40,5103,53,2197,22,53
"1020","2020-05-14",188,12,285,619,6601,0.201939100136343,0,0,565,1066,36,5139,43,2240,19,43
"1021","2020-05-15",177,12,265,605,6601,0.201939100136343,0,0,565,1066,36,5175,19,2259,17,19
"1022","2020-05-16",178,12,253,587,6601,0.201939100136343,0,0,565,1066,33,5208,66,2325,15,66
"1023","2020-05-17",175,12,267,586,6601,0.201939100136343,0,0,565,1066,36,5244,67,2392,12,67
"1024","2020-05-18",169,12,263,559,6601,0.201939100136343,0,0,565,1066,24,5268,62,2454,11,62
"1025","2020-05-19",152,12,257,539,6601,0.201939100136343,0,0,565,1066,27,5295,35,2489,14,35
"1026","2020-05-20",154,12,225,507,6601,0.201939100136343,0,0,565,1066,22,5317,17,2506,9,17
"1027","2020-05-21",147,12,213,473,6601,0.201939100136343,0,0,565,1066,30,5347,21,2527,16,21
"1028","2020-05-22",138,12,228,440,6601,0.201939100136343,0,0,565,1066,27,5374,17,2544,15,17
"1029","2020-05-23",129,12,220,416,6601,0.201939100136343,0,0,565,1066,25,5399,15,2559,13,15
"1030","2020-05-24",127,12,221,398,6601,0.201939100136343,0,0,565,1066,29,5428,15,2574,17,15
"1031","2020-05-25",121,12,202,373,6601,0.201939100136343,0,0,565,1066,21,5449,46,2620,12,46
"1032","2020-05-26",119,12,209,352,6601,0.201939100136343,0,0,565,1066,19,5468,53,2673,11,53
"1033","2020-05-27",109,12,216,341,6601,0.201939100136343,0,0,565,1066,21,5489,25,2698,13,25
"1034","2020-05-28",99,12,218,327,6601,0.201939100136343,0,0,565,1066,15,5504,35,2733,6,35
"1035","2020-05-29",94,12,216,316,6601,0.201939100136343,0,0,565,1066,19,5523,29,2762,9,29
"1036","2020-05-30",92,12,231,297,6601,0.201939100136343,0,0,565,1066,12,5535,31,2793,8,31
"1037","2020-05-31",79,12,248,278,6601,0.201939100136343,0,0,565,1066,13,5548,30,2823,5,30
"1038","2020-06-01",74,12,236,266,6601,0.201939100136343,0,0,565,1066,20,5568,43,2866,5,43
"1039","2020-06-02",69,12,221,259,6601,0.201939100136343,0,0,565,1066,19,5587,59,2925,13,59
"1040","2020-06-03",68,12,210,245,6601,0.201939100136343,0,0,565,1066,22,5609,62,2987,14,62
"1041","2020-06-04",70,12,182,237,6601,0.201939100136343,0,0,565,1066,11,5620,65,3052,8,65
"1042","2020-06-05",70,12,176,241,6601,0.201939100136343,0,0,565,1066,14,5634,42,3094,9,42
"1043","2020-06-06",66,12,177,231,6601,0.201939100136343,0,0,565,1066,6,5640,20,3114,4,20
"1044","2020-06-07",72,12,180,222,6601,0.201939100136343,0,0,565,1066,20,5660,39,3153,9,39
"1045","2020-03-13",3,13,73,81,3200,0.36125,0,0,270,865,58,165,15,52,7,15
"1046","2020-03-14",4,13,74,105,3200,0.36125,0,0,270,865,43,208,12,64,14,12
"1047","2020-03-15",9,13,86,147,3200,0.36125,0,0,270,865,70,278,19,83,15,19
"1048","2020-03-16",16,13,93,177,3200,0.36125,0,0,270,865,53,331,17,100,13,17
"1049","2020-03-17",24,13,104,219,3200,0.36125,0,0,270,865,74,405,7,107,24,7
"1050","2020-03-18",29,13,101,256,3200,0.36125,0,0,270,865,77,482,6,113,27,6
"1051","2020-03-19",36,13,131,297,3200,0.36125,0,0,270,865,83,565,9,122,32,9
"1052","2020-03-20",47,13,160,330,3200,0.36125,0,0,270,865,75,640,4,126,36,4
"1053","2020-03-21",57,13,187,362,3200,0.36125,0,0,270,865,88,728,6,132,44,6
"1054","2020-03-22",70,13,185,395,3200,0.36125,0,0,270,865,86,814,12,144,31,12
"1055","2020-03-23",79,13,173,424,3200,0.36125,0,0,270,865,84,898,16,160,41,16
"1056","2020-03-24",90,13,165,453,3200,0.36125,0,0,270,865,111,1009,24,184,53,24
"1057","2020-03-25",105,13,166,458,3200,0.36125,0,0,270,865,87,1096,16,200,40,16
"1058","2020-03-26",112,13,176,461,3200,0.36125,0,0,270,865,85,1181,27,227,37,27
"1059","2020-03-27",119,13,174,474,3200,0.36125,0,0,270,865,76,1257,36,263,38,36
"1060","2020-03-28",129,13,203,488,3200,0.36125,0,0,270,865,84,1341,40,303,44,40
"1061","2020-03-29",125,13,243,496,3200,0.36125,0,0,270,865,100,1441,46,349,43,46
"1062","2020-03-30",126,13,241,505,3200,0.36125,0,0,270,865,82,1523,54,403,23,54
"1063","2020-03-31",128,13,227,487,3200,0.36125,0,0,270,865,78,1601,34,437,34,34
"1064","2020-04-01",120,13,218,474,3200,0.36125,0,0,270,865,70,1671,22,459,18,22
"1065","2020-04-02",130,13,211,481,3200,0.36125,0,0,270,865,72,1743,19,478,20,19
"1066","2020-04-03",119,13,219,478,3200,0.36125,0,0,270,865,86,1829,10,488,32,10
"1067","2020-04-04",115,13,215,470,3200,0.36125,0,0,270,865,76,1905,16,504,31,16
"1068","2020-04-05",125,13,239,458,3200,0.36125,0,0,270,865,86,1991,11,515,30,11
"1069","2020-04-06",135,13,249,453,3200,0.36125,0,0,270,865,92,2083,8,523,26,8
"1070","2020-04-07",132,13,279,454,3200,0.36125,0,0,270,865,89,2172,29,552,41,29
"1071","2020-04-08",143,13,309,448,3200,0.36125,0,0,270,865,76,2248,14,566,13,14
"1072","2020-04-09",133,13,272,445,3200,0.36125,0,0,270,865,96,2344,26,592,36,26
"1073","2020-04-10",143,13,246,446,3200,0.36125,0,0,270,865,64,2408,32,624,24,32
"1074","2020-04-11",140,13,237,461,3200,0.36125,0,0,270,865,76,2484,26,650,34,26
"1075","2020-04-12",144,13,254,490,3200,0.36125,0,0,270,865,87,2571,46,696,32,46
"1076","2020-04-13",138,13,296,489,3200,0.36125,0,0,270,865,81,2652,42,738,20,42
"1077","2020-04-14",137,13,282,484,3200,0.36125,0,0,270,865,79,2731,25,763,24,25
"1078","2020-04-15",135,13,275,486,3200,0.36125,0,0,270,865,70,2801,33,796,24,33
"1079","2020-04-16",140,13,260,482,3200,0.36125,0,0,270,865,81,2882,61,857,21,61
"1080","2020-04-17",138,13,262,486,3200,0.36125,0,0,270,865,54,2936,24,881,20,24
"1081","2020-04-18",144,13,258,474,3200,0.36125,0,0,270,865,63,2999,11,892,21,11
"1082","2020-04-19",148,13,244,472,3200,0.36125,0,0,270,865,73,3072,6,898,23,6
"1083","2020-04-20",140,13,248,466,3200,0.36125,0,0,270,865,74,3146,38,936,22,38
"1084","2020-04-21",136,13,274,463,3200,0.36125,0,0,270,865,70,3216,62,998,17,62
"1085","2020-04-22",129,13,269,476,3200,0.36125,0,0,270,865,75,3291,49,1047,16,49
"1086","2020-04-23",127,13,276,482,3200,0.36125,0,0,270,865,67,3358,37,1084,7,37
"1087","2020-04-24",120,13,280,473,3200,0.36125,0,0,270,865,71,3429,24,1108,15,24
"1088","2020-04-25",124,13,283,473,3200,0.36125,0,0,270,865,70,3499,27,1135,21,27
"1089","2020-04-26",109,13,305,460,3200,0.36125,0,0,270,865,65,3564,16,1151,17,16
"1090","2020-04-27",110,13,332,441,3200,0.36125,0,0,270,865,80,3644,11,1162,17,11
"1091","2020-04-28",113,13,314,440,3200,0.36125,0,0,270,865,77,3721,34,1196,25,34
"1092","2020-04-29",116,13,302,441,3200,0.36125,0,0,270,865,51,3772,35,1231,14,35
"1093","2020-04-30",113,13,304,431,3200,0.36125,0,0,270,865,73,3845,21,1252,20,21
"1094","2020-05-01",122,13,293,424,3200,0.36125,0,0,270,865,51,3896,21,1273,10,21
"1095","2020-05-02",116,13,281,419,3200,0.36125,0,0,270,865,68,3964,37,1310,18,37
"1096","2020-05-03",119,13,292,418,3200,0.36125,0,0,270,865,46,4010,24,1334,14,24
"1097","2020-05-04",121,13,274,412,3200,0.36125,0,0,270,865,73,4083,19,1353,17,19
"1098","2020-05-05",124,13,272,411,3200,0.36125,0,0,270,865,56,4139,9,1362,18,9
"1099","2020-05-06",118,13,272,409,3200,0.36125,0,0,270,865,41,4180,11,1373,12,11
"1100","2020-05-07",120,13,272,410,3200,0.36125,0,0,270,865,55,4235,19,1392,17,19
"1101","2020-05-08",114,13,278,398,3200,0.36125,0,0,270,865,53,4288,17,1409,13,17
"1102","2020-05-09",112,13,282,382,3200,0.36125,0,0,270,865,47,4335,24,1433,15,24
"1103","2020-05-10",106,13,283,382,3200,0.36125,0,0,270,865,42,4377,36,1469,9,36
"1104","2020-05-11",102,13,294,379,3200,0.36125,0,0,270,865,52,4429,24,1493,18,24
"1105","2020-05-12",96,13,294,375,3200,0.36125,0,0,270,865,47,4476,63,1556,11,63
"1106","2020-05-13",104,13,297,395,3200,0.36125,0,0,270,865,36,4512,56,1612,7,56
"1107","2020-05-14",98,13,285,374,3200,0.36125,0,0,270,865,48,4560,41,1653,6,41
"1108","2020-05-15",104,13,288,362,3200,0.36125,0,0,270,865,37,4597,35,1688,10,35
"1109","2020-05-16",105,13,279,338,3200,0.36125,0,0,270,865,31,4628,30,1718,6,30
"1110","2020-05-17",104,13,292,333,3200,0.36125,0,0,270,865,45,4673,25,1743,13,25
"1111","2020-05-18",104,13,305,324,3200,0.36125,0,0,270,865,38,4711,38,1781,10,38
"1112","2020-05-19",104,13,318,317,3200,0.36125,0,0,270,865,37,4748,31,1812,9,31
"1113","2020-05-20",98,13,313,308,3200,0.36125,0,0,270,865,40,4788,46,1858,9,46
"1114","2020-05-21",101,13,301,308,3200,0.36125,0,0,270,865,38,4826,56,1914,8,56
"1115","2020-05-22",89,13,303,306,3200,0.36125,0,0,270,865,26,4852,69,1983,3,69
"1116","2020-05-23",79,13,267,295,3200,0.36125,0,0,270,865,33,4885,29,2012,9,29
"1117","2020-05-24",77,13,239,285,3200,0.36125,0,0,270,865,24,4909,44,2056,6,44
"1118","2020-05-25",77,13,224,274,3200,0.36125,0,0,270,865,25,4934,47,2103,6,47
"1119","2020-05-26",76,13,217,265,3200,0.36125,0,0,270,865,18,4952,25,2128,5,25
"1120","2020-05-27",77,13,201,263,3200,0.36125,0,0,270,865,16,4968,19,2147,4,19
"1121","2020-05-28",77,13,210,254,3200,0.36125,0,0,270,865,24,4992,13,2160,8,13
"1122","2020-05-29",79,13,217,248,3200,0.36125,0,0,270,865,23,5015,19,2179,6,19
"1123","2020-05-30",80,13,237,230,3200,0.36125,0,0,270,865,23,5038,10,2189,7,10
"1124","2020-05-31",77,13,258,233,3200,0.36125,0,0,270,865,17,5055,16,2205,5,16
"1125","2020-06-01",73,13,275,221,3200,0.36125,0,0,270,865,22,5077,14,2219,5,14
"1126","2020-06-02",71,13,289,215,3200,0.36125,0,0,270,865,27,5104,16,2235,8,16
"1127","2020-06-03",66,13,281,206,3200,0.36125,0,0,270,865,24,5128,13,2248,4,13
"1128","2020-06-04",61,13,266,198,3200,0.36125,0,0,270,865,18,5146,44,2292,6,44
"1129","2020-06-05",58,13,277,189,3200,0.36125,0,0,270,865,15,5161,32,2324,3,32
"1130","2020-06-06",59,13,277,184,3200,0.36125,0,0,270,865,15,5176,12,2336,5,12
"1131","2020-06-07",59,13,283,183,3200,0.36125,0,0,270,865,18,5194,31,2367,8,31
"1132","2020-03-13",1,14,129,103,7229,0.805505602434638,0,0,558,1254,76,196,12,67,34,12
"1133","2020-03-14",7,14,170,152,7229,0.805505602434638,0,0,558,1254,107,303,9,76,68,9
"1134","2020-03-15",12,14,180,211,7229,0.805505602434638,0,0,558,1254,123,426,5,81,86,5
"1135","2020-03-16",19,14,170,277,7229,0.805505602434638,0,0,558,1254,153,579,11,92,106,11
"1136","2020-03-17",26,14,165,358,7229,0.805505602434638,0,0,558,1254,160,739,57,149,130,57
"1137","2020-03-18",31,14,155,452,7229,0.805505602434638,0,0,558,1254,241,980,28,177,202,28
"1138","2020-03-19",45,14,151,540,7229,0.805505602434638,0,0,558,1254,289,1269,49,226,258,49
"1139","2020-03-20",64,14,190,650,7229,0.805505602434638,0,0,558,1254,337,1606,25,251,300,25
"1140","2020-03-21",89,14,191,749,7229,0.805505602434638,0,0,558,1254,450,2056,11,262,408,11
"1141","2020-03-22",115,14,234,869,7229,0.805505602434638,0,0,558,1254,487,2543,9,271,451,9
"1142","2020-03-23",141,14,231,977,7229,0.805505602434638,0,0,558,1254,508,3051,12,283,475,12
"1143","2020-03-24",188,14,221,1085,7229,0.805505602434638,0,0,558,1254,507,3558,13,296,480,13
"1144","2020-03-25",214,14,234,1215,7229,0.805505602434638,0,0,558,1254,644,4202,13,309,619,13
"1145","2020-03-26",240,14,236,1392,7229,0.805505602434638,0,0,558,1254,584,4786,25,334,555,25
"1146","2020-03-27",265,14,226,1478,7229,0.805505602434638,0,0,558,1254,492,5278,22,356,476,22
"1147","2020-03-28",297,14,215,1594,7229,0.805505602434638,0,0,558,1254,429,5707,63,419,410,63
"1148","2020-03-29",335,14,196,1689,7229,0.805505602434638,0,0,558,1254,314,6021,80,499,297,80
"1149","2020-03-30",363,14,192,1783,7229,0.805505602434638,0,0,558,1254,306,6327,46,545,301,46
"1150","2020-03-31",383,14,183,1885,7229,0.805505602434638,0,0,558,1254,337,6664,41,586,330,41
"1151","2020-04-01",422,14,179,1983,7229,0.805505602434638,0,0,558,1254,223,6887,18,604,214,18
"1152","2020-04-02",481,14,187,2056,7229,0.805505602434638,0,0,558,1254,200,7087,22,626,192,22
"1153","2020-04-03",515,14,223,2129,7229,0.805505602434638,0,0,558,1254,166,7253,34,660,162,34
"1154","2020-04-04",539,14,253,2191,7229,0.805505602434638,0,0,558,1254,103,7356,37,697,99,37
"1155","2020-04-05",554,14,252,2234,7229,0.805505602434638,0,0,558,1254,79,7435,32,729,73,32
"1156","2020-04-06",580,14,233,2253,7229,0.805505602434638,0,0,558,1254,63,7498,29,758,62,29
"1157","2020-04-07",591,14,231,2268,7229,0.805505602434638,0,0,558,1254,42,7540,51,809,38,51
"1158","2020-04-08",607,14,226,2269,7229,0.805505602434638,0,0,558,1254,30,7570,35,844,27,35
"1159","2020-04-09",596,14,211,2228,7229,0.805505602434638,0,0,558,1254,32,7602,20,864,30,20
"1160","2020-04-10",599,14,201,2145,7229,0.805505602434638,0,0,558,1254,31,7633,18,882,30,18
"1161","2020-04-11",597,14,203,2122,7229,0.805505602434638,0,0,558,1254,19,7652,14,896,15,14
"1162","2020-04-12",600,14,204,2017,7229,0.805505602434638,0,0,558,1254,12,7664,14,910,9,14
"1163","2020-04-13",592,14,244,1929,7229,0.805505602434638,0,0,558,1254,14,7678,28,938,10,28
"1164","2020-04-14",584,14,278,1886,7229,0.805505602434638,0,0,558,1254,9,7687,21,959,7,21
"1165","2020-04-15",565,14,273,1784,7229,0.805505602434638,0,0,558,1254,5,7692,10,969,3,10
"1166","2020-04-16",545,14,275,1681,7229,0.805505602434638,0,0,558,1254,10,7702,13,982,8,13
"1167","2020-04-17",542,14,259,1559,7229,0.805505602434638,0,0,558,1254,3,7705,33,1015,2,33
"1168","2020-04-18",521,14,275,1446,7229,0.805505602434638,0,0,558,1254,9,7714,20,1035,7,20
"1169","2020-04-19",507,14,308,1334,7229,0.805505602434638,0,0,558,1254,1,7715,11,1046,1,11
"1170","2020-04-20",483,14,320,1235,7229,0.805505602434638,0,0,558,1254,7,7722,8,1054,6,8
"1171","2020-04-21",446,14,316,1162,7229,0.805505602434638,0,0,558,1254,7,7729,9,1063,3,9
"1172","2020-04-22",418,14,314,1103,7229,0.805505602434638,0,0,558,1254,6,7735,5,1068,1,5
"1173","2020-04-23",395,14,297,1026,7229,0.805505602434638,0,0,558,1254,3,7738,26,1094,2,26
"1174","2020-04-24",361,14,292,952,7229,0.805505602434638,0,0,558,1254,5,7743,24,1118,2,24
"1175","2020-04-25",333,14,286,879,7229,0.805505602434638,0,0,558,1254,3,7746,25,1143,1,25
"1176","2020-04-26",300,14,301,824,7229,0.805505602434638,0,0,558,1254,3,7749,18,1161,2,18
"1177","2020-04-27",287,14,306,767,7229,0.805505602434638,0,0,558,1254,4,7753,26,1187,2,26
"1178","2020-04-28",278,14,300,704,7229,0.805505602434638,0,0,558,1254,1,7754,14,1201,NA,14
"1179","2020-04-29",263,14,278,668,7229,0.805505602434638,0,0,558,1254,4,7758,13,1214,1,13
"1180","2020-04-30",244,14,291,635,7229,0.805505602434638,0,0,558,1254,5,7763,20,1234,1,20
"1181","2020-05-01",226,14,281,620,7229,0.805505602434638,0,0,558,1254,1,7764,40,1274,1,40
"1182","2020-05-02",210,14,272,578,7229,0.805505602434638,0,0,558,1254,3,7767,26,1300,1,26
"1183","2020-05-03",187,14,278,523,7229,0.805505602434638,0,0,558,1254,3,7770,20,1320,1,20
"1184","2020-05-04",167,14,261,501,7229,0.805505602434638,0,0,558,1254,3,7773,15,1335,3,15
"1185","2020-05-05",165,14,268,466,7229,0.805505602434638,0,0,558,1254,1,7774,7,1342,NA,7
"1186","2020-05-06",162,14,260,441,7229,0.805505602434638,0,0,558,1254,3,7777,3,1345,NA,3
"1187","2020-05-07",155,14,262,420,7229,0.805505602434638,0,0,558,1254,5,7782,12,1357,5,12
"1188","2020-05-08",141,14,279,403,7229,0.805505602434638,0,0,558,1254,NA,NA,24,1381,NA,24
"1189","2020-05-09",136,14,322,386,7229,0.805505602434638,0,0,558,1254,4,7786,55,1436,3,55
"1190","2020-05-10",135,14,336,368,7229,0.805505602434638,0,0,558,1254,2,7788,33,1469,1,33
"1191","2020-05-11",126,14,310,348,7229,0.805505602434638,0,0,558,1254,2,7790,20,1489,2,20
"1192","2020-05-12",110,14,300,339,7229,0.805505602434638,0,0,558,1254,1,7791,11,1500,NA,11
"1193","2020-05-13",101,14,297,302,7229,0.805505602434638,0,0,558,1254,3,7794,11,1511,1,11
"1194","2020-05-14",93,14,279,284,7229,0.805505602434638,0,0,558,1254,2,7796,29,1540,1,29
"1195","2020-05-15",89,14,274,263,7229,0.805505602434638,0,0,558,1254,NA,NA,15,1555,NA,15
"1196","2020-05-16",81,14,260,254,7229,0.805505602434638,0,0,558,1254,3,7799,17,1572,1,17
"1197","2020-05-17",79,14,289,237,7229,0.805505602434638,0,0,558,1254,3,7802,9,1581,1,9
"1198","2020-05-18",74,14,297,221,7229,0.805505602434638,0,0,558,1254,1,7803,23,1604,1,23
"1199","2020-05-19",67,14,327,203,7229,0.805505602434638,0,0,558,1254,1,7804,26,1630,NA,26
"1200","2020-05-20",58,14,312,177,7229,0.805505602434638,0,0,558,1254,NA,NA,16,1646,NA,16
"1201","2020-05-21",51,14,284,175,7229,0.805505602434638,0,0,558,1254,1,7805,16,1662,NA,16
"1202","2020-05-22",52,14,273,159,7229,0.805505602434638,0,0,558,1254,NA,NA,15,1677,NA,15
"1203","2020-05-23",48,14,252,154,7229,0.805505602434638,0,0,558,1254,NA,NA,20,1697,NA,20
"1204","2020-05-24",42,14,253,137,7229,0.805505602434638,0,0,558,1254,2,7807,22,1719,1,22
"1205","2020-05-25",40,14,244,135,7229,0.805505602434638,0,0,558,1254,NA,NA,12,1731,NA,12
"1206","2020-05-26",43,14,232,121,7229,0.805505602434638,0,0,558,1254,1,7808,16,1747,NA,16
"1207","2020-05-27",44,14,231,118,7229,0.805505602434638,0,0,558,1254,2,7810,44,1791,1,44
"1208","2020-05-28",41,14,232,115,7229,0.805505602434638,0,0,558,1254,2,7812,23,1814,1,23
"1209","2020-05-29",35,14,231,111,7229,0.805505602434638,0,0,558,1254,2,7814,61,1875,2,61
"1210","2020-05-30",41,14,266,108,7229,0.805505602434638,0,0,558,1254,2,7816,74,1949,NA,74
"1211","2020-05-31",36,14,269,108,7229,0.805505602434638,0,0,558,1254,1,7817,32,1981,1,32
"1212","2020-06-01",37,14,255,100,7229,0.805505602434638,0,0,558,1254,4,7821,20,2001,1,20
"1213","2020-06-02",33,14,270,95,7229,0.805505602434638,0,0,558,1254,1,7822,12,2013,1,12
"1214","2020-06-03",34,14,293,94,7229,0.805505602434638,0,0,558,1254,NA,NA,6,2019,NA,6
"1215","2020-06-04",36,14,263,84,7229,0.805505602434638,0,0,558,1254,1,7823,15,2034,NA,15
"1216","2020-06-05",35,14,253,79,7229,0.805505602434638,0,0,558,1254,NA,NA,38,2072,NA,38
"1217","2020-06-06",29,14,245,80,7229,0.805505602434638,0,0,558,1254,NA,NA,25,2097,NA,25
"1218","2020-06-07",27,14,245,79,7229,0.805505602434638,0,0,558,1254,NA,NA,17,2114,NA,17
"1219","2020-03-12",2,15,214,201,9480,0.758544303797468,0,0,876,2173,97,185,26,57,2,26
"1220","2020-03-13",6,15,301,338,9480,0.758544303797468,0,0,876,2173,116,301,11,68,8,11
"1221","2020-03-14",13,15,296,535,9480,0.758544303797468,0,0,876,2173,89,390,14,82,17,14
"1222","2020-03-15",30,15,261,793,9480,0.758544303797468,0,0,876,2173,108,498,29,111,14,29
"1223","2020-03-16",51,15,243,1125,9480,0.758544303797468,0,0,876,2173,112,610,32,143,30,32
"1224","2020-03-17",87,15,243,1614,9480,0.758544303797468,0,0,876,2173,112,722,39,182,33,39
"1225","2020-03-18",132,15,239,2074,9480,0.758544303797468,0,0,876,2173,123,845,17,199,33,17
"1226","2020-03-19",206,15,250,2586,9480,0.758544303797468,0,0,876,2173,125,970,20,219,35,20
"1227","2020-03-20",285,15,269,3197,9480,0.758544303797468,0,0,876,2173,115,1085,51,270,36,51
"1228","2020-03-21",383,15,259,3684,9480,0.758544303797468,0,0,876,2173,106,1191,24,294,37,24
"1229","2020-03-22",515,15,219,4324,9480,0.758544303797468,0,0,876,2173,128,1319,24,318,37,24
"1230","2020-03-23",668,15,226,4914,9480,0.758544303797468,0,0,876,2173,116,1435,16,334,36,16
"1231","2020-03-24",818,15,235,5257,9480,0.758544303797468,0,0,876,2173,121,1556,9,343,42,9
"1232","2020-03-25",995,15,214,5519,9480,0.758544303797468,0,0,876,2173,104,1660,19,362,36,19
"1233","2020-03-26",1130,15,189,5632,9480,0.758544303797468,0,0,876,2173,127,1787,43,405,45,43
"1234","2020-03-27",1269,15,203,5568,9480,0.758544303797468,0,0,876,2173,125,1912,16,421,48,16
"1235","2020-03-28",1404,15,258,5410,9480,0.758544303797468,0,0,876,2173,106,2018,12,433,29,12
"1236","2020-03-29",1473,15,251,5161,9480,0.758544303797468,0,0,876,2173,123,2141,17,450,37,17
"1237","2020-03-30",1543,15,242,4778,9480,0.758544303797468,0,0,876,2173,122,2263,6,456,43,6
"1238","2020-03-31",1559,15,215,4349,9480,0.758544303797468,0,0,876,2173,126,2389,11,467,43,11
"1239","2020-04-01",1493,15,224,3895,9480,0.758544303797468,0,0,876,2173,121,2510,13,480,39,13
"1240","2020-04-02",1454,15,247,3440,9480,0.758544303797468,0,0,876,2173,101,2611,16,496,27,16
"1241","2020-04-03",1370,15,253,2976,9480,0.758544303797468,0,0,876,2173,114,2725,17,513,38,17
"1242","2020-04-04",1247,15,252,2565,9480,0.758544303797468,0,0,876,2173,99,2824,7,520,32,7
"1243","2020-04-05",1116,15,276,2152,9480,0.758544303797468,0,0,876,2173,105,2929,18,538,34,18
"1244","2020-04-06",940,15,254,1779,9480,0.758544303797468,0,0,876,2173,114,3043,23,561,32,23
"1245","2020-04-07",789,15,272,1468,9480,0.758544303797468,0,0,876,2173,105,3148,32,593,35,32
"1246","2020-04-08",686,15,269,1238,9480,0.758544303797468,0,0,876,2173,117,3265,31,624,31,31
"1247","2020-04-09",550,15,279,1029,9480,0.758544303797468,0,0,876,2173,109,3374,21,645,34,21
"1248","2020-04-10",455,15,265,852,9480,0.758544303797468,0,0,876,2173,107,3481,15,660,26,15
"1249","2020-04-11",358,15,250,703,9480,0.758544303797468,0,0,876,2173,88,3569,12,672,24,12
"1250","2020-04-12",296,15,229,587,9480,0.758544303797468,0,0,876,2173,104,3673,14,686,33,14
"1251","2020-04-13",245,15,224,475,9480,0.758544303797468,0,0,876,2173,97,3770,19,705,29,19
"1252","2020-04-14",205,15,210,408,9480,0.758544303797468,0,0,876,2173,90,3860,15,720,27,15
"1253","2020-04-15",161,15,208,343,9480,0.758544303797468,0,0,876,2173,104,3964,18,738,28,18
"1254","2020-04-16",137,15,189,291,9480,0.758544303797468,0,0,876,2173,95,4059,57,795,16,57
"1255","2020-04-17",97,15,195,253,9480,0.758544303797468,0,0,876,2173,102,4161,60,855,18,60
"1256","2020-04-18",80,15,228,216,9480,0.758544303797468,0,0,876,2173,72,4233,33,888,8,33
"1257","2020-04-19",64,15,261,193,9480,0.758544303797468,0,0,876,2173,81,4314,55,943,17,55
"1258","2020-04-20",51,15,248,168,9480,0.758544303797468,0,0,876,2173,83,4397,25,968,17,25
"1259","2020-04-21",42,15,229,151,9480,0.758544303797468,0,0,876,2173,84,4481,42,1010,14,42
"1260","2020-04-22",35,15,223,126,9480,0.758544303797468,0,0,876,2173,69,4550,53,1063,7,53
"1261","2020-04-23",26,15,215,103,9480,0.758544303797468,0,0,876,2173,76,4626,40,1103,13,40
"1262","2020-04-24",25,15,226,95,9480,0.758544303797468,0,0,876,2173,78,4704,33,1136,14,33
"1263","2020-04-25",22,15,235,87,9480,0.758544303797468,0,0,876,2173,72,4776,48,1184,19,48
"1264","2020-04-26",19,15,241,78,9480,0.758544303797468,0,0,876,2173,67,4843,47,1231,10,47
"1265","2020-04-27",15,15,244,72,9480,0.758544303797468,0,0,876,2173,60,4903,29,1260,12,29
"1266","2020-04-28",14,15,246,64,9480,0.758544303797468,0,0,876,2173,66,4969,21,1281,7,21
"1267","2020-04-29",14,15,234,55,9480,0.758544303797468,0,0,876,2173,63,5032,19,1300,11,19
"1268","2020-04-30",14,15,212,51,9480,0.758544303797468,0,0,876,2173,66,5098,13,1313,9,13
"1269","2020-05-01",12,15,219,44,9480,0.758544303797468,0,0,876,2173,66,5164,14,1327,9,14
"1270","2020-05-02",13,15,211,44,9480,0.758544303797468,0,0,876,2173,65,5229,21,1348,8,21
"1271","2020-05-03",7,15,204,38,9480,0.758544303797468,0,0,876,2173,58,5287,62,1410,6,62
"1272","2020-05-04",8,15,196,33,9480,0.758544303797468,0,0,876,2173,61,5348,40,1450,8,40
"1273","2020-05-05",8,15,209,35,9480,0.758544303797468,0,0,876,2173,49,5397,34,1484,4,34
"1274","2020-05-06",6,15,216,32,9480,0.758544303797468,0,0,876,2173,56,5453,11,1495,9,11
"1275","2020-05-07",3,15,232,28,9480,0.758544303797468,0,0,876,2173,74,5527,15,1510,14,15
"1276","2020-05-08",3,15,236,26,9480,0.758544303797468,0,0,876,2173,39,5566,12,1522,7,12
"1277","2020-05-09",3,15,228,24,9480,0.758544303797468,0,0,876,2173,54,5620,7,1529,11,7
"1278","2020-05-10",4,15,220,22,9480,0.758544303797468,0,0,876,2173,47,5667,6,1535,8,6
"1279","2020-05-11",4,15,265,18,9480,0.758544303797468,0,0,876,2173,37,5704,4,1539,8,4
"1280","2020-05-12",4,15,261,18,9480,0.758544303797468,0,0,876,2173,41,5745,12,1551,11,12
"1281","2020-05-13",4,15,258,17,9480,0.758544303797468,0,0,876,2173,38,5783,11,1562,6,11
"1282","2020-05-14",4,15,279,16,9480,0.758544303797468,0,0,876,2173,42,5825,13,1575,6,13
"1283","2020-05-15",5,15,306,13,9480,0.758544303797468,0,0,876,2173,33,5858,15,1590,6,15
"1284","2020-05-16",5,15,300,12,9480,0.758544303797468,0,0,876,2173,45,5903,36,1626,6,36
"1285","2020-05-17",4,15,287,13,9480,0.758544303797468,0,0,876,2173,46,5949,50,1676,8,50
"1286","2020-05-18",3,15,260,10,9480,0.758544303797468,0,0,876,2173,33,5982,56,1732,8,56
"1287","2020-05-19",3,15,238,10,9480,0.758544303797468,0,0,876,2173,31,6013,68,1800,9,68
"1288","2020-05-20",3,15,232,11,9480,0.758544303797468,0,0,876,2173,30,6043,35,1835,2,35
"1289","2020-05-21",3,15,212,11,9480,0.758544303797468,0,0,876,2173,34,6077,38,1873,5,38
"1290","2020-05-22",3,15,204,11,9480,0.758544303797468,0,0,876,2173,30,6107,32,1905,3,32
"1291","2020-05-23",3,15,202,11,9480,0.758544303797468,0,0,876,2173,36,6143,59,1964,6,59
"1292","2020-05-24",3,15,181,10,9480,0.758544303797468,0,0,876,2173,24,6167,49,2013,4,49
"1293","2020-05-25",4,15,176,12,9480,0.758544303797468,0,0,876,2173,17,6184,54,2067,1,54
"1294","2020-05-26",3,15,179,11,9480,0.758544303797468,0,0,876,2173,21,6205,50,2117,2,50
"1295","2020-05-27",3,15,182,12,9480,0.758544303797468,0,0,876,2173,23,6228,28,2145,3,28
"1296","2020-05-28",4,15,177,10,9480,0.758544303797468,0,0,876,2173,22,6250,46,2191,3,46
"1297","2020-05-29",4,15,168,11,9480,0.758544303797468,0,0,876,2173,17,6267,35,2226,NA,35
"1298","2020-05-30",3,15,183,10,9480,0.758544303797468,0,0,876,2173,22,6289,15,2241,4,15
"1299","2020-05-31",4,15,181,8,9480,0.758544303797468,0,0,876,2173,22,6311,18,2259,2,18
"1300","2020-06-01",3,15,187,10,9480,0.758544303797468,0,0,876,2173,25,6336,24,2283,3,24
"1301","2020-06-02",3,15,181,10,9480,0.758544303797468,0,0,876,2173,15,6351,20,2303,1,20
"1302","2020-06-03",3,15,167,10,9480,0.758544303797468,0,0,876,2173,14,6365,16,2319,1,16
"1303","2020-06-04",2,15,224,9,9480,0.758544303797468,0,0,876,2173,11,6376,19,2338,2,19
"1304","2020-06-05",2,15,264,7,9480,0.758544303797468,0,0,876,2173,16,6392,13,2351,3,13
"1305","2020-06-06",2,15,261,7,9480,0.758544303797468,0,0,876,2173,18,6410,11,2362,NA,11
"1306","2020-06-07",1,15,231,7,9480,0.758544303797468,0,0,876,2173,22,6432,12,2374,2,12
"1307","2020-03-13",1,16,197,88,4074,0.413598429062347,0,0,374,1465,67,192,19,75,11,19
"1308","2020-03-14",3,16,212,119,4074,0.413598429062347,0,0,374,1465,57,249,31,106,12,31
"1309","2020-03-15",8,16,214,166,4074,0.413598429062347,0,0,374,1465,81,330,60,166,19,60
"1310","2020-03-16",12,16,224,202,4074,0.413598429062347,0,0,374,1465,76,406,53,219,20,53
"1311","2020-03-17",19,16,225,251,4074,0.413598429062347,0,0,374,1465,96,502,74,293,31,74
"1312","2020-03-18",29,16,216,298,4074,0.413598429062347,0,0,374,1465,83,585,52,345,29,52
"1313","2020-03-19",42,16,232,340,4074,0.413598429062347,0,0,374,1465,74,659,75,420,30,75
"1314","2020-03-20",49,16,240,389,4074,0.413598429062347,0,0,374,1465,98,757,47,467,32,47
"1315","2020-03-21",61,16,247,408,4074,0.413598429062347,0,0,374,1465,115,872,46,513,46,46
"1316","2020-03-22",73,16,254,440,4074,0.413598429062347,0,0,374,1465,88,960,41,554,34,41
"1317","2020-03-23",95,16,236,467,4074,0.413598429062347,0,0,374,1465,98,1058,33,587,45,33
"1318","2020-03-24",110,16,269,480,4074,0.413598429062347,0,0,374,1465,113,1171,58,645,44,58
"1319","2020-03-25",120,16,257,490,4074,0.413598429062347,0,0,374,1465,94,1265,37,682,43,37
"1320","2020-03-26",136,16,239,506,4074,0.413598429062347,0,0,374,1465,89,1354,47,729,31,47
"1321","2020-03-27",145,16,229,529,4074,0.413598429062347,0,0,374,1465,93,1447,37,766,39,37
"1322","2020-03-28",155,16,223,532,4074,0.413598429062347,0,0,374,1465,101,1548,34,800,44,34
"1323","2020-03-29",158,16,216,520,4074,0.413598429062347,0,0,374,1465,100,1648,31,831,33,31
"1324","2020-03-30",153,16,198,512,4074,0.413598429062347,0,0,374,1465,103,1751,31,862,43,31
"1325","2020-03-31",153,16,197,519,4074,0.413598429062347,0,0,374,1465,120,1871,23,885,44,23
"1326","2020-04-01",157,16,180,525,4074,0.413598429062347,0,0,374,1465,105,1976,39,924,44,39
"1327","2020-04-02",141,16,176,532,4074,0.413598429062347,0,0,374,1465,86,2062,30,954,40,30
"1328","2020-04-03",147,16,176,548,4074,0.413598429062347,0,0,374,1465,81,2143,32,986,38,32
"1329","2020-04-04",144,16,197,559,4074,0.413598429062347,0,0,374,1465,104,2247,26,1012,47,26
"1330","2020-04-05",148,16,207,554,4074,0.413598429062347,0,0,374,1465,98,2345,26,1038,39,26
"1331","2020-04-06",154,16,248,576,4074,0.413598429062347,0,0,374,1465,102,2447,46,1084,40,46
"1332","2020-04-07",158,16,284,593,4074,0.413598429062347,0,0,374,1465,95,2542,42,1126,35,42
"1333","2020-04-08",155,16,307,618,4074,0.413598429062347,0,0,374,1465,102,2644,23,1149,36,23
"1334","2020-04-09",158,16,328,632,4074,0.413598429062347,0,0,374,1465,86,2730,37,1186,31,37
"1335","2020-04-10",157,16,310,636,4074,0.413598429062347,0,0,374,1465,98,2828,27,1213,37,27
"1336","2020-04-11",175,16,302,633,4074,0.413598429062347,0,0,374,1465,120,2948,23,1236,47,23
"1337","2020-04-12",178,16,299,633,4074,0.413598429062347,0,0,374,1465,89,3037,38,1274,42,38
"1338","2020-04-13",185,16,294,654,4074,0.413598429062347,0,0,374,1465,84,3121,39,1313,29,39
"1339","2020-04-14",209,16,312,648,4074,0.413598429062347,0,0,374,1465,89,3210,44,1357,32,44
"1340","2020-04-15",212,16,336,671,4074,0.413598429062347,0,0,374,1465,99,3309,42,1399,36,42
"1341","2020-04-16",221,16,354,677,4074,0.413598429062347,0,0,374,1465,101,3410,29,1428,39,29
"1342","2020-04-17",224,16,320,661,4074,0.413598429062347,0,0,374,1465,95,3505,62,1490,33,62
"1343","2020-04-18",213,16,262,630,4074,0.413598429062347,0,0,374,1465,71,3576,36,1526,31,36
"1344","2020-04-19",200,16,251,620,4074,0.413598429062347,0,0,374,1465,93,3669,37,1563,29,37
"1345","2020-04-20",192,16,241,608,4074,0.413598429062347,0,0,374,1465,79,3748,24,1587,31,24
"1346","2020-04-21",157,16,244,596,4074,0.413598429062347,0,0,374,1465,78,3826,26,1613,25,26
"1347","2020-04-22",160,16,277,584,4074,0.413598429062347,0,0,374,1465,95,3921,39,1652,26,39
"1348","2020-04-23",153,16,300,584,4074,0.413598429062347,0,0,374,1465,65,3986,44,1696,15,44
"1349","2020-04-24",156,16,285,592,4074,0.413598429062347,0,0,374,1465,67,4053,37,1733,16,37
"1350","2020-04-25",165,16,276,602,4074,0.413598429062347,0,0,374,1465,60,4113,35,1768,22,35
"1351","2020-04-26",181,16,280,601,4074,0.413598429062347,0,0,374,1465,76,4189,44,1812,20,44
"1352","2020-04-27",176,16,294,624,4074,0.413598429062347,0,0,374,1465,72,4261,56,1868,18,56
"1353","2020-04-28",187,16,291,617,4074,0.413598429062347,0,0,374,1465,69,4330,42,1910,22,42
"1354","2020-04-29",180,16,269,607,4074,0.413598429062347,0,0,374,1465,70,4400,34,1944,23,34
"1355","2020-04-30",187,16,260,597,4074,0.413598429062347,0,0,374,1465,64,4464,41,1985,26,41
"1356","2020-05-01",195,16,276,585,4074,0.413598429062347,0,0,374,1465,58,4522,49,2034,19,49
"1357","2020-05-02",177,16,253,584,4074,0.413598429062347,0,0,374,1465,50,4572,40,2074,11,40
"1358","2020-05-03",161,16,243,577,4074,0.413598429062347,0,0,374,1465,54,4626,41,2115,7,41
"1359","2020-05-04",163,16,229,561,4074,0.413598429062347,0,0,374,1465,63,4689,37,2152,14,37
"1360","2020-05-05",159,16,214,541,4074,0.413598429062347,0,0,374,1465,48,4737,37,2189,12,37
"1361","2020-05-06",152,16,254,550,4074,0.413598429062347,0,0,374,1465,51,4788,37,2226,11,37
"1362","2020-05-07",145,16,277,554,4074,0.413598429062347,0,0,374,1465,67,4855,39,2265,20,39
"1363","2020-05-08",125,16,272,537,4074,0.413598429062347,0,0,374,1465,48,4903,34,2299,11,34
"1364","2020-05-09",122,16,263,517,4074,0.413598429062347,0,0,374,1465,46,4949,34,2333,7,34
"1365","2020-05-10",135,16,285,507,4074,0.413598429062347,0,0,374,1465,47,4996,36,2369,16,36
"1366","2020-05-11",131,16,313,516,4074,0.413598429062347,0,0,374,1465,35,5031,30,2399,9,30
"1367","2020-05-12",125,16,288,495,4074,0.413598429062347,0,0,374,1465,35,5066,29,2428,11,29
"1368","2020-05-13",140,16,269,491,4074,0.413598429062347,0,0,374,1465,40,5106,41,2469,12,41
"1369","2020-05-14",141,16,265,478,4074,0.413598429062347,0,0,374,1465,61,5167,30,2499,15,30
"1370","2020-05-15",142,16,274,465,4074,0.413598429062347,0,0,374,1465,41,5208,51,2550,13,51
"1371","2020-05-16",140,16,268,462,4074,0.413598429062347,0,0,374,1465,32,5240,41,2591,10,41
"1372","2020-05-17",137,16,267,452,4074,0.413598429062347,0,0,374,1465,34,5274,34,2625,14,34
"1373","2020-05-18",131,16,287,447,4074,0.413598429062347,0,0,374,1465,34,5308,39,2664,5,39
"1374","2020-05-19",130,16,284,440,4074,0.413598429062347,0,0,374,1465,34,5342,56,2720,6,56
"1375","2020-05-20",121,16,267,426,4074,0.413598429062347,0,0,374,1465,36,5378,28,2748,8,28
"1376","2020-05-21",120,16,263,423,4074,0.413598429062347,0,0,374,1465,27,5405,48,2796,8,48
"1377","2020-05-22",113,16,262,404,4074,0.413598429062347,0,0,374,1465,33,5438,40,2836,12,40
"1378","2020-05-23",116,16,273,381,4074,0.413598429062347,0,0,374,1465,28,5466,30,2866,5,30
"1379","2020-05-24",113,16,278,380,4074,0.413598429062347,0,0,374,1465,29,5495,50,2916,4,50
"1380","2020-05-25",119,16,254,373,4074,0.413598429062347,0,0,374,1465,32,5527,52,2968,7,52
"1381","2020-05-26",114,16,273,362,4074,0.413598429062347,0,0,374,1465,25,5552,41,3009,5,41
"1382","2020-05-27",103,16,306,358,4074,0.413598429062347,0,0,374,1465,23,5575,38,3047,7,38
"1383","2020-05-28",107,16,350,344,4074,0.413598429062347,0,0,374,1465,15,5590,22,3069,4,22
"1384","2020-05-29",112,16,358,344,4074,0.413598429062347,0,0,374,1465,25,5615,34,3103,6,34
"1385","2020-05-30",111,16,359,333,4074,0.413598429062347,0,0,374,1465,20,5635,40,3143,4,40
"1386","2020-05-31",99,16,338,324,4074,0.413598429062347,0,0,374,1465,16,5651,33,3176,6,33
"1387","2020-06-01",97,16,326,313,4074,0.413598429062347,0,0,374,1465,26,5677,26,3202,8,26
"1388","2020-06-02",99,16,319,301,4074,0.413598429062347,0,0,374,1465,16,5693,31,3233,6,31
"1389","2020-06-03",108,16,320,289,4074,0.413598429062347,0,0,374,1465,24,5717,44,3277,5,44
"1390","2020-06-04",91,16,289,290,4074,0.413598429062347,0,0,374,1465,22,5739,40,3317,6,40
"1391","2020-06-05",82,16,287,275,4074,0.413598429062347,0,0,374,1465,21,5760,38,3355,4,38
"1392","2020-06-06",74,16,286,264,4074,0.413598429062347,0,0,374,1465,14,5774,43,3398,3,43
"1393","2020-06-07",76,16,280,244,4074,0.413598429062347,0,0,374,1465,19,5793,55,3453,6,55
"1394","2020-03-13",4,17,140,147,5288,0.181543116490166,0,0,448,1157,27,70,43,124,16,43
"1395","2020-03-14",7,17,157,205,5288,0.181543116490166,0,0,448,1157,45,115,26,150,28,26
"1396","2020-03-15",9,17,205,268,5288,0.181543116490166,0,0,448,1157,44,159,18,168,37,18
"1397","2020-03-16",19,17,237,337,5288,0.181543116490166,0,0,448,1157,65,224,9,177,54,9
"1398","2020-03-17",25,17,220,400,5288,0.181543116490166,0,0,448,1157,73,297,7,184,60,7
"1399","2020-03-18",40,17,212,462,5288,0.181543116490166,0,0,448,1157,87,384,17,201,79,17
"1400","2020-03-19",60,17,272,516,5288,0.181543116490166,0,0,448,1157,121,505,42,243,110,42
"1401","2020-03-20",85,17,284,563,5288,0.181543116490166,0,0,448,1157,167,672,67,310,156,67
"1402","2020-03-21",114,17,255,616,5288,0.181543116490166,0,0,448,1157,221,893,38,348,210,38
"1403","2020-03-22",134,17,213,640,5288,0.181543116490166,0,0,448,1157,192,1085,29,377,181,29
"1404","2020-03-23",160,17,192,679,5288,0.181543116490166,0,0,448,1157,210,1295,45,422,198,45
"1405","2020-03-24",188,17,190,708,5288,0.181543116490166,0,0,448,1157,249,1544,66,488,236,66
"1406","2020-03-25",206,17,184,702,5288,0.181543116490166,0,0,448,1157,355,1899,30,518,342,30
"1407","2020-03-26",209,17,202,713,5288,0.181543116490166,0,0,448,1157,352,2251,27,545,345,27
"1408","2020-03-27",213,17,213,730,5288,0.181543116490166,0,0,448,1157,474,2725,21,566,463,21
"1409","2020-03-28",206,17,235,722,5288,0.181543116490166,0,0,448,1157,470,3195,22,588,462,22
"1410","2020-03-29",213,17,229,731,5288,0.181543116490166,0,0,448,1157,397,3592,17,605,392,17
"1411","2020-03-30",200,17,214,752,5288,0.181543116490166,0,0,448,1157,480,4072,14,619,477,14
"1412","2020-03-31",197,17,252,745,5288,0.181543116490166,0,0,448,1157,404,4476,10,629,399,10
"1413","2020-04-01",195,17,304,749,5288,0.181543116490166,0,0,448,1157,355,4831,10,639,354,10
"1414","2020-04-02",209,17,305,756,5288,0.181543116490166,0,0,448,1157,301,5132,18,657,295,18
"1415","2020-04-03",210,17,278,756,5288,0.181543116490166,0,0,448,1157,351,5483,11,668,347,11
"1416","2020-04-04",217,17,251,769,5288,0.181543116490166,0,0,448,1157,255,5738,18,686,250,18
"1417","2020-04-05",223,17,245,763,5288,0.181543116490166,0,0,448,1157,247,5985,11,697,243,11
"1418","2020-04-06",229,17,223,754,5288,0.181543116490166,0,0,448,1157,187,6172,12,709,182,12
"1419","2020-04-07",227,17,220,777,5288,0.181543116490166,0,0,448,1157,163,6335,20,729,160,20
"1420","2020-04-08",216,17,239,783,5288,0.181543116490166,0,0,448,1157,141,6476,9,738,136,9
"1421","2020-04-09",199,17,242,782,5288,0.181543116490166,0,0,448,1157,137,6613,12,750,134,12
"1422","2020-04-10",188,17,237,771,5288,0.181543116490166,0,0,448,1157,97,6710,25,775,92,25
"1423","2020-04-11",182,17,230,761,5288,0.181543116490166,0,0,448,1157,89,6799,63,838,84,63
"1424","2020-04-12",176,17,218,765,5288,0.181543116490166,0,0,448,1157,72,6871,68,906,71,68
"1425","2020-04-13",180,17,215,773,5288,0.181543116490166,0,0,448,1157,71,6942,35,941,67,35
"1426","2020-04-14",180,17,214,780,5288,0.181543116490166,0,0,448,1157,63,7005,25,966,60,25
"1427","2020-04-15",190,17,205,797,5288,0.181543116490166,0,0,448,1157,31,7036,29,995,31,29
"1428","2020-04-16",198,17,197,804,5288,0.181543116490166,0,0,448,1157,51,7087,34,1029,47,34
"1429","2020-04-17",203,17,193,791,5288,0.181543116490166,0,0,448,1157,31,7118,29,1058,30,29
"1430","2020-04-18",206,17,175,773,5288,0.181543116490166,0,0,448,1157,38,7156,39,1097,32,39
"1431","2020-04-19",213,17,165,749,5288,0.181543116490166,0,0,448,1157,24,7180,36,1133,23,36
"1432","2020-04-20",217,17,176,767,5288,0.181543116490166,0,0,448,1157,18,7198,21,1154,17,21
"1433","2020-04-21",227,17,172,779,5288,0.181543116490166,0,0,448,1157,18,7216,40,1194,15,40
"1434","2020-04-22",225,17,167,784,5288,0.181543116490166,0,0,448,1157,12,7228,30,1224,11,30
"1435","2020-04-23",226,17,176,789,5288,0.181543116490166,0,0,448,1157,11,7239,14,1238,8,14
"1436","2020-04-24",227,17,228,797,5288,0.181543116490166,0,0,448,1157,11,7250,12,1250,7,12
"1437","2020-04-25",217,17,238,795,5288,0.181543116490166,0,0,448,1157,13,7263,48,1298,8,48
"1438","2020-04-26",216,17,214,796,5288,0.181543116490166,0,0,448,1157,8,7271,44,1342,8,44
"1439","2020-04-27",204,17,218,803,5288,0.181543116490166,0,0,448,1157,11,7282,27,1369,9,27
"1440","2020-04-28",200,17,233,804,5288,0.181543116490166,0,0,448,1157,8,7290,13,1382,8,13
"1441","2020-04-29",201,17,246,794,5288,0.181543116490166,0,0,448,1157,7,7297,21,1403,7,21
"1442","2020-04-30",194,17,248,782,5288,0.181543116490166,0,0,448,1157,10,7307,14,1417,7,14
"1443","2020-05-01",206,17,251,769,5288,0.181543116490166,0,0,448,1157,7,7314,11,1428,5,11
"1444","2020-05-02",220,17,237,762,5288,0.181543116490166,0,0,448,1157,7,7321,41,1469,6,41
"1445","2020-05-03",210,17,233,777,5288,0.181543116490166,0,0,448,1157,6,7327,38,1507,3,38
"1446","2020-05-04",209,17,239,763,5288,0.181543116490166,0,0,448,1157,7,7334,60,1567,5,60
"1447","2020-05-05",205,17,236,740,5288,0.181543116490166,0,0,448,1157,3,7337,39,1606,3,39
"1448","2020-05-06",210,17,226,724,5288,0.181543116490166,0,0,448,1157,7,7344,49,1655,7,49
"1449","2020-05-07",221,17,213,708,5288,0.181543116490166,0,0,448,1157,4,7348,37,1692,2,37
"1450","2020-05-08",204,17,196,710,5288,0.181543116490166,0,0,448,1157,2,7350,18,1710,1,18
"1451","2020-05-09",210,17,194,710,5288,0.181543116490166,0,0,448,1157,6,7356,25,1735,5,25
"1452","2020-05-10",207,17,225,683,5288,0.181543116490166,0,0,448,1157,1,7357,33,1768,NA,33
"1453","2020-05-11",213,17,240,652,5288,0.181543116490166,0,0,448,1157,2,7359,24,1792,1,24
"1454","2020-05-12",198,17,236,617,5288,0.181543116490166,0,0,448,1157,2,7361,16,1808,1,16
"1455","2020-05-13",183,17,225,601,5288,0.181543116490166,0,0,448,1157,5,7366,19,1827,5,19
"1456","2020-05-14",175,17,236,585,5288,0.181543116490166,0,0,448,1157,3,7369,13,1840,NA,13
"1457","2020-05-15",172,17,227,551,5288,0.181543116490166,0,0,448,1157,6,7375,57,1897,4,57
"1458","2020-05-16",156,17,245,523,5288,0.181543116490166,0,0,448,1157,2,7377,36,1933,2,36
"1459","2020-05-17",163,17,235,519,5288,0.181543116490166,0,0,448,1157,2,7379,14,1947,1,14
"1460","2020-05-18",156,17,226,513,5288,0.181543116490166,0,0,448,1157,5,7384,47,1994,4,47
"1461","2020-05-19",155,17,259,499,5288,0.181543116490166,0,0,448,1157,NA,NA,38,2032,NA,38
"1462","2020-05-20",153,17,276,472,5288,0.181543116490166,0,0,448,1157,4,7388,28,2060,1,28
"1463","2020-05-21",138,17,273,461,5288,0.181543116490166,0,0,448,1157,1,7389,55,2115,1,55
"1464","2020-05-22",133,17,264,436,5288,0.181543116490166,0,0,448,1157,5,7394,54,2169,3,54
"1465","2020-05-23",136,17,279,427,5288,0.181543116490166,0,0,448,1157,3,7397,41,2210,2,41
"1466","2020-05-24",122,17,259,416,5288,0.181543116490166,0,0,448,1157,3,7400,43,2253,2,43
"1467","2020-05-25",117,17,237,411,5288,0.181543116490166,0,0,448,1157,3,7403,53,2306,1,53
"1468","2020-05-26",117,17,221,406,5288,0.181543116490166,0,0,448,1157,5,7408,57,2363,2,57
"1469","2020-05-27",118,17,202,402,5288,0.181543116490166,0,0,448,1157,3,7411,23,2386,1,23
"1470","2020-05-28",120,17,222,400,5288,0.181543116490166,0,0,448,1157,4,7415,23,2409,3,23
"1471","2020-05-29",120,17,248,371,5288,0.181543116490166,0,0,448,1157,6,7421,20,2429,6,20
"1472","2020-05-30",103,17,275,351,5288,0.181543116490166,0,0,448,1157,4,7425,32,2461,2,32
"1473","2020-05-31",101,17,305,339,5288,0.181543116490166,0,0,448,1157,2,7427,14,2475,1,14
"1474","2020-06-01",99,17,288,327,5288,0.181543116490166,0,0,448,1157,5,7432,15,2490,4,15
"1475","2020-06-02",101,17,293,303,5288,0.181543116490166,0,0,448,1157,1,7433,26,2516,NA,26
"1476","2020-06-03",94,17,307,288,5288,0.181543116490166,0,0,448,1157,5,7438,30,2546,3,30
"1477","2020-06-04",89,17,260,277,5288,0.181543116490166,0,0,448,1157,4,7442,33,2579,3,33
"1478","2020-06-05",85,17,248,253,5288,0.181543116490166,0,0,448,1157,3,7445,56,2635,3,56
"1479","2020-06-06",90,17,234,232,5288,0.181543116490166,0,0,448,1157,2,7447,24,2659,2,24
"1480","2020-06-07",82,17,196,222,5288,0.181543116490166,0,0,448,1157,3,7450,28,2687,3,28
"1481","2020-03-12",1,18,137,57,4324,0.468547641073081,0,0,360,2188,19,27,9,22,3,9
"1482","2020-03-13",1,18,147,98,4324,0.468547641073081,0,0,360,2188,22,49,6,28,2,6
"1483","2020-03-14",4,18,138,127,4324,0.468547641073081,0,0,360,2188,17,66,32,60,5,32
"1484","2020-03-15",10,18,132,169,4324,0.468547641073081,0,0,360,2188,20,86,45,105,10,45
"1485","2020-03-16",20,18,129,214,4324,0.468547641073081,0,0,360,2188,29,115,24,129,11,24
"1486","2020-03-17",28,18,185,267,4324,0.468547641073081,0,0,360,2188,29,144,44,173,17,44
"1487","2020-03-18",41,18,181,303,4324,0.468547641073081,0,0,360,2188,27,171,21,194,11,21
"1488","2020-03-19",50,18,177,342,4324,0.468547641073081,0,0,360,2188,27,198,51,245,11,51
"1489","2020-03-20",59,18,172,382,4324,0.468547641073081,0,0,360,2188,31,229,32,277,14,32
"1490","2020-03-21",75,18,191,412,4324,0.468547641073081,0,0,360,2188,32,261,43,320,13,43
"1491","2020-03-22",81,18,184,436,4324,0.468547641073081,0,0,360,2188,35,296,31,351,17,31
"1492","2020-03-23",91,18,194,473,4324,0.468547641073081,0,0,360,2188,23,319,36,387,8,36
"1493","2020-03-24",105,18,182,495,4324,0.468547641073081,0,0,360,2188,30,349,30,417,16,30
"1494","2020-03-25",109,18,182,525,4324,0.468547641073081,0,0,360,2188,28,377,22,439,13,22
"1495","2020-03-26",119,18,237,550,4324,0.468547641073081,0,0,360,2188,33,410,35,474,21,35
"1496","2020-03-27",125,18,280,567,4324,0.468547641073081,0,0,360,2188,29,439,37,511,10,37
"1497","2020-03-28",131,18,289,589,4324,0.468547641073081,0,0,360,2188,23,462,11,522,14,11
"1498","2020-03-29",149,18,280,614,4324,0.468547641073081,0,0,360,2188,27,489,13,535,15,13
"1499","2020-03-30",153,18,258,632,4324,0.468547641073081,0,0,360,2188,46,535,57,592,27,57
"1500","2020-03-31",150,18,233,654,4324,0.468547641073081,0,0,360,2188,35,570,38,630,14,38
"1501","2020-04-01",153,18,202,651,4324,0.468547641073081,0,0,360,2188,36,606,26,656,21,26
"1502","2020-04-02",158,18,196,660,4324,0.468547641073081,0,0,360,2188,24,630,27,683,10,27
"1503","2020-04-03",166,18,199,662,4324,0.468547641073081,0,0,360,2188,33,663,17,700,14,17
"1504","2020-04-04",168,18,189,685,4324,0.468547641073081,0,0,360,2188,30,693,16,716,9,16
"1505","2020-04-05",159,18,162,688,4324,0.468547641073081,0,0,360,2188,30,723,12,728,13,12
"1506","2020-04-06",165,18,150,695,4324,0.468547641073081,0,0,360,2188,27,750,22,750,16,22
"1507","2020-04-07",176,18,156,693,4324,0.468547641073081,0,0,360,2188,26,776,13,763,9,13
"1508","2020-04-08",194,18,172,701,4324,0.468547641073081,0,0,360,2188,17,793,25,788,7,25
"1509","2020-04-09",191,18,235,708,4324,0.468547641073081,0,0,360,2188,31,824,27,815,12,27
"1510","2020-04-10",196,18,255,726,4324,0.468547641073081,0,0,360,2188,22,846,25,840,6,25
"1511","2020-04-11",201,18,249,713,4324,0.468547641073081,0,0,360,2188,31,877,17,857,15,17
"1512","2020-04-12",210,18,234,692,4324,0.468547641073081,0,0,360,2188,31,908,35,892,9,35
"1513","2020-04-13",210,18,229,692,4324,0.468547641073081,0,0,360,2188,33,941,18,910,12,18
"1514","2020-04-14",204,18,236,681,4324,0.468547641073081,0,0,360,2188,25,966,9,919,8,9
"1515","2020-04-15",202,18,220,682,4324,0.468547641073081,0,0,360,2188,32,998,6,925,11,6
"1516","2020-04-16",207,18,211,663,4324,0.468547641073081,0,0,360,2188,35,1033,9,934,12,9
"1517","2020-04-17",201,18,218,674,4324,0.468547641073081,0,0,360,2188,32,1065,12,946,7,12
"1518","2020-04-18",202,18,186,656,4324,0.468547641073081,0,0,360,2188,31,1096,16,962,9,16
"1519","2020-04-19",204,18,183,670,4324,0.468547641073081,0,0,360,2188,37,1133,16,978,13,16
"1520","2020-04-20",200,18,163,670,4324,0.468547641073081,0,0,360,2188,29,1162,18,996,10,18
"1521","2020-04-21",204,18,185,669,4324,0.468547641073081,0,0,360,2188,34,1196,8,1004,15,8
"1522","2020-04-22",196,18,182,681,4324,0.468547641073081,0,0,360,2188,35,1231,8,1012,15,8
"1523","2020-04-23",201,18,205,675,4324,0.468547641073081,0,0,360,2188,23,1254,14,1026,10,14
"1524","2020-04-24",207,18,231,668,4324,0.468547641073081,0,0,360,2188,37,1291,11,1037,11,11
"1525","2020-04-25",202,18,215,671,4324,0.468547641073081,0,0,360,2188,44,1335,12,1049,20,12
"1526","2020-04-26",195,18,215,666,4324,0.468547641073081,0,0,360,2188,34,1369,9,1058,18,9
"1527","2020-04-27",194,18,207,649,4324,0.468547641073081,0,0,360,2188,20,1389,6,1064,9,6
"1528","2020-04-28",183,18,214,623,4324,0.468547641073081,0,0,360,2188,30,1419,10,1074,11,10
"1529","2020-04-29",172,18,235,624,4324,0.468547641073081,0,0,360,2188,43,1462,4,1078,14,4
"1530","2020-04-30",163,18,225,622,4324,0.468547641073081,0,0,360,2188,47,1509,5,1083,19,5
"1531","2020-05-01",160,18,256,615,4324,0.468547641073081,0,0,360,2188,38,1547,8,1091,18,8
"1532","2020-05-02",150,18,287,602,4324,0.468547641073081,0,0,360,2188,27,1574,26,1117,14,26
"1533","2020-05-03",147,18,262,589,4324,0.468547641073081,0,0,360,2188,49,1623,17,1134,31,17
"1534","2020-05-04",148,18,260,593,4324,0.468547641073081,0,0,360,2188,38,1661,16,1150,27,16
"1535","2020-05-05",157,18,262,592,4324,0.468547641073081,0,0,360,2188,50,1711,52,1202,29,52
"1536","2020-05-06",154,18,262,573,4324,0.468547641073081,0,0,360,2188,49,1760,65,1267,30,65
"1537","2020-05-07",159,18,238,556,4324,0.468547641073081,0,0,360,2188,41,1801,43,1310,21,43
"1538","2020-05-08",152,18,222,537,4324,0.468547641073081,0,0,360,2188,31,1832,28,1338,11,28
"1539","2020-05-09",163,18,207,525,4324,0.468547641073081,0,0,360,2188,24,1856,22,1360,12,22
"1540","2020-05-10",161,18,212,518,4324,0.468547641073081,0,0,360,2188,40,1896,24,1384,21,24
"1541","2020-05-11",151,18,194,506,4324,0.468547641073081,0,0,360,2188,45,1941,29,1413,23,29
"1542","2020-05-12",141,18,188,494,4324,0.468547641073081,0,0,360,2188,28,1969,24,1437,14,24
"1543","2020-05-13",147,18,187,467,4324,0.468547641073081,0,0,360,2188,27,1996,14,1451,12,14
"1544","2020-05-14",140,18,223,463,4324,0.468547641073081,0,0,360,2188,23,2019,21,1472,9,21
"1545","2020-05-15",139,18,221,439,4324,0.468547641073081,0,0,360,2188,37,2056,23,1495,18,23
"1546","2020-05-16",127,18,222,432,4324,0.468547641073081,0,0,360,2188,32,2088,19,1514,19,19
"1547","2020-05-17",124,18,237,435,4324,0.468547641073081,0,0,360,2188,30,2118,35,1549,15,35
"1548","2020-05-18",126,18,253,413,4324,0.468547641073081,0,0,360,2188,29,2147,20,1569,14,20
"1549","2020-05-19",129,18,293,406,4324,0.468547641073081,0,0,360,2188,30,2177,17,1586,20,17
"1550","2020-05-20",127,18,285,395,4324,0.468547641073081,0,0,360,2188,31,2208,12,1598,15,12
"1551","2020-05-21",120,18,246,378,4324,0.468547641073081,0,0,360,2188,38,2246,12,1610,19,12
"1552","2020-05-22",119,18,268,381,4324,0.468547641073081,0,0,360,2188,25,2271,23,1633,13,23
"1553","2020-05-23",114,18,251,368,4324,0.468547641073081,0,0,360,2188,28,2299,26,1659,17,26
"1554","2020-05-24",112,18,234,358,4324,0.468547641073081,0,0,360,2188,26,2325,18,1677,10,18
"1555","2020-05-25",109,18,209,354,4324,0.468547641073081,0,0,360,2188,26,2351,12,1689,13,12
"1556","2020-05-26",101,18,190,337,4324,0.468547641073081,0,0,360,2188,26,2377,30,1719,8,30
"1557","2020-05-27",98,18,162,337,4324,0.468547641073081,0,0,360,2188,18,2395,53,1772,8,53
"1558","2020-05-28",108,18,198,333,4324,0.468547641073081,0,0,360,2188,17,2412,61,1833,11,61
"1559","2020-05-29",112,18,242,326,4324,0.468547641073081,0,0,360,2188,17,2429,39,1872,9,39
"1560","2020-05-30",113,18,246,308,4324,0.468547641073081,0,0,360,2188,22,2451,16,1888,10,16
"1561","2020-05-31",107,18,228,301,4324,0.468547641073081,0,0,360,2188,18,2469,35,1923,11,35
"1562","2020-06-01",113,18,231,289,4324,0.468547641073081,0,0,360,2188,17,2486,35,1958,9,35
"1563","2020-06-02",110,18,245,290,4324,0.468547641073081,0,0,360,2188,21,2507,33,1991,8,33
"1564","2020-06-03",108,18,244,284,4324,0.468547641073081,0,0,360,2188,11,2518,21,2012,5,21
"1565","2020-06-04",91,18,250,271,4324,0.468547641073081,0,0,360,2188,20,2538,18,2030,13,18
"1566","2020-06-05",78,18,221,261,4324,0.468547641073081,0,0,360,2188,11,2549,21,2051,5,21
"1567","2020-06-06",76,18,206,245,4324,0.468547641073081,0,0,360,2188,19,2568,41,2092,8,41
"1568","2020-06-07",76,18,195,237,4324,0.468547641073081,0,0,360,2188,7,2575,18,2110,4,18
"1569","2020-03-13",2,19,140,152,5260,0.171863117870722,0,0,477,995,57,160,9,63,6,9
"1570","2020-03-14",4,19,178,197,5260,0.171863117870722,0,0,477,995,76,236,6,69,17,6
"1571","2020-03-15",11,19,191,256,5260,0.171863117870722,0,0,477,995,71,307,9,78,23,9
"1572","2020-03-16",25,19,190,314,5260,0.171863117870722,0,0,477,995,70,377,55,133,26,55
"1573","2020-03-17",41,19,174,374,5260,0.171863117870722,0,0,477,995,91,468,38,171,36,38
"1574","2020-03-18",55,19,173,427,5260,0.171863117870722,0,0,477,995,106,574,59,230,50,59
"1575","2020-03-19",68,19,159,468,5260,0.171863117870722,0,0,477,995,87,661,37,267,39,37
"1576","2020-03-20",82,19,145,506,5260,0.171863117870722,0,0,477,995,89,750,31,298,24,31
"1577","2020-03-21",94,19,130,546,5260,0.171863117870722,0,0,477,995,69,819,32,330,29,32
"1578","2020-03-22",113,19,118,587,5260,0.171863117870722,0,0,477,995,77,896,66,396,17,66
"1579","2020-03-23",121,19,128,615,5260,0.171863117870722,0,0,477,995,85,981,37,433,31,37
"1580","2020-03-24",132,19,144,649,5260,0.171863117870722,0,0,477,995,85,1066,26,459,27,26
"1581","2020-03-25",157,19,123,658,5260,0.171863117870722,0,0,477,995,90,1156,61,520,30,61
"1582","2020-03-26",177,19,125,672,5260,0.171863117870722,0,0,477,995,84,1240,58,578,30,58
"1583","2020-03-27",194,19,155,701,5260,0.171863117870722,0,0,477,995,77,1317,33,611,22,33
"1584","2020-03-28",208,19,183,710,5260,0.171863117870722,0,0,477,995,91,1408,48,659,31,48
"1585","2020-03-29",208,19,177,724,5260,0.171863117870722,0,0,477,995,72,1480,28,687,21,28
"1586","2020-03-30",209,19,169,732,5260,0.171863117870722,0,0,477,995,77,1557,21,708,28,21
"1587","2020-03-31",204,19,217,734,5260,0.171863117870722,0,0,477,995,77,1634,17,725,24,17
"1588","2020-04-01",191,19,225,754,5260,0.171863117870722,0,0,477,995,94,1728,11,736,34,11
"1589","2020-04-02",188,19,224,755,5260,0.171863117870722,0,0,477,995,105,1833,53,789,43,53
"1590","2020-04-03",194,19,199,749,5260,0.171863117870722,0,0,477,995,90,1923,58,847,43,58
"1591","2020-04-04",197,19,184,765,5260,0.171863117870722,0,0,477,995,87,2010,26,873,25,26
"1592","2020-04-05",207,19,211,772,5260,0.171863117870722,0,0,477,995,80,2090,27,900,25,27
"1593","2020-04-06",214,19,221,789,5260,0.171863117870722,0,0,477,995,108,2198,19,919,42,19
"1594","2020-04-07",224,19,227,811,5260,0.171863117870722,0,0,477,995,100,2298,64,983,41,64
"1595","2020-04-08",237,19,245,819,5260,0.171863117870722,0,0,477,995,83,2381,29,1012,29,29
"1596","2020-04-09",238,19,234,828,5260,0.171863117870722,0,0,477,995,68,2449,17,1029,18,17
"1597","2020-04-10",231,19,230,845,5260,0.171863117870722,0,0,477,995,87,2536,10,1039,25,10
"1598","2020-04-11",227,19,205,852,5260,0.171863117870722,0,0,477,995,78,2614,28,1067,20,28
"1599","2020-04-12",226,19,215,833,5260,0.171863117870722,0,0,477,995,69,2683,26,1093,21,26
"1600","2020-04-13",226,19,211,829,5260,0.171863117870722,0,0,477,995,84,2767,30,1123,30,30
"1601","2020-04-14",238,19,210,812,5260,0.171863117870722,0,0,477,995,79,2846,23,1146,18,23
"1602","2020-04-15",226,19,229,815,5260,0.171863117870722,0,0,477,995,91,2937,59,1205,36,59
"1603","2020-04-16",229,19,212,804,5260,0.171863117870722,0,0,477,995,93,3030,68,1273,29,68
"1604","2020-04-17",232,19,261,801,5260,0.171863117870722,0,0,477,995,73,3103,39,1312,20,39
"1605","2020-04-18",238,19,243,785,5260,0.171863117870722,0,0,477,995,83,3186,56,1368,19,56
"1606","2020-04-19",240,19,215,804,5260,0.171863117870722,0,0,477,995,87,3273,33,1401,25,33
"1607","2020-04-20",242,19,187,810,5260,0.171863117870722,0,0,477,995,68,3341,61,1462,19,61
"1608","2020-04-21",228,19,174,809,5260,0.171863117870722,0,0,477,995,73,3414,53,1515,28,53
"1609","2020-04-22",225,19,162,798,5260,0.171863117870722,0,0,477,995,64,3478,22,1537,16,22
"1610","2020-04-23",221,19,163,809,5260,0.171863117870722,0,0,477,995,58,3536,32,1569,16,32
"1611","2020-04-24",218,19,168,809,5260,0.171863117870722,0,0,477,995,79,3615,26,1595,10,26
"1612","2020-04-25",217,19,165,802,5260,0.171863117870722,0,0,477,995,72,3687,43,1638,28,43
"1613","2020-04-26",214,19,172,807,5260,0.171863117870722,0,0,477,995,83,3770,21,1659,17,21
"1614","2020-04-27",221,19,153,800,5260,0.171863117870722,0,0,477,995,72,3842,13,1672,23,13
"1615","2020-04-28",222,19,153,795,5260,0.171863117870722,0,0,477,995,81,3923,11,1683,25,11
"1616","2020-04-29",219,19,159,791,5260,0.171863117870722,0,0,477,995,61,3984,12,1695,11,12
"1617","2020-04-30",224,19,163,772,5260,0.171863117870722,0,0,477,995,62,4046,15,1710,19,15
"1618","2020-05-01",217,19,168,768,5260,0.171863117870722,0,0,477,995,68,4114,11,1721,14,11
"1619","2020-05-02",211,19,217,751,5260,0.171863117870722,0,0,477,995,51,4165,20,1741,16,20
"1620","2020-05-03",213,19,263,736,5260,0.171863117870722,0,0,477,995,51,4216,69,1810,15,69
"1621","2020-05-04",203,19,284,735,5260,0.171863117870722,0,0,477,995,47,4263,40,1850,17,40
"1622","2020-05-05",195,19,265,711,5260,0.171863117870722,0,0,477,995,60,4323,24,1874,14,24
"1623","2020-05-06",203,19,259,702,5260,0.171863117870722,0,0,477,995,55,4378,21,1895,11,21
"1624","2020-05-07",199,19,281,709,5260,0.171863117870722,0,0,477,995,58,4436,19,1914,19,19
"1625","2020-05-08",199,19,276,690,5260,0.171863117870722,0,0,477,995,53,4489,60,1974,16,60
"1626","2020-05-09",196,19,258,669,5260,0.171863117870722,0,0,477,995,46,4535,47,2021,16,47
"1627","2020-05-10",185,19,268,658,5260,0.171863117870722,0,0,477,995,46,4581,35,2056,7,35
"1628","2020-05-11",179,19,250,634,5260,0.171863117870722,0,0,477,995,48,4629,39,2095,9,39
"1629","2020-05-12",177,19,258,620,5260,0.171863117870722,0,0,477,995,37,4666,16,2111,2,16
"1630","2020-05-13",176,19,225,600,5260,0.171863117870722,0,0,477,995,38,4704,7,2118,9,7
"1631","2020-05-14",169,19,198,594,5260,0.171863117870722,0,0,477,995,45,4749,17,2135,11,17
"1632","2020-05-15",176,19,189,562,5260,0.171863117870722,0,0,477,995,44,4793,32,2167,7,32
"1633","2020-05-16",178,19,218,530,5260,0.171863117870722,0,0,477,995,39,4832,21,2188,7,21
"1634","2020-05-17",183,19,245,527,5260,0.171863117870722,0,0,477,995,32,4864,9,2197,2,9
"1635","2020-05-18",179,19,236,500,5260,0.171863117870722,0,0,477,995,41,4905,15,2212,11,15
"1636","2020-05-19",181,19,220,486,5260,0.171863117870722,0,0,477,995,24,4929,36,2248,6,36
"1637","2020-05-20",175,19,248,466,5260,0.171863117870722,0,0,477,995,40,4969,21,2269,6,21
"1638","2020-05-21",172,19,255,454,5260,0.171863117870722,0,0,477,995,26,4995,15,2284,3,15
"1639","2020-05-22",154,19,273,447,5260,0.171863117870722,0,0,477,995,31,5026,13,2297,6,13
"1640","2020-05-23",144,19,287,429,5260,0.171863117870722,0,0,477,995,45,5071,11,2308,9,11
"1641","2020-05-24",130,19,308,412,5260,0.171863117870722,0,0,477,995,27,5098,11,2319,5,11
"1642","2020-05-25",136,19,276,398,5260,0.171863117870722,0,0,477,995,20,5118,3,2322,5,3
"1643","2020-05-26",127,19,254,377,5260,0.171863117870722,0,0,477,995,24,5142,8,2330,9,8
"1644","2020-05-27",122,19,232,359,5260,0.171863117870722,0,0,477,995,28,5170,10,2340,7,10
"1645","2020-05-28",117,19,217,353,5260,0.171863117870722,0,0,477,995,30,5200,9,2349,9,9
"1646","2020-05-29",111,19,210,325,5260,0.171863117870722,0,0,477,995,23,5223,86,2435,3,86
"1647","2020-05-30",106,19,203,314,5260,0.171863117870722,0,0,477,995,20,5243,46,2481,7,46
"1648","2020-05-31",96,19,169,297,5260,0.171863117870722,0,0,477,995,16,5259,33,2514,4,33
"1649","2020-06-01",83,19,152,293,5260,0.171863117870722,0,0,477,995,24,5283,55,2569,6,55
"1650","2020-06-02",82,19,149,273,5260,0.171863117870722,0,0,477,995,19,5302,52,2621,4,52
"1651","2020-06-03",82,19,136,260,5260,0.171863117870722,0,0,477,995,11,5313,42,2663,1,42
"1652","2020-06-04",79,19,129,253,5260,0.171863117870722,0,0,477,995,21,5334,36,2699,1,36
"1653","2020-06-05",78,19,117,248,5260,0.171863117870722,0,0,477,995,14,5348,31,2730,2,31
"1654","2020-06-06",79,19,108,242,5260,0.171863117870722,0,0,477,995,12,5360,36,2766,1,36
"1655","2020-06-07",78,19,112,229,5260,0.171863117870722,0,0,477,995,11,5371,38,2804,2,38
"1656","2020-03-13",1,20,144,51,5032,0.815977742448331,0,0,425,1088,30,81,18,66,6,18
"1657","2020-03-14",1,20,169,77,5032,0.815977742448331,0,0,425,1088,24,105,10,76,5,10
"1658","2020-03-15",2,20,220,109,5032,0.815977742448331,0,0,425,1088,42,147,17,93,14,17
"1659","2020-03-16",4,20,255,150,5032,0.815977742448331,0,0,425,1088,30,177,19,112,16,19
"1660","2020-03-17",9,20,218,177,5032,0.815977742448331,0,0,425,1088,42,219,12,124,24,12
"1661","2020-03-18",15,20,228,212,5032,0.815977742448331,0,0,425,1088,40,259,22,146,20,22
"1662","2020-03-19",20,20,273,259,5032,0.815977742448331,0,0,425,1088,51,310,40,186,26,40
"1663","2020-03-20",26,20,270,290,5032,0.815977742448331,0,0,425,1088,45,355,42,228,18,42
"1664","2020-03-21",33,20,268,332,5032,0.815977742448331,0,0,425,1088,45,400,43,271,15,43
"1665","2020-03-22",41,20,264,380,5032,0.815977742448331,0,0,425,1088,40,440,37,308,16,37
"1666","2020-03-23",53,20,278,427,5032,0.815977742448331,0,0,425,1088,46,486,29,337,21,29
"1667","2020-03-24",68,20,236,463,5032,0.815977742448331,0,0,425,1088,57,543,25,362,34,25
"1668","2020-03-25",77,20,226,519,5032,0.815977742448331,0,0,425,1088,40,583,22,384,18,22
"1669","2020-03-26",94,20,257,549,5032,0.815977742448331,0,0,425,1088,40,623,34,418,20,34
"1670","2020-03-27",117,20,253,606,5032,0.815977742448331,0,0,425,1088,46,669,26,444,26,26
"1671","2020-03-28",135,20,224,642,5032,0.815977742448331,0,0,425,1088,47,716,53,497,24,53
"1672","2020-03-29",152,20,203,681,5032,0.815977742448331,0,0,425,1088,52,768,65,562,26,65
"1673","2020-03-30",167,20,193,711,5032,0.815977742448331,0,0,425,1088,47,815,53,615,21,53
"1674","2020-03-31",176,20,179,747,5032,0.815977742448331,0,0,425,1088,30,845,34,649,14,34
"1675","2020-04-01",189,20,170,776,5032,0.815977742448331,0,0,425,1088,37,882,30,679,19,30
"1676","2020-04-02",200,20,158,788,5032,0.815977742448331,0,0,425,1088,51,933,31,710,24,31
"1677","2020-04-03",205,20,158,835,5032,0.815977742448331,0,0,425,1088,36,969,40,750,16,40
"1678","2020-04-04",212,20,189,854,5032,0.815977742448331,0,0,425,1088,35,1004,35,785,15,35
"1679","2020-04-05",217,20,217,895,5032,0.815977742448331,0,0,425,1088,49,1053,45,830,27,45
"1680","2020-04-06",231,20,267,918,5032,0.815977742448331,0,0,425,1088,42,1095,48,878,17,48
"1681","2020-04-07",246,20,239,965,5032,0.815977742448331,0,0,425,1088,43,1138,66,944,15,66
"1682","2020-04-08",259,20,225,975,5032,0.815977742448331,0,0,425,1088,38,1176,69,1013,9,69
"1683","2020-04-09",258,20,203,995,5032,0.815977742448331,0,0,425,1088,39,1215,25,1038,6,25
"1684","2020-04-10",259,20,201,1020,5032,0.815977742448331,0,0,425,1088,42,1257,28,1066,16,28
"1685","2020-04-11",277,20,194,1029,5032,0.815977742448331,0,0,425,1088,58,1315,41,1107,21,41
"1686","2020-04-12",293,20,191,1035,5032,0.815977742448331,0,0,425,1088,70,1385,48,1155,34,48
"1687","2020-04-13",295,20,178,1037,5032,0.815977742448331,0,0,425,1088,46,1431,65,1220,23,65
"1688","2020-04-14",292,20,166,1041,5032,0.815977742448331,0,0,425,1088,34,1465,45,1265,12,45
"1689","2020-04-15",302,20,167,1029,5032,0.815977742448331,0,0,425,1088,35,1500,50,1315,10,50
"1690","2020-04-16",312,20,197,1029,5032,0.815977742448331,0,0,425,1088,37,1537,32,1347,12,32
"1691","2020-04-17",309,20,205,1031,5032,0.815977742448331,0,0,425,1088,42,1579,41,1388,20,41
"1692","2020-04-18",302,20,229,1027,5032,0.815977742448331,0,0,425,1088,27,1606,29,1417,5,29
"1693","2020-04-19",289,20,232,1003,5032,0.815977742448331,0,0,425,1088,40,1646,31,1448,8,31
"1694","2020-04-20",279,20,216,999,5032,0.815977742448331,0,0,425,1088,45,1691,35,1483,5,35
"1695","2020-04-21",267,20,191,990,5032,0.815977742448331,0,0,425,1088,48,1739,56,1539,17,56
"1696","2020-04-22",246,20,235,969,5032,0.815977742448331,0,0,425,1088,51,1790,38,1577,15,38
"1697","2020-04-23",247,20,230,958,5032,0.815977742448331,0,0,425,1088,42,1832,41,1618,16,41
"1698","2020-04-24",262,20,218,933,5032,0.815977742448331,0,0,425,1088,43,1875,37,1655,15,37
"1699","2020-04-25",248,20,196,919,5032,0.815977742448331,0,0,425,1088,45,1920,41,1696,11,41
"1700","2020-04-26",256,20,220,897,5032,0.815977742448331,0,0,425,1088,32,1952,59,1755,13,59
"1701","2020-04-27",266,20,259,874,5032,0.815977742448331,0,0,425,1088,30,1982,58,1813,8,58
"1702","2020-04-28",259,20,247,862,5032,0.815977742448331,0,0,425,1088,34,2016,44,1857,9,44
"1703","2020-04-29",262,20,245,849,5032,0.815977742448331,0,0,425,1088,31,2047,49,1906,7,49
"1704","2020-04-30",248,20,260,842,5032,0.815977742448331,0,0,425,1088,33,2080,49,1955,12,49
"1705","2020-05-01",237,20,235,811,5032,0.815977742448331,0,0,425,1088,38,2118,37,1992,7,37
"1706","2020-05-02",233,20,235,792,5032,0.815977742448331,0,0,425,1088,39,2157,37,2029,15,37
"1707","2020-05-03",219,20,227,771,5032,0.815977742448331,0,0,425,1088,37,2194,36,2065,15,36
"1708","2020-05-04",209,20,205,741,5032,0.815977742448331,0,0,425,1088,44,2238,31,2096,12,31
"1709","2020-05-05",222,20,200,716,5032,0.815977742448331,0,0,425,1088,32,2270,41,2137,13,41
"1710","2020-05-06",225,20,231,692,5032,0.815977742448331,0,0,425,1088,27,2297,40,2177,13,40
"1711","2020-05-07",225,20,270,660,5032,0.815977742448331,0,0,425,1088,38,2335,31,2208,7,31
"1712","2020-05-08",212,20,257,634,5032,0.815977742448331,0,0,425,1088,32,2367,39,2247,7,39
"1713","2020-05-09",207,20,251,598,5032,0.815977742448331,0,0,425,1088,38,2405,49,2296,9,49
"1714","2020-05-10",207,20,282,574,5032,0.815977742448331,0,0,425,1088,35,2440,46,2342,5,46
"1715","2020-05-11",202,20,292,554,5032,0.815977742448331,0,0,425,1088,33,2473,44,2386,16,44
"1716","2020-05-12",194,20,308,551,5032,0.815977742448331,0,0,425,1088,39,2512,44,2430,13,44
"1717","2020-05-13",178,20,317,538,5032,0.815977742448331,0,0,425,1088,43,2555,46,2476,11,46
"1718","2020-05-14",171,20,288,519,5032,0.815977742448331,0,0,425,1088,25,2580,33,2509,12,33
"1719","2020-05-15",174,20,278,494,5032,0.815977742448331,0,0,425,1088,29,2609,43,2552,13,43
"1720","2020-05-16",171,20,259,473,5032,0.815977742448331,0,0,425,1088,23,2632,30,2582,9,30
"1721","2020-05-17",160,20,278,445,5032,0.815977742448331,0,0,425,1088,26,2658,49,2631,11,49
"1722","2020-05-18",147,20,309,440,5032,0.815977742448331,0,0,425,1088,19,2677,55,2686,6,55
"1723","2020-05-19",138,20,316,435,5032,0.815977742448331,0,0,425,1088,24,2701,65,2751,3,65
"1724","2020-05-20",144,20,286,411,5032,0.815977742448331,0,0,425,1088,19,2720,39,2790,5,39
"1725","2020-05-21",139,20,285,383,5032,0.815977742448331,0,0,425,1088,24,2744,41,2831,10,41
"1726","2020-05-22",129,20,263,371,5032,0.815977742448331,0,0,425,1088,33,2777,38,2869,14,38
"1727","2020-05-23",121,20,246,350,5032,0.815977742448331,0,0,425,1088,22,2799,35,2904,10,35
"1728","2020-05-24",113,20,231,332,5032,0.815977742448331,0,0,425,1088,20,2819,24,2928,10,24
"1729","2020-05-25",113,20,215,317,5032,0.815977742448331,0,0,425,1088,25,2844,27,2955,8,27
"1730","2020-05-26",107,20,194,309,5032,0.815977742448331,0,0,425,1088,19,2863,28,2983,3,28
"1731","2020-05-27",91,20,195,294,5032,0.815977742448331,0,0,425,1088,20,2883,17,3000,8,17
"1732","2020-05-28",88,20,220,288,5032,0.815977742448331,0,0,425,1088,19,2902,32,3032,10,32
"1733","2020-05-29",78,20,219,266,5032,0.815977742448331,0,0,425,1088,13,2915,30,3062,5,30
"1734","2020-05-30",85,20,242,248,5032,0.815977742448331,0,0,425,1088,13,2928,52,3114,8,52
"1735","2020-05-31",91,20,270,234,5032,0.815977742448331,0,0,425,1088,28,2956,48,3162,14,48
"1736","2020-06-01",85,20,312,230,5032,0.815977742448331,0,0,425,1088,16,2972,49,3211,11,49
"1737","2020-06-02",83,20,310,230,5032,0.815977742448331,0,0,425,1088,19,2991,51,3262,8,51
"1738","2020-06-03",85,20,325,226,5032,0.815977742448331,0,0,425,1088,15,3006,44,3306,4,44
"1739","2020-06-04",75,20,287,210,5032,0.815977742448331,0,0,425,1088,12,3018,32,3338,4,32
"1740","2020-06-05",78,20,254,208,5032,0.815977742448331,0,0,425,1088,14,3032,46,3384,8,46
"1741","2020-06-06",70,20,308,190,5032,0.815977742448331,0,0,425,1088,15,3047,33,3417,7,33
"1742","2020-06-07",60,20,314,182,5032,0.815977742448331,0,0,425,1088,13,3060,45,3462,4,45
