"","Date","Absents","Paramset","Infections_or_Exposed_per_day_Patient","Infections_or_Exposed_per_day_HCW","total_infections","nosocomial_proportion","PCR_pooled","LFD_pooled","HCW_symp_test","patient_symp_test","new_hcw_infs","cumulative_hcw_infs","new_pat_infs","cumulative_pats_infs","new_nosocomial_hcw_infs","new_nosocomial_pat_infs"
"1","2020-03-13",5,1,121,313,9202,0.574549011084547,0,0,665,825,112,313,40,100,27,40
"2","2020-03-14",16,1,130,429,9202,0.574549011084547,0,0,665,825,116,429,22,122,41,22
"3","2020-03-15",30,1,114,562,9202,0.574549011084547,0,0,665,825,134,563,8,130,52,8
"4","2020-03-16",58,1,110,703,9202,0.574549011084547,0,0,665,825,141,704,15,145,61,15
"5","2020-03-17",86,1,113,869,9202,0.574549011084547,0,0,665,825,170,874,19,164,92,19
"6","2020-03-18",108,1,141,1037,9202,0.574549011084547,0,0,665,825,176,1050,43,207,107,43
"7","2020-03-19",147,1,179,1238,9202,0.574549011084547,0,0,665,825,231,1281,48,255,163,48
"8","2020-03-20",189,1,174,1469,9202,0.574549011084547,0,0,665,825,267,1548,29,284,179,29
"9","2020-03-21",221,1,205,1662,9202,0.574549011084547,0,0,665,825,228,1776,52,336,154,52
"10","2020-03-22",260,1,206,1922,9202,0.574549011084547,0,0,665,825,313,2089,32,368,238,32
"11","2020-03-23",296,1,231,2145,9202,0.574549011084547,0,0,665,825,308,2397,66,434,240,66
"12","2020-03-24",344,1,239,2311,9202,0.574549011084547,0,0,665,825,279,2676,30,464,210,30
"13","2020-03-25",402,1,217,2534,9202,0.574549011084547,0,0,665,825,341,3017,23,487,285,23
"14","2020-03-26",467,1,218,2693,9202,0.574549011084547,0,0,665,825,316,3333,25,512,252,25
"15","2020-03-27",535,1,205,2854,9202,0.574549011084547,0,0,665,825,314,3647,18,530,265,18
"16","2020-03-28",609,1,205,2994,9202,0.574549011084547,0,0,665,825,307,3954,37,567,254,37
"17","2020-03-29",676,1,193,3170,9202,0.574549011084547,0,0,665,825,357,4311,17,584,316,17
"18","2020-03-30",730,1,209,3256,9202,0.574549011084547,0,0,665,825,297,4608,46,630,253,46
"19","2020-03-31",791,1,209,3295,9202,0.574549011084547,0,0,665,825,267,4875,26,656,224,26
"20","2020-04-01",848,1,229,3290,9202,0.574549011084547,0,0,665,825,231,5106,44,700,175,44
"21","2020-04-02",878,1,285,3251,9202,0.574549011084547,0,0,665,825,223,5329,81,781,187,81
"22","2020-04-03",894,1,272,3238,9202,0.574549011084547,0,0,665,825,230,5559,36,817,191,36
"23","2020-04-04",926,1,246,3122,9202,0.574549011084547,0,0,665,825,174,5733,30,847,133,30
"24","2020-04-05",922,1,223,3027,9202,0.574549011084547,0,0,665,825,184,5917,29,876,149,29
"25","2020-04-06",920,1,241,2893,9202,0.574549011084547,0,0,665,825,160,6077,32,908,133,32
"26","2020-04-07",890,1,247,2742,9202,0.574549011084547,0,0,665,825,139,6216,30,938,110,30
"27","2020-04-08",872,1,242,2575,9202,0.574549011084547,0,0,665,825,122,6338,30,968,94,30
"28","2020-04-09",839,1,272,2409,9202,0.574549011084547,0,0,665,825,103,6441,60,1028,79,60
"29","2020-04-10",812,1,273,2233,9202,0.574549011084547,0,0,665,825,93,6534,35,1063,70,35
"30","2020-04-11",740,1,246,2058,9202,0.574549011084547,0,0,665,825,84,6618,32,1095,56,32
"31","2020-04-12",693,1,226,1908,9202,0.574549011084547,0,0,665,825,62,6680,22,1117,40,22
"32","2020-04-13",650,1,251,1766,9202,0.574549011084547,0,0,665,825,74,6754,50,1167,45,50
"33","2020-04-14",603,1,242,1600,9202,0.574549011084547,0,0,665,825,49,6803,40,1207,30,40
"34","2020-04-15",541,1,236,1462,9202,0.574549011084547,0,0,665,825,45,6848,30,1237,25,30
"35","2020-04-16",491,1,249,1339,9202,0.574549011084547,0,0,665,825,41,6889,35,1272,25,35
"36","2020-04-17",423,1,243,1182,9202,0.574549011084547,0,0,665,825,32,6921,41,1313,19,41
"37","2020-04-18",384,1,246,1081,9202,0.574549011084547,0,0,665,825,44,6965,37,1350,26,37
"38","2020-04-19",352,1,244,969,9202,0.574549011084547,0,0,665,825,36,7001,37,1387,19,37
"39","2020-04-20",318,1,229,871,9202,0.574549011084547,0,0,665,825,29,7030,23,1410,15,23
"40","2020-04-21",292,1,260,793,9202,0.574549011084547,0,0,665,825,28,7058,50,1460,6,50
"41","2020-04-22",258,1,241,721,9202,0.574549011084547,0,0,665,825,35,7093,24,1484,22,24
"42","2020-04-23",230,1,204,653,9202,0.574549011084547,0,0,665,825,20,7113,25,1509,5,25
"43","2020-04-24",206,1,210,603,9202,0.574549011084547,0,0,665,825,27,7140,21,1530,9,21
"44","2020-04-25",188,1,242,562,9202,0.574549011084547,0,0,665,825,26,7166,60,1590,12,60
"45","2020-04-26",169,1,252,515,9202,0.574549011084547,0,0,665,825,18,7184,36,1626,4,36
"46","2020-04-27",149,1,295,477,9202,0.574549011084547,0,0,665,825,24,7208,65,1691,11,65
"47","2020-04-28",135,1,291,433,9202,0.574549011084547,0,0,665,825,23,7231,48,1739,3,48
"48","2020-04-29",124,1,307,402,9202,0.574549011084547,0,0,665,825,13,7244,54,1793,6,54
"49","2020-04-30",113,1,276,356,9202,0.574549011084547,0,0,665,825,12,7256,28,1821,3,28
"50","2020-05-01",108,1,267,335,9202,0.574549011084547,0,0,665,825,20,7276,22,1843,6,22
"51","2020-05-02",106,1,252,318,9202,0.574549011084547,0,0,665,825,17,7293,26,1869,3,26
"52","2020-05-03",97,1,271,308,9202,0.574549011084547,0,0,665,825,17,7310,46,1915,2,46
"53","2020-05-04",82,1,265,290,9202,0.574549011084547,0,0,665,825,16,7326,31,1946,2,31
"54","2020-05-05",75,1,269,277,9202,0.574549011084547,0,0,665,825,28,7354,40,1986,10,40
"55","2020-05-06",70,1,242,271,9202,0.574549011084547,0,0,665,825,23,7377,26,2012,3,26
"56","2020-05-07",65,1,222,270,9202,0.574549011084547,0,0,665,825,13,7390,19,2031,4,19
"57","2020-05-08",65,1,217,257,9202,0.574549011084547,0,0,665,825,17,7407,25,2056,6,25
"58","2020-05-09",58,1,219,243,9202,0.574549011084547,0,0,665,825,15,7422,29,2085,2,29
"59","2020-05-10",56,1,207,230,9202,0.574549011084547,0,0,665,825,11,7433,15,2100,4,15
"60","2020-05-11",61,1,195,217,9202,0.574549011084547,0,0,665,825,7,7440,12,2112,2,12
"61","2020-05-12",55,1,184,209,9202,0.574549011084547,0,0,665,825,10,7450,13,2125,1,13
"62","2020-05-13",59,1,189,192,9202,0.574549011084547,0,0,665,825,12,7462,17,2142,NA,17
"63","2020-05-14",63,1,170,183,9202,0.574549011084547,0,0,665,825,11,7473,14,2156,5,14
"64","2020-05-15",60,1,162,182,9202,0.574549011084547,0,0,665,825,12,7485,13,2169,4,13
"65","2020-05-16",55,1,156,167,9202,0.574549011084547,0,0,665,825,8,7493,14,2183,1,14
"66","2020-05-17",56,1,152,159,9202,0.574549011084547,0,0,665,825,9,7502,13,2196,NA,13
"67","2020-05-18",54,1,184,150,9202,0.574549011084547,0,0,665,825,9,7511,43,2239,1,43
"68","2020-05-19",51,1,223,141,9202,0.574549011084547,0,0,665,825,10,7521,49,2288,2,49
"69","2020-05-20",48,1,225,135,9202,0.574549011084547,0,0,665,825,11,7532,33,2321,1,33
"70","2020-05-21",43,1,215,131,9202,0.574549011084547,0,0,665,825,3,7535,17,2338,2,17
"71","2020-05-22",43,1,209,122,9202,0.574549011084547,0,0,665,825,4,7539,27,2365,1,27
"72","2020-05-23",40,1,222,115,9202,0.574549011084547,0,0,665,825,7,7546,25,2390,2,25
"73","2020-05-24",35,1,246,109,9202,0.574549011084547,0,0,665,825,3,7549,51,2441,NA,51
"74","2020-05-25",31,1,259,107,9202,0.574549011084547,0,0,665,825,8,7557,38,2479,1,38
"75","2020-05-26",29,1,271,101,9202,0.574549011084547,0,0,665,825,10,7567,53,2532,NA,53
"76","2020-05-27",22,1,238,92,9202,0.574549011084547,0,0,665,825,6,7573,32,2564,1,32
"77","2020-05-28",21,1,213,89,9202,0.574549011084547,0,0,665,825,4,7577,25,2589,NA,25
"78","2020-05-29",22,1,216,83,9202,0.574549011084547,0,0,665,825,6,7583,31,2620,NA,31
"79","2020-05-30",20,1,193,79,9202,0.574549011084547,0,0,665,825,5,7588,23,2643,NA,23
"80","2020-05-31",18,1,185,78,9202,0.574549011084547,0,0,665,825,7,7595,24,2667,1,24
"81","2020-06-01",16,1,200,72,9202,0.574549011084547,0,0,665,825,4,7599,43,2710,3,43
"82","2020-06-02",17,1,235,65,9202,0.574549011084547,0,0,665,825,5,7604,60,2770,1,60
"83","2020-06-03",19,1,227,64,9202,0.574549011084547,0,0,665,825,3,7607,32,2802,1,32
"84","2020-06-04",16,1,222,63,9202,0.574549011084547,0,0,665,825,4,7611,30,2832,NA,30
"85","2020-06-05",13,1,230,56,9202,0.574549011084547,0,0,665,825,1,7612,42,2874,NA,42
"86","2020-06-06",13,1,227,50,9202,0.574549011084547,0,0,665,825,2,7614,36,2910,NA,36
"87","2020-06-07",15,1,205,48,9202,0.574549011084547,0,0,665,825,3,7617,31,2941,NA,31
"88","2020-03-12",1,2,56,92,6349,0.506378957316113,0,0,507,754,65,139,19,39,3,19
"89","2020-03-13",2,2,54,145,6349,0.506378957316113,0,0,507,754,66,205,23,62,2,23
"90","2020-03-14",11,2,56,201,6349,0.506378957316113,0,0,507,754,82,287,21,83,15,21
"91","2020-03-15",17,2,62,256,6349,0.506378957316113,0,0,507,754,66,353,25,108,14,25
"92","2020-03-16",25,2,56,333,6349,0.506378957316113,0,0,507,754,69,422,27,135,13,27
"93","2020-03-17",36,2,63,410,6349,0.506378957316113,0,0,507,754,92,514,25,160,22,25
"94","2020-03-18",47,2,61,486,6349,0.506378957316113,0,0,507,754,90,604,57,217,22,57
"95","2020-03-19",65,2,76,571,6349,0.506378957316113,0,0,507,754,91,695,43,260,30,43
"96","2020-03-20",84,2,85,642,6349,0.506378957316113,0,0,507,754,95,790,52,312,29,52
"97","2020-03-21",101,2,115,716,6349,0.506378957316113,0,0,507,754,85,875,45,357,23,45
"98","2020-03-22",120,2,129,799,6349,0.506378957316113,0,0,507,754,83,958,48,405,31,48
"99","2020-03-23",147,2,127,877,6349,0.506378957316113,0,0,507,754,99,1057,48,453,30,48
"100","2020-03-24",178,2,113,949,6349,0.506378957316113,0,0,507,754,75,1132,44,497,13,44
"101","2020-03-25",204,2,107,1002,6349,0.506378957316113,0,0,507,754,89,1221,41,538,29,41
"102","2020-03-26",224,2,89,1056,6349,0.506378957316113,0,0,507,754,93,1314,51,589,25,51
"103","2020-03-27",250,2,102,1084,6349,0.506378957316113,0,0,507,754,76,1390,58,647,19,58
"104","2020-03-28",274,2,108,1169,6349,0.506378957316113,0,0,507,754,91,1481,30,677,32,30
"105","2020-03-29",303,2,105,1192,6349,0.506378957316113,0,0,507,754,101,1582,30,707,30,30
"106","2020-03-30",316,2,113,1194,6349,0.506378957316113,0,0,507,754,98,1680,24,731,25,24
"107","2020-03-31",329,2,108,1236,6349,0.506378957316113,0,0,507,754,100,1780,23,754,32,23
"108","2020-04-01",330,2,110,1248,6349,0.506378957316113,0,0,507,754,97,1877,36,790,28,36
"109","2020-04-02",346,2,122,1265,6349,0.506378957316113,0,0,507,754,97,1974,37,827,29,37
"110","2020-04-03",354,2,123,1300,6349,0.506378957316113,0,0,507,754,103,2077,25,852,34,25
"111","2020-04-04",358,2,126,1324,6349,0.506378957316113,0,0,507,754,80,2157,42,894,22,42
"112","2020-04-05",356,2,138,1311,6349,0.506378957316113,0,0,507,754,89,2246,37,931,11,37
"113","2020-04-06",353,2,180,1307,6349,0.506378957316113,0,0,507,754,106,2352,28,959,20,28
"114","2020-04-07",353,2,235,1282,6349,0.506378957316113,0,0,507,754,101,2453,14,973,34,15
"115","2020-04-08",379,2,212,1282,6349,0.506378957316113,0,0,507,754,96,2549,49,1022,16,49
"116","2020-04-09",371,2,196,1271,6349,0.506378957316113,0,0,507,754,86,2635,33,1055,18,33
"117","2020-04-10",354,2,166,1254,6349,0.506378957316113,0,0,507,754,110,2745,24,1079,31,24
"118","2020-04-11",340,2,156,1228,6349,0.506378957316113,0,0,507,754,86,2831,24,1103,17,24
"119","2020-04-12",330,2,158,1223,6349,0.506378957316113,0,0,507,754,92,2923,21,1124,21,21
"120","2020-04-13",326,2,191,1209,6349,0.506378957316113,0,0,507,754,103,3026,22,1146,24,22
"121","2020-04-14",310,2,198,1159,6349,0.506378957316113,0,0,507,754,73,3099,32,1178,16,32
"122","2020-04-15",278,2,179,1142,6349,0.506378957316113,0,0,507,754,82,3181,32,1210,19,32
"123","2020-04-16",273,2,188,1113,6349,0.506378957316113,0,0,507,754,74,3255,45,1255,18,45
"124","2020-04-17",281,2,187,1089,6349,0.506378957316113,0,0,507,754,104,3359,35,1290,34,35
"125","2020-04-18",281,2,186,1058,6349,0.506378957316113,0,0,507,754,105,3464,29,1319,28,29
"126","2020-04-19",276,2,234,1049,6349,0.506378957316113,0,0,507,754,98,3562,48,1367,21,48
"127","2020-04-20",276,2,213,1027,6349,0.506378957316113,0,0,507,754,86,3648,23,1390,26,23
"128","2020-04-21",286,2,190,985,6349,0.506378957316113,0,0,507,754,68,3716,33,1423,20,33
"129","2020-04-22",302,2,181,967,6349,0.506378957316113,0,0,507,754,66,3782,32,1455,21,32
"130","2020-04-23",292,2,215,952,6349,0.506378957316113,0,0,507,754,63,3845,43,1498,19,43
"131","2020-04-24",278,2,210,957,6349,0.506378957316113,0,0,507,754,82,3927,27,1525,14,27
"132","2020-04-25",273,2,223,945,6349,0.506378957316113,0,0,507,754,71,3998,33,1558,19,33
"133","2020-04-26",259,2,214,943,6349,0.506378957316113,0,0,507,754,69,4067,30,1588,13,30
"134","2020-04-27",247,2,191,947,6349,0.506378957316113,0,0,507,754,64,4131,42,1630,8,42
"135","2020-04-28",236,2,177,912,6349,0.506378957316113,0,0,507,754,79,4210,42,1672,9,42
"136","2020-04-29",229,2,170,898,6349,0.506378957316113,0,0,507,754,56,4266,34,1706,11,34
"137","2020-04-30",235,2,182,892,6349,0.506378957316113,0,0,507,754,61,4327,59,1765,9,59
"138","2020-05-01",242,2,178,849,6349,0.506378957316113,0,0,507,754,66,4393,34,1799,9,34
"139","2020-05-02",233,2,213,826,6349,0.506378957316113,0,0,507,754,67,4460,24,1823,14,24
"140","2020-05-03",239,2,253,810,6349,0.506378957316113,0,0,507,754,64,4524,29,1852,8,29
"141","2020-05-04",240,2,235,804,6349,0.506378957316113,0,0,507,754,59,4583,25,1877,11,25
"142","2020-05-05",244,2,227,747,6349,0.506378957316113,0,0,507,754,55,4638,49,1926,8,49
"143","2020-05-06",232,2,216,710,6349,0.506378957316113,0,0,507,754,53,4691,33,1959,7,33
"144","2020-05-07",225,2,241,693,6349,0.506378957316113,0,0,507,754,42,4733,42,2001,4,42
"145","2020-05-08",211,2,262,666,6349,0.506378957316113,0,0,507,754,51,4784,29,2030,8,29
"146","2020-05-09",213,2,276,620,6349,0.506378957316113,0,0,507,754,50,4834,35,2065,13,35
"147","2020-05-10",204,2,291,577,6349,0.506378957316113,0,0,507,754,57,4891,36,2101,9,36
"148","2020-05-11",195,2,292,541,6349,0.506378957316113,0,0,507,754,68,4959,26,2127,13,26
"149","2020-05-12",177,2,267,519,6349,0.506378957316113,0,0,507,754,50,5009,27,2154,8,27
"150","2020-05-13",169,2,260,502,6349,0.506378957316113,0,0,507,754,38,5047,23,2177,8,23
"151","2020-05-14",162,2,259,479,6349,0.506378957316113,0,0,507,754,39,5086,24,2201,7,24
"152","2020-05-15",161,2,233,469,6349,0.506378957316113,0,0,507,754,44,5130,24,2225,9,24
"153","2020-05-16",150,2,205,444,6349,0.506378957316113,0,0,507,754,44,5174,16,2241,4,16
"154","2020-05-17",150,2,179,425,6349,0.506378957316113,0,0,507,754,28,5202,19,2260,6,19
"155","2020-05-18",147,2,173,395,6349,0.506378957316113,0,0,507,754,51,5253,45,2305,10,45
"156","2020-05-19",142,2,163,371,6349,0.506378957316113,0,0,507,754,33,5286,47,2352,6,47
"157","2020-05-20",143,2,155,370,6349,0.506378957316113,0,0,507,754,30,5316,50,2402,7,50
"158","2020-05-21",131,2,156,342,6349,0.506378957316113,0,0,507,754,32,5348,33,2435,7,33
"159","2020-05-22",115,2,170,317,6349,0.506378957316113,0,0,507,754,27,5375,27,2462,6,27
"160","2020-05-23",112,2,198,301,6349,0.506378957316113,0,0,507,754,30,5405,27,2489,9,27
"161","2020-05-24",105,2,200,286,6349,0.506378957316113,0,0,507,754,24,5429,25,2514,1,25
"162","2020-05-25",102,2,233,281,6349,0.506378957316113,0,0,507,754,33,5462,27,2541,6,27
"163","2020-05-26",101,2,268,267,6349,0.506378957316113,0,0,507,754,21,5483,46,2587,2,46
"164","2020-05-27",91,2,275,256,6349,0.506378957316113,0,0,507,754,34,5517,38,2625,5,38
"165","2020-05-28",88,2,269,244,6349,0.506378957316113,0,0,507,754,35,5552,46,2671,NA,46
"166","2020-05-29",92,2,251,223,6349,0.506378957316113,0,0,507,754,24,5576,38,2709,5,38
"167","2020-05-30",86,2,227,213,6349,0.506378957316113,0,0,507,754,32,5608,46,2755,5,46
"168","2020-05-31",80,2,198,211,6349,0.506378957316113,0,0,507,754,25,5633,52,2807,2,52
"169","2020-06-01",70,2,186,205,6349,0.506378957316113,0,0,507,754,15,5648,49,2856,NA,49
"170","2020-06-02",59,2,209,205,6349,0.506378957316113,0,0,507,754,16,5664,45,2901,3,45
"171","2020-06-03",53,2,214,202,6349,0.506378957316113,0,0,507,754,18,5682,44,2945,1,44
"172","2020-06-04",56,2,189,199,6349,0.506378957316113,0,0,507,754,24,5706,52,2997,1,52
"173","2020-06-05",55,2,177,188,6349,0.506378957316113,0,0,507,754,10,5716,45,3042,3,45
"174","2020-06-06",58,2,180,186,6349,0.506378957316113,0,0,507,754,21,5737,38,3080,2,38
"175","2020-06-07",59,2,182,180,6349,0.506378957316113,0,0,507,754,13,5750,24,3104,1,24
"176","2020-03-13",1,3,195,234,7479,0.278513170209921,0,0,617,1481,35,95,34,106,17,34
"177","2020-03-14",8,3,271,353,7479,0.278513170209921,0,0,617,1481,40,135,50,156,26,50
"178","2020-03-15",19,3,333,446,7479,0.278513170209921,0,0,617,1481,61,196,54,210,39,54
"179","2020-03-16",38,3,340,542,7479,0.278513170209921,0,0,617,1481,63,259,43,253,43,43
"180","2020-03-17",57,3,334,636,7479,0.278513170209921,0,0,617,1481,75,334,56,309,47,56
"181","2020-03-18",80,3,343,731,7479,0.278513170209921,0,0,617,1481,100,434,32,341,71,32
"182","2020-03-19",110,3,317,808,7479,0.278513170209921,0,0,617,1481,92,526,37,378,70,37
"183","2020-03-20",142,3,296,858,7479,0.278513170209921,0,0,617,1481,120,646,42,420,92,42
"184","2020-03-21",170,3,314,935,7479,0.278513170209921,0,0,617,1481,115,761,46,466,99,46
"185","2020-03-22",202,3,327,994,7479,0.278513170209921,0,0,617,1481,136,897,36,502,117,36
"186","2020-03-23",238,3,341,1054,7479,0.278513170209921,0,0,617,1481,151,1048,31,533,125,31
"187","2020-03-24",259,3,317,1095,7479,0.278513170209921,0,0,617,1481,178,1226,46,579,162,46
"188","2020-03-25",279,3,315,1149,7479,0.278513170209921,0,0,617,1481,176,1402,43,622,158,43
"189","2020-03-26",301,3,314,1195,7479,0.278513170209921,0,0,617,1481,164,1566,35,657,144,35
"190","2020-03-27",311,3,305,1214,7479,0.278513170209921,0,0,617,1481,201,1767,23,680,178,23
"191","2020-03-28",328,3,304,1238,7479,0.278513170209921,0,0,617,1481,167,1934,27,707,148,27
"192","2020-03-29",328,3,303,1268,7479,0.278513170209921,0,0,617,1481,200,2134,33,740,179,33
"193","2020-03-30",332,3,331,1280,7479,0.278513170209921,0,0,617,1481,221,2355,31,771,205,31
"194","2020-03-31",342,3,373,1320,7479,0.278513170209921,0,0,617,1481,218,2573,43,814,197,43
"195","2020-04-01",353,3,343,1342,7479,0.278513170209921,0,0,617,1481,185,2758,26,840,157,26
"196","2020-04-02",343,3,315,1369,7479,0.278513170209921,0,0,617,1481,229,2987,37,877,208,37
"197","2020-04-03",358,3,297,1405,7479,0.278513170209921,0,0,617,1481,197,3184,42,919,186,42
"198","2020-04-04",369,3,297,1407,7479,0.278513170209921,0,0,617,1481,207,3391,39,958,189,39
"199","2020-04-05",375,3,328,1392,7479,0.278513170209921,0,0,617,1481,205,3596,29,987,187,29
"200","2020-04-06",370,3,356,1360,7479,0.278513170209921,0,0,617,1481,220,3816,20,1007,204,20
"201","2020-04-07",372,3,365,1324,7479,0.278513170209921,0,0,617,1481,189,4005,32,1039,170,32
"202","2020-04-08",366,3,383,1315,7479,0.278513170209921,0,0,617,1481,176,4181,31,1070,165,31
"203","2020-04-09",371,3,379,1310,7479,0.278513170209921,0,0,617,1481,158,4339,43,1113,148,43
"204","2020-04-10",367,3,366,1289,7479,0.278513170209921,0,0,617,1481,183,4522,36,1149,175,36
"205","2020-04-11",346,3,345,1277,7479,0.278513170209921,0,0,617,1481,149,4671,31,1180,140,31
"206","2020-04-12",346,3,335,1238,7479,0.278513170209921,0,0,617,1481,153,4824,14,1194,136,14
"207","2020-04-13",335,3,339,1220,7479,0.278513170209921,0,0,617,1481,129,4953,21,1215,116,21
"208","2020-04-14",333,3,340,1212,7479,0.278513170209921,0,0,617,1481,125,5078,17,1232,113,17
"209","2020-04-15",333,3,342,1204,7479,0.278513170209921,0,0,617,1481,122,5200,20,1252,105,20
"210","2020-04-16",330,3,339,1204,7479,0.278513170209921,0,0,617,1481,90,5290,34,1286,79,34
"211","2020-04-17",320,3,337,1194,7479,0.278513170209921,0,0,617,1481,97,5387,39,1325,90,39
"212","2020-04-18",320,3,323,1163,7479,0.278513170209921,0,0,617,1481,99,5486,25,1350,86,25
"213","2020-04-19",318,3,326,1161,7479,0.278513170209921,0,0,617,1481,90,5576,24,1374,71,24
"214","2020-04-20",323,3,321,1144,7479,0.278513170209921,0,0,617,1481,84,5660,36,1410,73,36
"215","2020-04-21",314,3,332,1166,7479,0.278513170209921,0,0,617,1481,68,5728,29,1439,61,29
"216","2020-04-22",314,3,384,1131,7479,0.278513170209921,0,0,617,1481,58,5786,40,1479,51,40
"217","2020-04-23",309,3,381,1096,7479,0.278513170209921,0,0,617,1481,74,5860,31,1510,53,31
"218","2020-04-24",317,3,356,1089,7479,0.278513170209921,0,0,617,1481,55,5915,25,1535,44,25
"219","2020-04-25",313,3,337,1061,7479,0.278513170209921,0,0,617,1481,42,5957,18,1553,35,18
"220","2020-04-26",301,3,335,1073,7479,0.278513170209921,0,0,617,1481,48,6005,20,1573,34,20
"221","2020-04-27",286,3,325,1034,7479,0.278513170209921,0,0,617,1481,41,6046,19,1592,30,19
"222","2020-04-28",287,3,351,977,7479,0.278513170209921,0,0,617,1481,30,6076,21,1613,23,21
"223","2020-04-29",277,3,362,971,7479,0.278513170209921,0,0,617,1481,32,6108,36,1649,24,36
"224","2020-04-30",260,3,348,934,7479,0.278513170209921,0,0,617,1481,32,6140,45,1694,26,45
"225","2020-05-01",242,3,358,905,7479,0.278513170209921,0,0,617,1481,31,6171,31,1725,23,31
"226","2020-05-02",240,3,352,879,7479,0.278513170209921,0,0,617,1481,33,6204,19,1744,26,19
"227","2020-05-03",231,3,348,835,7479,0.278513170209921,0,0,617,1481,31,6235,44,1788,23,44
"228","2020-05-04",224,3,364,809,7479,0.278513170209921,0,0,617,1481,33,6268,52,1840,26,52
"229","2020-05-05",226,3,351,787,7479,0.278513170209921,0,0,617,1481,39,6307,35,1875,30,35
"230","2020-05-06",220,3,341,756,7479,0.278513170209921,0,0,617,1481,24,6331,27,1902,18,27
"231","2020-05-07",223,3,342,743,7479,0.278513170209921,0,0,617,1481,22,6353,25,1927,17,25
"232","2020-05-08",221,3,350,734,7479,0.278513170209921,0,0,617,1481,21,6374,16,1943,15,16
"233","2020-05-09",221,3,330,718,7479,0.278513170209921,0,0,617,1481,21,6395,61,2004,10,61
"234","2020-05-10",220,3,360,691,7479,0.278513170209921,0,0,617,1481,26,6421,45,2049,20,45
"235","2020-05-11",223,3,348,682,7479,0.278513170209921,0,0,617,1481,20,6441,33,2082,12,33
"236","2020-05-12",204,3,354,670,7479,0.278513170209921,0,0,617,1481,23,6464,26,2108,18,26
"237","2020-05-13",200,3,341,635,7479,0.278513170209921,0,0,617,1481,16,6480,44,2152,10,44
"238","2020-05-14",206,3,349,608,7479,0.278513170209921,0,0,617,1481,16,6496,43,2195,11,43
"239","2020-05-15",200,3,337,588,7479,0.278513170209921,0,0,617,1481,15,6511,34,2229,9,34
"240","2020-05-16",188,3,332,562,7479,0.278513170209921,0,0,617,1481,22,6533,26,2255,16,26
"241","2020-05-17",186,3,319,549,7479,0.278513170209921,0,0,617,1481,15,6548,19,2274,12,19
"242","2020-05-18",176,3,340,534,7479,0.278513170209921,0,0,617,1481,11,6559,20,2294,7,20
"243","2020-05-19",173,3,364,516,7479,0.278513170209921,0,0,617,1481,14,6573,13,2307,7,13
"244","2020-05-20",166,3,382,488,7479,0.278513170209921,0,0,617,1481,13,6586,24,2331,7,24
"245","2020-05-21",149,3,367,469,7479,0.278513170209921,0,0,617,1481,16,6602,20,2351,9,20
"246","2020-05-22",139,3,402,452,7479,0.278513170209921,0,0,617,1481,17,6619,20,2371,9,20
"247","2020-05-23",126,3,403,430,7479,0.278513170209921,0,0,617,1481,11,6630,22,2393,10,22
"248","2020-05-24",120,3,379,407,7479,0.278513170209921,0,0,617,1481,9,6639,58,2451,6,58
"249","2020-05-25",115,3,381,396,7479,0.278513170209921,0,0,617,1481,12,6651,30,2481,11,30
"250","2020-05-26",102,3,374,375,7479,0.278513170209921,0,0,617,1481,9,6660,40,2521,7,40
"251","2020-05-27",100,3,349,348,7479,0.278513170209921,0,0,617,1481,9,6669,37,2558,5,37
"252","2020-05-28",101,3,357,330,7479,0.278513170209921,0,0,617,1481,12,6681,38,2596,7,38
"253","2020-05-29",97,3,350,325,7479,0.278513170209921,0,0,617,1481,9,6690,49,2645,6,49
"254","2020-05-30",100,3,353,309,7479,0.278513170209921,0,0,617,1481,10,6700,64,2709,7,64
"255","2020-05-31",99,3,354,300,7479,0.278513170209921,0,0,617,1481,6,6706,35,2744,4,35
"256","2020-06-01",94,3,357,287,7479,0.278513170209921,0,0,617,1481,5,6711,35,2779,4,35
"257","2020-06-02",99,3,335,263,7479,0.278513170209921,0,0,617,1481,12,6723,25,2804,8,25
"258","2020-06-03",90,3,337,250,7479,0.278513170209921,0,0,617,1481,8,6731,32,2836,3,32
"259","2020-06-04",84,3,329,228,7479,0.278513170209921,0,0,617,1481,7,6738,28,2864,4,28
"260","2020-06-05",80,3,344,220,7479,0.278513170209921,0,0,617,1481,11,6749,28,2892,7,28
"261","2020-06-06",72,3,334,204,7479,0.278513170209921,0,0,617,1481,4,6753,32,2924,4,32
"262","2020-06-07",65,3,327,195,7479,0.278513170209921,0,0,617,1481,5,6758,21,2945,4,21
"263","2020-03-14",2,4,191,184,6206,0.575249758298421,0,0,564,889,196,543,84,259,116,84
"264","2020-03-15",6,4,183,244,6206,0.575249758298421,0,0,564,889,256,799,79,338,187,79
"265","2020-03-16",16,4,176,307,6206,0.575249758298421,0,0,564,889,338,1137,39,377,257,39
"266","2020-03-17",21,4,188,377,6206,0.575249758298421,0,0,564,889,403,1540,19,396,337,19
"267","2020-03-18",41,4,182,450,6206,0.575249758298421,0,0,564,889,507,2047,19,415,432,19
"268","2020-03-19",51,4,164,519,6206,0.575249758298421,0,0,564,889,581,2628,26,441,525,26
"269","2020-03-20",73,4,191,601,6206,0.575249758298421,0,0,564,889,664,3292,12,453,607,12
"270","2020-03-21",91,4,221,676,6206,0.575249758298421,0,0,564,889,698,3990,16,469,650,16
"271","2020-03-22",120,4,214,729,6206,0.575249758298421,0,0,564,889,624,4614,14,483,565,14
"272","2020-03-23",140,4,223,810,6206,0.575249758298421,0,0,564,889,602,5216,38,521,569,38
"273","2020-03-24",171,4,228,862,6206,0.575249758298421,0,0,564,889,588,5804,53,574,560,53
"274","2020-03-25",184,4,213,928,6206,0.575249758298421,0,0,564,889,448,6252,29,603,428,29
"275","2020-03-26",213,4,186,1002,6206,0.575249758298421,0,0,564,889,395,6647,21,624,371,21
"276","2020-03-27",229,4,175,1061,6206,0.575249758298421,0,0,564,889,254,6901,21,645,236,21
"277","2020-03-28",247,4,199,1105,6206,0.575249758298421,0,0,564,889,227,7128,13,658,210,13
"278","2020-03-29",247,4,212,1145,6206,0.575249758298421,0,0,564,889,139,7267,10,668,131,10
"279","2020-03-30",248,4,199,1181,6206,0.575249758298421,0,0,564,889,124,7391,19,687,117,19
"280","2020-03-31",258,4,233,1189,6206,0.575249758298421,0,0,564,889,91,7482,56,743,82,56
"281","2020-04-01",277,4,245,1200,6206,0.575249758298421,0,0,564,889,77,7559,39,782,69,39
"282","2020-04-02",282,4,217,1240,6206,0.575249758298421,0,0,564,889,59,7618,30,812,54,30
"283","2020-04-03",292,4,221,1230,6206,0.575249758298421,0,0,564,889,40,7658,24,836,35,24
"284","2020-04-04",318,4,227,1245,6206,0.575249758298421,0,0,564,889,25,7683,14,850,19,14
"285","2020-04-05",350,4,212,1259,6206,0.575249758298421,0,0,564,889,28,7711,13,863,24,13
"286","2020-04-06",354,4,219,1242,6206,0.575249758298421,0,0,564,889,16,7727,15,878,12,15
"287","2020-04-07",370,4,252,1253,6206,0.575249758298421,0,0,564,889,24,7751,36,914,17,36
"288","2020-04-08",376,4,297,1263,6206,0.575249758298421,0,0,564,889,17,7768,30,944,14,30
"289","2020-04-09",386,4,356,1255,6206,0.575249758298421,0,0,564,889,12,7780,31,975,7,31
"290","2020-04-10",377,4,354,1237,6206,0.575249758298421,0,0,564,889,12,7792,19,994,8,19
"291","2020-04-11",368,4,339,1229,6206,0.575249758298421,0,0,564,889,10,7802,12,1006,6,12
"292","2020-04-12",352,4,344,1238,6206,0.575249758298421,0,0,564,889,4,7806,10,1016,1,10
"293","2020-04-13",372,4,313,1212,6206,0.575249758298421,0,0,564,889,10,7816,23,1039,4,23
"294","2020-04-14",365,4,316,1181,6206,0.575249758298421,0,0,564,889,2,7818,41,1080,1,41
"295","2020-04-15",346,4,302,1157,6206,0.575249758298421,0,0,564,889,4,7822,51,1131,3,51
"296","2020-04-16",339,4,297,1153,6206,0.575249758298421,0,0,564,889,1,7823,27,1158,NA,27
"297","2020-04-17",344,4,318,1138,6206,0.575249758298421,0,0,564,889,4,7827,29,1187,2,29
"298","2020-04-18",324,4,313,1100,6206,0.575249758298421,0,0,564,889,4,7831,61,1248,NA,61
"299","2020-04-19",335,4,283,1068,6206,0.575249758298421,0,0,564,889,2,7833,64,1312,1,64
"300","2020-04-20",321,4,266,1041,6206,0.575249758298421,0,0,564,889,10,7843,29,1341,3,29
"301","2020-04-21",315,4,251,1022,6206,0.575249758298421,0,0,564,889,4,7847,20,1361,2,20
"302","2020-04-22",314,4,244,993,6206,0.575249758298421,0,0,564,889,10,7857,28,1389,4,28
"303","2020-04-23",307,4,235,981,6206,0.575249758298421,0,0,564,889,6,7863,17,1406,1,17
"304","2020-04-24",291,4,269,955,6206,0.575249758298421,0,0,564,889,3,7866,19,1425,NA,19
"305","2020-04-25",287,4,256,935,6206,0.575249758298421,0,0,564,889,6,7872,8,1433,3,8
"306","2020-04-26",272,4,255,909,6206,0.575249758298421,0,0,564,889,3,7875,25,1458,2,25
"307","2020-04-27",269,4,266,877,6206,0.575249758298421,0,0,564,889,2,7877,15,1473,NA,15
"308","2020-04-28",254,4,280,830,6206,0.575249758298421,0,0,564,889,5,7882,20,1493,1,20
"309","2020-04-29",248,4,290,795,6206,0.575249758298421,0,0,564,889,2,7884,16,1509,NA,16
"310","2020-04-30",252,4,294,779,6206,0.575249758298421,0,0,564,889,5,7889,30,1539,2,30
"311","2020-05-01",258,4,279,754,6206,0.575249758298421,0,0,564,889,4,7893,15,1554,3,15
"312","2020-05-02",256,4,268,712,6206,0.575249758298421,0,0,564,889,5,7898,16,1570,2,16
"313","2020-05-03",234,4,286,691,6206,0.575249758298421,0,0,564,889,3,7901,9,1579,1,9
"314","2020-05-04",233,4,286,658,6206,0.575249758298421,0,0,564,889,1,7902,28,1607,NA,28
"315","2020-05-05",227,4,319,627,6206,0.575249758298421,0,0,564,889,1,7903,31,1638,NA,31
"316","2020-05-06",217,4,294,603,6206,0.575249758298421,0,0,564,889,2,7905,20,1658,1,20
"317","2020-05-07",191,4,280,582,6206,0.575249758298421,0,0,564,889,4,7909,25,1683,2,25
"318","2020-05-08",174,4,243,581,6206,0.575249758298421,0,0,564,889,1,7910,27,1710,NA,27
"319","2020-05-09",168,4,233,567,6206,0.575249758298421,0,0,564,889,2,7912,50,1760,2,50
"320","2020-05-10",164,4,220,546,6206,0.575249758298421,0,0,564,889,1,7913,20,1780,NA,20
"321","2020-05-11",144,4,211,559,6206,0.575249758298421,0,0,564,889,2,7915,19,1799,NA,19
"322","2020-05-12",142,4,185,549,6206,0.575249758298421,0,0,564,889,1,7916,16,1815,NA,16
"323","2020-05-13",142,4,174,532,6206,0.575249758298421,0,0,564,889,5,7921,15,1830,1,15
"324","2020-05-14",142,4,180,498,6206,0.575249758298421,0,0,564,889,1,7922,12,1842,1,12
"325","2020-05-15",145,4,204,480,6206,0.575249758298421,0,0,564,889,2,7924,19,1861,1,19
"326","2020-05-16",141,4,252,457,6206,0.575249758298421,0,0,564,889,1,7925,49,1910,1,49
"327","2020-05-17",139,4,253,456,6206,0.575249758298421,0,0,564,889,1,7926,22,1932,NA,22
"328","2020-05-18",136,4,236,438,6206,0.575249758298421,0,0,564,889,NA,NA,14,1946,NA,14
"329","2020-05-19",124,4,259,421,6206,0.575249758298421,0,0,564,889,NA,NA,28,1974,NA,28
"330","2020-05-20",119,4,279,403,6206,0.575249758298421,0,0,564,889,1,7927,45,2019,NA,45
"331","2020-05-21",110,4,310,384,6206,0.575249758298421,0,0,564,889,NA,NA,29,2048,NA,29
"332","2020-05-22",100,4,293,383,6206,0.575249758298421,0,0,564,889,2,7929,17,2065,1,17
"333","2020-05-23",94,4,280,365,6206,0.575249758298421,0,0,564,889,NA,NA,12,2077,NA,12
"334","2020-05-24",89,4,260,355,6206,0.575249758298421,0,0,564,889,1,7930,12,2089,1,12
"335","2020-05-25",87,4,247,335,6206,0.575249758298421,0,0,564,889,1,7931,12,2101,NA,12
"336","2020-05-26",81,4,243,325,6206,0.575249758298421,0,0,564,889,2,7933,45,2146,NA,45
"337","2020-05-27",76,4,225,318,6206,0.575249758298421,0,0,564,889,1,7934,37,2183,NA,37
"338","2020-05-28",86,4,223,314,6206,0.575249758298421,0,0,564,889,NA,NA,25,2208,NA,25
"339","2020-05-29",90,4,244,291,6206,0.575249758298421,0,0,564,889,2,7936,13,2221,NA,13
"340","2020-05-30",87,4,261,275,6206,0.575249758298421,0,0,564,889,2,7938,13,2234,1,13
"341","2020-05-31",85,4,228,270,6206,0.575249758298421,0,0,564,889,NA,NA,8,2242,NA,8
"342","2020-06-01",87,4,227,268,6206,0.575249758298421,0,0,564,889,NA,NA,6,2248,NA,6
"343","2020-06-02",95,4,252,264,6206,0.575249758298421,0,0,564,889,NA,NA,24,2272,NA,24
"344","2020-06-03",94,4,247,249,6206,0.575249758298421,0,0,564,889,1,7939,16,2288,1,16
"345","2020-06-04",87,4,237,239,6206,0.575249758298421,0,0,564,889,1,7940,14,2302,NA,14
"346","2020-06-05",86,4,254,238,6206,0.575249758298421,0,0,564,889,1,7941,72,2374,NA,72
"347","2020-06-06",84,4,256,228,6206,0.575249758298421,0,0,564,889,1,7942,37,2411,1,37
"348","2020-06-07",83,4,231,221,6206,0.575249758298421,0,0,564,889,NA,NA,26,2437,NA,26
"349","2020-03-13",2,5,47,146,5565,0.26199460916442,0,0,526,738,28,91,45,117,9,45
"350","2020-03-14",3,5,63,212,5565,0.26199460916442,0,0,526,738,34,125,24,141,11,24
"351","2020-03-15",12,5,74,265,5565,0.26199460916442,0,0,526,738,36,161,52,193,14,52
"352","2020-03-16",23,5,86,355,5565,0.26199460916442,0,0,526,738,35,196,50,243,16,50
"353","2020-03-17",40,5,97,425,5565,0.26199460916442,0,0,526,738,40,236,49,292,14,49
"354","2020-03-18",54,5,125,496,5565,0.26199460916442,0,0,526,738,29,265,52,344,12,52
"355","2020-03-19",76,5,122,546,5565,0.26199460916442,0,0,526,738,51,316,34,378,23,34
"356","2020-03-20",98,5,139,604,5565,0.26199460916442,0,0,526,738,53,369,21,399,32,21
"357","2020-03-21",119,5,133,656,5565,0.26199460916442,0,0,526,738,53,422,43,442,19,43
"358","2020-03-22",131,5,159,699,5565,0.26199460916442,0,0,526,738,45,467,19,461,23,19
"359","2020-03-23",159,5,156,745,5565,0.26199460916442,0,0,526,738,46,513,28,489,24,28
"360","2020-03-24",171,5,144,766,5565,0.26199460916442,0,0,526,738,58,571,25,514,23,25
"361","2020-03-25",189,5,138,803,5565,0.26199460916442,0,0,526,738,49,620,29,543,26,29
"362","2020-03-26",205,5,167,821,5565,0.26199460916442,0,0,526,738,66,686,37,580,34,37
"363","2020-03-27",198,5,184,852,5565,0.26199460916442,0,0,526,738,47,733,36,616,22,36
"364","2020-03-28",206,5,202,873,5565,0.26199460916442,0,0,526,738,66,799,42,658,40,42
"365","2020-03-29",221,5,217,900,5565,0.26199460916442,0,0,526,738,63,862,36,694,35,36
"366","2020-03-30",218,5,213,894,5565,0.26199460916442,0,0,526,738,48,910,35,729,20,35
"367","2020-03-31",223,5,208,892,5565,0.26199460916442,0,0,526,738,60,970,29,758,29,29
"368","2020-04-01",233,5,200,883,5565,0.26199460916442,0,0,526,738,51,1021,35,793,27,35
"369","2020-04-02",227,5,223,894,5565,0.26199460916442,0,0,526,738,57,1078,43,836,26,43
"370","2020-04-03",251,5,234,890,5565,0.26199460916442,0,0,526,738,53,1131,31,867,31,31
"371","2020-04-04",266,5,224,891,5565,0.26199460916442,0,0,526,738,44,1175,42,909,21,42
"372","2020-04-05",253,5,224,870,5565,0.26199460916442,0,0,526,738,72,1247,23,932,33,23
"373","2020-04-06",250,5,195,853,5565,0.26199460916442,0,0,526,738,53,1300,20,952,32,20
"374","2020-04-07",250,5,192,851,5565,0.26199460916442,0,0,526,738,69,1369,22,974,38,22
"375","2020-04-08",243,5,207,833,5565,0.26199460916442,0,0,526,738,54,1423,36,1010,20,36
"376","2020-04-09",241,5,237,833,5565,0.26199460916442,0,0,526,738,53,1476,41,1051,30,41
"377","2020-04-10",234,5,203,825,5565,0.26199460916442,0,0,526,738,48,1524,20,1071,19,20
"378","2020-04-11",221,5,188,815,5565,0.26199460916442,0,0,526,738,69,1593,27,1098,24,27
"379","2020-04-12",226,5,168,805,5565,0.26199460916442,0,0,526,738,56,1649,32,1130,27,32
"380","2020-04-13",225,5,158,816,5565,0.26199460916442,0,0,526,738,57,1706,21,1151,29,21
"381","2020-04-14",220,5,204,810,5565,0.26199460916442,0,0,526,738,52,1758,35,1186,19,35
"382","2020-04-15",207,5,236,798,5565,0.26199460916442,0,0,526,738,58,1816,20,1206,30,20
"383","2020-04-16",216,5,244,784,5565,0.26199460916442,0,0,526,738,67,1883,50,1256,29,50
"384","2020-04-17",211,5,240,790,5565,0.26199460916442,0,0,526,738,57,1940,24,1280,24,24
"385","2020-04-18",212,5,229,791,5565,0.26199460916442,0,0,526,738,57,1997,28,1308,23,28
"386","2020-04-19",215,5,210,797,5565,0.26199460916442,0,0,526,738,76,2073,35,1343,37,35
"387","2020-04-20",212,5,198,798,5565,0.26199460916442,0,0,526,738,67,2140,27,1370,15,27
"388","2020-04-21",212,5,200,810,5565,0.26199460916442,0,0,526,738,55,2195,23,1393,19,23
"389","2020-04-22",222,5,202,813,5565,0.26199460916442,0,0,526,738,46,2241,36,1429,21,36
"390","2020-04-23",214,5,193,809,5565,0.26199460916442,0,0,526,738,67,2308,39,1468,27,39
"391","2020-04-24",226,5,209,811,5565,0.26199460916442,0,0,526,738,53,2361,27,1495,28,27
"392","2020-04-25",227,5,212,796,5565,0.26199460916442,0,0,526,738,64,2425,24,1519,33,24
"393","2020-04-26",222,5,203,801,5565,0.26199460916442,0,0,526,738,43,2468,24,1543,15,24
"394","2020-04-27",222,5,207,792,5565,0.26199460916442,0,0,526,738,62,2530,21,1564,33,21
"395","2020-04-28",218,5,205,776,5565,0.26199460916442,0,0,526,738,54,2584,27,1591,26,27
"396","2020-04-29",220,5,215,755,5565,0.26199460916442,0,0,526,738,55,2639,29,1620,23,29
"397","2020-04-30",225,5,234,735,5565,0.26199460916442,0,0,526,738,56,2695,51,1671,32,51
"398","2020-05-01",208,5,224,717,5565,0.26199460916442,0,0,526,738,55,2750,49,1720,24,49
"399","2020-05-02",193,5,210,714,5565,0.26199460916442,0,0,526,738,40,2790,62,1782,21,62
"400","2020-05-03",197,5,189,720,5565,0.26199460916442,0,0,526,738,42,2832,36,1818,10,36
"401","2020-05-04",184,5,189,705,5565,0.26199460916442,0,0,526,738,61,2893,35,1853,29,35
"402","2020-05-05",183,5,191,714,5565,0.26199460916442,0,0,526,738,38,2931,35,1888,12,35
"403","2020-05-06",180,5,183,707,5565,0.26199460916442,0,0,526,738,49,2980,22,1910,19,22
"404","2020-05-07",175,5,175,700,5565,0.26199460916442,0,0,526,738,51,3031,19,1929,22,19
"405","2020-05-08",184,5,205,693,5565,0.26199460916442,0,0,526,738,30,3061,21,1950,10,21
"406","2020-05-09",201,5,188,685,5565,0.26199460916442,0,0,526,738,34,3095,18,1968,12,18
"407","2020-05-10",198,5,166,662,5565,0.26199460916442,0,0,526,738,36,3131,11,1979,18,11
"408","2020-05-11",222,5,163,635,5565,0.26199460916442,0,0,526,738,53,3184,25,2004,24,25
"409","2020-05-12",223,5,186,620,5565,0.26199460916442,0,0,526,738,29,3213,18,2022,14,18
"410","2020-05-13",214,5,187,620,5565,0.26199460916442,0,0,526,738,24,3237,21,2043,13,21
"411","2020-05-14",200,5,221,601,5565,0.26199460916442,0,0,526,738,34,3271,22,2065,10,22
"412","2020-05-15",186,5,244,570,5565,0.26199460916442,0,0,526,738,46,3317,42,2107,19,42
"413","2020-05-16",180,5,258,554,5565,0.26199460916442,0,0,526,738,36,3353,37,2144,9,37
"414","2020-05-17",175,5,287,541,5565,0.26199460916442,0,0,526,738,21,3374,26,2170,2,26
"415","2020-05-18",151,5,305,518,5565,0.26199460916442,0,0,526,738,22,3396,27,2197,5,27
"416","2020-05-19",152,5,291,504,5565,0.26199460916442,0,0,526,738,32,3428,18,2215,16,18
"417","2020-05-20",158,5,263,495,5565,0.26199460916442,0,0,526,738,36,3464,32,2247,15,32
"418","2020-05-21",164,5,254,468,5565,0.26199460916442,0,0,526,738,32,3496,26,2273,16,26
"419","2020-05-22",159,5,254,442,5565,0.26199460916442,0,0,526,738,28,3524,31,2304,11,31
"420","2020-05-23",143,5,233,428,5565,0.26199460916442,0,0,526,738,31,3555,38,2342,12,38
"421","2020-05-24",136,5,233,420,5565,0.26199460916442,0,0,526,738,27,3582,31,2373,8,31
"422","2020-05-25",143,5,230,422,5565,0.26199460916442,0,0,526,738,20,3602,36,2409,7,36
"423","2020-05-26",134,5,213,413,5565,0.26199460916442,0,0,526,738,28,3630,40,2449,6,40
"424","2020-05-27",119,5,200,413,5565,0.26199460916442,0,0,526,738,26,3656,47,2496,10,47
"425","2020-05-28",111,5,201,402,5565,0.26199460916442,0,0,526,738,38,3694,34,2530,19,34
"426","2020-05-29",120,5,208,381,5565,0.26199460916442,0,0,526,738,22,3716,38,2568,8,38
"427","2020-05-30",127,5,205,377,5565,0.26199460916442,0,0,526,738,16,3732,24,2592,6,24
"428","2020-05-31",123,5,211,364,5565,0.26199460916442,0,0,526,738,16,3748,28,2620,9,28
"429","2020-06-01",119,5,217,362,5565,0.26199460916442,0,0,526,738,30,3778,18,2638,10,18
"430","2020-06-02",120,5,222,336,5565,0.26199460916442,0,0,526,738,16,3794,25,2663,7,25
"431","2020-06-03",119,5,221,314,5565,0.26199460916442,0,0,526,738,20,3814,14,2677,11,14
"432","2020-06-04",112,5,229,292,5565,0.26199460916442,0,0,526,738,25,3839,27,2704,14,27
"433","2020-06-05",103,5,228,273,5565,0.26199460916442,0,0,526,738,14,3853,17,2721,4,17
"434","2020-06-06",95,5,204,253,5565,0.26199460916442,0,0,526,738,19,3872,15,2736,11,15
"435","2020-06-07",93,5,195,239,5565,0.26199460916442,0,0,526,738,19,3891,16,2752,13,16
"436","2020-03-14",5,6,169,253,8741,0.849788353735271,0,0,691,1995,49,180,51,143,7,51
"437","2020-03-15",9,6,173,361,8741,0.849788353735271,0,0,691,1995,53,233,34,177,8,34
"438","2020-03-16",18,6,166,511,8741,0.849788353735271,0,0,691,1995,56,289,18,195,10,18
"439","2020-03-17",33,6,204,723,8741,0.849788353735271,0,0,691,1995,61,350,20,215,14,20
"440","2020-03-18",56,6,287,947,8741,0.849788353735271,0,0,691,1995,51,401,28,243,11,28
"441","2020-03-19",86,6,296,1280,8741,0.849788353735271,0,0,691,1995,62,463,33,276,15,33
"442","2020-03-20",131,6,260,1640,8741,0.849788353735271,0,0,691,1995,79,542,62,338,24,62
"443","2020-03-21",184,6,229,2109,8741,0.849788353735271,0,0,691,1995,52,594,43,381,8,43
"444","2020-03-22",253,6,214,2529,8741,0.849788353735271,0,0,691,1995,62,656,55,436,15,55
"445","2020-03-23",357,6,202,3051,8741,0.849788353735271,0,0,691,1995,58,714,27,463,13,27
"446","2020-03-24",457,6,218,3600,8741,0.849788353735271,0,0,691,1995,58,772,20,483,21,20
"447","2020-03-25",570,6,262,4052,8741,0.849788353735271,0,0,691,1995,68,840,11,494,17,12
"448","2020-03-26",698,6,247,4445,8741,0.849788353735271,0,0,691,1995,78,918,19,513,16,19
"449","2020-03-27",816,6,220,4772,8741,0.849788353735271,0,0,691,1995,64,982,16,529,15,16
"450","2020-03-28",947,6,253,4935,8741,0.849788353735271,0,0,691,1995,69,1051,16,545,12,16
"451","2020-03-29",1066,6,245,5083,8741,0.849788353735271,0,0,691,1995,65,1116,15,560,15,15
"452","2020-03-30",1182,6,211,5045,8741,0.849788353735271,0,0,691,1995,66,1182,37,597,17,37
"453","2020-03-31",1255,6,198,4945,8741,0.849788353735271,0,0,691,1995,78,1260,20,617,21,20
"454","2020-04-01",1325,6,236,4685,8741,0.849788353735271,0,0,691,1995,60,1320,17,634,15,17
"455","2020-04-02",1391,6,267,4461,8741,0.849788353735271,0,0,691,1995,67,1387,31,665,13,31
"456","2020-04-03",1412,6,260,4150,8741,0.849788353735271,0,0,691,1995,80,1467,19,684,27,19
"457","2020-04-04",1384,6,285,3785,8741,0.849788353735271,0,0,691,1995,83,1550,10,694,21,10
"458","2020-04-05",1367,6,299,3375,8741,0.849788353735271,0,0,691,1995,67,1617,10,704,16,10
"459","2020-04-06",1280,6,276,2979,8741,0.849788353735271,0,0,691,1995,88,1705,23,727,27,23
"460","2020-04-07",1215,6,301,2523,8741,0.849788353735271,0,0,691,1995,94,1799,61,788,27,61
"461","2020-04-08",1111,6,286,2165,8741,0.849788353735271,0,0,691,1995,57,1856,45,833,16,45
"462","2020-04-09",960,6,264,1807,8741,0.849788353735271,0,0,691,1995,76,1932,19,852,9,19
"463","2020-04-10",851,6,258,1510,8741,0.849788353735271,0,0,691,1995,82,2014,14,866,21,14
"464","2020-04-11",743,6,223,1196,8741,0.849788353735271,0,0,691,1995,76,2090,12,878,19,12
"465","2020-04-12",608,6,199,991,8741,0.849788353735271,0,0,691,1995,92,2182,19,897,21,19
"466","2020-04-13",507,6,193,825,8741,0.849788353735271,0,0,691,1995,79,2261,56,953,25,56
"467","2020-04-14",417,6,175,688,8741,0.849788353735271,0,0,691,1995,72,2333,34,987,25,34
"468","2020-04-15",342,6,192,566,8741,0.849788353735271,0,0,691,1995,51,2384,29,1016,14,29
"469","2020-04-16",290,6,241,457,8741,0.849788353735271,0,0,691,1995,69,2453,72,1088,11,72
"470","2020-04-17",232,6,219,373,8741,0.849788353735271,0,0,691,1995,71,2524,33,1121,13,33
"471","2020-04-18",188,6,206,312,8741,0.849788353735271,0,0,691,1995,72,2596,13,1134,20,13
"472","2020-04-19",153,6,176,262,8741,0.849788353735271,0,0,691,1995,77,2673,27,1161,18,27
"473","2020-04-20",124,6,189,211,8741,0.849788353735271,0,0,691,1995,83,2756,27,1188,24,27
"474","2020-04-21",97,6,180,181,8741,0.849788353735271,0,0,691,1995,58,2814,69,1257,7,69
"475","2020-04-22",77,6,185,148,8741,0.849788353735271,0,0,691,1995,66,2880,37,1294,12,37
"476","2020-04-23",60,6,189,117,8741,0.849788353735271,0,0,691,1995,51,2931,32,1326,13,32
"477","2020-04-24",47,6,204,91,8741,0.849788353735271,0,0,691,1995,46,2977,47,1373,10,47
"478","2020-04-25",40,6,242,78,8741,0.849788353735271,0,0,691,1995,63,3040,25,1398,14,25
"479","2020-04-26",36,6,224,61,8741,0.849788353735271,0,0,691,1995,60,3100,22,1420,6,22
"480","2020-04-27",28,6,221,58,8741,0.849788353735271,0,0,691,1995,70,3170,21,1441,7,21
"481","2020-04-28",26,6,242,47,8741,0.849788353735271,0,0,691,1995,53,3223,17,1458,8,17
"482","2020-04-29",20,6,260,45,8741,0.849788353735271,0,0,691,1995,48,3271,19,1477,10,19
"483","2020-04-30",18,6,300,39,8741,0.849788353735271,0,0,691,1995,49,3320,28,1505,7,28
"484","2020-05-01",15,6,278,38,8741,0.849788353735271,0,0,691,1995,50,3370,38,1543,6,38
"485","2020-05-02",14,6,263,37,8741,0.849788353735271,0,0,691,1995,74,3444,39,1582,8,39
"486","2020-05-03",13,6,254,34,8741,0.849788353735271,0,0,691,1995,59,3503,45,1627,7,45
"487","2020-05-04",10,6,245,31,8741,0.849788353735271,0,0,691,1995,48,3551,48,1675,6,48
"488","2020-05-05",9,6,237,30,8741,0.849788353735271,0,0,691,1995,56,3607,28,1703,9,28
"489","2020-05-06",8,6,240,28,8741,0.849788353735271,0,0,691,1995,47,3654,13,1716,2,13
"490","2020-05-07",6,6,280,28,8741,0.849788353735271,0,0,691,1995,69,3723,13,1729,11,13
"491","2020-05-08",5,6,278,25,8741,0.849788353735271,0,0,691,1995,48,3771,20,1749,8,20
"492","2020-05-09",6,6,255,23,8741,0.849788353735271,0,0,691,1995,58,3829,22,1771,10,22
"493","2020-05-10",7,6,256,22,8741,0.849788353735271,0,0,691,1995,36,3865,18,1789,4,18
"494","2020-05-11",9,6,226,25,8741,0.849788353735271,0,0,691,1995,46,3911,15,1804,8,15
"495","2020-05-12",6,6,208,25,8741,0.849788353735271,0,0,691,1995,50,3961,12,1816,5,12
"496","2020-05-13",9,6,193,27,8741,0.849788353735271,0,0,691,1995,40,4001,11,1827,5,11
"497","2020-05-14",9,6,184,29,8741,0.849788353735271,0,0,691,1995,37,4038,6,1833,6,6
"498","2020-05-15",10,6,184,28,8741,0.849788353735271,0,0,691,1995,53,4091,7,1840,13,7
"499","2020-05-16",8,6,198,28,8741,0.849788353735271,0,0,691,1995,43,4134,4,1844,9,4
"500","2020-05-17",8,6,199,28,8741,0.849788353735271,0,0,691,1995,51,4185,38,1882,17,38
"501","2020-05-18",6,6,202,28,8741,0.849788353735271,0,0,691,1995,31,4216,27,1909,6,27
"502","2020-05-19",8,6,209,28,8741,0.849788353735271,0,0,691,1995,44,4260,19,1928,11,19
"503","2020-05-20",8,6,211,26,8741,0.849788353735271,0,0,691,1995,28,4288,30,1958,6,30
"504","2020-05-21",9,6,238,24,8741,0.849788353735271,0,0,691,1995,34,4322,14,1972,9,14
"505","2020-05-22",8,6,226,20,8741,0.849788353735271,0,0,691,1995,41,4363,18,1990,17,18
"506","2020-05-23",8,6,227,17,8741,0.849788353735271,0,0,691,1995,34,4397,23,2013,7,23
"507","2020-05-24",9,6,198,17,8741,0.849788353735271,0,0,691,1995,35,4432,43,2056,8,43
"508","2020-05-25",8,6,189,19,8741,0.849788353735271,0,0,691,1995,21,4453,28,2084,4,28
"509","2020-05-26",6,6,229,15,8741,0.849788353735271,0,0,691,1995,24,4477,37,2121,5,37
"510","2020-05-27",3,6,253,15,8741,0.849788353735271,0,0,691,1995,25,4502,29,2150,6,29
"511","2020-05-28",5,6,232,15,8741,0.849788353735271,0,0,691,1995,30,4532,45,2195,6,45
"512","2020-05-29",5,6,217,14,8741,0.849788353735271,0,0,691,1995,24,4556,53,2248,3,53
"513","2020-05-30",5,6,250,16,8741,0.849788353735271,0,0,691,1995,24,4580,29,2277,8,29
"514","2020-05-31",3,6,255,13,8741,0.849788353735271,0,0,691,1995,23,4603,17,2294,1,17
"515","2020-06-01",4,6,226,13,8741,0.849788353735271,0,0,691,1995,22,4625,11,2305,2,11
"516","2020-06-02",5,6,252,16,8741,0.849788353735271,0,0,691,1995,19,4644,4,2309,3,4
"517","2020-06-03",5,6,245,14,8741,0.849788353735271,0,0,691,1995,12,4656,8,2317,3,8
"518","2020-06-04",3,6,234,13,8741,0.849788353735271,0,0,691,1995,28,4684,21,2338,7,21
"519","2020-06-05",3,6,237,12,8741,0.849788353735271,0,0,691,1995,17,4701,31,2369,1,31
"520","2020-06-06",4,6,216,12,8741,0.849788353735271,0,0,691,1995,13,4714,23,2392,5,23
"521","2020-06-07",6,6,250,11,8741,0.849788353735271,0,0,691,1995,23,4737,10,2402,4,10
"522","2020-03-12",1,7,44,186,7757,0.202011086760345,0,0,720,714,23,56,59,113,3,59
"523","2020-03-13",3,7,53,288,7757,0.202011086760345,0,0,720,714,39,95,42,155,6,42
"524","2020-03-14",16,7,60,379,7757,0.202011086760345,0,0,720,714,35,130,62,217,10,62
"525","2020-03-15",27,7,78,475,7757,0.202011086760345,0,0,720,714,36,166,30,247,15,30
"526","2020-03-16",47,7,98,573,7757,0.202011086760345,0,0,720,714,36,202,24,271,14,24
"527","2020-03-17",67,7,102,671,7757,0.202011086760345,0,0,720,714,50,252,19,290,24,19
"528","2020-03-18",94,7,113,770,7757,0.202011086760345,0,0,720,714,60,312,58,348,23,58
"529","2020-03-19",121,7,120,888,7757,0.202011086760345,0,0,720,714,55,367,28,376,28,28
"530","2020-03-20",160,7,141,970,7757,0.202011086760345,0,0,720,714,50,417,10,386,28,10
"531","2020-03-21",186,7,161,1038,7757,0.202011086760345,0,0,720,714,57,474,8,394,29,8
"532","2020-03-22",217,7,175,1104,7757,0.202011086760345,0,0,720,714,67,541,6,400,41,6
"533","2020-03-23",236,7,160,1181,7757,0.202011086760345,0,0,720,714,47,588,55,455,26,55
"534","2020-03-24",261,7,154,1235,7757,0.202011086760345,0,0,720,714,56,644,47,502,33,47
"535","2020-03-25",275,7,154,1291,7757,0.202011086760345,0,0,720,714,54,698,17,519,33,17
"536","2020-03-26",309,7,163,1329,7757,0.202011086760345,0,0,720,714,52,750,59,578,24,59
"537","2020-03-27",333,7,168,1347,7757,0.202011086760345,0,0,720,714,55,805,41,619,28,41
"538","2020-03-28",347,7,178,1373,7757,0.202011086760345,0,0,720,714,49,854,16,635,24,16
"539","2020-03-29",364,7,199,1401,7757,0.202011086760345,0,0,720,714,58,912,11,646,34,11
"540","2020-03-30",385,7,184,1414,7757,0.202011086760345,0,0,720,714,51,963,9,655,34,9
"541","2020-03-31",401,7,173,1415,7757,0.202011086760345,0,0,720,714,74,1037,6,661,39,6
"542","2020-04-01",420,7,154,1419,7757,0.202011086760345,0,0,720,714,50,1087,5,666,32,5
"543","2020-04-02",421,7,142,1420,7757,0.202011086760345,0,0,720,714,57,1144,4,670,28,4
"544","2020-04-03",416,7,141,1423,7757,0.202011086760345,0,0,720,714,68,1212,4,674,46,4
"545","2020-04-04",420,7,156,1404,7757,0.202011086760345,0,0,720,714,78,1290,4,678,39,4
"546","2020-04-05",417,7,160,1373,7757,0.202011086760345,0,0,720,714,67,1357,5,683,33,5
"547","2020-04-06",404,7,187,1347,7757,0.202011086760345,0,0,720,714,68,1425,8,691,39,8
"548","2020-04-07",400,7,170,1326,7757,0.202011086760345,0,0,720,714,64,1489,59,750,35,59
"549","2020-04-08",386,7,168,1280,7757,0.202011086760345,0,0,720,714,67,1556,61,811,29,61
"550","2020-04-09",377,7,162,1274,7757,0.202011086760345,0,0,720,714,63,1619,35,846,32,35
"551","2020-04-10",367,7,175,1252,7757,0.202011086760345,0,0,720,714,70,1689,14,860,41,14
"552","2020-04-11",357,7,179,1221,7757,0.202011086760345,0,0,720,714,56,1745,11,871,31,11
"553","2020-04-12",338,7,174,1206,7757,0.202011086760345,0,0,720,714,63,1808,45,916,31,45
"554","2020-04-13",345,7,224,1216,7757,0.202011086760345,0,0,720,714,64,1872,32,948,33,32
"555","2020-04-14",330,7,238,1225,7757,0.202011086760345,0,0,720,714,62,1934,57,1005,32,57
"556","2020-04-15",326,7,293,1201,7757,0.202011086760345,0,0,720,714,57,1991,40,1045,32,40
"557","2020-04-16",314,7,282,1170,7757,0.202011086760345,0,0,720,714,54,2045,17,1062,28,17
"558","2020-04-17",297,7,274,1142,7757,0.202011086760345,0,0,720,714,59,2104,23,1085,30,23
"559","2020-04-18",300,7,253,1116,7757,0.202011086760345,0,0,720,714,44,2148,29,1114,24,29
"560","2020-04-19",318,7,257,1135,7757,0.202011086760345,0,0,720,714,49,2197,29,1143,21,29
"561","2020-04-20",318,7,245,1122,7757,0.202011086760345,0,0,720,714,61,2258,21,1164,32,21
"562","2020-04-21",313,7,234,1108,7757,0.202011086760345,0,0,720,714,67,2325,14,1178,31,14
"563","2020-04-22",312,7,225,1079,7757,0.202011086760345,0,0,720,714,44,2369,25,1203,16,25
"564","2020-04-23",311,7,228,1081,7757,0.202011086760345,0,0,720,714,50,2419,7,1210,24,7
"565","2020-04-24",312,7,256,1056,7757,0.202011086760345,0,0,720,714,66,2485,5,1215,30,5
"566","2020-04-25",306,7,259,1052,7757,0.202011086760345,0,0,720,714,48,2533,10,1225,18,10
"567","2020-04-26",283,7,271,1060,7757,0.202011086760345,0,0,720,714,52,2585,25,1250,21,25
"568","2020-04-27",264,7,261,1049,7757,0.202011086760345,0,0,720,714,46,2631,36,1286,27,36
"569","2020-04-28",256,7,237,1015,7757,0.202011086760345,0,0,720,714,67,2698,37,1323,36,37
"570","2020-04-29",256,7,210,999,7757,0.202011086760345,0,0,720,714,46,2744,12,1335,23,12
"571","2020-04-30",247,7,181,975,7757,0.202011086760345,0,0,720,714,35,2779,9,1344,12,9
"572","2020-05-01",253,7,166,955,7757,0.202011086760345,0,0,720,714,54,2833,15,1359,29,15
"573","2020-05-02",236,7,160,931,7757,0.202011086760345,0,0,720,714,34,2867,17,1376,17,17
"574","2020-05-03",243,7,202,915,7757,0.202011086760345,0,0,720,714,45,2912,21,1397,22,21
"575","2020-05-04",248,7,193,892,7757,0.202011086760345,0,0,720,714,43,2955,16,1413,16,16
"576","2020-05-05",249,7,206,872,7757,0.202011086760345,0,0,720,714,41,2996,11,1424,21,11
"577","2020-05-06",246,7,204,835,7757,0.202011086760345,0,0,720,714,44,3040,5,1429,21,5
"578","2020-05-07",243,7,193,817,7757,0.202011086760345,0,0,720,714,55,3095,7,1436,27,7
"579","2020-05-08",236,7,187,803,7757,0.202011086760345,0,0,720,714,46,3141,5,1441,22,5
"580","2020-05-09",237,7,185,783,7757,0.202011086760345,0,0,720,714,56,3197,5,1446,32,5
"581","2020-05-10",228,7,196,769,7757,0.202011086760345,0,0,720,714,39,3236,15,1461,18,15
"582","2020-05-11",217,7,223,753,7757,0.202011086760345,0,0,720,714,32,3268,14,1475,9,14
"583","2020-05-12",215,7,221,726,7757,0.202011086760345,0,0,720,714,49,3317,15,1490,20,15
"584","2020-05-13",204,7,213,700,7757,0.202011086760345,0,0,720,714,44,3361,18,1508,24,18
"585","2020-05-14",201,7,239,676,7757,0.202011086760345,0,0,720,714,50,3411,63,1571,23,63
"586","2020-05-15",198,7,248,633,7757,0.202011086760345,0,0,720,714,43,3454,46,1617,21,46
"587","2020-05-16",193,7,244,606,7757,0.202011086760345,0,0,720,714,27,3481,24,1641,10,24
"588","2020-05-17",184,7,258,572,7757,0.202011086760345,0,0,720,714,44,3525,14,1655,18,14
"589","2020-05-18",169,7,251,547,7757,0.202011086760345,0,0,720,714,37,3562,13,1668,17,13
"590","2020-05-19",164,7,242,529,7757,0.202011086760345,0,0,720,714,28,3590,23,1691,11,23
"591","2020-05-20",156,7,230,500,7757,0.202011086760345,0,0,720,714,45,3635,33,1724,22,33
"592","2020-05-21",147,7,224,483,7757,0.202011086760345,0,0,720,714,33,3668,27,1751,16,27
"593","2020-05-22",134,7,253,464,7757,0.202011086760345,0,0,720,714,23,3691,28,1779,7,28
"594","2020-05-23",134,7,243,438,7757,0.202011086760345,0,0,720,714,26,3717,12,1791,15,12
"595","2020-05-24",130,7,247,412,7757,0.202011086760345,0,0,720,714,40,3757,13,1804,24,13
"596","2020-05-25",130,7,248,394,7757,0.202011086760345,0,0,720,714,30,3787,13,1817,14,13
"597","2020-05-26",125,7,223,377,7757,0.202011086760345,0,0,720,714,30,3817,24,1841,11,24
"598","2020-05-27",120,7,231,361,7757,0.202011086760345,0,0,720,714,25,3842,11,1852,13,11
"599","2020-05-28",118,7,217,335,7757,0.202011086760345,0,0,720,714,30,3872,44,1896,13,44
"600","2020-05-29",115,7,219,317,7757,0.202011086760345,0,0,720,714,27,3899,30,1926,10,30
"601","2020-05-30",104,7,202,310,7757,0.202011086760345,0,0,720,714,22,3921,13,1939,11,13
"602","2020-05-31",100,7,182,298,7757,0.202011086760345,0,0,720,714,19,3940,16,1955,12,16
"603","2020-06-01",95,7,188,280,7757,0.202011086760345,0,0,720,714,15,3955,6,1961,10,6
"604","2020-06-02",86,7,165,259,7757,0.202011086760345,0,0,720,714,22,3977,8,1969,7,8
"605","2020-06-03",84,7,152,234,7757,0.202011086760345,0,0,720,714,17,3994,2,1971,6,2
"606","2020-06-04",76,7,137,226,7757,0.202011086760345,0,0,720,714,19,4013,6,1977,8,6
"607","2020-06-05",69,7,133,206,7757,0.202011086760345,0,0,720,714,16,4029,9,1986,7,9
"608","2020-06-06",63,7,155,195,7757,0.202011086760345,0,0,720,714,16,4045,8,1994,5,8
"609","2020-06-07",56,7,158,187,7757,0.202011086760345,0,0,720,714,27,4072,6,2000,16,6
"610","2020-03-13",3,8,109,178,6596,0.29426925409339,0,0,605,1921,55,170,41,100,5,41
"611","2020-03-14",8,8,117,258,6596,0.29426925409339,0,0,605,1921,48,218,53,153,9,53
"612","2020-03-15",16,8,116,341,6596,0.29426925409339,0,0,605,1921,55,273,50,203,6,50
"613","2020-03-16",30,8,128,421,6596,0.29426925409339,0,0,605,1921,58,331,57,260,9,57
"614","2020-03-17",47,8,122,506,6596,0.29426925409339,0,0,605,1921,56,387,52,312,5,52
"615","2020-03-18",71,8,178,572,6596,0.29426925409339,0,0,605,1921,48,435,34,346,8,34
"616","2020-03-19",88,8,253,645,6596,0.29426925409339,0,0,605,1921,52,487,45,391,12,45
"617","2020-03-20",113,8,292,722,6596,0.29426925409339,0,0,605,1921,58,545,33,424,12,33
"618","2020-03-21",131,8,326,812,6596,0.29426925409339,0,0,605,1921,54,599,60,484,12,60
"619","2020-03-22",165,8,321,890,6596,0.29426925409339,0,0,605,1921,62,661,26,510,16,26
"620","2020-03-23",186,8,290,937,6596,0.29426925409339,0,0,605,1921,63,724,29,539,7,29
"621","2020-03-24",203,8,298,977,6596,0.29426925409339,0,0,605,1921,62,786,39,578,11,39
"622","2020-03-25",221,8,306,1031,6596,0.29426925409339,0,0,605,1921,62,848,30,608,11,30
"623","2020-03-26",245,8,285,1079,6596,0.29426925409339,0,0,605,1921,90,938,34,642,19,34
"624","2020-03-27",256,8,288,1126,6596,0.29426925409339,0,0,605,1921,64,1002,36,678,11,36
"625","2020-03-28",270,8,303,1141,6596,0.29426925409339,0,0,605,1921,74,1076,16,694,20,16
"626","2020-03-29",265,8,287,1157,6596,0.29426925409339,0,0,605,1921,67,1143,27,721,13,27
"627","2020-03-30",278,8,279,1172,6596,0.29426925409339,0,0,605,1921,65,1208,19,740,17,19
"628","2020-03-31",304,8,263,1193,6596,0.29426925409339,0,0,605,1921,69,1277,45,785,16,45
"629","2020-04-01",312,8,258,1215,6596,0.29426925409339,0,0,605,1921,67,1344,35,820,11,35
"630","2020-04-02",308,8,287,1206,6596,0.29426925409339,0,0,605,1921,68,1412,13,833,15,13
"631","2020-04-03",333,8,284,1217,6596,0.29426925409339,0,0,605,1921,56,1468,16,849,8,16
"632","2020-04-04",337,8,280,1219,6596,0.29426925409339,0,0,605,1921,66,1534,21,870,15,21
"633","2020-04-05",345,8,287,1226,6596,0.29426925409339,0,0,605,1921,68,1602,43,913,16,43
"634","2020-04-06",353,8,292,1219,6596,0.29426925409339,0,0,605,1921,71,1673,35,948,9,35
"635","2020-04-07",336,8,301,1173,6596,0.29426925409339,0,0,605,1921,72,1745,20,968,16,20
"636","2020-04-08",338,8,305,1138,6596,0.29426925409339,0,0,605,1921,63,1808,27,995,5,27
"637","2020-04-09",357,8,309,1121,6596,0.29426925409339,0,0,605,1921,68,1876,43,1038,16,43
"638","2020-04-10",339,8,295,1092,6596,0.29426925409339,0,0,605,1921,80,1956,38,1076,14,38
"639","2020-04-11",344,8,313,1083,6596,0.29426925409339,0,0,605,1921,65,2021,28,1104,10,28
"640","2020-04-12",346,8,339,1061,6596,0.29426925409339,0,0,605,1921,70,2091,45,1149,12,45
"641","2020-04-13",332,8,347,1023,6596,0.29426925409339,0,0,605,1921,63,2154,20,1169,13,20
"642","2020-04-14",322,8,351,1032,6596,0.29426925409339,0,0,605,1921,61,2215,23,1192,11,23
"643","2020-04-15",317,8,354,1018,6596,0.29426925409339,0,0,605,1921,64,2279,29,1221,15,29
"644","2020-04-16",290,8,339,994,6596,0.29426925409339,0,0,605,1921,73,2352,45,1266,9,45
"645","2020-04-17",272,8,335,951,6596,0.29426925409339,0,0,605,1921,70,2422,31,1297,9,31
"646","2020-04-18",268,8,359,922,6596,0.29426925409339,0,0,605,1921,63,2485,27,1324,12,27
"647","2020-04-19",246,8,353,916,6596,0.29426925409339,0,0,605,1921,70,2555,49,1373,13,49
"648","2020-04-20",230,8,327,905,6596,0.29426925409339,0,0,605,1921,53,2608,31,1404,9,31
"649","2020-04-21",242,8,315,924,6596,0.29426925409339,0,0,605,1921,71,2679,27,1431,12,27
"650","2020-04-22",234,8,292,915,6596,0.29426925409339,0,0,605,1921,58,2737,22,1453,7,22
"651","2020-04-23",244,8,301,921,6596,0.29426925409339,0,0,605,1921,82,2819,22,1475,14,22
"652","2020-04-24",257,8,302,921,6596,0.29426925409339,0,0,605,1921,74,2893,38,1513,20,38
"653","2020-04-25",254,8,300,914,6596,0.29426925409339,0,0,605,1921,68,2961,66,1579,19,66
"654","2020-04-26",261,8,294,901,6596,0.29426925409339,0,0,605,1921,64,3025,47,1626,16,47
"655","2020-04-27",269,8,300,880,6596,0.29426925409339,0,0,605,1921,53,3078,21,1647,10,21
"656","2020-04-28",259,8,302,874,6596,0.29426925409339,0,0,605,1921,75,3153,47,1694,10,47
"657","2020-04-29",254,8,313,867,6596,0.29426925409339,0,0,605,1921,47,3200,37,1731,10,37
"658","2020-04-30",244,8,298,863,6596,0.29426925409339,0,0,605,1921,54,3254,19,1750,6,19
"659","2020-05-01",238,8,288,852,6596,0.29426925409339,0,0,605,1921,61,3315,28,1778,9,28
"660","2020-05-02",236,8,289,838,6596,0.29426925409339,0,0,605,1921,65,3380,23,1801,8,23
"661","2020-05-03",230,8,315,813,6596,0.29426925409339,0,0,605,1921,64,3444,16,1817,8,16
"662","2020-05-04",230,8,342,785,6596,0.29426925409339,0,0,605,1921,63,3507,10,1827,8,10
"663","2020-05-05",223,8,349,765,6596,0.29426925409339,0,0,605,1921,60,3567,15,1842,8,15
"664","2020-05-06",224,8,359,759,6596,0.29426925409339,0,0,605,1921,59,3626,25,1867,16,25
"665","2020-05-07",213,8,339,704,6596,0.29426925409339,0,0,605,1921,68,3694,46,1913,21,46
"666","2020-05-08",198,8,323,699,6596,0.29426925409339,0,0,605,1921,49,3743,27,1940,10,27
"667","2020-05-09",182,8,345,682,6596,0.29426925409339,0,0,605,1921,59,3802,20,1960,9,20
"668","2020-05-10",190,8,319,679,6596,0.29426925409339,0,0,605,1921,52,3854,31,1991,17,31
"669","2020-05-11",184,8,299,657,6596,0.29426925409339,0,0,605,1921,44,3898,26,2017,12,26
"670","2020-05-12",178,8,294,638,6596,0.29426925409339,0,0,605,1921,56,3954,14,2031,18,14
"671","2020-05-13",171,8,288,642,6596,0.29426925409339,0,0,605,1921,48,4002,11,2042,12,11
"672","2020-05-14",179,8,283,620,6596,0.29426925409339,0,0,605,1921,44,4046,13,2055,7,13
"673","2020-05-15",184,8,287,617,6596,0.29426925409339,0,0,605,1921,41,4087,6,2061,8,6
"674","2020-05-16",191,8,271,583,6596,0.29426925409339,0,0,605,1921,48,4135,7,2068,14,7
"675","2020-05-17",175,8,274,578,6596,0.29426925409339,0,0,605,1921,54,4189,12,2080,11,12
"676","2020-05-18",170,8,288,550,6596,0.29426925409339,0,0,605,1921,39,4228,6,2086,10,6
"677","2020-05-19",174,8,297,541,6596,0.29426925409339,0,0,605,1921,33,4261,11,2097,8,11
"678","2020-05-20",168,8,310,512,6596,0.29426925409339,0,0,605,1921,42,4303,18,2115,7,18
"679","2020-05-21",165,8,356,490,6596,0.29426925409339,0,0,605,1921,40,4343,49,2164,8,49
"680","2020-05-22",155,8,356,477,6596,0.29426925409339,0,0,605,1921,40,4383,51,2215,9,51
"681","2020-05-23",149,8,356,464,6596,0.29426925409339,0,0,605,1921,32,4415,41,2256,2,41
"682","2020-05-24",149,8,328,456,6596,0.29426925409339,0,0,605,1921,31,4446,22,2278,4,22
"683","2020-05-25",138,8,308,439,6596,0.29426925409339,0,0,605,1921,23,4469,50,2328,3,50
"684","2020-05-26",128,8,304,435,6596,0.29426925409339,0,0,605,1921,25,4494,31,2359,8,31
"685","2020-05-27",131,8,298,414,6596,0.29426925409339,0,0,605,1921,29,4523,20,2379,3,20
"686","2020-05-28",130,8,302,405,6596,0.29426925409339,0,0,605,1921,24,4547,26,2405,5,26
"687","2020-05-29",126,8,274,378,6596,0.29426925409339,0,0,605,1921,33,4580,38,2443,4,38
"688","2020-05-30",120,8,276,359,6596,0.29426925409339,0,0,605,1921,27,4607,24,2467,9,24
"689","2020-05-31",114,8,297,354,6596,0.29426925409339,0,0,605,1921,15,4622,24,2491,NA,24
"690","2020-06-01",111,8,316,337,6596,0.29426925409339,0,0,605,1921,24,4646,15,2506,4,15
"691","2020-06-02",107,8,310,322,6596,0.29426925409339,0,0,605,1921,22,4668,11,2517,1,11
"692","2020-06-03",96,8,326,301,6596,0.29426925409339,0,0,605,1921,19,4687,40,2557,5,40
"693","2020-06-04",87,8,325,279,6596,0.29426925409339,0,0,605,1921,19,4706,46,2603,4,46
"694","2020-06-05",91,8,306,280,6596,0.29426925409339,0,0,605,1921,15,4721,17,2620,2,17
"695","2020-06-06",85,8,313,266,6596,0.29426925409339,0,0,605,1921,18,4739,21,2641,6,21
"696","2020-06-07",86,8,296,251,6596,0.29426925409339,0,0,605,1921,21,4760,36,2677,6,36
"697","2020-03-13",1,9,94,67,7836,0.939127105666156,0,0,714,1342,25,56,8,58,10,8
"698","2020-03-14",2,9,91,96,7836,0.939127105666156,0,0,714,1342,26,82,56,114,17,56
"699","2020-03-15",8,9,104,136,7836,0.939127105666156,0,0,714,1342,23,105,20,134,16,20
"700","2020-03-16",9,9,155,187,7836,0.939127105666156,0,0,714,1342,44,149,12,146,37,12
"701","2020-03-17",12,9,211,261,7836,0.939127105666156,0,0,714,1342,32,181,13,159,25,13
"702","2020-03-18",23,9,233,347,7836,0.939127105666156,0,0,714,1342,46,227,15,174,33,15
"703","2020-03-19",37,9,201,452,7836,0.939127105666156,0,0,714,1342,48,275,12,186,34,12
"704","2020-03-20",49,9,185,555,7836,0.939127105666156,0,0,714,1342,60,335,100,286,46,100
"705","2020-03-21",73,9,189,720,7836,0.939127105666156,0,0,714,1342,56,391,59,345,42,59
"706","2020-03-22",91,9,162,888,7836,0.939127105666156,0,0,714,1342,64,455,43,388,50,43
"707","2020-03-23",116,9,170,1118,7836,0.939127105666156,0,0,714,1342,80,535,47,435,69,47
"708","2020-03-24",147,9,213,1315,7836,0.939127105666156,0,0,714,1342,83,618,38,473,70,38
"709","2020-03-25",183,9,201,1564,7836,0.939127105666156,0,0,714,1342,68,686,22,495,55,22
"710","2020-03-26",227,9,260,1873,7836,0.939127105666156,0,0,714,1342,92,778,20,515,77,20
"711","2020-03-27",283,9,239,2225,7836,0.939127105666156,0,0,714,1342,102,880,16,531,93,16
"712","2020-03-28",332,9,224,2592,7836,0.939127105666156,0,0,714,1342,81,961,25,556,67,25
"713","2020-03-29",407,9,209,2945,7836,0.939127105666156,0,0,714,1342,78,1039,75,631,66,75
"714","2020-03-30",499,9,206,3226,7836,0.939127105666156,0,0,714,1342,104,1143,42,673,89,42
"715","2020-03-31",595,9,188,3573,7836,0.939127105666156,0,0,714,1342,98,1241,49,722,87,49
"716","2020-04-01",695,9,194,3802,7836,0.939127105666156,0,0,714,1342,88,1329,31,753,77,31
"717","2020-04-02",782,9,230,3965,7836,0.939127105666156,0,0,714,1342,97,1426,38,791,83,38
"718","2020-04-03",862,9,271,4092,7836,0.939127105666156,0,0,714,1342,96,1522,50,841,87,50
"719","2020-04-04",941,9,269,4139,7836,0.939127105666156,0,0,714,1342,96,1618,30,871,80,30
"720","2020-04-05",1034,9,252,4175,7836,0.939127105666156,0,0,714,1342,106,1724,21,892,95,21
"721","2020-04-06",1078,9,242,4059,7836,0.939127105666156,0,0,714,1342,115,1839,10,902,101,10
"722","2020-04-07",1100,9,201,3870,7836,0.939127105666156,0,0,714,1342,133,1972,17,919,115,17
"723","2020-04-08",1118,9,194,3650,7836,0.939127105666156,0,0,714,1342,85,2057,8,927,77,8
"724","2020-04-09",1140,9,182,3388,7836,0.939127105666156,0,0,714,1342,109,2166,9,936,96,9
"725","2020-04-10",1158,9,167,3101,7836,0.939127105666156,0,0,714,1342,90,2256,15,951,81,15
"726","2020-04-11",1157,9,148,2811,7836,0.939127105666156,0,0,714,1342,104,2360,12,963,92,12
"727","2020-04-12",1076,9,140,2496,7836,0.939127105666156,0,0,714,1342,102,2462,13,976,91,13
"728","2020-04-13",1020,9,138,2193,7836,0.939127105666156,0,0,714,1342,134,2596,31,1007,121,31
"729","2020-04-14",931,9,153,1898,7836,0.939127105666156,0,0,714,1342,91,2687,27,1034,82,27
"730","2020-04-15",850,9,172,1641,7836,0.939127105666156,0,0,714,1342,115,2802,13,1047,102,13
"731","2020-04-16",741,9,182,1407,7836,0.939127105666156,0,0,714,1342,104,2906,21,1068,94,21
"732","2020-04-17",628,9,194,1163,7836,0.939127105666156,0,0,714,1342,89,2995,32,1100,77,32
"733","2020-04-18",528,9,247,964,7836,0.939127105666156,0,0,714,1342,113,3108,65,1165,101,65
"734","2020-04-19",444,9,282,796,7836,0.939127105666156,0,0,714,1342,108,3216,44,1209,93,44
"735","2020-04-20",367,9,259,656,7836,0.939127105666156,0,0,714,1342,98,3314,33,1242,91,33
"736","2020-04-21",333,9,240,555,7836,0.939127105666156,0,0,714,1342,94,3408,29,1271,80,29
"737","2020-04-22",269,9,237,454,7836,0.939127105666156,0,0,714,1342,80,3488,24,1295,67,24
"738","2020-04-23",226,9,285,379,7836,0.939127105666156,0,0,714,1342,72,3560,43,1338,57,43
"739","2020-04-24",184,9,299,313,7836,0.939127105666156,0,0,714,1342,79,3639,40,1378,68,40
"740","2020-04-25",144,9,289,259,7836,0.939127105666156,0,0,714,1342,68,3707,34,1412,59,34
"741","2020-04-26",131,9,254,210,7836,0.939127105666156,0,0,714,1342,86,3793,17,1429,74,17
"742","2020-04-27",108,9,240,176,7836,0.939127105666156,0,0,714,1342,73,3866,15,1444,58,15
"743","2020-04-28",83,9,215,157,7836,0.939127105666156,0,0,714,1342,59,3925,8,1452,50,8
"744","2020-04-29",66,9,195,134,7836,0.939127105666156,0,0,714,1342,66,3991,7,1459,58,7
"745","2020-04-30",54,9,179,118,7836,0.939127105666156,0,0,714,1342,39,4030,9,1468,33,9
"746","2020-05-01",45,9,168,99,7836,0.939127105666156,0,0,714,1342,49,4079,27,1495,41,27
"747","2020-05-02",35,9,166,90,7836,0.939127105666156,0,0,714,1342,54,4133,16,1511,45,16
"748","2020-05-03",25,9,213,74,7836,0.939127105666156,0,0,714,1342,52,4185,15,1526,37,15
"749","2020-05-04",22,9,220,69,7836,0.939127105666156,0,0,714,1342,40,4225,14,1540,33,14
"750","2020-05-05",20,9,209,63,7836,0.939127105666156,0,0,714,1342,45,4270,9,1549,35,9
"751","2020-05-06",21,9,191,56,7836,0.939127105666156,0,0,714,1342,51,4321,13,1562,41,13
"752","2020-05-07",20,9,199,55,7836,0.939127105666156,0,0,714,1342,39,4360,11,1573,30,11
"753","2020-05-08",20,9,207,49,7836,0.939127105666156,0,0,714,1342,33,4393,7,1580,29,7
"754","2020-05-09",20,9,191,45,7836,0.939127105666156,0,0,714,1342,30,4423,14,1594,26,14
"755","2020-05-10",21,9,171,41,7836,0.939127105666156,0,0,714,1342,30,4453,66,1660,19,66
"756","2020-05-11",19,9,171,35,7836,0.939127105666156,0,0,714,1342,38,4491,38,1698,31,38
"757","2020-05-12",17,9,157,28,7836,0.939127105666156,0,0,714,1342,36,4527,78,1776,25,78
"758","2020-05-13",13,9,168,21,7836,0.939127105666156,0,0,714,1342,33,4560,72,1848,24,72
"759","2020-05-14",11,9,174,24,7836,0.939127105666156,0,0,714,1342,29,4589,27,1875,21,27
"760","2020-05-15",9,9,180,21,7836,0.939127105666156,0,0,714,1342,32,4621,32,1907,26,32
"761","2020-05-16",7,9,242,23,7836,0.939127105666156,0,0,714,1342,30,4651,26,1933,28,26
"762","2020-05-17",4,9,298,23,7836,0.939127105666156,0,0,714,1342,32,4683,20,1953,25,20
"763","2020-05-18",4,9,310,24,7836,0.939127105666156,0,0,714,1342,23,4706,22,1975,18,22
"764","2020-05-19",5,9,300,22,7836,0.939127105666156,0,0,714,1342,26,4732,20,1995,18,20
"765","2020-05-20",6,9,275,22,7836,0.939127105666156,0,0,714,1342,21,4753,56,2051,19,56
"766","2020-05-21",8,9,248,23,7836,0.939127105666156,0,0,714,1342,23,4776,32,2083,18,32
"767","2020-05-22",8,9,247,23,7836,0.939127105666156,0,0,714,1342,22,4798,16,2099,14,16
"768","2020-05-23",11,9,254,24,7836,0.939127105666156,0,0,714,1342,24,4822,14,2113,19,14
"769","2020-05-24",9,9,227,25,7836,0.939127105666156,0,0,714,1342,14,4836,8,2121,11,8
"770","2020-05-25",9,9,217,24,7836,0.939127105666156,0,0,714,1342,15,4851,37,2158,11,37
"771","2020-05-26",9,9,211,23,7836,0.939127105666156,0,0,714,1342,23,4874,15,2173,18,15
"772","2020-05-27",9,9,192,23,7836,0.939127105666156,0,0,714,1342,18,4892,9,2182,10,9
"773","2020-05-28",7,9,191,23,7836,0.939127105666156,0,0,714,1342,23,4915,7,2189,18,7
"774","2020-05-29",7,9,166,21,7836,0.939127105666156,0,0,714,1342,21,4936,21,2210,17,21
"775","2020-05-30",7,9,154,21,7836,0.939127105666156,0,0,714,1342,18,4954,58,2268,15,58
"776","2020-05-31",8,9,165,20,7836,0.939127105666156,0,0,714,1342,18,4972,28,2296,17,28
"777","2020-06-01",7,9,187,18,7836,0.939127105666156,0,0,714,1342,9,4981,24,2320,7,24
"778","2020-06-02",7,9,209,17,7836,0.939127105666156,0,0,714,1342,12,4993,21,2341,9,21
"779","2020-06-03",7,9,190,17,7836,0.939127105666156,0,0,714,1342,10,5003,10,2351,6,10
"780","2020-06-04",7,9,169,15,7836,0.939127105666156,0,0,714,1342,10,5013,69,2420,9,69
"781","2020-06-05",7,9,172,16,7836,0.939127105666156,0,0,714,1342,13,5026,30,2450,8,30
"782","2020-06-06",5,9,149,15,7836,0.939127105666156,0,0,714,1342,13,5039,54,2504,11,54
"783","2020-06-07",4,9,140,14,7836,0.939127105666156,0,0,714,1342,12,5051,57,2561,10,57
"784","2020-03-13",2,10,165,54,2733,0.461397731430662,0,0,270,1625,53,145,2,44,8,2
"785","2020-03-14",2,10,159,75,2733,0.461397731430662,0,0,270,1625,56,201,6,50,18,6
"786","2020-03-15",4,10,160,89,2733,0.461397731430662,0,0,270,1625,55,256,11,61,15,11
"787","2020-03-16",10,10,150,115,2733,0.461397731430662,0,0,270,1625,77,333,4,65,26,4
"788","2020-03-17",14,10,142,138,2733,0.461397731430662,0,0,270,1625,80,413,7,72,40,7
"789","2020-03-18",18,10,148,162,2733,0.461397731430662,0,0,270,1625,86,499,8,80,46,8
"790","2020-03-19",25,10,173,181,2733,0.461397731430662,0,0,270,1625,96,595,23,103,60,23
"791","2020-03-20",32,10,171,188,2733,0.461397731430662,0,0,270,1625,88,683,16,119,53,16
"792","2020-03-21",40,10,166,203,2733,0.461397731430662,0,0,270,1625,106,789,34,153,60,34
"793","2020-03-22",49,10,164,213,2733,0.461397731430662,0,0,270,1625,102,891,35,188,68,35
"794","2020-03-23",55,10,184,229,2733,0.461397731430662,0,0,270,1625,105,996,16,204,70,16
"795","2020-03-24",58,10,173,253,2733,0.461397731430662,0,0,270,1625,125,1121,13,217,89,13
"796","2020-03-25",61,10,211,265,2733,0.461397731430662,0,0,270,1625,114,1235,9,226,72,9
"797","2020-03-26",68,10,203,286,2733,0.461397731430662,0,0,270,1625,105,1340,8,234,67,8
"798","2020-03-27",76,10,172,296,2733,0.461397731430662,0,0,270,1625,103,1443,13,247,65,13
"799","2020-03-28",79,10,154,299,2733,0.461397731430662,0,0,270,1625,153,1596,29,276,94,29
"800","2020-03-29",82,10,145,310,2733,0.461397731430662,0,0,270,1625,106,1702,17,293,77,17
"801","2020-03-30",79,10,143,328,2733,0.461397731430662,0,0,270,1625,105,1807,23,316,70,23
"802","2020-03-31",84,10,179,332,2733,0.461397731430662,0,0,270,1625,125,1932,14,330,86,14
"803","2020-04-01",86,10,204,328,2733,0.461397731430662,0,0,270,1625,111,2043,20,350,69,20
"804","2020-04-02",82,10,199,339,2733,0.461397731430662,0,0,270,1625,121,2164,19,369,82,19
"805","2020-04-03",85,10,203,344,2733,0.461397731430662,0,0,270,1625,128,2292,16,385,84,16
"806","2020-04-04",92,10,228,348,2733,0.461397731430662,0,0,270,1625,119,2411,12,397,77,12
"807","2020-04-05",93,10,226,365,2733,0.461397731430662,0,0,270,1625,104,2515,24,421,65,24
"808","2020-04-06",96,10,224,369,2733,0.461397731430662,0,0,270,1625,106,2621,62,483,66,62
"809","2020-04-07",99,10,214,361,2733,0.461397731430662,0,0,270,1625,99,2720,67,550,70,67
"810","2020-04-08",102,10,230,371,2733,0.461397731430662,0,0,270,1625,109,2829,34,584,66,34
"811","2020-04-09",113,10,213,376,2733,0.461397731430662,0,0,270,1625,94,2923,24,608,61,24
"812","2020-04-10",111,10,244,368,2733,0.461397731430662,0,0,270,1625,95,3018,8,616,57,8
"813","2020-04-11",104,10,251,364,2733,0.461397731430662,0,0,270,1625,87,3105,13,629,49,13
"814","2020-04-12",104,10,241,356,2733,0.461397731430662,0,0,270,1625,108,3213,15,644,74,15
"815","2020-04-13",104,10,237,339,2733,0.461397731430662,0,0,270,1625,111,3324,62,706,66,62
"816","2020-04-14",107,10,220,343,2733,0.461397731430662,0,0,270,1625,81,3405,26,732,51,26
"817","2020-04-15",106,10,200,332,2733,0.461397731430662,0,0,270,1625,99,3504,25,757,53,25
"818","2020-04-16",102,10,170,326,2733,0.461397731430662,0,0,270,1625,95,3599,25,782,48,25
"819","2020-04-17",98,10,170,333,2733,0.461397731430662,0,0,270,1625,79,3678,23,805,42,23
"820","2020-04-18",100,10,226,345,2733,0.461397731430662,0,0,270,1625,75,3753,29,834,42,29
"821","2020-04-19",96,10,231,354,2733,0.461397731430662,0,0,270,1625,90,3843,66,900,54,66
"822","2020-04-20",95,10,213,362,2733,0.461397731430662,0,0,270,1625,77,3920,28,928,46,28
"823","2020-04-21",89,10,187,383,2733,0.461397731430662,0,0,270,1625,67,3987,14,942,41,14
"824","2020-04-22",87,10,194,399,2733,0.461397731430662,0,0,270,1625,69,4056,25,967,38,25
"825","2020-04-23",83,10,205,392,2733,0.461397731430662,0,0,270,1625,79,4135,61,1028,34,61
"826","2020-04-24",93,10,210,402,2733,0.461397731430662,0,0,270,1625,90,4225,35,1063,38,35
"827","2020-04-25",99,10,221,412,2733,0.461397731430662,0,0,270,1625,76,4301,24,1087,36,24
"828","2020-04-26",105,10,210,427,2733,0.461397731430662,0,0,270,1625,90,4391,25,1112,39,25
"829","2020-04-27",112,10,203,424,2733,0.461397731430662,0,0,270,1625,97,4488,18,1130,64,18
"830","2020-04-28",117,10,178,436,2733,0.461397731430662,0,0,270,1625,51,4539,14,1144,26,14
"831","2020-04-29",121,10,220,441,2733,0.461397731430662,0,0,270,1625,63,4602,18,1162,33,18
"832","2020-04-30",123,10,180,450,2733,0.461397731430662,0,0,270,1625,73,4675,37,1199,44,37
"833","2020-05-01",116,10,200,447,2733,0.461397731430662,0,0,270,1625,53,4728,22,1221,30,22
"834","2020-05-02",119,10,192,452,2733,0.461397731430662,0,0,270,1625,53,4781,53,1274,21,53
"835","2020-05-03",127,10,171,443,2733,0.461397731430662,0,0,270,1625,62,4843,59,1333,33,59
"836","2020-05-04",127,10,174,441,2733,0.461397731430662,0,0,270,1625,64,4907,27,1360,31,27
"837","2020-05-05",126,10,179,440,2733,0.461397731430662,0,0,270,1625,37,4944,17,1377,17,17
"838","2020-05-06",124,10,186,430,2733,0.461397731430662,0,0,270,1625,43,4987,19,1396,23,19
"839","2020-05-07",126,10,186,433,2733,0.461397731430662,0,0,270,1625,47,5034,62,1458,14,62
"840","2020-05-08",125,10,171,416,2733,0.461397731430662,0,0,270,1625,44,5078,63,1521,16,63
"841","2020-05-09",117,10,170,417,2733,0.461397731430662,0,0,270,1625,42,5120,37,1558,22,37
"842","2020-05-10",111,10,168,407,2733,0.461397731430662,0,0,270,1625,34,5154,51,1609,9,51
"843","2020-05-11",112,10,154,396,2733,0.461397731430662,0,0,270,1625,36,5190,42,1651,12,42
"844","2020-05-12",110,10,149,377,2733,0.461397731430662,0,0,270,1625,32,5222,36,1687,12,36
"845","2020-05-13",121,10,141,369,2733,0.461397731430662,0,0,270,1625,36,5258,27,1714,16,27
"846","2020-05-14",119,10,119,365,2733,0.461397731430662,0,0,270,1625,33,5291,38,1752,11,38
"847","2020-05-15",111,10,123,365,2733,0.461397731430662,0,0,270,1625,35,5326,23,1775,12,23
"848","2020-05-16",108,10,130,349,2733,0.461397731430662,0,0,270,1625,29,5355,17,1792,9,17
"849","2020-05-17",103,10,147,339,2733,0.461397731430662,0,0,270,1625,29,5384,11,1803,16,11
"850","2020-05-18",104,10,164,339,2733,0.461397731430662,0,0,270,1625,21,5405,14,1817,8,14
"851","2020-05-19",102,10,200,334,2733,0.461397731430662,0,0,270,1625,24,5429,10,1827,9,10
"852","2020-05-20",91,10,190,326,2733,0.461397731430662,0,0,270,1625,31,5460,11,1838,13,11
"853","2020-05-21",93,10,197,309,2733,0.461397731430662,0,0,270,1625,18,5478,24,1862,7,24
"854","2020-05-22",95,10,214,307,2733,0.461397731430662,0,0,270,1625,14,5492,32,1894,7,32
"855","2020-05-23",102,10,219,301,2733,0.461397731430662,0,0,270,1625,19,5511,42,1936,8,42
"856","2020-05-24",95,10,228,283,2733,0.461397731430662,0,0,270,1625,19,5530,32,1968,9,32
"857","2020-05-25",87,10,231,291,2733,0.461397731430662,0,0,270,1625,20,5550,54,2022,8,54
"858","2020-05-26",86,10,245,284,2733,0.461397731430662,0,0,270,1625,18,5568,50,2072,7,50
"859","2020-05-27",84,10,275,289,2733,0.461397731430662,0,0,270,1625,17,5585,58,2130,4,58
"860","2020-05-28",75,10,245,275,2733,0.461397731430662,0,0,270,1625,22,5607,42,2172,8,42
"861","2020-05-29",83,10,205,273,2733,0.461397731430662,0,0,270,1625,13,5620,23,2195,5,23
"862","2020-05-30",74,10,217,261,2733,0.461397731430662,0,0,270,1625,15,5635,20,2215,7,20
"863","2020-05-31",73,10,235,258,2733,0.461397731430662,0,0,270,1625,19,5654,13,2228,11,13
"864","2020-06-01",75,10,243,248,2733,0.461397731430662,0,0,270,1625,15,5669,19,2247,8,19
"865","2020-06-02",76,10,223,230,2733,0.461397731430662,0,0,270,1625,17,5686,36,2283,10,36
"866","2020-06-03",79,10,243,231,2733,0.461397731430662,0,0,270,1625,22,5708,42,2325,11,42
"867","2020-06-04",76,10,212,230,2733,0.461397731430662,0,0,270,1625,17,5725,25,2350,4,25
"868","2020-06-05",63,10,209,222,2733,0.461397731430662,0,0,270,1625,12,5737,10,2360,7,10
"869","2020-06-06",67,10,187,220,2733,0.461397731430662,0,0,270,1625,13,5750,26,2386,7,26
"870","2020-06-07",71,10,170,208,2733,0.461397731430662,0,0,270,1625,13,5763,26,2412,5,26
"871","2020-03-13",1,11,91,199,6078,0.260118460019743,0,0,485,1280,84,234,43,155,13,43
"872","2020-03-14",7,11,135,279,6078,0.260118460019743,0,0,485,1280,119,353,77,232,21,77
"873","2020-03-15",19,11,151,363,6078,0.260118460019743,0,0,485,1280,94,447,90,322,19,90
"874","2020-03-16",34,11,183,448,6078,0.260118460019743,0,0,485,1280,97,544,57,379,31,57
"875","2020-03-17",58,11,198,529,6078,0.260118460019743,0,0,485,1280,95,639,56,435,33,56
"876","2020-03-18",76,11,209,623,6078,0.260118460019743,0,0,485,1280,107,746,46,481,34,46
"877","2020-03-19",101,11,245,683,6078,0.260118460019743,0,0,485,1280,103,849,40,521,45,40
"878","2020-03-20",130,11,222,727,6078,0.260118460019743,0,0,485,1280,84,933,44,565,41,44
"879","2020-03-21",165,11,205,782,6078,0.260118460019743,0,0,485,1280,108,1041,37,602,48,37
"880","2020-03-22",188,11,173,831,6078,0.260118460019743,0,0,485,1280,106,1147,61,663,41,61
"881","2020-03-23",208,11,140,855,6078,0.260118460019743,0,0,485,1280,113,1260,66,729,35,66
"882","2020-03-24",230,11,134,876,6078,0.260118460019743,0,0,485,1280,110,1370,49,778,41,49
"883","2020-03-25",258,11,136,903,6078,0.260118460019743,0,0,485,1280,129,1499,39,817,52,39
"884","2020-03-26",271,11,134,910,6078,0.260118460019743,0,0,485,1280,121,1620,38,855,46,38
"885","2020-03-27",271,11,125,926,6078,0.260118460019743,0,0,485,1280,122,1742,51,906,56,51
"886","2020-03-28",277,11,125,926,6078,0.260118460019743,0,0,485,1280,118,1860,45,951,48,45
"887","2020-03-29",264,11,119,926,6078,0.260118460019743,0,0,485,1280,119,1979,37,988,46,37
"888","2020-03-30",265,11,139,911,6078,0.260118460019743,0,0,485,1280,115,2094,58,1046,48,58
"889","2020-03-31",252,11,155,930,6078,0.260118460019743,0,0,485,1280,140,2234,70,1116,59,70
"890","2020-04-01",231,11,209,947,6078,0.260118460019743,0,0,485,1280,123,2357,43,1159,41,43
"891","2020-04-02",225,11,219,947,6078,0.260118460019743,0,0,485,1280,132,2489,33,1192,62,33
"892","2020-04-03",229,11,203,954,6078,0.260118460019743,0,0,485,1280,135,2624,34,1226,60,34
"893","2020-04-04",219,11,191,953,6078,0.260118460019743,0,0,485,1280,100,2724,33,1259,39,33
"894","2020-04-05",230,11,179,946,6078,0.260118460019743,0,0,485,1280,102,2826,61,1320,29,61
"895","2020-04-06",237,11,148,963,6078,0.260118460019743,0,0,485,1280,94,2920,60,1380,39,60
"896","2020-04-07",236,11,138,967,6078,0.260118460019743,0,0,485,1280,89,3009,47,1427,32,47
"897","2020-04-08",240,11,149,986,6078,0.260118460019743,0,0,485,1280,109,3118,58,1485,42,58
"898","2020-04-09",241,11,156,996,6078,0.260118460019743,0,0,485,1280,127,3245,44,1529,44,44
"899","2020-04-10",244,11,141,1022,6078,0.260118460019743,0,0,485,1280,93,3338,44,1573,35,44
"900","2020-04-11",254,11,155,1013,6078,0.260118460019743,0,0,485,1280,98,3436,42,1615,42,42
"901","2020-04-12",269,11,211,1023,6078,0.260118460019743,0,0,485,1280,107,3543,45,1660,36,45
"902","2020-04-13",275,11,227,1022,6078,0.260118460019743,0,0,485,1280,79,3622,38,1698,29,38
"903","2020-04-14",275,11,248,1040,6078,0.260118460019743,0,0,485,1280,92,3714,37,1735,36,37
"904","2020-04-15",284,11,250,1048,6078,0.260118460019743,0,0,485,1280,98,3812,40,1775,35,40
"905","2020-04-16",308,11,291,1067,6078,0.260118460019743,0,0,485,1280,106,3918,39,1814,35,39
"906","2020-04-17",313,11,301,1054,6078,0.260118460019743,0,0,485,1280,91,4009,36,1850,29,36
"907","2020-04-18",310,11,297,1040,6078,0.260118460019743,0,0,485,1280,70,4079,41,1891,26,41
"908","2020-04-19",303,11,260,1024,6078,0.260118460019743,0,0,485,1280,92,4171,28,1919,24,28
"909","2020-04-20",287,11,233,1007,6078,0.260118460019743,0,0,485,1280,80,4251,41,1960,27,41
"910","2020-04-21",292,11,246,999,6078,0.260118460019743,0,0,485,1280,102,4353,40,2000,38,40
"911","2020-04-22",288,11,281,968,6078,0.260118460019743,0,0,485,1280,82,4435,72,2072,24,72
"912","2020-04-23",266,11,270,935,6078,0.260118460019743,0,0,485,1280,78,4513,41,2113,26,41
"913","2020-04-24",267,11,227,901,6078,0.260118460019743,0,0,485,1280,82,4595,39,2152,23,39
"914","2020-04-25",261,11,223,861,6078,0.260118460019743,0,0,485,1280,76,4671,34,2186,16,34
"915","2020-04-26",260,11,248,838,6078,0.260118460019743,0,0,485,1280,102,4773,42,2228,28,42
"916","2020-04-27",255,11,252,804,6078,0.260118460019743,0,0,485,1280,69,4842,37,2265,30,37
"917","2020-04-28",257,11,228,795,6078,0.260118460019743,0,0,485,1280,52,4894,43,2308,12,43
"918","2020-04-29",253,11,221,779,6078,0.260118460019743,0,0,485,1280,77,4971,29,2337,29,29
"919","2020-04-30",247,11,218,755,6078,0.260118460019743,0,0,485,1280,61,5032,29,2366,13,29
"920","2020-05-01",228,11,206,755,6078,0.260118460019743,0,0,485,1280,60,5092,46,2412,2,46
"921","2020-05-02",225,11,205,758,6078,0.260118460019743,0,0,485,1280,54,5146,31,2443,11,31
"922","2020-05-03",211,11,203,744,6078,0.260118460019743,0,0,485,1280,50,5196,38,2481,20,38
"923","2020-05-04",209,11,192,724,6078,0.260118460019743,0,0,485,1280,56,5252,46,2527,9,46
"924","2020-05-05",199,11,230,728,6078,0.260118460019743,0,0,485,1280,59,5311,31,2558,11,31
"925","2020-05-06",200,11,249,720,6078,0.260118460019743,0,0,485,1280,48,5359,34,2592,9,34
"926","2020-05-07",201,11,273,700,6078,0.260118460019743,0,0,485,1280,56,5415,35,2627,12,35
"927","2020-05-08",204,11,256,672,6078,0.260118460019743,0,0,485,1280,67,5482,32,2659,17,32
"928","2020-05-09",202,11,231,648,6078,0.260118460019743,0,0,485,1280,43,5525,24,2683,10,24
"929","2020-05-10",189,11,209,644,6078,0.260118460019743,0,0,485,1280,43,5568,35,2718,12,35
"930","2020-05-11",191,11,191,636,6078,0.260118460019743,0,0,485,1280,48,5616,34,2752,9,34
"931","2020-05-12",188,11,184,619,6078,0.260118460019743,0,0,485,1280,45,5661,33,2785,12,33
"932","2020-05-13",175,11,205,607,6078,0.260118460019743,0,0,485,1280,43,5704,37,2822,11,37
"933","2020-05-14",172,11,225,600,6078,0.260118460019743,0,0,485,1280,28,5732,30,2852,9,30
"934","2020-05-15",170,11,258,579,6078,0.260118460019743,0,0,485,1280,36,5768,34,2886,8,34
"935","2020-05-16",168,11,313,551,6078,0.260118460019743,0,0,485,1280,32,5800,31,2917,10,31
"936","2020-05-17",177,11,285,532,6078,0.260118460019743,0,0,485,1280,40,5840,26,2943,7,26
"937","2020-05-18",167,11,265,500,6078,0.260118460019743,0,0,485,1280,45,5885,41,2984,8,41
"938","2020-05-19",157,11,243,467,6078,0.260118460019743,0,0,485,1280,33,5918,53,3037,5,53
"939","2020-05-20",163,11,219,458,6078,0.260118460019743,0,0,485,1280,27,5945,40,3077,8,40
"940","2020-05-21",157,11,200,439,6078,0.260118460019743,0,0,485,1280,38,5983,42,3119,5,42
"941","2020-05-22",142,11,202,417,6078,0.260118460019743,0,0,485,1280,37,6020,64,3183,6,64
"942","2020-05-23",125,11,182,397,6078,0.260118460019743,0,0,485,1280,22,6042,49,3232,6,49
"943","2020-05-24",116,11,160,368,6078,0.260118460019743,0,0,485,1280,28,6070,42,3274,7,42
"944","2020-05-25",113,11,161,353,6078,0.260118460019743,0,0,485,1280,28,6098,40,3314,4,40
"945","2020-05-26",105,11,185,340,6078,0.260118460019743,0,0,485,1280,24,6122,39,3353,6,39
"946","2020-05-27",89,11,239,323,6078,0.260118460019743,0,0,485,1280,18,6140,36,3389,2,36
"947","2020-05-28",74,11,296,316,6078,0.260118460019743,0,0,485,1280,20,6160,55,3444,9,55
"948","2020-05-29",78,11,311,308,6078,0.260118460019743,0,0,485,1280,22,6182,39,3483,8,39
"949","2020-05-30",79,11,287,292,6078,0.260118460019743,0,0,485,1280,18,6200,38,3521,5,38
"950","2020-05-31",79,11,289,290,6078,0.260118460019743,0,0,485,1280,21,6221,47,3568,2,47
"951","2020-06-01",76,11,279,281,6078,0.260118460019743,0,0,485,1280,20,6241,51,3619,4,51
"952","2020-06-02",81,11,297,258,6078,0.260118460019743,0,0,485,1280,10,6251,31,3650,3,31
"953","2020-06-03",82,11,294,259,6078,0.260118460019743,0,0,485,1280,13,6264,42,3692,2,42
"954","2020-06-04",94,11,278,250,6078,0.260118460019743,0,0,485,1280,12,6276,30,3722,2,30
"955","2020-06-05",90,11,243,242,6078,0.260118460019743,0,0,485,1280,12,6288,43,3765,1,43
"956","2020-06-06",83,11,218,236,6078,0.260118460019743,0,0,485,1280,12,6300,39,3804,4,39
"957","2020-06-07",76,11,213,225,6078,0.260118460019743,0,0,485,1280,13,6313,38,3842,6,38
"958","2020-03-13",2,12,93,204,6670,0.192953523238381,0,0,574,1005,41,119,36,119,13,36
"959","2020-03-14",5,12,102,286,6670,0.192953523238381,0,0,574,1005,65,184,53,172,26,53
"960","2020-03-15",19,12,114,350,6670,0.192953523238381,0,0,574,1005,60,244,26,198,28,26
"961","2020-03-16",33,12,122,419,6670,0.192953523238381,0,0,574,1005,63,307,25,223,39,25
"962","2020-03-17",61,12,132,511,6670,0.192953523238381,0,0,574,1005,73,380,43,266,41,43
"963","2020-03-18",84,12,181,594,6670,0.192953523238381,0,0,574,1005,79,459,26,292,47,26
"964","2020-03-19",108,12,193,666,6670,0.192953523238381,0,0,574,1005,80,539,25,317,47,25
"965","2020-03-20",129,12,211,741,6670,0.192953523238381,0,0,574,1005,100,639,43,360,63,43
"966","2020-03-21",159,12,219,797,6670,0.192953523238381,0,0,574,1005,91,730,57,417,54,57
"967","2020-03-22",175,12,222,848,6670,0.192953523238381,0,0,574,1005,79,809,33,450,47,33
"968","2020-03-23",196,12,230,903,6670,0.192953523238381,0,0,574,1005,102,911,40,490,70,40
"969","2020-03-24",207,12,229,921,6670,0.192953523238381,0,0,574,1005,104,1015,52,542,70,52
"970","2020-03-25",224,12,230,931,6670,0.192953523238381,0,0,574,1005,122,1137,31,573,83,31
"971","2020-03-26",233,12,224,948,6670,0.192953523238381,0,0,574,1005,126,1263,21,594,86,21
"972","2020-03-27",254,12,254,946,6670,0.192953523238381,0,0,574,1005,122,1385,19,613,86,19
"973","2020-03-28",258,12,238,956,6670,0.192953523238381,0,0,574,1005,125,1510,53,666,88,53
"974","2020-03-29",264,12,220,994,6670,0.192953523238381,0,0,574,1005,111,1621,30,696,84,30
"975","2020-03-30",280,12,213,1002,6670,0.192953523238381,0,0,574,1005,111,1732,20,716,82,20
"976","2020-03-31",276,12,193,1016,6670,0.192953523238381,0,0,574,1005,105,1837,55,771,71,55
"977","2020-04-01",274,12,203,1035,6670,0.192953523238381,0,0,574,1005,105,1942,37,808,68,37
"978","2020-04-02",287,12,200,1050,6670,0.192953523238381,0,0,574,1005,134,2076,24,832,93,24
"979","2020-04-03",272,12,199,1074,6670,0.192953523238381,0,0,574,1005,96,2172,23,855,73,23
"980","2020-04-04",281,12,225,1079,6670,0.192953523238381,0,0,574,1005,133,2305,35,890,101,35
"981","2020-04-05",289,12,222,1063,6670,0.192953523238381,0,0,574,1005,109,2414,25,915,77,25
"982","2020-04-06",281,12,218,1087,6670,0.192953523238381,0,0,574,1005,95,2509,33,948,61,33
"983","2020-04-07",282,12,198,1097,6670,0.192953523238381,0,0,574,1005,119,2628,59,1007,93,59
"984","2020-04-08",279,12,240,1107,6670,0.192953523238381,0,0,574,1005,109,2737,62,1069,83,62
"985","2020-04-09",267,12,232,1104,6670,0.192953523238381,0,0,574,1005,93,2830,79,1148,64,79
"986","2020-04-10",280,12,213,1122,6670,0.192953523238381,0,0,574,1005,106,2936,58,1206,67,58
"987","2020-04-11",284,12,198,1094,6670,0.192953523238381,0,0,574,1005,111,3047,43,1249,73,43
"988","2020-04-12",276,12,202,1090,6670,0.192953523238381,0,0,574,1005,115,3162,59,1308,77,59
"989","2020-04-13",276,12,202,1104,6670,0.192953523238381,0,0,574,1005,86,3248,54,1362,65,54
"990","2020-04-14",277,12,213,1092,6670,0.192953523238381,0,0,574,1005,94,3342,26,1388,55,26
"991","2020-04-15",300,12,224,1083,6670,0.192953523238381,0,0,574,1005,97,3439,47,1435,60,47
"992","2020-04-16",286,12,228,1059,6670,0.192953523238381,0,0,574,1005,90,3529,36,1471,51,36
"993","2020-04-17",286,12,216,1076,6670,0.192953523238381,0,0,574,1005,94,3623,59,1530,62,59
"994","2020-04-18",282,12,237,1086,6670,0.192953523238381,0,0,574,1005,72,3695,42,1572,42,42
"995","2020-04-19",292,12,247,1080,6670,0.192953523238381,0,0,574,1005,74,3769,23,1595,49,23
"996","2020-04-20",283,12,225,1061,6670,0.192953523238381,0,0,574,1005,86,3855,22,1617,59,22
"997","2020-04-21",287,12,226,1036,6670,0.192953523238381,0,0,574,1005,84,3939,31,1648,48,31
"998","2020-04-22",267,12,232,1021,6670,0.192953523238381,0,0,574,1005,72,4011,29,1677,31,29
"999","2020-04-23",292,12,252,993,6670,0.192953523238381,0,0,574,1005,76,4087,23,1700,40,23
"1000","2020-04-24",287,12,244,987,6670,0.192953523238381,0,0,574,1005,68,4155,64,1764,37,64
"1001","2020-04-25",276,12,239,975,6670,0.192953523238381,0,0,574,1005,70,4225,28,1792,36,28
"1002","2020-04-26",266,12,252,959,6670,0.192953523238381,0,0,574,1005,64,4289,29,1821,36,29
"1003","2020-04-27",268,12,266,922,6670,0.192953523238381,0,0,574,1005,61,4350,52,1873,38,52
"1004","2020-04-28",260,12,265,925,6670,0.192953523238381,0,0,574,1005,58,4408,46,1919,38,46
"1005","2020-04-29",248,12,265,886,6670,0.192953523238381,0,0,574,1005,47,4455,44,1963,30,44
"1006","2020-04-30",241,12,296,870,6670,0.192953523238381,0,0,574,1005,57,4512,50,2013,37,50
"1007","2020-05-01",232,12,268,856,6670,0.192953523238381,0,0,574,1005,53,4565,34,2047,29,34
"1008","2020-05-02",234,12,245,827,6670,0.192953523238381,0,0,574,1005,43,4608,28,2075,22,28
"1009","2020-05-03",230,12,247,808,6670,0.192953523238381,0,0,574,1005,48,4656,56,2131,24,56
"1010","2020-05-04",224,12,254,792,6670,0.192953523238381,0,0,574,1005,43,4699,36,2167,18,36
"1011","2020-05-05",225,12,276,783,6670,0.192953523238381,0,0,574,1005,51,4750,52,2219,27,52
"1012","2020-05-06",226,12,275,768,6670,0.192953523238381,0,0,574,1005,45,4795,43,2262,22,43
"1013","2020-05-07",220,12,262,739,6670,0.192953523238381,0,0,574,1005,50,4845,30,2292,31,30
"1014","2020-05-08",225,12,273,726,6670,0.192953523238381,0,0,574,1005,52,4897,16,2308,28,16
"1015","2020-05-09",214,12,268,698,6670,0.192953523238381,0,0,574,1005,48,4945,18,2326,25,18
"1016","2020-05-10",220,12,258,688,6670,0.192953523238381,0,0,574,1005,32,4977,26,2352,14,26
"1017","2020-05-11",219,12,249,709,6670,0.192953523238381,0,0,574,1005,53,5030,13,2365,28,13
"1018","2020-05-12",210,12,231,689,6670,0.192953523238381,0,0,574,1005,37,5067,14,2379,20,14
"1019","2020-05-13",216,12,226,660,6670,0.192953523238381,0,0,574,1005,41,5108,12,2391,23,12
"1020","2020-05-14",209,12,217,633,6670,0.192953523238381,0,0,574,1005,29,5137,22,2413,13,22
"1021","2020-05-15",199,12,226,603,6670,0.192953523238381,0,0,574,1005,30,5167,34,2447,13,34
"1022","2020-05-16",189,12,201,587,6670,0.192953523238381,0,0,574,1005,30,5197,58,2505,16,58
"1023","2020-05-17",168,12,188,554,6670,0.192953523238381,0,0,574,1005,37,5234,35,2540,23,35
"1024","2020-05-18",163,12,216,559,6670,0.192953523238381,0,0,574,1005,28,5262,17,2557,12,17
"1025","2020-05-19",159,12,257,529,6670,0.192953523238381,0,0,574,1005,30,5292,66,2623,11,66
"1026","2020-05-20",157,12,270,518,6670,0.192953523238381,0,0,574,1005,28,5320,46,2669,14,46
"1027","2020-05-21",153,12,261,500,6670,0.192953523238381,0,0,574,1005,28,5348,64,2733,12,64
"1028","2020-05-22",147,12,250,474,6670,0.192953523238381,0,0,574,1005,28,5376,26,2759,12,26
"1029","2020-05-23",147,12,246,452,6670,0.192953523238381,0,0,574,1005,27,5403,43,2802,13,43
"1030","2020-05-24",154,12,239,416,6670,0.192953523238381,0,0,574,1005,27,5430,27,2829,14,27
"1031","2020-05-25",145,12,247,406,6670,0.192953523238381,0,0,574,1005,18,5448,27,2856,12,27
"1032","2020-05-26",139,12,263,384,6670,0.192953523238381,0,0,574,1005,31,5479,29,2885,13,29
"1033","2020-05-27",125,12,259,386,6670,0.192953523238381,0,0,574,1005,22,5501,17,2902,8,17
"1034","2020-05-28",121,12,257,391,6670,0.192953523238381,0,0,574,1005,29,5530,21,2923,20,21
"1035","2020-05-29",117,12,270,373,6670,0.192953523238381,0,0,574,1005,20,5550,48,2971,10,48
"1036","2020-05-30",120,12,271,369,6670,0.192953523238381,0,0,574,1005,10,5560,55,3026,10,55
"1037","2020-05-31",105,12,307,359,6670,0.192953523238381,0,0,574,1005,21,5581,19,3045,11,19
"1038","2020-06-01",102,12,318,337,6670,0.192953523238381,0,0,574,1005,28,5609,27,3072,12,27
"1039","2020-06-02",102,12,317,317,6670,0.192953523238381,0,0,574,1005,19,5628,53,3125,10,53
"1040","2020-06-03",94,12,323,294,6670,0.192953523238381,0,0,574,1005,15,5643,35,3160,8,35
"1041","2020-06-04",83,12,319,284,6670,0.192953523238381,0,0,574,1005,14,5657,37,3197,7,37
"1042","2020-06-05",78,12,318,267,6670,0.192953523238381,0,0,574,1005,17,5674,49,3246,13,49
"1043","2020-06-06",71,12,313,260,6670,0.192953523238381,0,0,574,1005,17,5691,42,3288,5,42
"1044","2020-06-07",68,12,272,242,6670,0.192953523238381,0,0,574,1005,18,5709,24,3312,10,24
"1045","2020-03-12",1,13,64,35,2970,0.314814814814815,0,0,287,910,52,90,9,15,1,9
"1046","2020-03-13",2,13,88,52,2970,0.314814814814815,0,0,287,910,56,146,9,24,2,9
"1047","2020-03-14",4,13,81,76,2970,0.314814814814815,0,0,287,910,66,212,17,41,17,17
"1048","2020-03-15",6,13,111,108,2970,0.314814814814815,0,0,287,910,53,265,13,54,10,13
"1049","2020-03-16",12,13,136,134,2970,0.314814814814815,0,0,287,910,90,355,21,75,36,21
"1050","2020-03-17",17,13,141,164,2970,0.314814814814815,0,0,287,910,71,426,23,98,24,23
"1051","2020-03-18",23,13,164,206,2970,0.314814814814815,0,0,287,910,79,505,27,125,36,27
"1052","2020-03-19",35,13,176,243,2970,0.314814814814815,0,0,287,910,61,566,25,150,16,25
"1053","2020-03-20",43,13,194,267,2970,0.314814814814815,0,0,287,910,79,645,33,183,30,33
"1054","2020-03-21",47,13,220,286,2970,0.314814814814815,0,0,287,910,70,715,29,212,21,29
"1055","2020-03-22",55,13,218,314,2970,0.314814814814815,0,0,287,910,74,789,32,244,30,32
"1056","2020-03-23",58,13,228,341,2970,0.314814814814815,0,0,287,910,86,875,31,275,32,31
"1057","2020-03-24",61,13,261,355,2970,0.314814814814815,0,0,287,910,74,949,22,297,27,22
"1058","2020-03-25",69,13,234,369,2970,0.314814814814815,0,0,287,910,92,1041,14,311,38,14
"1059","2020-03-26",77,13,237,376,2970,0.314814814814815,0,0,287,910,80,1121,35,346,33,35
"1060","2020-03-27",83,13,234,384,2970,0.314814814814815,0,0,287,910,89,1210,43,389,43,43
"1061","2020-03-28",97,13,234,386,2970,0.314814814814815,0,0,287,910,80,1290,48,437,35,48
"1062","2020-03-29",105,13,218,390,2970,0.314814814814815,0,0,287,910,96,1386,57,494,44,57
"1063","2020-03-30",111,13,208,390,2970,0.314814814814815,0,0,287,910,65,1451,31,525,25,31
"1064","2020-03-31",115,13,197,398,2970,0.314814814814815,0,0,287,910,73,1524,39,564,33,39
"1065","2020-04-01",115,13,216,400,2970,0.314814814814815,0,0,287,910,76,1600,24,588,36,24
"1066","2020-04-02",112,13,232,408,2970,0.314814814814815,0,0,287,910,83,1683,48,636,26,48
"1067","2020-04-03",108,13,274,410,2970,0.314814814814815,0,0,287,910,78,1761,48,684,32,48
"1068","2020-04-04",106,13,312,416,2970,0.314814814814815,0,0,287,910,69,1830,25,709,15,25
"1069","2020-04-05",101,13,313,418,2970,0.314814814814815,0,0,287,910,68,1898,33,742,14,33
"1070","2020-04-06",102,13,284,431,2970,0.314814814814815,0,0,287,910,47,1945,23,765,15,23
"1071","2020-04-07",101,13,277,437,2970,0.314814814814815,0,0,287,910,78,2023,21,786,26,21
"1072","2020-04-08",105,13,249,419,2970,0.314814814814815,0,0,287,910,68,2091,45,831,24,45
"1073","2020-04-09",108,13,254,417,2970,0.314814814814815,0,0,287,910,82,2173,37,868,22,37
"1074","2020-04-10",114,13,234,402,2970,0.314814814814815,0,0,287,910,69,2242,20,888,15,20
"1075","2020-04-11",117,13,223,396,2970,0.314814814814815,0,0,287,910,78,2320,15,903,28,15
"1076","2020-04-12",121,13,244,406,2970,0.314814814814815,0,0,287,910,60,2380,11,914,20,11
"1077","2020-04-13",121,13,250,401,2970,0.314814814814815,0,0,287,910,75,2455,24,938,27,24
"1078","2020-04-14",127,13,239,400,2970,0.314814814814815,0,0,287,910,58,2513,50,988,13,50
"1079","2020-04-15",131,13,260,395,2970,0.314814814814815,0,0,287,910,59,2572,45,1033,9,45
"1080","2020-04-16",132,13,263,395,2970,0.314814814814815,0,0,287,910,64,2636,37,1070,17,37
"1081","2020-04-17",130,13,285,410,2970,0.314814814814815,0,0,287,910,83,2719,41,1111,25,41
"1082","2020-04-18",121,13,315,401,2970,0.314814814814815,0,0,287,910,69,2788,31,1142,21,31
"1083","2020-04-19",130,13,302,397,2970,0.314814814814815,0,0,287,910,65,2853,19,1161,18,19
"1084","2020-04-20",130,13,299,407,2970,0.314814814814815,0,0,287,910,64,2917,20,1181,22,20
"1085","2020-04-21",130,13,317,404,2970,0.314814814814815,0,0,287,910,87,3004,19,1200,30,19
"1086","2020-04-22",118,13,324,391,2970,0.314814814814815,0,0,287,910,69,3073,28,1228,16,28
"1087","2020-04-23",116,13,330,402,2970,0.314814814814815,0,0,287,910,61,3134,19,1247,16,19
"1088","2020-04-24",113,13,306,408,2970,0.314814814814815,0,0,287,910,72,3206,37,1284,14,37
"1089","2020-04-25",119,13,307,406,2970,0.314814814814815,0,0,287,910,56,3262,30,1314,11,30
"1090","2020-04-26",117,13,333,405,2970,0.314814814814815,0,0,287,910,67,3329,15,1329,18,15
"1091","2020-04-27",114,13,309,419,2970,0.314814814814815,0,0,287,910,64,3393,29,1358,11,29
"1092","2020-04-28",119,13,291,418,2970,0.314814814814815,0,0,287,910,48,3441,21,1379,17,21
"1093","2020-04-29",124,13,298,411,2970,0.314814814814815,0,0,287,910,56,3497,48,1427,13,48
"1094","2020-04-30",113,13,292,404,2970,0.314814814814815,0,0,287,910,63,3560,41,1468,17,41
"1095","2020-05-01",119,13,309,412,2970,0.314814814814815,0,0,287,910,53,3613,23,1491,9,23
"1096","2020-05-02",112,13,341,399,2970,0.314814814814815,0,0,287,910,64,3677,18,1509,16,18
"1097","2020-05-03",105,13,347,394,2970,0.314814814814815,0,0,287,910,69,3746,25,1534,20,25
"1098","2020-05-04",109,13,315,389,2970,0.314814814814815,0,0,287,910,52,3798,17,1551,15,17
"1099","2020-05-05",106,13,325,392,2970,0.314814814814815,0,0,287,910,65,3863,15,1566,21,15
"1100","2020-05-06",112,13,320,389,2970,0.314814814814815,0,0,287,910,55,3918,16,1582,14,16
"1101","2020-05-07",121,13,329,382,2970,0.314814814814815,0,0,287,910,50,3968,14,1596,16,14
"1102","2020-05-08",116,13,313,404,2970,0.314814814814815,0,0,287,910,46,4014,41,1637,12,41
"1103","2020-05-09",120,13,275,392,2970,0.314814814814815,0,0,287,910,64,4078,18,1655,15,18
"1104","2020-05-10",121,13,267,384,2970,0.314814814814815,0,0,287,910,40,4118,12,1667,7,12
"1105","2020-05-11",122,13,261,389,2970,0.314814814814815,0,0,287,910,42,4160,18,1685,10,18
"1106","2020-05-12",114,13,261,392,2970,0.314814814814815,0,0,287,910,43,4203,39,1724,6,39
"1107","2020-05-13",110,13,285,395,2970,0.314814814814815,0,0,287,910,61,4264,23,1747,15,23
"1108","2020-05-14",107,13,333,385,2970,0.314814814814815,0,0,287,910,43,4307,52,1799,11,52
"1109","2020-05-15",105,13,333,398,2970,0.314814814814815,0,0,287,910,37,4344,43,1842,8,43
"1110","2020-05-16",109,13,326,386,2970,0.314814814814815,0,0,287,910,36,4380,52,1894,12,52
"1111","2020-05-17",106,13,352,384,2970,0.314814814814815,0,0,287,910,50,4430,60,1954,12,60
"1112","2020-05-18",102,13,324,379,2970,0.314814814814815,0,0,287,910,37,4467,52,2006,11,52
"1113","2020-05-19",107,13,299,369,2970,0.314814814814815,0,0,287,910,33,4500,50,2056,8,50
"1114","2020-05-20",109,13,310,372,2970,0.314814814814815,0,0,287,910,32,4532,32,2088,4,32
"1115","2020-05-21",109,13,318,364,2970,0.314814814814815,0,0,287,910,30,4562,41,2129,5,41
"1116","2020-05-22",117,13,293,365,2970,0.314814814814815,0,0,287,910,24,4586,36,2165,7,36
"1117","2020-05-23",118,13,283,351,2970,0.314814814814815,0,0,287,910,31,4617,29,2194,1,29
"1118","2020-05-24",115,13,279,348,2970,0.314814814814815,0,0,287,910,36,4653,32,2226,5,32
"1119","2020-05-25",110,13,315,338,2970,0.314814814814815,0,0,287,910,45,4698,33,2259,12,33
"1120","2020-05-26",105,13,334,327,2970,0.314814814814815,0,0,287,910,31,4729,29,2288,6,29
"1121","2020-05-27",102,13,365,313,2970,0.314814814814815,0,0,287,910,33,4762,16,2304,10,16
"1122","2020-05-28",93,13,362,294,2970,0.314814814814815,0,0,287,910,35,4797,35,2339,9,35
"1123","2020-05-29",85,13,359,277,2970,0.314814814814815,0,0,287,910,15,4812,43,2382,3,43
"1124","2020-05-30",81,13,358,269,2970,0.314814814814815,0,0,287,910,29,4841,27,2409,7,27
"1125","2020-05-31",76,13,346,258,2970,0.314814814814815,0,0,287,910,30,4871,40,2449,3,40
"1126","2020-06-01",72,13,330,248,2970,0.314814814814815,0,0,287,910,33,4904,38,2487,4,38
"1127","2020-06-02",79,13,331,246,2970,0.314814814814815,0,0,287,910,15,4919,33,2520,3,33
"1128","2020-06-03",74,13,319,244,2970,0.314814814814815,0,0,287,910,11,4930,28,2548,2,28
"1129","2020-06-04",81,13,326,229,2970,0.314814814814815,0,0,287,910,15,4945,45,2593,6,45
"1130","2020-06-05",77,13,311,223,2970,0.314814814814815,0,0,287,910,16,4961,38,2631,4,38
"1131","2020-06-06",71,13,306,214,2970,0.314814814814815,0,0,287,910,13,4974,20,2651,4,20
"1132","2020-06-07",73,13,300,213,2970,0.314814814814815,0,0,287,910,20,4994,21,2672,2,21
"1133","2020-03-13",1,14,133,95,7290,0.808641975308642,0,0,635,1471,63,150,51,106,24,51
"1134","2020-03-14",7,14,171,135,7290,0.808641975308642,0,0,635,1471,103,253,25,131,61,25
"1135","2020-03-15",15,14,205,196,7290,0.808641975308642,0,0,635,1471,109,362,19,150,75,19
"1136","2020-03-16",16,14,221,259,7290,0.808641975308642,0,0,635,1471,150,512,9,159,114,9
"1137","2020-03-17",22,14,243,333,7290,0.808641975308642,0,0,635,1471,214,726,50,209,178,50
"1138","2020-03-18",33,14,239,427,7290,0.808641975308642,0,0,635,1471,232,958,70,279,199,70
"1139","2020-03-19",50,14,240,506,7290,0.808641975308642,0,0,635,1471,341,1299,48,327,299,48
"1140","2020-03-20",73,14,234,613,7290,0.808641975308642,0,0,635,1471,382,1681,23,350,354,23
"1141","2020-03-21",88,14,258,713,7290,0.808641975308642,0,0,635,1471,493,2174,21,371,471,21
"1142","2020-03-22",108,14,254,824,7290,0.808641975308642,0,0,635,1471,460,2634,20,391,429,20
"1143","2020-03-23",143,14,250,949,7290,0.808641975308642,0,0,635,1471,585,3219,24,415,559,24
"1144","2020-03-24",171,14,252,1085,7290,0.808641975308642,0,0,635,1471,619,3838,36,451,593,36
"1145","2020-03-25",207,14,247,1218,7290,0.808641975308642,0,0,635,1471,574,4412,46,497,547,46
"1146","2020-03-26",234,14,224,1319,7290,0.808641975308642,0,0,635,1471,536,4948,27,524,518,27
"1147","2020-03-27",268,14,213,1455,7290,0.808641975308642,0,0,635,1471,526,5474,22,546,512,22
"1148","2020-03-28",298,14,215,1552,7290,0.808641975308642,0,0,635,1471,357,5831,59,605,343,59
"1149","2020-03-29",332,14,223,1659,7290,0.808641975308642,0,0,635,1471,452,6283,28,633,440,28
"1150","2020-03-30",356,14,227,1778,7290,0.808641975308642,0,0,635,1471,296,6579,9,642,286,9
"1151","2020-03-31",403,14,239,1887,7290,0.808641975308642,0,0,635,1471,275,6854,13,655,262,13
"1152","2020-04-01",428,14,232,1937,7290,0.808641975308642,0,0,635,1471,166,7020,53,708,158,53
"1153","2020-04-02",450,14,229,2043,7290,0.808641975308642,0,0,635,1471,196,7216,46,754,190,46
"1154","2020-04-03",472,14,250,2089,7290,0.808641975308642,0,0,635,1471,133,7349,34,788,129,34
"1155","2020-04-04",496,14,254,2135,7290,0.808641975308642,0,0,635,1471,104,7453,41,829,100,41
"1156","2020-04-05",517,14,248,2181,7290,0.808641975308642,0,0,635,1471,59,7512,51,880,54,51
"1157","2020-04-06",548,14,223,2241,7290,0.808641975308642,0,0,635,1471,60,7572,26,906,58,26
"1158","2020-04-07",545,14,224,2243,7290,0.808641975308642,0,0,635,1471,24,7596,49,955,22,49
"1159","2020-04-08",563,14,234,2225,7290,0.808641975308642,0,0,635,1471,41,7637,28,983,33,28
"1160","2020-04-09",581,14,250,2176,7290,0.808641975308642,0,0,635,1471,27,7664,14,997,21,14
"1161","2020-04-10",595,14,256,2182,7290,0.808641975308642,0,0,635,1471,29,7693,22,1019,28,22
"1162","2020-04-11",626,14,236,2117,7290,0.808641975308642,0,0,635,1471,11,7704,16,1035,11,16
"1163","2020-04-12",619,14,216,2062,7290,0.808641975308642,0,0,635,1471,18,7722,10,1045,15,10
"1164","2020-04-13",613,14,214,1986,7290,0.808641975308642,0,0,635,1471,9,7731,12,1057,9,12
"1165","2020-04-14",613,14,201,1888,7290,0.808641975308642,0,0,635,1471,11,7742,11,1068,9,11
"1166","2020-04-15",596,14,197,1811,7290,0.808641975308642,0,0,635,1471,7,7749,15,1083,4,15
"1167","2020-04-16",590,14,243,1725,7290,0.808641975308642,0,0,635,1471,8,7757,41,1124,6,41
"1168","2020-04-17",569,14,226,1631,7290,0.808641975308642,0,0,635,1471,5,7762,22,1146,3,22
"1169","2020-04-18",530,14,235,1546,7290,0.808641975308642,0,0,635,1471,4,7766,8,1154,2,8
"1170","2020-04-19",518,14,224,1430,7290,0.808641975308642,0,0,635,1471,4,7770,8,1162,2,8
"1171","2020-04-20",497,14,233,1355,7290,0.808641975308642,0,0,635,1471,2,7772,8,1170,1,8
"1172","2020-04-21",463,14,251,1262,7290,0.808641975308642,0,0,635,1471,3,7775,9,1179,2,9
"1173","2020-04-22",446,14,254,1163,7290,0.808641975308642,0,0,635,1471,2,7777,5,1184,2,5
"1174","2020-04-23",419,14,252,1097,7290,0.808641975308642,0,0,635,1471,4,7781,8,1192,1,8
"1175","2020-04-24",397,14,237,1033,7290,0.808641975308642,0,0,635,1471,4,7785,36,1228,3,36
"1176","2020-04-25",371,14,217,980,7290,0.808641975308642,0,0,635,1471,4,7789,33,1261,NA,33
"1177","2020-04-26",333,14,209,895,7290,0.808641975308642,0,0,635,1471,NA,NA,16,1277,NA,16
"1178","2020-04-27",310,14,213,824,7290,0.808641975308642,0,0,635,1471,3,7792,14,1291,1,14
"1179","2020-04-28",299,14,207,750,7290,0.808641975308642,0,0,635,1471,1,7793,39,1330,NA,39
"1180","2020-04-29",278,14,232,688,7290,0.808641975308642,0,0,635,1471,4,7797,32,1362,1,32
"1181","2020-04-30",249,14,263,640,7290,0.808641975308642,0,0,635,1471,2,7799,54,1416,NA,54
"1182","2020-05-01",220,14,258,575,7290,0.808641975308642,0,0,635,1471,2,7801,24,1440,1,24
"1183","2020-05-02",198,14,231,534,7290,0.808641975308642,0,0,635,1471,2,7803,23,1463,2,23
"1184","2020-05-03",191,14,255,481,7290,0.808641975308642,0,0,635,1471,2,7805,18,1481,1,18
"1185","2020-05-04",165,14,300,458,7290,0.808641975308642,0,0,635,1471,2,7807,13,1494,1,13
"1186","2020-05-05",155,14,287,444,7290,0.808641975308642,0,0,635,1471,3,7810,30,1524,1,30
"1187","2020-05-06",138,14,275,423,7290,0.808641975308642,0,0,635,1471,1,7811,15,1539,NA,15
"1188","2020-05-07",131,14,256,384,7290,0.808641975308642,0,0,635,1471,2,7813,51,1590,1,51
"1189","2020-05-08",126,14,238,361,7290,0.808641975308642,0,0,635,1471,2,7815,38,1628,NA,38
"1190","2020-05-09",121,14,292,343,7290,0.808641975308642,0,0,635,1471,1,7816,17,1645,1,17
"1191","2020-05-10",121,14,302,335,7290,0.808641975308642,0,0,635,1471,2,7818,13,1658,NA,13
"1192","2020-05-11",120,14,278,322,7290,0.808641975308642,0,0,635,1471,4,7822,17,1675,3,17
"1193","2020-05-12",107,14,259,307,7290,0.808641975308642,0,0,635,1471,2,7824,10,1685,NA,10
"1194","2020-05-13",99,14,291,290,7290,0.808641975308642,0,0,635,1471,3,7827,12,1697,1,12
"1195","2020-05-14",93,14,289,271,7290,0.808641975308642,0,0,635,1471,2,7829,16,1713,NA,16
"1196","2020-05-15",90,14,288,256,7290,0.808641975308642,0,0,635,1471,2,7831,11,1724,NA,11
"1197","2020-05-16",84,14,271,245,7290,0.808641975308642,0,0,635,1471,1,7832,28,1752,NA,28
"1198","2020-05-17",73,14,257,228,7290,0.808641975308642,0,0,635,1471,1,7833,17,1769,NA,17
"1199","2020-05-18",70,14,236,207,7290,0.808641975308642,0,0,635,1471,1,7834,13,1782,NA,13
"1200","2020-05-19",68,14,233,196,7290,0.808641975308642,0,0,635,1471,1,7835,20,1802,NA,20
"1201","2020-05-20",72,14,217,194,7290,0.808641975308642,0,0,635,1471,1,7836,36,1838,NA,36
"1202","2020-05-21",70,14,215,187,7290,0.808641975308642,0,0,635,1471,1,7837,45,1883,NA,45
"1203","2020-05-22",63,14,218,182,7290,0.808641975308642,0,0,635,1471,3,7840,24,1907,1,24
"1204","2020-05-23",60,14,216,175,7290,0.808641975308642,0,0,635,1471,NA,NA,16,1923,NA,16
"1205","2020-05-24",58,14,257,158,7290,0.808641975308642,0,0,635,1471,1,7841,8,1931,NA,8
"1206","2020-05-25",54,14,253,151,7290,0.808641975308642,0,0,635,1471,3,7844,13,1944,2,13
"1207","2020-05-26",57,14,259,146,7290,0.808641975308642,0,0,635,1471,NA,NA,46,1990,NA,46
"1208","2020-05-27",47,14,264,147,7290,0.808641975308642,0,0,635,1471,1,7845,57,2047,NA,57
"1209","2020-05-28",47,14,265,149,7290,0.808641975308642,0,0,635,1471,1,7846,31,2078,NA,31
"1210","2020-05-29",48,14,282,134,7290,0.808641975308642,0,0,635,1471,1,7847,25,2103,NA,25
"1211","2020-05-30",48,14,324,130,7290,0.808641975308642,0,0,635,1471,2,7849,53,2156,NA,53
"1212","2020-05-31",45,14,301,117,7290,0.808641975308642,0,0,635,1471,NA,NA,35,2191,NA,35
"1213","2020-06-01",40,14,295,115,7290,0.808641975308642,0,0,635,1471,NA,NA,22,2213,NA,22
"1214","2020-06-02",36,14,272,119,7290,0.808641975308642,0,0,635,1471,3,7852,37,2250,2,37
"1215","2020-06-03",38,14,263,115,7290,0.808641975308642,0,0,635,1471,NA,NA,34,2284,NA,34
"1216","2020-06-04",35,14,245,112,7290,0.808641975308642,0,0,635,1471,NA,NA,31,2315,NA,31
"1217","2020-06-05",30,14,248,105,7290,0.808641975308642,0,0,635,1471,2,7854,39,2354,1,39
"1218","2020-06-06",28,14,252,94,7290,0.808641975308642,0,0,635,1471,1,7855,22,2376,NA,22
"1219","2020-06-07",26,14,223,91,7290,0.808641975308642,0,0,635,1471,NA,NA,58,2434,NA,58
"1220","2020-03-12",2,15,191,207,9535,0.740115364446775,0,0,755,1852,99,186,6,33,5,6
"1221","2020-03-13",2,15,219,346,9535,0.740115364446775,0,0,755,1852,102,288,7,40,7,7
"1222","2020-03-14",9,15,284,541,9535,0.740115364446775,0,0,755,1852,91,379,5,45,19,5
"1223","2020-03-15",23,15,327,797,9535,0.740115364446775,0,0,755,1852,97,476,21,66,21,21
"1224","2020-03-16",46,15,324,1135,9535,0.740115364446775,0,0,755,1852,99,575,31,97,23,31
"1225","2020-03-17",84,15,290,1533,9535,0.740115364446775,0,0,755,1852,101,676,17,114,29,17
"1226","2020-03-18",128,15,253,2030,9535,0.740115364446775,0,0,755,1852,113,789,27,141,28,27
"1227","2020-03-19",194,15,245,2574,9535,0.740115364446775,0,0,755,1852,144,933,25,166,52,25
"1228","2020-03-20",283,15,218,3189,9535,0.740115364446775,0,0,755,1852,113,1046,35,201,31,35
"1229","2020-03-21",409,15,201,3838,9535,0.740115364446775,0,0,755,1852,113,1159,50,251,34,50
"1230","2020-03-22",513,15,179,4378,9535,0.740115364446775,0,0,755,1852,108,1267,40,291,38,40
"1231","2020-03-23",676,15,219,4870,9535,0.740115364446775,0,0,755,1852,136,1403,15,306,46,15
"1232","2020-03-24",817,15,242,5276,9535,0.740115364446775,0,0,755,1852,131,1534,20,326,44,20
"1233","2020-03-25",1004,15,238,5481,9535,0.740115364446775,0,0,755,1852,149,1683,19,345,52,19
"1234","2020-03-26",1131,15,224,5603,9535,0.740115364446775,0,0,755,1852,136,1819,43,388,55,43
"1235","2020-03-27",1278,15,218,5515,9535,0.740115364446775,0,0,755,1852,124,1943,23,411,45,23
"1236","2020-03-28",1378,15,201,5354,9535,0.740115364446775,0,0,755,1852,116,2059,29,440,36,29
"1237","2020-03-29",1511,15,193,5052,9535,0.740115364446775,0,0,755,1852,115,2174,39,479,31,39
"1238","2020-03-30",1553,15,199,4647,9535,0.740115364446775,0,0,755,1852,117,2291,32,511,36,32
"1239","2020-03-31",1565,15,240,4251,9535,0.740115364446775,0,0,755,1852,111,2402,24,535,31,24
"1240","2020-04-01",1500,15,259,3809,9535,0.740115364446775,0,0,755,1852,126,2528,13,548,54,13
"1241","2020-04-02",1460,15,263,3390,9535,0.740115364446775,0,0,755,1852,105,2633,13,561,31,13
"1242","2020-04-03",1345,15,257,2936,9535,0.740115364446775,0,0,755,1852,118,2751,21,582,41,21
"1243","2020-04-04",1228,15,232,2525,9535,0.740115364446775,0,0,755,1852,107,2858,31,613,35,31
"1244","2020-04-05",1062,15,209,2106,9535,0.740115364446775,0,0,755,1852,95,2953,30,643,23,30
"1245","2020-04-06",907,15,207,1765,9535,0.740115364446775,0,0,755,1852,95,3048,44,687,30,44
"1246","2020-04-07",773,15,251,1477,9535,0.740115364446775,0,0,755,1852,108,3156,19,706,29,19
"1247","2020-04-08",650,15,262,1252,9535,0.740115364446775,0,0,755,1852,87,3243,17,723,19,17
"1248","2020-04-09",540,15,251,1035,9535,0.740115364446775,0,0,755,1852,94,3337,16,739,21,16
"1249","2020-04-10",459,15,244,857,9535,0.740115364446775,0,0,755,1852,98,3435,42,781,28,42
"1250","2020-04-11",375,15,216,724,9535,0.740115364446775,0,0,755,1852,70,3505,21,802,14,21
"1251","2020-04-12",309,15,195,616,9535,0.740115364446775,0,0,755,1852,99,3604,19,821,26,19
"1252","2020-04-13",252,15,212,536,9535,0.740115364446775,0,0,755,1852,93,3697,66,887,17,66
"1253","2020-04-14",209,15,241,454,9535,0.740115364446775,0,0,755,1852,108,3805,36,923,33,36
"1254","2020-04-15",176,15,276,389,9535,0.740115364446775,0,0,755,1852,93,3898,88,1011,17,88
"1255","2020-04-16",141,15,290,328,9535,0.740115364446775,0,0,755,1852,80,3978,42,1053,16,42
"1256","2020-04-17",103,15,280,282,9535,0.740115364446775,0,0,755,1852,80,4058,46,1099,17,46
"1257","2020-04-18",75,15,313,241,9535,0.740115364446775,0,0,755,1852,86,4144,35,1134,15,35
"1258","2020-04-19",63,15,356,200,9535,0.740115364446775,0,0,755,1852,96,4240,46,1180,29,46
"1259","2020-04-20",50,15,332,182,9535,0.740115364446775,0,0,755,1852,78,4318,30,1210,15,31
"1260","2020-04-21",41,15,297,155,9535,0.740115364446775,0,0,755,1852,82,4400,31,1241,8,31
"1261","2020-04-22",34,15,287,135,9535,0.740115364446775,0,0,755,1852,71,4471,24,1265,9,24
"1262","2020-04-23",27,15,268,127,9535,0.740115364446775,0,0,755,1852,102,4573,37,1302,19,37
"1263","2020-04-24",31,15,262,120,9535,0.740115364446775,0,0,755,1852,63,4636,46,1348,13,46
"1264","2020-04-25",30,15,249,104,9535,0.740115364446775,0,0,755,1852,86,4722,37,1385,19,37
"1265","2020-04-26",26,15,241,97,9535,0.740115364446775,0,0,755,1852,98,4820,45,1430,15,45
"1266","2020-04-27",26,15,215,92,9535,0.740115364446775,0,0,755,1852,83,4903,36,1466,21,36
"1267","2020-04-28",22,15,220,87,9535,0.740115364446775,0,0,755,1852,59,4962,16,1482,7,16
"1268","2020-04-29",22,15,225,78,9535,0.740115364446775,0,0,755,1852,62,5024,21,1503,9,21
"1269","2020-04-30",21,15,247,70,9535,0.740115364446775,0,0,755,1852,72,5096,6,1509,11,6
"1270","2020-05-01",15,15,235,68,9535,0.740115364446775,0,0,755,1852,58,5154,9,1518,14,9
"1271","2020-05-02",15,15,240,65,9535,0.740115364446775,0,0,755,1852,70,5224,10,1528,16,10
"1272","2020-05-03",16,15,215,64,9535,0.740115364446775,0,0,755,1852,66,5290,50,1578,15,50
"1273","2020-05-04",16,15,217,60,9535,0.740115364446775,0,0,755,1852,67,5357,21,1599,17,21
"1274","2020-05-05",16,15,240,55,9535,0.740115364446775,0,0,755,1852,58,5415,28,1627,11,28
"1275","2020-05-06",13,15,235,53,9535,0.740115364446775,0,0,755,1852,54,5469,16,1643,10,16
"1276","2020-05-07",11,15,237,55,9535,0.740115364446775,0,0,755,1852,48,5517,11,1654,7,11
"1277","2020-05-08",11,15,247,50,9535,0.740115364446775,0,0,755,1852,52,5569,19,1673,6,19
"1278","2020-05-09",10,15,284,50,9535,0.740115364446775,0,0,755,1852,55,5624,17,1690,12,17
"1279","2020-05-10",8,15,284,45,9535,0.740115364446775,0,0,755,1852,68,5692,26,1716,18,26
"1280","2020-05-11",7,15,269,42,9535,0.740115364446775,0,0,755,1852,48,5740,46,1762,7,46
"1281","2020-05-12",6,15,246,35,9535,0.740115364446775,0,0,755,1852,44,5784,34,1796,14,34
"1282","2020-05-13",6,15,224,38,9535,0.740115364446775,0,0,755,1852,42,5826,33,1829,6,33
"1283","2020-05-14",8,15,202,37,9535,0.740115364446775,0,0,755,1852,54,5880,47,1876,11,47
"1284","2020-05-15",8,15,207,33,9535,0.740115364446775,0,0,755,1852,33,5913,32,1908,7,32
"1285","2020-05-16",8,15,253,28,9535,0.740115364446775,0,0,755,1852,31,5944,26,1934,2,26
"1286","2020-05-17",7,15,255,26,9535,0.740115364446775,0,0,755,1852,28,5972,51,1985,3,51
"1287","2020-05-18",5,15,237,22,9535,0.740115364446775,0,0,755,1852,31,6003,35,2020,8,35
"1288","2020-05-19",5,15,245,19,9535,0.740115364446775,0,0,755,1852,38,6041,34,2054,8,34
"1289","2020-05-20",5,15,271,14,9535,0.740115364446775,0,0,755,1852,28,6069,26,2080,6,26
"1290","2020-05-21",3,15,270,11,9535,0.740115364446775,0,0,755,1852,35,6104,27,2107,7,27
"1291","2020-05-22",3,15,257,11,9535,0.740115364446775,0,0,755,1852,29,6133,44,2151,1,44
"1292","2020-05-23",1,15,237,10,9535,0.740115364446775,0,0,755,1852,29,6162,33,2184,3,33
"1293","2020-05-24",1,15,222,9,9535,0.740115364446775,0,0,755,1852,29,6191,50,2234,2,50
"1294","2020-05-25",3,15,215,9,9535,0.740115364446775,0,0,755,1852,24,6215,37,2271,6,37
"1295","2020-05-26",4,15,232,10,9535,0.740115364446775,0,0,755,1852,23,6238,19,2290,3,19
"1296","2020-05-27",4,15,237,10,9535,0.740115364446775,0,0,755,1852,17,6255,39,2329,2,39
"1297","2020-05-28",5,15,235,9,9535,0.740115364446775,0,0,755,1852,16,6271,24,2353,2,24
"1298","2020-05-29",7,15,212,10,9535,0.740115364446775,0,0,755,1852,19,6290,25,2378,3,25
"1299","2020-05-30",7,15,192,12,9535,0.740115364446775,0,0,755,1852,18,6308,21,2399,3,21
"1300","2020-05-31",6,15,189,12,9535,0.740115364446775,0,0,755,1852,16,6324,19,2418,5,19
"1301","2020-06-01",4,15,172,12,9535,0.740115364446775,0,0,755,1852,19,6343,31,2449,NA,31
"1302","2020-06-02",3,15,175,11,9535,0.740115364446775,0,0,755,1852,18,6361,16,2465,2,16
"1303","2020-06-03",3,15,184,12,9535,0.740115364446775,0,0,755,1852,13,6374,12,2477,2,12
"1304","2020-06-04",2,15,182,10,9535,0.740115364446775,0,0,755,1852,16,6390,12,2489,1,12
"1305","2020-03-14",5,16,168,125,4131,0.416364076494795,0,0,355,1515,80,258,16,87,16,16
"1306","2020-03-15",8,16,215,160,4131,0.416364076494795,0,0,355,1515,83,341,12,99,16,12
"1307","2020-03-16",13,16,235,195,4131,0.416364076494795,0,0,355,1515,80,421,20,119,25,20
"1308","2020-03-17",20,16,269,235,4131,0.416364076494795,0,0,355,1515,86,507,15,134,33,15
"1309","2020-03-18",28,16,280,260,4131,0.416364076494795,0,0,355,1515,77,584,58,192,29,58
"1310","2020-03-19",41,16,257,300,4131,0.416364076494795,0,0,355,1515,91,675,80,272,43,80
"1311","2020-03-20",55,16,224,338,4131,0.416364076494795,0,0,355,1515,104,779,79,351,27,79
"1312","2020-03-21",62,16,222,374,4131,0.416364076494795,0,0,355,1515,115,894,72,423,57,72
"1313","2020-03-22",74,16,206,407,4131,0.416364076494795,0,0,355,1515,107,1001,46,469,45,46
"1314","2020-03-23",82,16,202,428,4131,0.416364076494795,0,0,355,1515,81,1082,44,513,33,44
"1315","2020-03-24",94,16,201,461,4131,0.416364076494795,0,0,355,1515,91,1173,52,565,43,52
"1316","2020-03-25",103,16,190,475,4131,0.416364076494795,0,0,355,1515,129,1302,43,608,49,43
"1317","2020-03-26",107,16,215,514,4131,0.416364076494795,0,0,355,1515,114,1416,38,646,52,38
"1318","2020-03-27",115,16,222,515,4131,0.416364076494795,0,0,355,1515,129,1545,43,689,73,43
"1319","2020-03-28",125,16,240,550,4131,0.416364076494795,0,0,355,1515,95,1640,54,743,47,54
"1320","2020-03-29",135,16,241,567,4131,0.416364076494795,0,0,355,1515,107,1747,33,776,38,33
"1321","2020-03-30",143,16,225,577,4131,0.416364076494795,0,0,355,1515,103,1850,32,808,38,32
"1322","2020-03-31",153,16,217,599,4131,0.416364076494795,0,0,355,1515,113,1963,33,841,42,33
"1323","2020-04-01",155,16,234,593,4131,0.416364076494795,0,0,355,1515,117,2080,39,880,47,39
"1324","2020-04-02",157,16,249,607,4131,0.416364076494795,0,0,355,1515,92,2172,45,925,39,45
"1325","2020-04-03",159,16,256,616,4131,0.416364076494795,0,0,355,1515,117,2289,41,966,52,41
"1326","2020-04-04",159,16,243,600,4131,0.416364076494795,0,0,355,1515,100,2389,33,999,30,33
"1327","2020-04-05",158,16,225,616,4131,0.416364076494795,0,0,355,1515,106,2495,45,1044,36,45
"1328","2020-04-06",163,16,208,614,4131,0.416364076494795,0,0,355,1515,89,2584,33,1077,27,33
"1329","2020-04-07",159,16,221,623,4131,0.416364076494795,0,0,355,1515,75,2659,60,1137,32,60
"1330","2020-04-08",162,16,246,620,4131,0.416364076494795,0,0,355,1515,78,2737,27,1164,25,27
"1331","2020-04-09",167,16,246,618,4131,0.416364076494795,0,0,355,1515,92,2829,37,1201,26,37
"1332","2020-04-10",181,16,220,613,4131,0.416364076494795,0,0,355,1515,73,2902,37,1238,34,37
"1333","2020-04-11",181,16,227,628,4131,0.416364076494795,0,0,355,1515,93,2995,50,1288,29,50
"1334","2020-04-12",181,16,247,643,4131,0.416364076494795,0,0,355,1515,75,3070,45,1333,22,45
"1335","2020-04-13",180,16,231,652,4131,0.416364076494795,0,0,355,1515,76,3146,48,1381,29,48
"1336","2020-04-14",186,16,243,650,4131,0.416364076494795,0,0,355,1515,101,3247,43,1424,28,43
"1337","2020-04-15",193,16,236,654,4131,0.416364076494795,0,0,355,1515,70,3317,47,1471,24,47
"1338","2020-04-16",192,16,240,652,4131,0.416364076494795,0,0,355,1515,77,3394,38,1509,25,38
"1339","2020-04-17",181,16,233,658,4131,0.416364076494795,0,0,355,1515,65,3459,39,1548,17,39
"1340","2020-04-18",185,16,226,648,4131,0.416364076494795,0,0,355,1515,77,3536,49,1597,31,49
"1341","2020-04-19",192,16,243,644,4131,0.416364076494795,0,0,355,1515,77,3613,52,1649,21,52
"1342","2020-04-20",189,16,250,659,4131,0.416364076494795,0,0,355,1515,71,3684,28,1677,26,28
"1343","2020-04-21",179,16,240,670,4131,0.416364076494795,0,0,355,1515,101,3785,24,1701,29,24
"1344","2020-04-22",173,16,272,664,4131,0.416364076494795,0,0,355,1515,71,3856,29,1730,22,29
"1345","2020-04-23",175,16,283,662,4131,0.416364076494795,0,0,355,1515,70,3926,31,1761,24,31
"1346","2020-04-24",188,16,256,661,4131,0.416364076494795,0,0,355,1515,68,3994,33,1794,23,33
"1347","2020-04-25",185,16,250,670,4131,0.416364076494795,0,0,355,1515,84,4078,45,1839,18,45
"1348","2020-04-26",186,16,229,655,4131,0.416364076494795,0,0,355,1515,65,4143,22,1861,22,22
"1349","2020-04-27",182,16,227,660,4131,0.416364076494795,0,0,355,1515,62,4205,45,1906,21,45
"1350","2020-04-28",179,16,228,649,4131,0.416364076494795,0,0,355,1515,62,4267,29,1935,17,29
"1351","2020-04-29",187,16,249,649,4131,0.416364076494795,0,0,355,1515,52,4319,32,1967,11,32
"1352","2020-04-30",191,16,279,634,4131,0.416364076494795,0,0,355,1515,75,4394,22,1989,21,22
"1353","2020-05-01",174,16,302,636,4131,0.416364076494795,0,0,355,1515,66,4460,42,2031,24,42
"1354","2020-05-02",176,16,330,622,4131,0.416364076494795,0,0,355,1515,64,4524,29,2060,18,29
"1355","2020-05-03",167,16,332,610,4131,0.416364076494795,0,0,355,1515,40,4564,49,2109,17,49
"1356","2020-05-04",167,16,304,616,4131,0.416364076494795,0,0,355,1515,63,4627,55,2164,20,55
"1357","2020-05-05",170,16,310,592,4131,0.416364076494795,0,0,355,1515,50,4677,41,2205,10,41
"1358","2020-05-06",172,16,287,589,4131,0.416364076494795,0,0,355,1515,47,4724,39,2244,14,39
"1359","2020-05-07",166,16,280,576,4131,0.416364076494795,0,0,355,1515,50,4774,34,2278,13,34
"1360","2020-05-08",158,16,247,551,4131,0.416364076494795,0,0,355,1515,58,4832,31,2309,15,31
"1361","2020-05-09",160,16,229,523,4131,0.416364076494795,0,0,355,1515,59,4891,42,2351,10,42
"1362","2020-05-10",165,16,221,512,4131,0.416364076494795,0,0,355,1515,60,4951,28,2379,12,28
"1363","2020-05-11",177,16,219,515,4131,0.416364076494795,0,0,355,1515,38,4989,25,2404,10,25
"1364","2020-05-12",172,16,225,486,4131,0.416364076494795,0,0,355,1515,38,5027,35,2439,11,35
"1365","2020-05-13",158,16,219,455,4131,0.416364076494795,0,0,355,1515,46,5073,34,2473,11,34
"1366","2020-05-14",153,16,219,432,4131,0.416364076494795,0,0,355,1515,39,5112,31,2504,15,31
"1367","2020-05-15",161,16,257,426,4131,0.416364076494795,0,0,355,1515,55,5167,33,2537,15,33
"1368","2020-05-16",146,16,268,426,4131,0.416364076494795,0,0,355,1515,32,5199,26,2563,11,26
"1369","2020-05-17",137,16,257,409,4131,0.416364076494795,0,0,355,1515,49,5248,33,2596,18,33
"1370","2020-05-18",121,16,242,390,4131,0.416364076494795,0,0,355,1515,29,5277,36,2632,11,36
"1371","2020-05-19",118,16,223,378,4131,0.416364076494795,0,0,355,1515,47,5324,36,2668,12,36
"1372","2020-05-20",112,16,246,376,4131,0.416364076494795,0,0,355,1515,34,5358,47,2715,9,47
"1373","2020-05-21",110,16,240,368,4131,0.416364076494795,0,0,355,1515,30,5388,75,2790,6,75
"1374","2020-05-22",102,16,251,359,4131,0.416364076494795,0,0,355,1515,31,5419,61,2851,6,61
"1375","2020-05-23",106,16,260,348,4131,0.416364076494795,0,0,355,1515,33,5452,44,2895,9,44
"1376","2020-05-24",103,16,250,347,4131,0.416364076494795,0,0,355,1515,30,5482,33,2928,6,33
"1377","2020-05-25",103,16,247,336,4131,0.416364076494795,0,0,355,1515,34,5516,33,2961,11,33
"1378","2020-05-26",103,16,257,338,4131,0.416364076494795,0,0,355,1515,35,5551,27,2988,13,27
"1379","2020-05-27",112,16,271,332,4131,0.416364076494795,0,0,355,1515,23,5574,36,3024,9,36
"1380","2020-05-28",109,16,263,334,4131,0.416364076494795,0,0,355,1515,28,5602,30,3054,9,30
"1381","2020-05-29",102,16,276,318,4131,0.416364076494795,0,0,355,1515,17,5619,25,3079,2,25
"1382","2020-05-30",99,16,271,303,4131,0.416364076494795,0,0,355,1515,19,5638,37,3116,5,37
"1383","2020-05-31",100,16,258,292,4131,0.416364076494795,0,0,355,1515,32,5670,51,3167,11,51
"1384","2020-06-01",92,16,245,294,4131,0.416364076494795,0,0,355,1515,25,5695,51,3218,7,51
"1385","2020-06-02",95,16,240,280,4131,0.416364076494795,0,0,355,1515,26,5721,31,3249,5,31
"1386","2020-06-03",85,16,214,273,4131,0.416364076494795,0,0,355,1515,22,5743,52,3301,7,52
"1387","2020-06-04",84,16,213,274,4131,0.416364076494795,0,0,355,1515,8,5751,44,3345,3,44
"1388","2020-06-05",84,16,197,265,4131,0.416364076494795,0,0,355,1515,19,5770,32,3377,5,32
"1389","2020-06-06",75,16,187,251,4131,0.416364076494795,0,0,355,1515,18,5788,40,3417,4,40
"1390","2020-06-07",75,16,171,237,4131,0.416364076494795,0,0,355,1515,14,5802,37,3454,2,37
"1391","2020-03-12",2,17,85,86,5245,0.190085795996187,0,0,429,1482,27,42,22,61,12,22
"1392","2020-03-13",5,17,146,131,5245,0.190085795996187,0,0,429,1482,25,67,15,76,16,15
"1393","2020-03-14",8,17,191,180,5245,0.190085795996187,0,0,429,1482,29,96,12,88,20,12
"1394","2020-03-15",10,17,190,233,5245,0.190085795996187,0,0,429,1482,40,136,11,99,28,11
"1395","2020-03-16",16,17,178,289,5245,0.190085795996187,0,0,429,1482,52,188,53,152,41,53
"1396","2020-03-17",27,17,165,348,5245,0.190085795996187,0,0,429,1482,75,263,54,206,68,54
"1397","2020-03-18",41,17,178,392,5245,0.190085795996187,0,0,429,1482,88,351,47,253,78,47
"1398","2020-03-19",53,17,199,440,5245,0.190085795996187,0,0,429,1482,107,458,21,274,98,21
"1399","2020-03-20",71,17,241,502,5245,0.190085795996187,0,0,429,1482,114,572,30,304,109,30
"1400","2020-03-21",93,17,244,533,5245,0.190085795996187,0,0,429,1482,175,747,15,319,162,15
"1401","2020-03-22",113,17,260,572,5245,0.190085795996187,0,0,429,1482,190,937,17,336,185,17
"1402","2020-03-23",128,17,247,607,5245,0.190085795996187,0,0,429,1482,247,1184,20,356,234,20
"1403","2020-03-24",140,17,208,627,5245,0.190085795996187,0,0,429,1482,238,1422,65,421,228,65
"1404","2020-03-25",140,17,187,659,5245,0.190085795996187,0,0,429,1482,287,1709,35,456,279,35
"1405","2020-03-26",153,17,166,676,5245,0.190085795996187,0,0,429,1482,364,2073,57,513,344,57
"1406","2020-03-27",157,17,162,691,5245,0.190085795996187,0,0,429,1482,413,2486,37,550,399,37
"1407","2020-03-28",161,17,157,693,5245,0.190085795996187,0,0,429,1482,452,2938,30,580,445,30
"1408","2020-03-29",175,17,163,702,5245,0.190085795996187,0,0,429,1482,443,3381,18,598,436,18
"1409","2020-03-30",184,17,186,709,5245,0.190085795996187,0,0,429,1482,433,3814,36,634,428,36
"1410","2020-03-31",195,17,171,736,5245,0.190085795996187,0,0,429,1482,502,4316,21,655,499,21
"1411","2020-04-01",211,17,167,738,5245,0.190085795996187,0,0,429,1482,410,4726,21,676,404,21
"1412","2020-04-02",215,17,185,748,5245,0.190085795996187,0,0,429,1482,371,5097,56,732,365,56
"1413","2020-04-03",217,17,176,762,5245,0.190085795996187,0,0,429,1482,375,5472,65,797,367,65
"1414","2020-04-04",223,17,163,778,5245,0.190085795996187,0,0,429,1482,307,5779,35,832,304,35
"1415","2020-04-05",217,17,159,789,5245,0.190085795996187,0,0,429,1482,302,6081,24,856,294,24
"1416","2020-04-06",217,17,167,820,5245,0.190085795996187,0,0,429,1482,236,6317,26,882,236,26
"1417","2020-04-07",219,17,228,845,5245,0.190085795996187,0,0,429,1482,178,6495,13,895,174,13
"1418","2020-04-08",215,17,235,832,5245,0.190085795996187,0,0,429,1482,154,6649,11,906,150,11
"1419","2020-04-09",225,17,222,839,5245,0.190085795996187,0,0,429,1482,141,6790,18,924,141,18
"1420","2020-04-10",239,17,204,856,5245,0.190085795996187,0,0,429,1482,115,6905,14,938,110,14
"1421","2020-04-11",243,17,188,852,5245,0.190085795996187,0,0,429,1482,107,7012,8,946,103,8
"1422","2020-04-12",249,17,196,887,5245,0.190085795996187,0,0,429,1482,90,7102,10,956,88,10
"1423","2020-04-13",247,17,239,874,5245,0.190085795996187,0,0,429,1482,65,7167,11,967,64,11
"1424","2020-04-14",259,17,249,882,5245,0.190085795996187,0,0,429,1482,44,7211,21,988,43,21
"1425","2020-04-15",256,17,220,863,5245,0.190085795996187,0,0,429,1482,36,7247,34,1022,35,34
"1426","2020-04-16",245,17,277,867,5245,0.190085795996187,0,0,429,1482,29,7276,25,1047,28,25
"1427","2020-04-17",241,17,252,860,5245,0.190085795996187,0,0,429,1482,18,7294,26,1073,17,26
"1428","2020-04-18",235,17,233,846,5245,0.190085795996187,0,0,429,1482,21,7315,61,1134,19,61
"1429","2020-04-19",225,17,251,836,5245,0.190085795996187,0,0,429,1482,25,7340,47,1181,24,47
"1430","2020-04-20",228,17,234,843,5245,0.190085795996187,0,0,429,1482,14,7354,31,1212,14,31
"1431","2020-04-21",209,17,290,830,5245,0.190085795996187,0,0,429,1482,11,7365,18,1230,9,18
"1432","2020-04-22",219,17,278,813,5245,0.190085795996187,0,0,429,1482,9,7374,26,1256,8,26
"1433","2020-04-23",221,17,273,789,5245,0.190085795996187,0,0,429,1482,11,7385,78,1334,10,78
"1434","2020-04-24",204,17,303,771,5245,0.190085795996187,0,0,429,1482,10,7395,40,1374,9,40
"1435","2020-04-25",192,17,277,751,5245,0.190085795996187,0,0,429,1482,7,7402,36,1410,7,36
"1436","2020-04-26",197,17,256,728,5245,0.190085795996187,0,0,429,1482,8,7410,19,1429,8,19
"1437","2020-04-27",197,17,234,723,5245,0.190085795996187,0,0,429,1482,4,7414,13,1442,2,13
"1438","2020-04-28",201,17,243,705,5245,0.190085795996187,0,0,429,1482,9,7423,8,1450,7,8
"1439","2020-04-29",199,17,216,689,5245,0.190085795996187,0,0,429,1482,2,7425,16,1466,1,16
"1440","2020-04-30",191,17,214,672,5245,0.190085795996187,0,0,429,1482,7,7432,12,1478,2,12
"1441","2020-05-01",198,17,231,660,5245,0.190085795996187,0,0,429,1482,3,7435,9,1487,2,9
"1442","2020-05-02",201,17,225,676,5245,0.190085795996187,0,0,429,1482,7,7442,12,1499,6,12
"1443","2020-05-03",192,17,260,681,5245,0.190085795996187,0,0,429,1482,2,7444,41,1540,1,41
"1444","2020-05-04",190,17,280,670,5245,0.190085795996187,0,0,429,1482,2,7446,29,1569,1,29
"1445","2020-05-05",180,17,270,674,5245,0.190085795996187,0,0,429,1482,5,7451,23,1592,1,23
"1446","2020-05-06",182,17,233,664,5245,0.190085795996187,0,0,429,1482,3,7454,14,1606,3,14
"1447","2020-05-07",186,17,224,664,5245,0.190085795996187,0,0,429,1482,4,7458,16,1622,2,16
"1448","2020-05-08",180,17,204,665,5245,0.190085795996187,0,0,429,1482,NA,NA,22,1644,NA,22
"1449","2020-05-09",183,17,209,657,5245,0.190085795996187,0,0,429,1482,1,7459,5,1649,1,5
"1450","2020-05-10",183,17,205,624,5245,0.190085795996187,0,0,429,1482,1,7460,11,1660,1,11
"1451","2020-05-11",181,17,185,612,5245,0.190085795996187,0,0,429,1482,1,7461,15,1675,NA,15
"1452","2020-05-12",181,17,176,605,5245,0.190085795996187,0,0,429,1482,3,7464,10,1685,2,10
"1453","2020-05-13",171,17,167,582,5245,0.190085795996187,0,0,429,1482,NA,NA,18,1703,NA,18
"1454","2020-05-14",173,17,160,558,5245,0.190085795996187,0,0,429,1482,4,7468,13,1716,4,13
"1455","2020-05-15",178,17,140,557,5245,0.190085795996187,0,0,429,1482,1,7469,29,1745,1,29
"1456","2020-05-16",175,17,148,548,5245,0.190085795996187,0,0,429,1482,4,7473,68,1813,4,68
"1457","2020-05-17",163,17,178,542,5245,0.190085795996187,0,0,429,1482,NA,NA,75,1888,NA,75
"1458","2020-05-18",153,17,186,532,5245,0.190085795996187,0,0,429,1482,3,7476,51,1939,3,51
"1459","2020-05-19",152,17,194,538,5245,0.190085795996187,0,0,429,1482,1,7477,33,1972,NA,33
"1460","2020-05-20",154,17,206,517,5245,0.190085795996187,0,0,429,1482,4,7481,31,2003,4,31
"1461","2020-05-21",143,17,192,495,5245,0.190085795996187,0,0,429,1482,3,7484,26,2029,2,26
"1462","2020-05-22",140,17,176,470,5245,0.190085795996187,0,0,429,1482,2,7486,9,2038,NA,9
"1463","2020-05-23",137,17,194,453,5245,0.190085795996187,0,0,429,1482,3,7489,57,2095,3,57
"1464","2020-05-24",143,17,222,447,5245,0.190085795996187,0,0,429,1482,2,7491,18,2113,2,18
"1465","2020-05-25",141,17,217,421,5245,0.190085795996187,0,0,429,1482,2,7493,27,2140,1,27
"1466","2020-05-26",138,17,230,401,5245,0.190085795996187,0,0,429,1482,1,7494,20,2160,NA,20
"1467","2020-05-27",127,17,225,392,5245,0.190085795996187,0,0,429,1482,1,7495,14,2174,1,14
"1468","2020-05-28",134,17,236,373,5245,0.190085795996187,0,0,429,1482,NA,NA,19,2193,NA,19
"1469","2020-05-29",129,17,260,358,5245,0.190085795996187,0,0,429,1482,1,7496,17,2210,1,17
"1470","2020-05-30",123,17,238,341,5245,0.190085795996187,0,0,429,1482,2,7498,10,2220,2,10
"1471","2020-05-31",119,17,210,331,5245,0.190085795996187,0,0,429,1482,1,7499,15,2235,1,15
"1472","2020-06-01",121,17,182,315,5245,0.190085795996187,0,0,429,1482,2,7501,44,2279,1,44
"1473","2020-06-02",107,17,164,298,5245,0.190085795996187,0,0,429,1482,NA,NA,40,2319,NA,40
"1474","2020-06-03",104,17,152,283,5245,0.190085795996187,0,0,429,1482,2,7503,28,2347,2,28
"1475","2020-06-04",94,17,151,280,5245,0.190085795996187,0,0,429,1482,NA,NA,15,2362,NA,15
"1476","2020-06-05",89,17,163,260,5245,0.190085795996187,0,0,429,1482,2,7505,27,2389,1,27
"1477","2020-06-06",83,17,163,245,5245,0.190085795996187,0,0,429,1482,3,7508,9,2398,NA,9
"1478","2020-06-07",81,17,161,242,5245,0.190085795996187,0,0,429,1482,NA,NA,13,2411,NA,13
"1479","2020-03-13",1,18,197,95,4292,0.468546132339236,0,0,408,1610,18,54,40,123,7,40
"1480","2020-03-14",2,18,232,129,4292,0.468546132339236,0,0,408,1610,21,75,22,145,5,22
"1481","2020-03-15",8,18,232,165,4292,0.468546132339236,0,0,408,1610,14,89,15,160,6,15
"1482","2020-03-16",11,18,207,199,4292,0.468546132339236,0,0,408,1610,27,116,8,168,11,8
"1483","2020-03-17",25,18,218,248,4292,0.468546132339236,0,0,408,1610,24,140,10,178,6,10
"1484","2020-03-18",39,18,253,305,4292,0.468546132339236,0,0,408,1610,24,164,8,186,6,8
"1485","2020-03-19",48,18,237,348,4292,0.468546132339236,0,0,408,1610,23,187,40,226,8,40
"1486","2020-03-20",59,18,200,386,4292,0.468546132339236,0,0,408,1610,15,202,25,251,7,25
"1487","2020-03-21",75,18,171,433,4292,0.468546132339236,0,0,408,1610,25,227,19,270,6,19
"1488","2020-03-22",86,18,154,481,4292,0.468546132339236,0,0,408,1610,23,250,20,290,11,20
"1489","2020-03-23",98,18,213,509,4292,0.468546132339236,0,0,408,1610,25,275,39,329,12,39
"1490","2020-03-24",107,18,228,531,4292,0.468546132339236,0,0,408,1610,38,313,20,349,19,20
"1491","2020-03-25",116,18,217,548,4292,0.468546132339236,0,0,408,1610,32,345,47,396,13,47
"1492","2020-03-26",136,18,267,572,4292,0.468546132339236,0,0,408,1610,33,378,24,420,19,24
"1493","2020-03-27",154,18,245,576,4292,0.468546132339236,0,0,408,1610,30,408,14,434,14,14
"1494","2020-03-28",159,18,208,585,4292,0.468546132339236,0,0,408,1610,33,441,13,447,16,13
"1495","2020-03-29",169,18,176,599,4292,0.468546132339236,0,0,408,1610,29,470,13,460,13,13
"1496","2020-03-30",173,18,170,603,4292,0.468546132339236,0,0,408,1610,38,508,11,471,26,11
"1497","2020-03-31",179,18,158,619,4292,0.468546132339236,0,0,408,1610,30,538,42,513,23,42
"1498","2020-04-01",179,18,144,609,4292,0.468546132339236,0,0,408,1610,29,567,32,545,19,32
"1499","2020-04-02",169,18,131,619,4292,0.468546132339236,0,0,408,1610,38,605,21,566,18,21
"1500","2020-04-03",153,18,146,629,4292,0.468546132339236,0,0,408,1610,32,637,18,584,10,18
"1501","2020-04-04",147,18,134,648,4292,0.468546132339236,0,0,408,1610,39,676,45,629,17,45
"1502","2020-04-05",153,18,132,665,4292,0.468546132339236,0,0,408,1610,38,714,35,664,22,35
"1503","2020-04-06",163,18,142,677,4292,0.468546132339236,0,0,408,1610,38,752,28,692,17,28
"1504","2020-04-07",165,18,209,686,4292,0.468546132339236,0,0,408,1610,22,774,17,709,11,17
"1505","2020-04-08",172,18,269,698,4292,0.468546132339236,0,0,408,1610,35,809,35,744,19,35
"1506","2020-04-09",187,18,264,713,4292,0.468546132339236,0,0,408,1610,36,845,21,765,13,21
"1507","2020-04-10",208,18,256,730,4292,0.468546132339236,0,0,408,1610,28,873,34,799,11,34
"1508","2020-04-11",221,18,229,724,4292,0.468546132339236,0,0,408,1610,31,904,36,835,13,36
"1509","2020-04-12",216,18,265,731,4292,0.468546132339236,0,0,408,1610,28,932,24,859,13,24
"1510","2020-04-13",212,18,269,730,4292,0.468546132339236,0,0,408,1610,26,958,30,889,17,30
"1511","2020-04-14",216,18,313,739,4292,0.468546132339236,0,0,408,1610,26,984,15,904,8,15
"1512","2020-04-15",214,18,312,742,4292,0.468546132339236,0,0,408,1610,32,1016,19,923,17,19
"1513","2020-04-16",207,18,266,721,4292,0.468546132339236,0,0,408,1610,28,1044,9,932,10,9
"1514","2020-04-17",208,18,279,704,4292,0.468546132339236,0,0,408,1610,43,1087,15,947,17,15
"1515","2020-04-18",213,18,284,668,4292,0.468546132339236,0,0,408,1610,39,1126,50,997,15,50
"1516","2020-04-19",206,18,279,643,4292,0.468546132339236,0,0,408,1610,44,1170,32,1029,20,32
"1517","2020-04-20",199,18,258,629,4292,0.468546132339236,0,0,408,1610,32,1202,22,1051,10,22
"1518","2020-04-21",184,18,238,635,4292,0.468546132339236,0,0,408,1610,42,1244,12,1063,16,12
"1519","2020-04-22",177,18,233,622,4292,0.468546132339236,0,0,408,1610,42,1286,19,1082,16,19
"1520","2020-04-23",167,18,209,608,4292,0.468546132339236,0,0,408,1610,34,1320,22,1104,13,22
"1521","2020-04-24",159,18,195,623,4292,0.468546132339236,0,0,408,1610,43,1363,24,1128,21,24
"1522","2020-04-25",148,18,199,616,4292,0.468546132339236,0,0,408,1610,47,1410,32,1160,19,32
"1523","2020-04-26",156,18,220,613,4292,0.468546132339236,0,0,408,1610,45,1455,28,1188,21,28
"1524","2020-04-27",170,18,235,603,4292,0.468546132339236,0,0,408,1610,31,1486,12,1200,18,12
"1525","2020-04-28",173,18,252,603,4292,0.468546132339236,0,0,408,1610,43,1529,5,1205,20,5
"1526","2020-04-29",178,18,238,605,4292,0.468546132339236,0,0,408,1610,40,1569,33,1238,15,33
"1527","2020-04-30",186,18,214,573,4292,0.468546132339236,0,0,408,1610,41,1610,17,1255,22,17
"1528","2020-05-01",181,18,231,571,4292,0.468546132339236,0,0,408,1610,41,1651,27,1282,19,27
"1529","2020-05-02",174,18,217,556,4292,0.468546132339236,0,0,408,1610,36,1687,20,1302,17,20
"1530","2020-05-03",164,18,246,548,4292,0.468546132339236,0,0,408,1610,33,1720,9,1311,16,9
"1531","2020-05-04",166,18,235,535,4292,0.468546132339236,0,0,408,1610,46,1766,19,1330,22,19
"1532","2020-05-05",167,18,228,536,4292,0.468546132339236,0,0,408,1610,35,1801,23,1353,14,23
"1533","2020-05-06",163,18,209,524,4292,0.468546132339236,0,0,408,1610,30,1831,23,1376,10,23
"1534","2020-05-07",153,18,203,542,4292,0.468546132339236,0,0,408,1610,36,1867,13,1389,16,13
"1535","2020-05-08",154,18,187,529,4292,0.468546132339236,0,0,408,1610,36,1903,14,1403,16,14
"1536","2020-05-09",156,18,156,550,4292,0.468546132339236,0,0,408,1610,39,1942,6,1409,26,6
"1537","2020-05-10",157,18,167,515,4292,0.468546132339236,0,0,408,1610,36,1978,14,1423,15,14
"1538","2020-05-11",145,18,173,503,4292,0.468546132339236,0,0,408,1610,33,2011,9,1432,18,9
"1539","2020-05-12",141,18,169,503,4292,0.468546132339236,0,0,408,1610,29,2040,7,1439,17,7
"1540","2020-05-13",140,18,181,510,4292,0.468546132339236,0,0,408,1610,29,2069,9,1448,17,9
"1541","2020-05-14",147,18,238,512,4292,0.468546132339236,0,0,408,1610,23,2092,8,1456,10,8
"1542","2020-05-15",141,18,279,510,4292,0.468546132339236,0,0,408,1610,35,2127,6,1462,27,6
"1543","2020-05-16",153,18,253,484,4292,0.468546132339236,0,0,408,1610,20,2147,9,1471,14,9
"1544","2020-05-17",163,18,235,475,4292,0.468546132339236,0,0,408,1610,30,2177,13,1484,19,13
"1545","2020-05-18",152,18,215,463,4292,0.468546132339236,0,0,408,1610,38,2215,14,1498,20,14
"1546","2020-05-19",153,18,225,453,4292,0.468546132339236,0,0,408,1610,30,2245,44,1542,18,44
"1547","2020-05-20",151,18,249,450,4292,0.468546132339236,0,0,408,1610,25,2270,26,1568,13,26
"1548","2020-05-21",145,18,255,448,4292,0.468546132339236,0,0,408,1610,16,2286,24,1592,6,24
"1549","2020-05-22",145,18,249,422,4292,0.468546132339236,0,0,408,1610,27,2313,36,1628,16,36
"1550","2020-05-23",135,18,218,404,4292,0.468546132339236,0,0,408,1610,26,2339,30,1658,13,30
"1551","2020-05-24",110,18,210,410,4292,0.468546132339236,0,0,408,1610,21,2360,43,1701,10,43
"1552","2020-05-25",108,18,180,398,4292,0.468546132339236,0,0,408,1610,27,2387,16,1717,18,16
"1553","2020-05-26",106,18,196,376,4292,0.468546132339236,0,0,408,1610,22,2409,39,1756,11,39
"1554","2020-05-27",100,18,189,357,4292,0.468546132339236,0,0,408,1610,34,2443,48,1804,14,48
"1555","2020-05-28",95,18,221,348,4292,0.468546132339236,0,0,408,1610,18,2461,24,1828,10,24
"1556","2020-05-29",90,18,212,341,4292,0.468546132339236,0,0,408,1610,17,2478,17,1845,11,17
"1557","2020-05-30",84,18,196,322,4292,0.468546132339236,0,0,408,1610,15,2493,37,1882,9,37
"1558","2020-05-31",92,18,184,304,4292,0.468546132339236,0,0,408,1610,22,2515,42,1924,13,42
"1559","2020-06-01",94,18,171,289,4292,0.468546132339236,0,0,408,1610,20,2535,41,1965,12,41
"1560","2020-06-02",86,18,156,275,4292,0.468546132339236,0,0,408,1610,13,2548,21,1986,7,21
"1561","2020-06-03",85,18,125,262,4292,0.468546132339236,0,0,408,1610,23,2571,48,2034,16,48
"1562","2020-06-04",79,18,123,252,4292,0.468546132339236,0,0,408,1610,20,2591,25,2059,5,25
"1563","2020-06-05",74,18,122,243,4292,0.468546132339236,0,0,408,1610,17,2608,20,2079,9,20
"1564","2020-06-06",68,18,119,234,4292,0.468546132339236,0,0,408,1610,20,2628,9,2088,10,9
"1565","2020-06-07",67,18,127,234,4292,0.468546132339236,0,0,408,1610,18,2646,7,2095,10,7
"1566","2020-03-12",1,19,89,115,5235,0.169436485195798,0,0,446,987,54,119,12,34,4,12
"1567","2020-03-13",3,19,128,170,5235,0.169436485195798,0,0,446,987,80,199,24,58,8,24
"1568","2020-03-14",10,19,181,218,5235,0.169436485195798,0,0,446,987,80,279,40,98,23,40
"1569","2020-03-15",16,19,213,273,5235,0.169436485195798,0,0,446,987,85,364,28,126,27,28
"1570","2020-03-16",28,19,220,330,5235,0.169436485195798,0,0,446,987,85,449,42,168,37,42
"1571","2020-03-17",43,19,244,386,5235,0.169436485195798,0,0,446,987,82,531,38,206,30,38
"1572","2020-03-18",63,19,238,426,5235,0.169436485195798,0,0,446,987,98,629,36,242,48,36
"1573","2020-03-19",77,19,240,463,5235,0.169436485195798,0,0,446,987,78,707,65,307,30,65
"1574","2020-03-20",102,19,234,497,5235,0.169436485195798,0,0,446,987,72,779,27,334,21,27
"1575","2020-03-21",121,19,258,536,5235,0.169436485195798,0,0,446,987,82,861,18,352,22,18
"1576","2020-03-22",135,19,241,585,5235,0.169436485195798,0,0,446,987,87,948,12,364,32,12
"1577","2020-03-23",143,19,220,607,5235,0.169436485195798,0,0,446,987,73,1021,11,375,20,11
"1578","2020-03-24",151,19,228,618,5235,0.169436485195798,0,0,446,987,66,1087,12,387,24,12
"1579","2020-03-25",158,19,226,637,5235,0.169436485195798,0,0,446,987,89,1176,7,394,29,7
"1580","2020-03-26",180,19,216,674,5235,0.169436485195798,0,0,446,987,72,1248,23,417,30,23
"1581","2020-03-27",173,19,217,685,5235,0.169436485195798,0,0,446,987,86,1334,10,427,32,10
"1582","2020-03-28",168,19,182,695,5235,0.169436485195798,0,0,446,987,87,1421,15,442,27,15
"1583","2020-03-29",169,19,166,710,5235,0.169436485195798,0,0,446,987,98,1519,15,457,43,15
"1584","2020-03-30",179,19,167,710,5235,0.169436485195798,0,0,446,987,72,1591,20,477,30,20
"1585","2020-03-31",183,19,204,721,5235,0.169436485195798,0,0,446,987,106,1697,19,496,40,19
"1586","2020-04-01",190,19,201,717,5235,0.169436485195798,0,0,446,987,97,1794,68,564,52,68
"1587","2020-04-02",179,19,180,725,5235,0.169436485195798,0,0,446,987,83,1877,34,598,33,34
"1588","2020-04-03",191,19,164,735,5235,0.169436485195798,0,0,446,987,88,1965,26,624,27,26
"1589","2020-04-04",191,19,163,745,5235,0.169436485195798,0,0,446,987,79,2044,26,650,22,26
"1590","2020-04-05",204,19,191,750,5235,0.169436485195798,0,0,446,987,73,2117,8,658,16,8
"1591","2020-04-06",197,19,186,770,5235,0.169436485195798,0,0,446,987,86,2203,8,666,32,8
"1592","2020-04-07",194,19,188,772,5235,0.169436485195798,0,0,446,987,85,2288,12,678,31,12
"1593","2020-04-08",190,19,204,767,5235,0.169436485195798,0,0,446,987,108,2396,25,703,43,25
"1594","2020-04-09",193,19,230,762,5235,0.169436485195798,0,0,446,987,90,2486,12,715,32,12
"1595","2020-04-10",192,19,209,762,5235,0.169436485195798,0,0,446,987,96,2582,4,719,44,4
"1596","2020-04-11",194,19,217,756,5235,0.169436485195798,0,0,446,987,87,2669,21,740,26,21
"1597","2020-04-12",186,19,239,771,5235,0.169436485195798,0,0,446,987,94,2763,68,808,39,68
"1598","2020-04-13",195,19,221,768,5235,0.169436485195798,0,0,446,987,93,2856,45,853,27,45
"1599","2020-04-14",204,19,200,754,5235,0.169436485195798,0,0,446,987,102,2958,42,895,31,42
"1600","2020-04-15",203,19,194,750,5235,0.169436485195798,0,0,446,987,79,3037,38,933,27,38
"1601","2020-04-16",206,19,214,769,5235,0.169436485195798,0,0,446,987,118,3155,61,994,37,61
"1602","2020-04-17",208,19,237,782,5235,0.169436485195798,0,0,446,987,79,3234,44,1038,32,44
"1603","2020-04-18",210,19,233,779,5235,0.169436485195798,0,0,446,987,74,3308,48,1086,18,48
"1604","2020-04-19",217,19,252,783,5235,0.169436485195798,0,0,446,987,71,3379,17,1103,14,17
"1605","2020-04-20",210,19,241,752,5235,0.169436485195798,0,0,446,987,81,3460,14,1117,18,14
"1606","2020-04-21",204,19,231,750,5235,0.169436485195798,0,0,446,987,78,3538,45,1162,14,45
"1607","2020-04-22",208,19,216,737,5235,0.169436485195798,0,0,446,987,64,3602,61,1223,20,61
"1608","2020-04-23",204,19,202,769,5235,0.169436485195798,0,0,446,987,64,3666,24,1247,14,24
"1609","2020-04-24",207,19,216,776,5235,0.169436485195798,0,0,446,987,49,3715,6,1253,7,6
"1610","2020-04-25",210,19,260,783,5235,0.169436485195798,0,0,446,987,57,3772,11,1264,11,11
"1611","2020-04-26",201,19,269,784,5235,0.169436485195798,0,0,446,987,63,3835,54,1318,14,54
"1612","2020-04-27",215,19,235,779,5235,0.169436485195798,0,0,446,987,55,3890,29,1347,15,29
"1613","2020-04-28",222,19,263,785,5235,0.169436485195798,0,0,446,987,68,3958,16,1363,10,16
"1614","2020-04-29",217,19,263,758,5235,0.169436485195798,0,0,446,987,65,4023,30,1393,17,30
"1615","2020-04-30",222,19,243,745,5235,0.169436485195798,0,0,446,987,53,4076,24,1417,5,24
"1616","2020-05-01",214,19,236,744,5235,0.169436485195798,0,0,446,987,68,4144,25,1442,12,25
"1617","2020-05-02",219,19,217,740,5235,0.169436485195798,0,0,446,987,59,4203,19,1461,15,19
"1618","2020-05-03",221,19,187,726,5235,0.169436485195798,0,0,446,987,60,4263,20,1481,21,20
"1619","2020-05-04",221,19,180,721,5235,0.169436485195798,0,0,446,987,64,4327,13,1494,17,13
"1620","2020-05-05",207,19,165,715,5235,0.169436485195798,0,0,446,987,60,4387,42,1536,13,42
"1621","2020-05-06",201,19,181,711,5235,0.169436485195798,0,0,446,987,59,4446,46,1582,10,46
"1622","2020-05-07",185,19,207,709,5235,0.169436485195798,0,0,446,987,47,4493,40,1622,9,40
"1623","2020-05-08",188,19,204,689,5235,0.169436485195798,0,0,446,987,37,4530,31,1653,4,31
"1624","2020-05-09",187,19,187,697,5235,0.169436485195798,0,0,446,987,38,4568,13,1666,6,13
"1625","2020-05-10",199,19,191,670,5235,0.169436485195798,0,0,446,987,47,4615,15,1681,8,15
"1626","2020-05-11",186,19,187,651,5235,0.169436485195798,0,0,446,987,51,4666,9,1690,12,9
"1627","2020-05-12",188,19,181,653,5235,0.169436485195798,0,0,446,987,50,4716,15,1705,9,15
"1628","2020-05-13",196,19,178,649,5235,0.169436485195798,0,0,446,987,43,4759,28,1733,10,28
"1629","2020-05-14",203,19,178,626,5235,0.169436485195798,0,0,446,987,46,4805,43,1776,12,43
"1630","2020-05-15",199,19,164,596,5235,0.169436485195798,0,0,446,987,45,4850,63,1839,11,63
"1631","2020-05-16",189,19,149,589,5235,0.169436485195798,0,0,446,987,34,4884,67,1906,12,67
"1632","2020-05-17",172,19,144,590,5235,0.169436485195798,0,0,446,987,35,4919,29,1935,5,29
"1633","2020-05-18",166,19,137,569,5235,0.169436485195798,0,0,446,987,24,4943,27,1962,8,27
"1634","2020-05-19",164,19,132,543,5235,0.169436485195798,0,0,446,987,30,4973,22,1984,4,22
"1635","2020-05-20",156,19,132,523,5235,0.169436485195798,0,0,446,987,37,5010,18,2002,6,18
"1636","2020-05-21",157,19,190,516,5235,0.169436485195798,0,0,446,987,27,5037,16,2018,9,16
"1637","2020-05-22",155,19,233,501,5235,0.169436485195798,0,0,446,987,27,5064,25,2043,5,25
"1638","2020-05-23",154,19,232,485,5235,0.169436485195798,0,0,446,987,25,5089,15,2058,7,15
"1639","2020-05-24",154,19,209,469,5235,0.169436485195798,0,0,446,987,24,5113,7,2065,3,7
"1640","2020-05-25",148,19,241,444,5235,0.169436485195798,0,0,446,987,22,5135,16,2081,6,16
"1641","2020-05-26",139,19,234,429,5235,0.169436485195798,0,0,446,987,31,5166,40,2121,9,40
"1642","2020-05-27",136,19,222,409,5235,0.169436485195798,0,0,446,987,20,5186,72,2193,6,72
"1643","2020-05-28",126,19,218,393,5235,0.169436485195798,0,0,446,987,23,5209,73,2266,4,73
"1644","2020-05-29",120,19,209,382,5235,0.169436485195798,0,0,446,987,24,5233,74,2340,7,74
"1645","2020-05-30",109,19,203,366,5235,0.169436485195798,0,0,446,987,19,5252,33,2373,3,33
"1646","2020-05-31",104,19,197,340,5235,0.169436485195798,0,0,446,987,18,5270,40,2413,4,40
"1647","2020-06-01",103,19,179,330,5235,0.169436485195798,0,0,446,987,17,5287,30,2443,5,30
"1648","2020-06-02",112,19,175,324,5235,0.169436485195798,0,0,446,987,14,5301,64,2507,1,64
"1649","2020-06-03",106,19,191,308,5235,0.169436485195798,0,0,446,987,28,5329,50,2557,5,50
"1650","2020-06-04",105,19,213,293,5235,0.169436485195798,0,0,446,987,24,5353,34,2591,3,34
"1651","2020-06-05",101,19,194,274,5235,0.169436485195798,0,0,446,987,13,5366,27,2618,2,27
"1652","2020-06-06",95,19,172,262,5235,0.169436485195798,0,0,446,987,17,5383,16,2634,4,16
"1653","2020-06-07",90,19,195,253,5235,0.169436485195798,0,0,446,987,16,5399,39,2673,3,39
"1654","2020-03-14",2,20,151,82,5224,0.822358346094946,0,0,491,1664,24,76,10,83,NA,10
"1655","2020-03-15",4,20,153,105,5224,0.822358346094946,0,0,491,1664,32,108,36,119,11,36
"1656","2020-03-16",10,20,149,149,5224,0.822358346094946,0,0,491,1664,26,134,33,152,7,33
"1657","2020-03-17",12,20,142,181,5224,0.822358346094946,0,0,491,1664,30,164,25,177,9,25
"1658","2020-03-18",16,20,134,226,5224,0.822358346094946,0,0,491,1664,46,210,45,222,17,45
"1659","2020-03-19",19,20,128,270,5224,0.822358346094946,0,0,491,1664,38,248,43,265,23,43
"1660","2020-03-20",27,20,231,325,5224,0.822358346094946,0,0,491,1664,36,284,52,317,18,52
"1661","2020-03-21",39,20,260,374,5224,0.822358346094946,0,0,491,1664,30,314,50,367,8,50
"1662","2020-03-22",54,20,259,424,5224,0.822358346094946,0,0,491,1664,39,353,40,407,14,40
"1663","2020-03-23",63,20,287,482,5224,0.822358346094946,0,0,491,1664,39,392,32,439,16,32
"1664","2020-03-24",77,20,278,546,5224,0.822358346094946,0,0,491,1664,32,424,62,501,10,62
"1665","2020-03-25",87,20,248,581,5224,0.822358346094946,0,0,491,1664,44,468,28,529,16,28
"1666","2020-03-26",112,20,230,637,5224,0.822358346094946,0,0,491,1664,37,505,46,575,15,46
"1667","2020-03-27",126,20,208,692,5224,0.822358346094946,0,0,491,1664,26,531,34,609,14,34
"1668","2020-03-28",146,20,220,723,5224,0.822358346094946,0,0,491,1664,33,564,33,642,12,33
"1669","2020-03-29",154,20,263,764,5224,0.822358346094946,0,0,491,1664,31,595,31,673,15,31
"1670","2020-03-30",159,20,280,828,5224,0.822358346094946,0,0,491,1664,42,637,31,704,14,31
"1671","2020-03-31",179,20,284,874,5224,0.822358346094946,0,0,491,1664,45,682,32,736,15,32
"1672","2020-04-01",200,20,262,888,5224,0.822358346094946,0,0,491,1664,42,724,49,785,18,49
"1673","2020-04-02",215,20,264,926,5224,0.822358346094946,0,0,491,1664,43,767,51,836,24,51
"1674","2020-04-03",228,20,271,959,5224,0.822358346094946,0,0,491,1664,41,808,75,911,19,75
"1675","2020-04-04",232,20,269,987,5224,0.822358346094946,0,0,491,1664,37,845,76,987,12,76
"1676","2020-04-05",255,20,250,1022,5224,0.822358346094946,0,0,491,1664,36,881,58,1045,8,58
"1677","2020-04-06",275,20,219,1064,5224,0.822358346094946,0,0,491,1664,48,929,33,1078,16,33
"1678","2020-04-07",287,20,197,1099,5224,0.822358346094946,0,0,491,1664,33,962,38,1116,9,38
"1679","2020-04-08",294,20,172,1090,5224,0.822358346094946,0,0,491,1664,29,991,27,1143,9,27
"1680","2020-04-09",286,20,157,1106,5224,0.822358346094946,0,0,491,1664,40,1031,42,1185,10,42
"1681","2020-04-10",302,20,166,1098,5224,0.822358346094946,0,0,491,1664,26,1057,34,1219,12,34
"1682","2020-04-11",300,20,160,1115,5224,0.822358346094946,0,0,491,1664,23,1080,30,1249,6,30
"1683","2020-04-12",298,20,157,1130,5224,0.822358346094946,0,0,491,1664,35,1115,53,1302,11,53
"1684","2020-04-13",298,20,191,1150,5224,0.822358346094946,0,0,491,1664,34,1149,45,1347,9,45
"1685","2020-04-14",293,20,182,1123,5224,0.822358346094946,0,0,491,1664,43,1192,38,1385,11,38
"1686","2020-04-15",297,20,174,1145,5224,0.822358346094946,0,0,491,1664,34,1226,46,1431,7,46
"1687","2020-04-16",299,20,182,1138,5224,0.822358346094946,0,0,491,1664,35,1261,43,1474,4,43
"1688","2020-04-17",280,20,194,1127,5224,0.822358346094946,0,0,491,1664,46,1307,56,1530,13,56
"1689","2020-04-18",299,20,257,1136,5224,0.822358346094946,0,0,491,1664,38,1345,62,1592,10,62
"1690","2020-04-19",307,20,282,1137,5224,0.822358346094946,0,0,491,1664,30,1375,41,1633,12,41
"1691","2020-04-20",322,20,273,1142,5224,0.822358346094946,0,0,491,1664,39,1414,47,1680,12,47
"1692","2020-04-21",341,20,264,1142,5224,0.822358346094946,0,0,491,1664,29,1443,55,1735,4,55
"1693","2020-04-22",327,20,259,1109,5224,0.822358346094946,0,0,491,1664,31,1474,69,1804,9,69
"1694","2020-04-23",333,20,280,1068,5224,0.822358346094946,0,0,491,1664,46,1520,47,1851,11,47
"1695","2020-04-24",340,20,286,1044,5224,0.822358346094946,0,0,491,1664,43,1563,34,1885,16,34
"1696","2020-04-25",319,20,274,1024,5224,0.822358346094946,0,0,491,1664,33,1596,58,1943,4,58
"1697","2020-04-26",311,20,251,1003,5224,0.822358346094946,0,0,491,1664,41,1637,62,2005,11,62
"1698","2020-04-27",298,20,226,969,5224,0.822358346094946,0,0,491,1664,36,1673,37,2042,9,37
"1699","2020-04-28",279,20,200,925,5224,0.822358346094946,0,0,491,1664,36,1709,31,2073,12,31
"1700","2020-04-29",292,20,175,895,5224,0.822358346094946,0,0,491,1664,30,1739,54,2127,8,54
"1701","2020-04-30",290,20,165,839,5224,0.822358346094946,0,0,491,1664,32,1771,49,2176,13,49
"1702","2020-05-01",288,20,194,792,5224,0.822358346094946,0,0,491,1664,44,1815,56,2232,11,56
"1703","2020-05-02",283,20,191,758,5224,0.822358346094946,0,0,491,1664,26,1841,73,2305,8,73
"1704","2020-05-03",268,20,174,725,5224,0.822358346094946,0,0,491,1664,36,1877,50,2355,4,50
"1705","2020-05-04",258,20,164,677,5224,0.822358346094946,0,0,491,1664,29,1906,31,2386,7,31
"1706","2020-05-05",232,20,149,658,5224,0.822358346094946,0,0,491,1664,33,1939,60,2446,14,60
"1707","2020-05-06",222,20,156,641,5224,0.822358346094946,0,0,491,1664,29,1968,43,2489,8,43
"1708","2020-05-07",202,20,156,591,5224,0.822358346094946,0,0,491,1664,31,1999,54,2543,7,54
"1709","2020-05-08",192,20,137,553,5224,0.822358346094946,0,0,491,1664,44,2043,52,2595,13,52
"1710","2020-05-09",189,20,154,509,5224,0.822358346094946,0,0,491,1664,32,2075,27,2622,13,27
"1711","2020-05-10",172,20,212,489,5224,0.822358346094946,0,0,491,1664,38,2113,38,2660,10,38
"1712","2020-05-11",164,20,242,480,5224,0.822358346094946,0,0,491,1664,32,2145,42,2702,6,42
"1713","2020-05-12",164,20,294,463,5224,0.822358346094946,0,0,491,1664,47,2192,40,2742,18,40
"1714","2020-05-13",145,20,346,435,5224,0.822358346094946,0,0,491,1664,37,2229,56,2798,13,56
"1715","2020-05-14",141,20,312,420,5224,0.822358346094946,0,0,491,1664,28,2257,73,2871,10,73
"1716","2020-05-15",133,20,297,412,5224,0.822358346094946,0,0,491,1664,46,2303,49,2920,24,49
"1717","2020-05-16",126,20,278,389,5224,0.822358346094946,0,0,491,1664,27,2330,48,2968,7,48
"1718","2020-05-17",123,20,260,368,5224,0.822358346094946,0,0,491,1664,30,2360,69,3037,11,69
"1719","2020-05-18",117,20,255,349,5224,0.822358346094946,0,0,491,1664,28,2388,33,3070,13,33
"1720","2020-05-19",116,20,228,338,5224,0.822358346094946,0,0,491,1664,32,2420,36,3106,14,36
"1721","2020-05-20",117,20,259,328,5224,0.822358346094946,0,0,491,1664,28,2448,60,3166,11,60
"1722","2020-05-21",109,20,250,320,5224,0.822358346094946,0,0,491,1664,26,2474,56,3222,10,56
"1723","2020-05-22",102,20,226,310,5224,0.822358346094946,0,0,491,1664,33,2507,31,3253,12,31
"1724","2020-05-23",105,20,204,298,5224,0.822358346094946,0,0,491,1664,22,2529,33,3286,9,33
"1725","2020-05-24",101,20,188,281,5224,0.822358346094946,0,0,491,1664,31,2560,32,3318,8,32
"1726","2020-05-25",91,20,205,262,5224,0.822358346094946,0,0,491,1664,20,2580,72,3390,5,72
"1727","2020-05-26",88,20,204,257,5224,0.822358346094946,0,0,491,1664,26,2606,60,3450,13,60
"1728","2020-05-27",78,20,182,238,5224,0.822358346094946,0,0,491,1664,26,2632,72,3522,10,72
"1729","2020-05-28",75,20,175,234,5224,0.822358346094946,0,0,491,1664,19,2651,58,3580,10,58
"1730","2020-05-29",70,20,178,225,5224,0.822358346094946,0,0,491,1664,20,2671,54,3634,8,54
"1731","2020-05-30",65,20,219,221,5224,0.822358346094946,0,0,491,1664,21,2692,55,3689,7,55
"1732","2020-05-31",68,20,208,221,5224,0.822358346094946,0,0,491,1664,22,2714,35,3724,4,35
"1733","2020-06-01",68,20,197,206,5224,0.822358346094946,0,0,491,1664,17,2731,46,3770,5,46
"1734","2020-06-02",61,20,190,196,5224,0.822358346094946,0,0,491,1664,18,2749,60,3830,6,60
"1735","2020-06-03",64,20,168,191,5224,0.822358346094946,0,0,491,1664,23,2772,40,3870,10,40
"1736","2020-06-04",63,20,232,182,5224,0.822358346094946,0,0,491,1664,16,2788,51,3921,6,51
"1737","2020-06-05",69,20,234,173,5224,0.822358346094946,0,0,491,1664,17,2805,37,3958,4,37
"1738","2020-06-06",61,20,247,166,5224,0.822358346094946,0,0,491,1664,21,2826,38,3996,7,38
"1739","2020-06-07",55,20,275,165,5224,0.822358346094946,0,0,491,1664,15,2841,44,4040,9,44
