"","Date","Absents","Paramset","Infections_or_Exposed_per_day_Patient","Infections_or_Exposed_per_day_HCW","total_infections","nosocomial_proportion","PCR_pooled","LFD_pooled","HCW_symp_test","patient_symp_test","new_hcw_infs","cumulative_hcw_infs","new_pat_infs","cumulative_pats_infs","new_nosocomial_hcw_infs","new_nosocomial_pat_infs"
"1","2020-03-13",1,1,43,81,5850,0.707179487179487,0,0,489,329,34,81,10,35,8,10
"2","2020-03-14",2,1,45,112,5850,0.707179487179487,0,0,489,329,31,112,4,39,8,4
"3","2020-03-15",4,1,51,145,5850,0.707179487179487,0,0,489,329,33,145,14,53,13,14
"4","2020-03-16",10,1,57,178,5850,0.707179487179487,0,0,489,329,33,178,12,65,15,12
"5","2020-03-17",18,1,67,214,5850,0.707179487179487,0,0,489,329,38,216,20,85,18,20
"6","2020-03-18",27,1,81,261,5850,0.707179487179487,0,0,489,329,50,266,24,109,25,24
"7","2020-03-19",36,1,75,322,5850,0.707179487179487,0,0,489,329,68,334,7,116,46,7
"8","2020-03-20",45,1,68,374,5850,0.707179487179487,0,0,489,329,65,399,7,123,44,7
"9","2020-03-21",57,1,61,432,5850,0.707179487179487,0,0,489,329,68,467,4,127,41,4
"10","2020-03-22",76,1,66,495,5850,0.707179487179487,0,0,489,329,79,546,12,139,57,12
"11","2020-03-23",86,1,60,564,5850,0.707179487179487,0,0,489,329,90,636,11,150,69,11
"12","2020-03-24",95,1,52,609,5850,0.707179487179487,0,0,489,329,72,708,9,159,52,9
"13","2020-03-25",112,1,59,670,5850,0.707179487179487,0,0,489,329,86,794,18,177,65,18
"14","2020-03-26",140,1,66,751,5850,0.707179487179487,0,0,489,329,113,907,14,191,87,14
"15","2020-03-27",156,1,59,807,5850,0.707179487179487,0,0,489,329,106,1013,17,208,82,17
"16","2020-03-28",176,1,49,881,5850,0.707179487179487,0,0,489,329,122,1135,7,215,89,7
"17","2020-03-29",183,1,48,911,5850,0.707179487179487,0,0,489,329,90,1225,10,225,64,10
"18","2020-03-30",205,1,48,990,5850,0.707179487179487,0,0,489,329,127,1352,6,231,106,6
"19","2020-03-31",220,1,60,1027,5850,0.707179487179487,0,0,489,329,102,1454,14,245,81,14
"20","2020-04-01",245,1,64,1065,5850,0.707179487179487,0,0,489,329,109,1563,9,254,87,9
"21","2020-04-02",265,1,71,1086,5850,0.707179487179487,0,0,489,329,95,1658,23,277,79,23
"22","2020-04-03",279,1,70,1105,5850,0.707179487179487,0,0,489,329,109,1767,8,285,83,8
"23","2020-04-04",282,1,67,1118,5850,0.707179487179487,0,0,489,329,105,1872,13,298,82,13
"24","2020-04-05",301,1,70,1160,5850,0.707179487179487,0,0,489,329,138,2010,10,308,113,10
"25","2020-04-06",310,1,65,1205,5850,0.707179487179487,0,0,489,329,135,2145,11,319,102,11
"26","2020-04-07",324,1,65,1221,5850,0.707179487179487,0,0,489,329,123,2268,9,328,102,9
"27","2020-04-08",313,1,61,1259,5850,0.707179487179487,0,0,489,329,139,2407,13,341,117,13
"28","2020-04-09",305,1,75,1274,5850,0.707179487179487,0,0,489,329,131,2538,16,357,111,16
"29","2020-04-10",316,1,82,1302,5850,0.707179487179487,0,0,489,329,116,2654,26,383,99,26
"30","2020-04-11",326,1,96,1340,5850,0.707179487179487,0,0,489,329,128,2782,17,400,104,17
"31","2020-04-12",341,1,78,1386,5850,0.707179487179487,0,0,489,329,140,2922,9,409,117,9
"32","2020-04-13",350,1,77,1371,5850,0.707179487179487,0,0,489,329,116,3038,11,420,93,11
"33","2020-04-14",358,1,75,1391,5850,0.707179487179487,0,0,489,329,130,3168,13,433,110,13
"34","2020-04-15",367,1,62,1364,5850,0.707179487179487,0,0,489,329,95,3263,4,437,73,4
"35","2020-04-16",376,1,57,1338,5850,0.707179487179487,0,0,489,329,93,3356,7,444,78,7
"36","2020-04-17",378,1,56,1344,5850,0.707179487179487,0,0,489,329,127,3483,7,451,108,7
"37","2020-04-18",385,1,55,1327,5850,0.707179487179487,0,0,489,329,105,3588,8,459,81,8
"38","2020-04-19",385,1,79,1303,5850,0.707179487179487,0,0,489,329,100,3688,24,483,86,24
"39","2020-04-20",394,1,87,1268,5850,0.707179487179487,0,0,489,329,88,3776,11,494,67,11
"40","2020-04-21",391,1,89,1211,5850,0.707179487179487,0,0,489,329,77,3853,13,507,59,13
"41","2020-04-22",389,1,82,1164,5850,0.707179487179487,0,0,489,329,94,3947,14,521,84,14
"42","2020-04-23",391,1,99,1145,5850,0.707179487179487,0,0,489,329,85,4032,28,549,67,28
"43","2020-04-24",384,1,104,1137,5850,0.707179487179487,0,0,489,329,93,4125,19,568,71,19
"44","2020-04-25",380,1,97,1075,5850,0.707179487179487,0,0,489,329,78,4203,9,577,59,9
"45","2020-04-26",355,1,106,1036,5850,0.707179487179487,0,0,489,329,68,4271,15,592,49,15
"46","2020-04-27",335,1,87,1014,5850,0.707179487179487,0,0,489,329,95,4366,9,601,76,9
"47","2020-04-28",331,1,79,966,5850,0.707179487179487,0,0,489,329,60,4426,6,607,42,6
"48","2020-04-29",328,1,80,918,5850,0.707179487179487,0,0,489,329,59,4485,11,618,45,11
"49","2020-04-30",293,1,81,876,5850,0.707179487179487,0,0,489,329,59,4544,13,631,41,13
"50","2020-05-01",282,1,98,843,5850,0.707179487179487,0,0,489,329,65,4609,28,659,45,28
"51","2020-05-02",261,1,102,788,5850,0.707179487179487,0,0,489,329,42,4651,19,678,26,19
"52","2020-05-03",263,1,102,742,5850,0.707179487179487,0,0,489,329,48,4699,14,692,34,14
"53","2020-05-04",249,1,105,715,5850,0.707179487179487,0,0,489,329,44,4743,20,712,31,20
"54","2020-05-05",228,1,96,674,5850,0.707179487179487,0,0,489,329,46,4789,18,730,42,18
"55","2020-05-06",211,1,105,641,5850,0.707179487179487,0,0,489,329,41,4830,27,757,26,27
"56","2020-05-07",206,1,104,622,5850,0.707179487179487,0,0,489,329,54,4884,13,770,32,13
"57","2020-05-08",198,1,93,601,5850,0.707179487179487,0,0,489,329,50,4934,15,785,28,15
"58","2020-05-09",196,1,93,569,5850,0.707179487179487,0,0,489,329,38,4972,23,808,25,23
"59","2020-05-10",182,1,107,544,5850,0.707179487179487,0,0,489,329,39,5011,24,832,26,24
"60","2020-05-11",170,1,108,522,5850,0.707179487179487,0,0,489,329,28,5039,20,852,17,20
"61","2020-05-12",164,1,124,504,5850,0.707179487179487,0,0,489,329,28,5067,35,887,19,35
"62","2020-05-13",164,1,128,467,5850,0.707179487179487,0,0,489,329,34,5101,26,913,24,26
"63","2020-05-14",153,1,122,464,5850,0.707179487179487,0,0,489,329,34,5135,14,927,20,14
"64","2020-05-15",137,1,110,440,5850,0.707179487179487,0,0,489,329,37,5172,10,937,27,10
"65","2020-05-16",124,1,102,415,5850,0.707179487179487,0,0,489,329,27,5199,12,949,18,12
"66","2020-05-17",112,1,106,410,5850,0.707179487179487,0,0,489,329,35,5234,22,971,20,22
"67","2020-05-18",112,1,107,383,5850,0.707179487179487,0,0,489,329,27,5261,23,994,15,23
"68","2020-05-19",107,1,109,367,5850,0.707179487179487,0,0,489,329,26,5287,17,1011,14,17
"69","2020-05-20",92,1,102,334,5850,0.707179487179487,0,0,489,329,16,5303,20,1031,12,20
"70","2020-05-21",97,1,98,309,5850,0.707179487179487,0,0,489,329,15,5318,12,1043,7,12
"71","2020-05-22",108,1,105,290,5850,0.707179487179487,0,0,489,329,16,5334,21,1064,7,21
"72","2020-05-23",109,1,112,280,5850,0.707179487179487,0,0,489,329,19,5353,24,1088,12,24
"73","2020-05-24",116,1,123,273,5850,0.707179487179487,0,0,489,329,19,5372,27,1115,10,27
"74","2020-05-25",105,1,110,253,5850,0.707179487179487,0,0,489,329,14,5386,16,1131,9,16
"75","2020-05-26",95,1,119,245,5850,0.707179487179487,0,0,489,329,19,5405,26,1157,14,26
"76","2020-05-27",99,1,112,236,5850,0.707179487179487,0,0,489,329,19,5424,21,1178,15,21
"77","2020-05-28",94,1,105,219,5850,0.707179487179487,0,0,489,329,12,5436,16,1194,5,16
"78","2020-05-29",76,1,115,206,5850,0.707179487179487,0,0,489,329,10,5446,25,1219,5,25
"79","2020-05-30",68,1,115,188,5850,0.707179487179487,0,0,489,329,15,5461,15,1234,10,15
"80","2020-05-31",53,1,101,179,5850,0.707179487179487,0,0,489,329,15,5476,12,1246,9,12
"81","2020-06-01",48,1,88,170,5850,0.707179487179487,0,0,489,329,12,5488,7,1253,3,7
"82","2020-06-02",45,1,83,171,5850,0.707179487179487,0,0,489,329,18,5506,17,1270,12,17
"83","2020-06-03",35,1,77,160,5850,0.707179487179487,0,0,489,329,15,5521,12,1282,10,12
"84","2020-06-04",32,1,82,162,5850,0.707179487179487,0,0,489,329,17,5538,15,1297,12,15
"85","2020-06-05",33,1,86,150,5850,0.707179487179487,0,0,489,329,9,5547,21,1318,4,21
"86","2020-06-06",39,1,78,152,5850,0.707179487179487,0,0,489,329,10,5557,10,1328,8,10
"87","2020-06-07",36,1,71,144,5850,0.707179487179487,0,0,489,329,3,5560,10,1338,1,10
"88","2020-03-15",2,2,17,65,3705,0.740890688259109,0,0,284,202,23,107,2,29,8,2
"89","2020-03-16",5,2,11,84,3705,0.740890688259109,0,0,284,202,24,131,4,33,6,4
"90","2020-03-17",7,2,14,106,3705,0.740890688259109,0,0,284,202,20,151,4,37,6,4
"91","2020-03-18",9,2,16,135,3705,0.740890688259109,0,0,284,202,33,184,4,41,11,4
"92","2020-03-19",13,2,25,156,3705,0.740890688259109,0,0,284,202,29,213,1,42,9,1
"93","2020-03-20",19,2,27,175,3705,0.740890688259109,0,0,284,202,30,243,6,48,11,6
"94","2020-03-21",25,2,30,196,3705,0.740890688259109,0,0,284,202,30,273,5,53,18,5
"95","2020-03-22",32,2,32,232,3705,0.740890688259109,0,0,284,202,24,297,6,59,7,6
"96","2020-03-23",39,2,36,261,3705,0.740890688259109,0,0,284,202,29,326,7,66,19,7
"97","2020-03-24",50,2,41,272,3705,0.740890688259109,0,0,284,202,38,364,4,70,21,4
"98","2020-03-25",61,2,38,307,3705,0.740890688259109,0,0,284,202,34,398,11,81,18,11
"99","2020-03-26",66,2,33,347,3705,0.740890688259109,0,0,284,202,34,432,10,91,17,10
"100","2020-03-27",68,2,37,381,3705,0.740890688259109,0,0,284,202,34,466,18,109,15,18
"101","2020-03-28",82,2,38,406,3705,0.740890688259109,0,0,284,202,34,500,12,121,20,12
"102","2020-03-29",91,2,41,427,3705,0.740890688259109,0,0,284,202,33,533,15,136,13,15
"103","2020-03-30",99,2,48,436,3705,0.740890688259109,0,0,284,202,42,575,16,152,25,16
"104","2020-03-31",106,2,54,455,3705,0.740890688259109,0,0,284,202,40,615,17,169,18,17
"105","2020-04-01",103,2,57,473,3705,0.740890688259109,0,0,284,202,33,648,18,187,17,18
"106","2020-04-02",120,2,49,505,3705,0.740890688259109,0,0,284,202,43,691,19,206,18,19
"107","2020-04-03",129,2,47,529,3705,0.740890688259109,0,0,284,202,46,737,21,227,25,21
"108","2020-04-04",127,2,55,546,3705,0.740890688259109,0,0,284,202,43,780,19,246,20,19
"109","2020-04-05",130,2,68,586,3705,0.740890688259109,0,0,284,202,38,818,19,265,16,19
"110","2020-04-06",136,2,68,596,3705,0.740890688259109,0,0,284,202,43,861,20,285,15,20
"111","2020-04-07",138,2,66,606,3705,0.740890688259109,0,0,284,202,34,895,19,304,14,19
"112","2020-04-08",146,2,71,621,3705,0.740890688259109,0,0,284,202,38,933,22,326,18,22
"113","2020-04-09",149,2,73,641,3705,0.740890688259109,0,0,284,202,32,965,19,345,15,19
"114","2020-04-10",152,2,74,664,3705,0.740890688259109,0,0,284,202,27,992,20,365,12,20
"115","2020-04-11",172,2,78,708,3705,0.740890688259109,0,0,284,202,45,1037,28,393,22,28
"116","2020-04-12",178,2,78,746,3705,0.740890688259109,0,0,284,202,54,1091,21,414,22,21
"117","2020-04-13",180,2,88,748,3705,0.740890688259109,0,0,284,202,36,1127,29,443,19,29
"118","2020-04-14",184,2,72,744,3705,0.740890688259109,0,0,284,202,41,1168,33,476,18,33
"119","2020-04-15",199,2,59,761,3705,0.740890688259109,0,0,284,202,48,1216,23,499,15,23
"120","2020-04-16",200,2,52,798,3705,0.740890688259109,0,0,284,202,41,1257,25,524,21,25
"121","2020-04-17",220,2,62,784,3705,0.740890688259109,0,0,284,202,51,1308,15,539,28,15
"122","2020-04-18",220,2,75,781,3705,0.740890688259109,0,0,284,202,42,1350,25,564,17,25
"123","2020-04-19",220,2,86,800,3705,0.740890688259109,0,0,284,202,30,1380,26,590,9,26
"124","2020-04-20",233,2,105,787,3705,0.740890688259109,0,0,284,202,38,1418,26,616,15,26
"125","2020-04-21",237,2,104,766,3705,0.740890688259109,0,0,284,202,52,1470,18,634,22,18
"126","2020-04-22",227,2,101,777,3705,0.740890688259109,0,0,284,202,54,1524,14,648,30,14
"127","2020-04-23",226,2,100,747,3705,0.740890688259109,0,0,284,202,37,1561,26,674,23,26
"128","2020-04-24",216,2,102,735,3705,0.740890688259109,0,0,284,202,39,1600,19,693,21,19
"129","2020-04-25",209,2,97,712,3705,0.740890688259109,0,0,284,202,41,1641,18,711,14,18
"130","2020-04-26",204,2,92,690,3705,0.740890688259109,0,0,284,202,31,1672,23,734,15,23
"131","2020-04-27",191,2,95,671,3705,0.740890688259109,0,0,284,202,31,1703,13,747,13,13
"132","2020-04-28",197,2,96,661,3705,0.740890688259109,0,0,284,202,34,1737,18,765,12,18
"133","2020-04-29",190,2,97,636,3705,0.740890688259109,0,0,284,202,44,1781,17,782,20,17
"134","2020-04-30",192,2,97,637,3705,0.740890688259109,0,0,284,202,28,1809,23,805,10,23
"135","2020-05-01",183,2,88,605,3705,0.740890688259109,0,0,284,202,45,1854,24,829,21,24
"136","2020-05-02",171,2,90,592,3705,0.740890688259109,0,0,284,202,42,1896,21,850,23,21
"137","2020-05-03",182,2,82,576,3705,0.740890688259109,0,0,284,202,36,1932,21,871,20,21
"138","2020-05-04",179,2,84,585,3705,0.740890688259109,0,0,284,202,51,1983,32,903,23,32
"139","2020-05-05",159,2,95,565,3705,0.740890688259109,0,0,284,202,37,2020,25,928,13,25
"140","2020-05-06",169,2,106,554,3705,0.740890688259109,0,0,284,202,33,2053,28,956,11,28
"141","2020-05-07",160,2,115,547,3705,0.740890688259109,0,0,284,202,40,2093,22,978,16,22
"142","2020-05-08",161,2,124,541,3705,0.740890688259109,0,0,284,202,37,2130,22,1000,13,22
"143","2020-05-09",163,2,106,527,3705,0.740890688259109,0,0,284,202,37,2167,14,1014,19,14
"144","2020-05-10",149,2,95,519,3705,0.740890688259109,0,0,284,202,36,2203,16,1030,15,16
"145","2020-05-11",144,2,91,504,3705,0.740890688259109,0,0,284,202,29,2232,18,1048,13,18
"146","2020-05-12",153,2,92,499,3705,0.740890688259109,0,0,284,202,40,2272,20,1068,13,20
"147","2020-05-13",142,2,93,477,3705,0.740890688259109,0,0,284,202,25,2297,32,1100,10,32
"148","2020-05-14",138,2,100,462,3705,0.740890688259109,0,0,284,202,27,2324,27,1127,13,27
"149","2020-05-15",143,2,103,446,3705,0.740890688259109,0,0,284,202,13,2337,14,1141,6,14
"150","2020-05-16",143,2,101,435,3705,0.740890688259109,0,0,284,202,27,2364,17,1158,7,17
"151","2020-05-17",141,2,97,413,3705,0.740890688259109,0,0,284,202,35,2399,16,1174,11,16
"152","2020-05-18",141,2,93,394,3705,0.740890688259109,0,0,284,202,25,2424,16,1190,6,16
"153","2020-05-19",132,2,108,374,3705,0.740890688259109,0,0,284,202,24,2448,23,1213,9,23
"154","2020-05-20",128,2,105,350,3705,0.740890688259109,0,0,284,202,21,2469,34,1247,9,34
"155","2020-05-21",123,2,100,340,3705,0.740890688259109,0,0,284,202,18,2487,40,1287,9,40
"156","2020-05-22",112,2,86,329,3705,0.740890688259109,0,0,284,202,18,2505,33,1320,5,33
"157","2020-05-23",102,2,83,311,3705,0.740890688259109,0,0,284,202,19,2524,23,1343,11,23
"158","2020-05-24",98,2,81,295,3705,0.740890688259109,0,0,284,202,30,2554,22,1365,12,22
"159","2020-05-25",95,2,79,271,3705,0.740890688259109,0,0,284,202,23,2577,22,1387,6,22
"160","2020-05-26",88,2,78,259,3705,0.740890688259109,0,0,284,202,16,2593,28,1415,4,28
"161","2020-05-27",85,2,65,243,3705,0.740890688259109,0,0,284,202,22,2615,21,1436,12,21
"162","2020-05-28",84,2,64,225,3705,0.740890688259109,0,0,284,202,25,2640,19,1455,16,19
"163","2020-05-29",78,2,66,221,3705,0.740890688259109,0,0,284,202,16,2656,21,1476,6,21
"164","2020-05-30",77,2,60,202,3705,0.740890688259109,0,0,284,202,14,2670,22,1498,4,22
"165","2020-05-31",73,2,60,188,3705,0.740890688259109,0,0,284,202,19,2689,24,1522,6,24
"166","2020-06-01",68,2,59,181,3705,0.740890688259109,0,0,284,202,15,2704,20,1542,8,20
"167","2020-06-02",67,2,70,177,3705,0.740890688259109,0,0,284,202,12,2716,19,1561,6,19
"168","2020-06-03",65,2,70,160,3705,0.740890688259109,0,0,284,202,16,2732,21,1582,7,21
"169","2020-06-04",59,2,65,159,3705,0.740890688259109,0,0,284,202,18,2750,20,1602,5,20
"170","2020-06-05",59,2,61,147,3705,0.740890688259109,0,0,284,202,20,2770,20,1622,10,20
"171","2020-06-06",52,2,51,139,3705,0.740890688259109,0,0,284,202,11,2781,12,1634,6,12
"172","2020-06-07",46,2,45,132,3705,0.740890688259109,0,0,284,202,12,2793,24,1658,5,24
"173","2020-03-13",1,3,45,60,3581,0.494275342083217,0,0,297,700,10,23,3,9,4,3
"174","2020-03-14",3,3,52,86,3581,0.494275342083217,0,0,297,700,8,31,12,21,6,12
"175","2020-03-15",5,3,74,119,3581,0.494275342083217,0,0,297,700,11,42,12,33,6,12
"176","2020-03-16",9,3,83,151,3581,0.494275342083217,0,0,297,700,17,59,13,46,15,13
"177","2020-03-17",15,3,91,185,3581,0.494275342083217,0,0,297,700,19,78,13,59,15,13
"178","2020-03-18",24,3,98,207,3581,0.494275342083217,0,0,297,700,22,100,12,71,15,12
"179","2020-03-19",28,3,118,235,3581,0.494275342083217,0,0,297,700,28,128,9,80,22,9
"180","2020-03-20",37,3,140,267,3581,0.494275342083217,0,0,297,700,22,150,12,92,17,12
"181","2020-03-21",46,3,139,295,3581,0.494275342083217,0,0,297,700,23,173,19,111,19,19
"182","2020-03-22",58,3,147,316,3581,0.494275342083217,0,0,297,700,33,206,15,126,32,15
"183","2020-03-23",69,3,157,348,3581,0.494275342083217,0,0,297,700,46,252,14,140,39,14
"184","2020-03-24",75,3,171,365,3581,0.494275342083217,0,0,297,700,51,303,9,149,41,9
"185","2020-03-25",79,3,202,385,3581,0.494275342083217,0,0,297,700,46,349,12,161,40,12
"186","2020-03-26",93,3,224,398,3581,0.494275342083217,0,0,297,700,53,402,17,178,49,17
"187","2020-03-27",99,3,224,423,3581,0.494275342083217,0,0,297,700,49,451,22,200,45,22
"188","2020-03-28",107,3,217,442,3581,0.494275342083217,0,0,297,700,55,506,23,223,48,23
"189","2020-03-29",118,3,194,463,3581,0.494275342083217,0,0,297,700,82,588,22,245,73,22
"190","2020-03-30",119,3,192,469,3581,0.494275342083217,0,0,297,700,74,662,24,269,72,24
"191","2020-03-31",128,3,175,493,3581,0.494275342083217,0,0,297,700,65,727,23,292,63,23
"192","2020-04-01",127,3,185,506,3581,0.494275342083217,0,0,297,700,87,814,16,308,82,16
"193","2020-04-02",132,3,211,518,3581,0.494275342083217,0,0,297,700,93,907,20,328,85,20
"194","2020-04-03",135,3,224,502,3581,0.494275342083217,0,0,297,700,79,986,18,346,76,18
"195","2020-04-04",135,3,209,508,3581,0.494275342083217,0,0,297,700,96,1082,12,358,88,12
"196","2020-04-05",126,3,199,522,3581,0.494275342083217,0,0,297,700,105,1187,24,382,99,24
"197","2020-04-06",133,3,193,526,3581,0.494275342083217,0,0,297,700,151,1338,27,409,141,27
"198","2020-04-07",136,3,179,542,3581,0.494275342083217,0,0,297,700,175,1513,32,441,166,32
"199","2020-04-08",141,3,186,556,3581,0.494275342083217,0,0,297,700,129,1642,42,483,126,42
"200","2020-04-09",140,3,182,572,3581,0.494275342083217,0,0,297,700,152,1794,24,507,148,24
"201","2020-04-10",139,3,188,592,3581,0.494275342083217,0,0,297,700,164,1958,20,527,159,20
"202","2020-04-11",145,3,179,609,3581,0.494275342083217,0,0,297,700,144,2102,25,552,138,25
"203","2020-04-12",149,3,182,621,3581,0.494275342083217,0,0,297,700,158,2260,23,575,153,23
"204","2020-04-13",159,3,195,651,3581,0.494275342083217,0,0,297,700,165,2425,11,586,158,11
"205","2020-04-14",165,3,222,652,3581,0.494275342083217,0,0,297,700,154,2579,15,601,150,15
"206","2020-04-15",172,3,210,653,3581,0.494275342083217,0,0,297,700,181,2760,13,614,176,13
"207","2020-04-16",183,3,224,659,3581,0.494275342083217,0,0,297,700,162,2922,26,640,155,26
"208","2020-04-17",196,3,243,656,3581,0.494275342083217,0,0,297,700,148,3070,19,659,142,19
"209","2020-04-18",198,3,263,666,3581,0.494275342083217,0,0,297,700,151,3221,21,680,150,21
"210","2020-04-19",208,3,247,664,3581,0.494275342083217,0,0,297,700,131,3352,18,698,126,18
"211","2020-04-20",205,3,236,656,3581,0.494275342083217,0,0,297,700,153,3505,28,726,146,28
"212","2020-04-21",197,3,254,635,3581,0.494275342083217,0,0,297,700,140,3645,34,760,135,34
"213","2020-04-22",196,3,262,609,3581,0.494275342083217,0,0,297,700,124,3769,18,778,116,18
"214","2020-04-23",187,3,266,585,3581,0.494275342083217,0,0,297,700,123,3892,24,802,116,24
"215","2020-04-24",180,3,283,579,3581,0.494275342083217,0,0,297,700,123,4015,25,827,117,25
"216","2020-04-25",176,3,261,580,3581,0.494275342083217,0,0,297,700,117,4132,37,864,112,37
"217","2020-04-26",174,3,266,556,3581,0.494275342083217,0,0,297,700,101,4233,28,892,97,28
"218","2020-04-27",163,3,292,539,3581,0.494275342083217,0,0,297,700,93,4326,21,913,92,21
"219","2020-04-28",164,3,295,538,3581,0.494275342083217,0,0,297,700,96,4422,33,946,94,33
"220","2020-04-29",164,3,307,537,3581,0.494275342083217,0,0,297,700,81,4503,22,968,79,22
"221","2020-04-30",165,3,301,519,3581,0.494275342083217,0,0,297,700,78,4581,46,1014,76,46
"222","2020-05-01",153,3,289,503,3581,0.494275342083217,0,0,297,700,61,4642,38,1052,59,38
"223","2020-05-02",155,3,287,498,3581,0.494275342083217,0,0,297,700,66,4708,32,1084,65,32
"224","2020-05-03",143,3,280,489,3581,0.494275342083217,0,0,297,700,77,4785,37,1121,71,37
"225","2020-05-04",145,3,268,498,3581,0.494275342083217,0,0,297,700,82,4867,40,1161,77,40
"226","2020-05-05",137,3,240,481,3581,0.494275342083217,0,0,297,700,39,4906,39,1200,35,39
"227","2020-05-06",126,3,224,454,3581,0.494275342083217,0,0,297,700,56,4962,31,1231,52,31
"228","2020-05-07",121,3,226,444,3581,0.494275342083217,0,0,297,700,52,5014,31,1262,51,31
"229","2020-05-08",120,3,239,432,3581,0.494275342083217,0,0,297,700,61,5075,31,1293,51,31
"230","2020-05-09",114,3,246,432,3581,0.494275342083217,0,0,297,700,43,5118,32,1325,42,32
"231","2020-05-10",121,3,253,429,3581,0.494275342083217,0,0,297,700,35,5153,36,1361,35,36
"232","2020-05-11",121,3,235,436,3581,0.494275342083217,0,0,297,700,39,5192,28,1389,33,28
"233","2020-05-12",127,3,221,422,3581,0.494275342083217,0,0,297,700,39,5231,32,1421,31,32
"234","2020-05-13",131,3,226,434,3581,0.494275342083217,0,0,297,700,22,5253,25,1446,19,25
"235","2020-05-14",131,3,256,436,3581,0.494275342083217,0,0,297,700,32,5285,33,1479,30,33
"236","2020-05-15",135,3,270,429,3581,0.494275342083217,0,0,297,700,27,5312,27,1506,22,27
"237","2020-05-16",138,3,279,433,3581,0.494275342083217,0,0,297,700,24,5336,36,1542,21,36
"238","2020-05-17",128,3,272,413,3581,0.494275342083217,0,0,297,700,22,5358,33,1575,21,33
"239","2020-05-18",125,3,262,406,3581,0.494275342083217,0,0,297,700,22,5380,37,1612,14,37
"240","2020-05-19",121,3,285,389,3581,0.494275342083217,0,0,297,700,18,5398,36,1648,17,36
"241","2020-05-20",118,3,294,374,3581,0.494275342083217,0,0,297,700,24,5422,23,1671,19,23
"242","2020-05-21",116,3,280,367,3581,0.494275342083217,0,0,297,700,22,5444,22,1693,18,22
"243","2020-05-22",116,3,263,360,3581,0.494275342083217,0,0,297,700,14,5458,31,1724,13,31
"244","2020-05-23",108,3,264,339,3581,0.494275342083217,0,0,297,700,13,5471,24,1748,12,24
"245","2020-05-24",105,3,266,331,3581,0.494275342083217,0,0,297,700,11,5482,23,1771,10,23
"246","2020-05-25",105,3,243,309,3581,0.494275342083217,0,0,297,700,13,5495,18,1789,10,18
"247","2020-05-26",103,3,252,301,3581,0.494275342083217,0,0,297,700,21,5516,20,1809,17,20
"248","2020-05-27",106,3,261,299,3581,0.494275342083217,0,0,297,700,11,5527,16,1825,11,16
"249","2020-05-28",99,3,269,288,3581,0.494275342083217,0,0,297,700,21,5548,14,1839,15,14
"250","2020-05-29",99,3,275,280,3581,0.494275342083217,0,0,297,700,8,5556,8,1847,7,8
"251","2020-05-30",100,3,302,262,3581,0.494275342083217,0,0,297,700,10,5566,15,1862,8,15
"252","2020-05-31",98,3,300,246,3581,0.494275342083217,0,0,297,700,15,5581,20,1882,13,20
"253","2020-06-01",94,3,269,253,3581,0.494275342083217,0,0,297,700,13,5594,17,1899,9,17
"254","2020-06-02",85,3,260,234,3581,0.494275342083217,0,0,297,700,8,5602,23,1922,7,23
"255","2020-06-03",80,3,259,225,3581,0.494275342083217,0,0,297,700,7,5609,16,1938,5,16
"256","2020-06-04",76,3,262,210,3581,0.494275342083217,0,0,297,700,8,5617,20,1958,7,20
"257","2020-06-05",68,3,270,190,3581,0.494275342083217,0,0,297,700,7,5624,17,1975,7,17
"258","2020-06-06",61,3,271,188,3581,0.494275342083217,0,0,297,700,5,5629,11,1986,3,11
"259","2020-06-07",60,3,270,181,3581,0.494275342083217,0,0,297,700,6,5635,8,1994,5,8
"260","2020-03-14",1,4,58,38,3436,0.758731082654249,0,0,301,330,46,128,9,68,26,9
"261","2020-03-15",3,4,56,52,3436,0.758731082654249,0,0,301,330,69,197,11,79,36,11
"262","2020-03-16",5,4,58,63,3436,0.758731082654249,0,0,301,330,57,254,30,109,30,30
"263","2020-03-17",8,4,58,78,3436,0.758731082654249,0,0,301,330,63,317,27,136,44,27
"264","2020-03-18",11,4,53,100,3436,0.758731082654249,0,0,301,330,109,426,39,175,84,39
"265","2020-03-19",14,4,62,117,3436,0.758731082654249,0,0,301,330,140,566,15,190,111,15
"266","2020-03-20",16,4,69,140,3436,0.758731082654249,0,0,301,330,153,719,36,226,130,36
"267","2020-03-21",22,4,87,163,3436,0.758731082654249,0,0,301,330,216,935,25,251,196,25
"268","2020-03-22",26,4,78,191,3436,0.758731082654249,0,0,301,330,200,1135,14,265,184,14
"269","2020-03-23",35,4,65,214,3436,0.758731082654249,0,0,301,330,311,1446,39,304,287,39
"270","2020-03-24",41,4,72,231,3436,0.758731082654249,0,0,301,330,345,1791,34,338,323,34
"271","2020-03-25",45,4,84,264,3436,0.758731082654249,0,0,301,330,370,2161,15,353,356,15
"272","2020-03-26",60,4,91,293,3436,0.758731082654249,0,0,301,330,458,2619,23,376,430,23
"273","2020-03-27",77,4,106,316,3436,0.758731082654249,0,0,301,330,502,3121,29,405,494,29
"274","2020-03-28",82,4,102,337,3436,0.758731082654249,0,0,301,330,488,3609,21,426,474,21
"275","2020-03-29",84,4,100,355,3436,0.758731082654249,0,0,301,330,524,4133,50,476,509,50
"276","2020-03-30",82,4,93,373,3436,0.758731082654249,0,0,301,330,514,4647,23,499,505,23
"277","2020-03-31",94,4,82,390,3436,0.758731082654249,0,0,301,330,467,5114,20,519,453,20
"278","2020-04-01",100,4,81,413,3436,0.758731082654249,0,0,301,330,411,5525,51,570,400,51
"279","2020-04-02",101,4,90,428,3436,0.758731082654249,0,0,301,330,340,5865,52,622,332,52
"280","2020-04-03",107,4,106,451,3436,0.758731082654249,0,0,301,330,373,6238,68,690,368,68
"281","2020-04-04",111,4,112,457,3436,0.758731082654249,0,0,301,330,282,6520,49,739,277,49
"282","2020-04-05",129,4,99,464,3436,0.758731082654249,0,0,301,330,198,6718,49,788,192,49
"283","2020-04-06",137,4,86,485,3436,0.758731082654249,0,0,301,330,158,6876,65,853,152,65
"284","2020-04-07",135,4,76,503,3436,0.758731082654249,0,0,301,330,179,7055,57,910,173,57
"285","2020-04-08",136,4,89,502,3436,0.758731082654249,0,0,301,330,122,7177,46,956,116,46
"286","2020-04-09",138,4,108,528,3436,0.758731082654249,0,0,301,330,105,7282,37,993,102,37
"287","2020-04-10",138,4,119,547,3436,0.758731082654249,0,0,301,330,78,7360,35,1028,74,35
"288","2020-04-11",138,4,113,566,3436,0.758731082654249,0,0,301,330,53,7413,23,1051,49,23
"289","2020-04-12",128,4,104,601,3436,0.758731082654249,0,0,301,330,43,7456,21,1072,41,21
"290","2020-04-13",134,4,98,609,3436,0.758731082654249,0,0,301,330,35,7491,22,1094,33,22
"291","2020-04-14",144,4,105,632,3436,0.758731082654249,0,0,301,330,20,7511,50,1144,18,50
"292","2020-04-15",158,4,97,648,3436,0.758731082654249,0,0,301,330,19,7530,23,1167,18,23
"293","2020-04-16",169,4,93,641,3436,0.758731082654249,0,0,301,330,17,7547,17,1184,16,17
"294","2020-04-17",168,4,113,651,3436,0.758731082654249,0,0,301,330,12,7559,9,1193,12,9
"295","2020-04-18",180,4,123,658,3436,0.758731082654249,0,0,301,330,9,7568,7,1200,7,7
"296","2020-04-19",190,4,149,673,3436,0.758731082654249,0,0,301,330,5,7573,6,1206,4,6
"297","2020-04-20",195,4,156,682,3436,0.758731082654249,0,0,301,330,6,7579,13,1219,5,13
"298","2020-04-21",193,4,152,690,3436,0.758731082654249,0,0,301,330,6,7585,44,1263,4,44
"299","2020-04-22",196,4,138,684,3436,0.758731082654249,0,0,301,330,4,7589,22,1285,2,22
"300","2020-04-23",186,4,117,673,3436,0.758731082654249,0,0,301,330,4,7593,14,1299,2,14
"301","2020-04-24",192,4,101,655,3436,0.758731082654249,0,0,301,330,4,7597,56,1355,2,56
"302","2020-04-25",192,4,120,641,3436,0.758731082654249,0,0,301,330,7,7604,40,1395,5,40
"303","2020-04-26",194,4,122,624,3436,0.758731082654249,0,0,301,330,5,7609,25,1420,5,25
"304","2020-04-27",193,4,133,618,3436,0.758731082654249,0,0,301,330,4,7613,27,1447,4,27
"305","2020-04-28",199,4,113,624,3436,0.758731082654249,0,0,301,330,6,7619,26,1473,1,26
"306","2020-04-29",203,4,96,620,3436,0.758731082654249,0,0,301,330,3,7622,35,1508,3,35
"307","2020-04-30",206,4,83,593,3436,0.758731082654249,0,0,301,330,1,7623,22,1530,1,22
"308","2020-05-01",198,4,81,594,3436,0.758731082654249,0,0,301,330,NA,NA,47,1577,NA,47
"309","2020-05-02",202,4,102,587,3436,0.758731082654249,0,0,301,330,3,7626,18,1595,2,18
"310","2020-05-03",200,4,129,556,3436,0.758731082654249,0,0,301,330,3,7629,28,1623,NA,28
"311","2020-05-04",195,4,123,549,3436,0.758731082654249,0,0,301,330,2,7631,26,1649,1,26
"312","2020-05-05",189,4,126,533,3436,0.758731082654249,0,0,301,330,3,7634,21,1670,2,21
"313","2020-05-06",178,4,147,503,3436,0.758731082654249,0,0,301,330,3,7637,18,1688,NA,18
"314","2020-05-07",178,4,139,484,3436,0.758731082654249,0,0,301,330,2,7639,24,1712,NA,24
"315","2020-05-08",171,4,143,471,3436,0.758731082654249,0,0,301,330,NA,NA,45,1757,NA,45
"316","2020-05-09",167,4,134,450,3436,0.758731082654249,0,0,301,330,3,7642,45,1802,1,45
"317","2020-05-10",158,4,149,448,3436,0.758731082654249,0,0,301,330,1,7643,54,1856,NA,54
"318","2020-05-11",153,4,153,434,3436,0.758731082654249,0,0,301,330,1,7644,25,1881,1,25
"319","2020-05-12",140,4,168,430,3436,0.758731082654249,0,0,301,330,NA,NA,62,1943,NA,62
"320","2020-05-13",129,4,181,426,3436,0.758731082654249,0,0,301,330,2,7646,24,1967,1,24
"321","2020-05-14",113,4,163,417,3436,0.758731082654249,0,0,301,330,NA,NA,23,1990,NA,23
"322","2020-05-15",113,4,159,418,3436,0.758731082654249,0,0,301,330,1,7647,18,2008,1,18
"323","2020-05-16",101,4,137,419,3436,0.758731082654249,0,0,301,330,NA,NA,49,2057,NA,49
"324","2020-05-17",110,4,121,409,3436,0.758731082654249,0,0,301,330,3,7650,29,2086,2,29
"325","2020-05-18",109,4,92,388,3436,0.758731082654249,0,0,301,330,3,7653,15,2101,2,15
"326","2020-05-19",110,4,81,386,3436,0.758731082654249,0,0,301,330,2,7655,22,2123,1,22
"327","2020-05-20",109,4,74,368,3436,0.758731082654249,0,0,301,330,1,7656,24,2147,1,24
"328","2020-05-21",117,4,64,372,3436,0.758731082654249,0,0,301,330,1,7657,44,2191,NA,44
"329","2020-05-22",117,4,81,361,3436,0.758731082654249,0,0,301,330,2,7659,35,2226,2,35
"330","2020-05-23",119,4,99,357,3436,0.758731082654249,0,0,301,330,3,7662,22,2248,2,22
"331","2020-05-24",113,4,100,357,3436,0.758731082654249,0,0,301,330,1,7663,14,2262,NA,14
"332","2020-05-25",113,4,88,354,3436,0.758731082654249,0,0,301,330,2,7665,15,2277,1,15
"333","2020-05-26",116,4,74,337,3436,0.758731082654249,0,0,301,330,3,7668,21,2298,2,21
"334","2020-05-27",117,4,69,327,3436,0.758731082654249,0,0,301,330,3,7671,14,2312,2,14
"335","2020-05-28",112,4,69,319,3436,0.758731082654249,0,0,301,330,1,7672,23,2335,1,23
"336","2020-05-29",110,4,69,297,3436,0.758731082654249,0,0,301,330,1,7673,31,2366,1,31
"337","2020-05-30",108,4,66,285,3436,0.758731082654249,0,0,301,330,NA,NA,20,2386,NA,20
"338","2020-05-31",100,4,71,280,3436,0.758731082654249,0,0,301,330,NA,NA,26,2412,NA,26
"339","2020-06-01",99,4,78,269,3436,0.758731082654249,0,0,301,330,2,7675,15,2427,1,15
"340","2020-06-02",89,4,68,271,3436,0.758731082654249,0,0,301,330,3,7678,31,2458,3,31
"341","2020-06-03",82,4,70,253,3436,0.758731082654249,0,0,301,330,1,7679,18,2476,1,18
"342","2020-06-04",75,4,73,232,3436,0.758731082654249,0,0,301,330,3,7682,37,2513,1,37
"343","2020-06-05",76,4,66,222,3436,0.758731082654249,0,0,301,330,NA,NA,18,2531,NA,18
"344","2020-06-06",69,4,74,212,3436,0.758731082654249,0,0,301,330,NA,NA,30,2561,NA,30
"345","2020-06-07",65,4,59,192,3436,0.758731082654249,0,0,301,330,NA,NA,23,2584,NA,23
"346","2020-03-16",4,5,18,88,2867,0.580397628182769,0,0,217,250,14,63,20,83,7,20
"347","2020-03-17",7,5,16,109,2867,0.580397628182769,0,0,217,250,11,74,19,102,4,19
"348","2020-03-18",11,5,27,132,2867,0.580397628182769,0,0,217,250,16,90,14,116,11,14
"349","2020-03-19",20,5,29,153,2867,0.580397628182769,0,0,217,250,17,107,11,127,11,11
"350","2020-03-20",28,5,34,170,2867,0.580397628182769,0,0,217,250,22,129,9,136,14,9
"351","2020-03-21",31,5,32,189,2867,0.580397628182769,0,0,217,250,28,157,14,150,18,14
"352","2020-03-22",38,5,30,209,2867,0.580397628182769,0,0,217,250,24,181,15,165,19,15
"353","2020-03-23",43,5,30,230,2867,0.580397628182769,0,0,217,250,18,199,19,184,10,19
"354","2020-03-24",51,5,39,251,2867,0.580397628182769,0,0,217,250,23,222,22,206,18,22
"355","2020-03-25",62,5,46,271,2867,0.580397628182769,0,0,217,250,25,247,17,223,21,17
"356","2020-03-26",65,5,44,280,2867,0.580397628182769,0,0,217,250,28,275,26,249,23,26
"357","2020-03-27",65,5,37,298,2867,0.580397628182769,0,0,217,250,33,308,19,268,27,19
"358","2020-03-28",80,5,33,304,2867,0.580397628182769,0,0,217,250,32,340,19,287,27,19
"359","2020-03-29",79,5,33,322,2867,0.580397628182769,0,0,217,250,32,372,18,305,25,18
"360","2020-03-30",87,5,31,338,2867,0.580397628182769,0,0,217,250,29,401,21,326,19,21
"361","2020-03-31",86,5,42,363,2867,0.580397628182769,0,0,217,250,28,429,31,357,21,31
"362","2020-04-01",86,5,49,379,2867,0.580397628182769,0,0,217,250,17,446,17,374,15,17
"363","2020-04-02",91,5,50,397,2867,0.580397628182769,0,0,217,250,29,475,23,397,22,23
"364","2020-04-03",97,5,59,416,2867,0.580397628182769,0,0,217,250,33,508,16,413,24,16
"365","2020-04-04",93,5,67,430,2867,0.580397628182769,0,0,217,250,28,536,27,440,16,27
"366","2020-04-05",104,5,78,443,2867,0.580397628182769,0,0,217,250,33,569,31,471,25,31
"367","2020-04-06",95,5,81,453,2867,0.580397628182769,0,0,217,250,50,619,35,506,34,35
"368","2020-04-07",105,5,82,438,2867,0.580397628182769,0,0,217,250,26,645,24,530,14,24
"369","2020-04-08",112,5,80,440,2867,0.580397628182769,0,0,217,250,32,677,43,573,28,43
"370","2020-04-09",116,5,80,455,2867,0.580397628182769,0,0,217,250,33,710,28,601,25,28
"371","2020-04-10",118,5,83,451,2867,0.580397628182769,0,0,217,250,28,738,30,631,22,30
"372","2020-04-11",116,5,83,453,2867,0.580397628182769,0,0,217,250,34,772,27,658,21,27
"373","2020-04-12",117,5,82,467,2867,0.580397628182769,0,0,217,250,38,810,18,676,27,18
"374","2020-04-13",130,5,67,464,2867,0.580397628182769,0,0,217,250,37,847,34,710,30,34
"375","2020-04-14",123,5,64,467,2867,0.580397628182769,0,0,217,250,37,884,27,737,28,27
"376","2020-04-15",122,5,63,466,2867,0.580397628182769,0,0,217,250,35,919,28,765,28,28
"377","2020-04-16",119,5,61,446,2867,0.580397628182769,0,0,217,250,32,951,27,792,21,27
"378","2020-04-17",119,5,52,446,2867,0.580397628182769,0,0,217,250,41,992,36,828,31,36
"379","2020-04-18",125,5,53,439,2867,0.580397628182769,0,0,217,250,33,1025,25,853,27,25
"380","2020-04-19",129,5,65,448,2867,0.580397628182769,0,0,217,250,32,1057,27,880,20,27
"381","2020-04-20",125,5,72,443,2867,0.580397628182769,0,0,217,250,47,1104,16,896,42,16
"382","2020-04-21",126,5,91,435,2867,0.580397628182769,0,0,217,250,33,1137,23,919,23,23
"383","2020-04-22",125,5,91,453,2867,0.580397628182769,0,0,217,250,41,1178,25,944,29,25
"384","2020-04-23",120,5,83,449,2867,0.580397628182769,0,0,217,250,34,1212,23,967,26,23
"385","2020-04-24",126,5,79,441,2867,0.580397628182769,0,0,217,250,21,1233,27,994,16,27
"386","2020-04-25",123,5,69,428,2867,0.580397628182769,0,0,217,250,35,1268,31,1025,25,31
"387","2020-04-26",117,5,59,430,2867,0.580397628182769,0,0,217,250,28,1296,36,1061,18,36
"388","2020-04-27",115,5,69,417,2867,0.580397628182769,0,0,217,250,31,1327,43,1104,22,43
"389","2020-04-28",123,5,75,436,2867,0.580397628182769,0,0,217,250,27,1354,28,1132,18,28
"390","2020-04-29",118,5,81,419,2867,0.580397628182769,0,0,217,250,27,1381,25,1157,16,25
"391","2020-04-30",122,5,74,418,2867,0.580397628182769,0,0,217,250,37,1418,25,1182,24,25
"392","2020-05-01",121,5,74,421,2867,0.580397628182769,0,0,217,250,26,1444,27,1209,15,27
"393","2020-05-02",123,5,85,417,2867,0.580397628182769,0,0,217,250,25,1469,25,1234,20,25
"394","2020-05-03",117,5,87,397,2867,0.580397628182769,0,0,217,250,27,1496,30,1264,20,30
"395","2020-05-04",120,5,102,408,2867,0.580397628182769,0,0,217,250,32,1528,25,1289,25,25
"396","2020-05-05",116,5,108,397,2867,0.580397628182769,0,0,217,250,27,1555,15,1304,15,15
"397","2020-05-06",116,5,123,401,2867,0.580397628182769,0,0,217,250,39,1594,23,1327,27,23
"398","2020-05-07",112,5,135,397,2867,0.580397628182769,0,0,217,250,34,1628,28,1355,24,28
"399","2020-05-08",106,5,120,393,2867,0.580397628182769,0,0,217,250,27,1655,10,1365,15,10
"400","2020-05-09",106,5,113,387,2867,0.580397628182769,0,0,217,250,31,1686,33,1398,23,33
"401","2020-05-10",109,5,117,391,2867,0.580397628182769,0,0,217,250,23,1709,26,1424,17,26
"402","2020-05-11",108,5,110,364,2867,0.580397628182769,0,0,217,250,18,1727,16,1440,11,16
"403","2020-05-12",108,5,108,377,2867,0.580397628182769,0,0,217,250,26,1753,21,1461,22,21
"404","2020-05-13",106,5,101,361,2867,0.580397628182769,0,0,217,250,28,1781,20,1481,21,20
"405","2020-05-14",108,5,97,363,2867,0.580397628182769,0,0,217,250,24,1805,15,1496,18,15
"406","2020-05-15",108,5,79,357,2867,0.580397628182769,0,0,217,250,15,1820,29,1525,11,29
"407","2020-05-16",112,5,80,361,2867,0.580397628182769,0,0,217,250,36,1856,46,1571,28,46
"408","2020-05-17",107,5,81,359,2867,0.580397628182769,0,0,217,250,22,1878,39,1610,16,39
"409","2020-05-18",104,5,93,355,2867,0.580397628182769,0,0,217,250,19,1897,37,1647,12,37
"410","2020-05-19",98,5,71,358,2867,0.580397628182769,0,0,217,250,24,1921,27,1674,16,27
"411","2020-05-20",93,5,75,353,2867,0.580397628182769,0,0,217,250,21,1942,23,1697,13,23
"412","2020-05-21",89,5,68,354,2867,0.580397628182769,0,0,217,250,24,1966,30,1727,17,30
"413","2020-05-22",90,5,66,366,2867,0.580397628182769,0,0,217,250,15,1981,25,1752,11,25
"414","2020-05-23",83,5,77,352,2867,0.580397628182769,0,0,217,250,24,2005,34,1786,18,34
"415","2020-05-24",92,5,75,335,2867,0.580397628182769,0,0,217,250,10,2015,22,1808,10,22
"416","2020-05-25",92,5,70,322,2867,0.580397628182769,0,0,217,250,19,2034,19,1827,12,19
"417","2020-05-26",90,5,73,318,2867,0.580397628182769,0,0,217,250,18,2052,26,1853,17,26
"418","2020-05-27",101,5,67,305,2867,0.580397628182769,0,0,217,250,13,2065,22,1875,10,22
"419","2020-05-28",99,5,68,278,2867,0.580397628182769,0,0,217,250,18,2083,19,1894,14,19
"420","2020-05-29",93,5,73,277,2867,0.580397628182769,0,0,217,250,12,2095,18,1912,9,18
"421","2020-05-30",87,5,65,258,2867,0.580397628182769,0,0,217,250,22,2117,14,1926,16,14
"422","2020-05-31",83,5,53,246,2867,0.580397628182769,0,0,217,250,18,2135,17,1943,13,17
"423","2020-06-01",82,5,53,244,2867,0.580397628182769,0,0,217,250,21,2156,14,1957,19,14
"424","2020-06-02",81,5,54,232,2867,0.580397628182769,0,0,217,250,7,2163,18,1975,6,18
"425","2020-06-03",70,5,54,218,2867,0.580397628182769,0,0,217,250,17,2180,6,1981,14,6
"426","2020-06-04",64,5,48,203,2867,0.580397628182769,0,0,217,250,15,2195,16,1997,11,16
"427","2020-06-05",60,5,52,196,2867,0.580397628182769,0,0,217,250,15,2210,25,2022,12,25
"428","2020-06-06",53,5,48,189,2867,0.580397628182769,0,0,217,250,16,2226,25,2047,14,25
"429","2020-06-07",47,5,47,185,2867,0.580397628182769,0,0,217,250,15,2241,18,2065,12,18
"430","2020-03-15",1,6,45,94,7582,0.935637035083091,0,0,655,569,17,66,7,39,8,7
"431","2020-03-16",4,6,40,122,7582,0.935637035083091,0,0,655,569,23,89,18,57,5,18
"432","2020-03-17",10,6,38,157,7582,0.935637035083091,0,0,655,569,19,108,8,65,8,8
"433","2020-03-18",16,6,34,191,7582,0.935637035083091,0,0,655,569,29,137,11,76,17,11
"434","2020-03-19",22,6,51,242,7582,0.935637035083091,0,0,655,569,19,156,18,94,6,18
"435","2020-03-20",36,6,70,290,7582,0.935637035083091,0,0,655,569,19,175,22,116,10,22
"436","2020-03-21",53,6,60,366,7582,0.935637035083091,0,0,655,569,30,205,21,137,12,21
"437","2020-03-22",66,6,68,428,7582,0.935637035083091,0,0,655,569,17,222,35,172,8,35
"438","2020-03-23",79,6,66,511,7582,0.935637035083091,0,0,655,569,34,256,21,193,14,21
"439","2020-03-24",94,6,96,592,7582,0.935637035083091,0,0,655,569,24,280,11,204,18,11
"440","2020-03-25",105,6,104,683,7582,0.935637035083091,0,0,655,569,22,302,15,219,10,15
"441","2020-03-26",113,6,94,879,7582,0.935637035083091,0,0,655,569,29,331,31,250,14,31
"442","2020-03-27",142,6,104,1023,7582,0.935637035083091,0,0,655,569,36,367,27,277,20,27
"443","2020-03-28",155,6,128,1165,7582,0.935637035083091,0,0,655,569,19,386,23,300,9,23
"444","2020-03-29",189,6,123,1394,7582,0.935637035083091,0,0,655,569,25,411,22,322,13,22
"445","2020-03-30",219,6,137,1593,7582,0.935637035083091,0,0,655,569,28,439,27,349,14,27
"446","2020-03-31",257,6,147,1824,7582,0.935637035083091,0,0,655,569,29,468,18,367,15,18
"447","2020-04-01",304,6,146,2060,7582,0.935637035083091,0,0,655,569,24,492,24,391,12,24
"448","2020-04-02",377,6,127,2310,7582,0.935637035083091,0,0,655,569,26,518,10,401,11,10
"449","2020-04-03",421,6,149,2559,7582,0.935637035083091,0,0,655,569,36,554,20,421,16,20
"450","2020-04-04",498,6,140,2791,7582,0.935637035083091,0,0,655,569,21,575,13,434,8,13
"451","2020-04-05",560,6,151,3066,7582,0.935637035083091,0,0,655,569,44,619,31,465,28,31
"452","2020-04-06",636,6,141,3298,7582,0.935637035083091,0,0,655,569,38,657,12,477,21,12
"453","2020-04-07",723,6,139,3480,7582,0.935637035083091,0,0,655,569,26,683,8,485,13,8
"454","2020-04-08",788,6,140,3619,7582,0.935637035083091,0,0,655,569,35,718,4,489,21,4
"455","2020-04-09",832,6,143,3674,7582,0.935637035083091,0,0,655,569,35,753,16,505,17,16
"456","2020-04-10",900,6,158,3743,7582,0.935637035083091,0,0,655,569,30,783,15,520,16,15
"457","2020-04-11",937,6,140,3758,7582,0.935637035083091,0,0,655,569,42,825,12,532,22,12
"458","2020-04-12",985,6,127,3633,7582,0.935637035083091,0,0,655,569,33,858,11,543,12,11
"459","2020-04-13",1027,6,113,3433,7582,0.935637035083091,0,0,655,569,35,893,13,556,20,13
"460","2020-04-14",1033,6,123,3245,7582,0.935637035083091,0,0,655,569,37,930,14,570,17,14
"461","2020-04-15",1019,6,120,2988,7582,0.935637035083091,0,0,655,569,31,961,32,602,15,32
"462","2020-04-16",1014,6,111,2750,7582,0.935637035083091,0,0,655,569,29,990,40,642,15,40
"463","2020-04-17",978,6,105,2455,7582,0.935637035083091,0,0,655,569,33,1023,47,689,12,47
"464","2020-04-18",940,6,89,2203,7582,0.935637035083091,0,0,655,569,35,1058,42,731,21,42
"465","2020-04-19",873,6,76,1944,7582,0.935637035083091,0,0,655,569,30,1088,23,754,13,23
"466","2020-04-20",787,6,67,1683,7582,0.935637035083091,0,0,655,569,30,1118,21,775,13,21
"467","2020-04-21",696,6,101,1432,7582,0.935637035083091,0,0,655,569,35,1153,35,810,15,35
"468","2020-04-22",636,6,106,1221,7582,0.935637035083091,0,0,655,569,24,1177,38,848,12,38
"469","2020-04-23",565,6,111,1025,7582,0.935637035083091,0,0,655,569,17,1194,44,892,5,44
"470","2020-04-24",486,6,110,859,7582,0.935637035083091,0,0,655,569,21,1215,34,926,7,34
"471","2020-04-25",414,6,127,727,7582,0.935637035083091,0,0,655,569,29,1244,17,943,11,17
"472","2020-04-26",365,6,130,605,7582,0.935637035083091,0,0,655,569,27,1271,24,967,11,24
"473","2020-04-27",312,6,126,496,7582,0.935637035083091,0,0,655,569,28,1299,28,995,8,28
"474","2020-04-28",271,6,154,398,7582,0.935637035083091,0,0,655,569,28,1327,33,1028,9,33
"475","2020-04-29",233,6,168,333,7582,0.935637035083091,0,0,655,569,22,1349,12,1040,8,12
"476","2020-04-30",194,6,156,287,7582,0.935637035083091,0,0,655,569,21,1370,3,1043,11,3
"477","2020-05-01",157,6,167,236,7582,0.935637035083091,0,0,655,569,31,1401,12,1055,10,12
"478","2020-05-02",134,6,158,200,7582,0.935637035083091,0,0,655,569,28,1429,18,1073,13,18
"479","2020-05-03",106,6,137,163,7582,0.935637035083091,0,0,655,569,29,1458,38,1111,11,38
"480","2020-05-04",84,6,124,133,7582,0.935637035083091,0,0,655,569,34,1492,22,1133,17,22
"481","2020-05-05",68,6,112,104,7582,0.935637035083091,0,0,655,569,20,1512,39,1172,7,39
"482","2020-05-06",54,6,104,94,7582,0.935637035083091,0,0,655,569,35,1547,21,1193,15,21
"483","2020-05-07",44,6,137,77,7582,0.935637035083091,0,0,655,569,26,1573,16,1209,15,16
"484","2020-05-08",43,6,158,65,7582,0.935637035083091,0,0,655,569,33,1606,15,1224,12,15
"485","2020-05-09",34,6,168,57,7582,0.935637035083091,0,0,655,569,26,1632,26,1250,13,26
"486","2020-05-10",21,6,182,51,7582,0.935637035083091,0,0,655,569,16,1648,31,1281,7,31
"487","2020-05-11",20,6,170,51,7582,0.935637035083091,0,0,655,569,28,1676,16,1297,13,16
"488","2020-05-12",17,6,188,45,7582,0.935637035083091,0,0,655,569,24,1700,17,1314,15,17
"489","2020-05-13",15,6,184,44,7582,0.935637035083091,0,0,655,569,25,1725,35,1349,11,35
"490","2020-05-14",10,6,180,43,7582,0.935637035083091,0,0,655,569,22,1747,19,1368,9,19
"491","2020-05-15",9,6,181,39,7582,0.935637035083091,0,0,655,569,26,1773,20,1388,9,20
"492","2020-05-16",9,6,188,36,7582,0.935637035083091,0,0,655,569,29,1802,22,1410,13,22
"493","2020-05-17",8,6,180,33,7582,0.935637035083091,0,0,655,569,17,1819,19,1429,8,19
"494","2020-05-18",7,6,165,30,7582,0.935637035083091,0,0,655,569,37,1856,16,1445,18,16
"495","2020-05-19",7,6,151,28,7582,0.935637035083091,0,0,655,569,25,1881,30,1475,16,30
"496","2020-05-20",8,6,121,28,7582,0.935637035083091,0,0,655,569,25,1906,20,1495,14,20
"497","2020-05-21",9,6,108,30,7582,0.935637035083091,0,0,655,569,31,1937,33,1528,21,33
"498","2020-05-22",9,6,100,28,7582,0.935637035083091,0,0,655,569,31,1968,16,1544,16,16
"499","2020-05-23",8,6,95,30,7582,0.935637035083091,0,0,655,569,23,1991,16,1560,15,16
"500","2020-05-24",10,6,83,32,7582,0.935637035083091,0,0,655,569,22,2013,10,1570,10,10
"501","2020-05-25",9,6,94,27,7582,0.935637035083091,0,0,655,569,16,2029,35,1605,8,35
"502","2020-05-26",8,6,87,31,7582,0.935637035083091,0,0,655,569,18,2047,23,1628,13,23
"503","2020-05-27",6,6,80,29,7582,0.935637035083091,0,0,655,569,22,2069,34,1662,13,34
"504","2020-05-28",6,6,71,29,7582,0.935637035083091,0,0,655,569,24,2093,23,1685,12,23
"505","2020-05-29",5,6,68,30,7582,0.935637035083091,0,0,655,569,23,2116,30,1715,10,30
"506","2020-05-30",5,6,64,28,7582,0.935637035083091,0,0,655,569,13,2129,22,1737,3,22
"507","2020-05-31",5,6,59,26,7582,0.935637035083091,0,0,655,569,13,2142,19,1756,8,19
"508","2020-06-01",8,6,58,28,7582,0.935637035083091,0,0,655,569,9,2151,20,1776,8,20
"509","2020-06-02",10,6,49,24,7582,0.935637035083091,0,0,655,569,14,2165,16,1792,8,16
"510","2020-06-03",10,6,45,22,7582,0.935637035083091,0,0,655,569,14,2179,10,1802,5,10
"511","2020-06-04",9,6,55,20,7582,0.935637035083091,0,0,655,569,14,2193,13,1815,8,13
"512","2020-06-05",9,6,56,20,7582,0.935637035083091,0,0,655,569,14,2207,22,1837,7,22
"513","2020-06-06",8,6,51,17,7582,0.935637035083091,0,0,655,569,16,2223,16,1853,8,16
"514","2020-06-07",6,6,45,17,7582,0.935637035083091,0,0,655,569,19,2242,17,1870,14,17
"515","2020-03-14",1,7,26,86,3512,0.387813211845102,0,0,323,214,7,32,11,58,2,11
"516","2020-03-15",2,7,35,110,3512,0.387813211845102,0,0,323,214,14,46,15,73,6,15
"517","2020-03-16",4,7,34,148,3512,0.387813211845102,0,0,323,214,11,57,18,91,7,18
"518","2020-03-17",11,7,28,190,3512,0.387813211845102,0,0,323,214,17,74,19,110,12,19
"519","2020-03-18",18,7,22,221,3512,0.387813211845102,0,0,323,214,16,90,37,147,13,37
"520","2020-03-19",29,7,20,255,3512,0.387813211845102,0,0,323,214,15,105,18,165,12,18
"521","2020-03-20",37,7,23,286,3512,0.387813211845102,0,0,323,214,18,123,18,183,12,18
"522","2020-03-21",58,7,21,325,3512,0.387813211845102,0,0,323,214,20,143,17,200,16,17
"523","2020-03-22",62,7,19,349,3512,0.387813211845102,0,0,323,214,18,161,12,212,14,12
"524","2020-03-23",72,7,32,377,3512,0.387813211845102,0,0,323,214,18,179,19,231,10,19
"525","2020-03-24",86,7,37,402,3512,0.387813211845102,0,0,323,214,18,197,7,238,15,7
"526","2020-03-25",93,7,51,419,3512,0.387813211845102,0,0,323,214,21,218,10,248,11,10
"527","2020-03-26",97,7,43,442,3512,0.387813211845102,0,0,323,214,26,244,5,253,18,5
"528","2020-03-27",106,7,38,452,3512,0.387813211845102,0,0,323,214,24,268,29,282,15,29
"529","2020-03-28",97,7,42,460,3512,0.387813211845102,0,0,323,214,27,295,7,289,20,7
"530","2020-03-29",117,7,41,465,3512,0.387813211845102,0,0,323,214,25,320,12,301,16,12
"531","2020-03-30",132,7,40,468,3512,0.387813211845102,0,0,323,214,33,353,36,337,24,36
"532","2020-03-31",132,7,49,469,3512,0.387813211845102,0,0,323,214,33,386,7,344,22,7
"533","2020-04-01",137,7,59,483,3512,0.387813211845102,0,0,323,214,38,424,9,353,25,9
"534","2020-04-02",133,7,71,481,3512,0.387813211845102,0,0,323,214,15,439,18,371,12,18
"535","2020-04-03",132,7,79,476,3512,0.387813211845102,0,0,323,214,32,471,25,396,26,25
"536","2020-04-04",136,7,84,480,3512,0.387813211845102,0,0,323,214,38,509,50,446,34,50
"537","2020-04-05",127,7,90,473,3512,0.387813211845102,0,0,323,214,25,534,59,505,18,59
"538","2020-04-06",122,7,79,510,3512,0.387813211845102,0,0,323,214,30,564,29,534,20,29
"539","2020-04-07",125,7,73,516,3512,0.387813211845102,0,0,323,214,36,600,32,566,30,32
"540","2020-04-08",122,7,71,520,3512,0.387813211845102,0,0,323,214,48,648,30,596,38,30
"541","2020-04-09",134,7,79,527,3512,0.387813211845102,0,0,323,214,29,677,19,615,19,19
"542","2020-04-10",141,7,82,549,3512,0.387813211845102,0,0,323,214,31,708,42,657,22,42
"543","2020-04-11",142,7,88,543,3512,0.387813211845102,0,0,323,214,41,749,45,702,29,45
"544","2020-04-12",151,7,81,553,3512,0.387813211845102,0,0,323,214,32,781,17,719,23,17
"545","2020-04-13",150,7,77,556,3512,0.387813211845102,0,0,323,214,21,802,41,760,18,41
"546","2020-04-14",153,7,75,558,3512,0.387813211845102,0,0,323,214,35,837,29,789,31,29
"547","2020-04-15",155,7,81,569,3512,0.387813211845102,0,0,323,214,24,861,16,805,15,16
"548","2020-04-16",158,7,86,567,3512,0.387813211845102,0,0,323,214,33,894,13,818,21,13
"549","2020-04-17",157,7,82,567,3512,0.387813211845102,0,0,323,214,33,927,24,842,21,24
"550","2020-04-18",161,7,80,574,3512,0.387813211845102,0,0,323,214,29,956,14,856,17,14
"551","2020-04-19",160,7,76,566,3512,0.387813211845102,0,0,323,214,41,997,12,868,29,12
"552","2020-04-20",155,7,89,568,3512,0.387813211845102,0,0,323,214,36,1033,5,873,22,5
"553","2020-04-21",150,7,89,564,3512,0.387813211845102,0,0,323,214,37,1070,12,885,24,12
"554","2020-04-22",154,7,95,575,3512,0.387813211845102,0,0,323,214,42,1112,30,915,33,30
"555","2020-04-23",152,7,97,561,3512,0.387813211845102,0,0,323,214,38,1150,21,936,30,21
"556","2020-04-24",151,7,94,551,3512,0.387813211845102,0,0,323,214,32,1182,21,957,23,21
"557","2020-04-25",151,7,89,551,3512,0.387813211845102,0,0,323,214,22,1204,28,985,13,28
"558","2020-04-26",144,7,87,545,3512,0.387813211845102,0,0,323,214,47,1251,18,1003,35,18
"559","2020-04-27",155,7,74,524,3512,0.387813211845102,0,0,323,214,27,1278,13,1016,17,13
"560","2020-04-28",163,7,76,522,3512,0.387813211845102,0,0,323,214,30,1308,7,1023,22,7
"561","2020-04-29",167,7,69,512,3512,0.387813211845102,0,0,323,214,22,1330,15,1038,18,15
"562","2020-04-30",156,7,67,505,3512,0.387813211845102,0,0,323,214,36,1366,37,1075,27,37
"563","2020-05-01",157,7,64,506,3512,0.387813211845102,0,0,323,214,37,1403,30,1105,30,30
"564","2020-05-02",155,7,64,505,3512,0.387813211845102,0,0,323,214,29,1432,23,1128,24,23
"565","2020-05-03",156,7,63,501,3512,0.387813211845102,0,0,323,214,35,1467,31,1159,27,31
"566","2020-05-04",147,7,66,495,3512,0.387813211845102,0,0,323,214,31,1498,19,1178,24,19
"567","2020-05-05",129,7,67,486,3512,0.387813211845102,0,0,323,214,37,1535,27,1205,28,27
"568","2020-05-06",128,7,63,495,3512,0.387813211845102,0,0,323,214,42,1577,34,1239,32,34
"569","2020-05-07",131,7,57,491,3512,0.387813211845102,0,0,323,214,31,1608,13,1252,23,13
"570","2020-05-08",133,7,51,472,3512,0.387813211845102,0,0,323,214,38,1646,23,1275,31,23
"571","2020-05-09",131,7,40,472,3512,0.387813211845102,0,0,323,214,30,1676,44,1319,25,44
"572","2020-05-10",129,7,58,472,3512,0.387813211845102,0,0,323,214,27,1703,26,1345,20,26
"573","2020-05-11",135,7,68,465,3512,0.387813211845102,0,0,323,214,26,1729,9,1354,21,9
"574","2020-05-12",147,7,75,467,3512,0.387813211845102,0,0,323,214,30,1759,6,1360,19,6
"575","2020-05-13",139,7,70,461,3512,0.387813211845102,0,0,323,214,35,1794,2,1362,29,2
"576","2020-05-14",138,7,60,434,3512,0.387813211845102,0,0,323,214,24,1818,6,1368,19,6
"577","2020-05-15",138,7,64,447,3512,0.387813211845102,0,0,323,214,32,1850,21,1389,23,21
"578","2020-05-16",129,7,68,424,3512,0.387813211845102,0,0,323,214,21,1871,30,1419,17,30
"579","2020-05-17",132,7,62,406,3512,0.387813211845102,0,0,323,214,22,1893,28,1447,18,28
"580","2020-05-18",120,7,53,402,3512,0.387813211845102,0,0,323,214,33,1926,6,1453,23,6
"581","2020-05-19",114,7,38,393,3512,0.387813211845102,0,0,323,214,32,1958,20,1473,28,20
"582","2020-05-20",118,7,38,376,3512,0.387813211845102,0,0,323,214,27,1985,24,1497,23,24
"583","2020-05-21",116,7,39,376,3512,0.387813211845102,0,0,323,214,46,2031,32,1529,38,32
"584","2020-05-22",110,7,45,375,3512,0.387813211845102,0,0,323,214,20,2051,15,1544,15,15
"585","2020-05-23",117,7,53,359,3512,0.387813211845102,0,0,323,214,27,2078,9,1553,20,9
"586","2020-05-24",117,7,52,330,3512,0.387813211845102,0,0,323,214,18,2096,7,1560,15,7
"587","2020-05-25",116,7,64,305,3512,0.387813211845102,0,0,323,214,27,2123,6,1566,19,6
"588","2020-05-26",113,7,62,286,3512,0.387813211845102,0,0,323,214,27,2150,5,1571,22,5
"589","2020-05-27",103,7,57,270,3512,0.387813211845102,0,0,323,214,26,2176,10,1581,22,10
"590","2020-05-28",101,7,61,253,3512,0.387813211845102,0,0,323,214,14,2190,8,1589,8,8
"591","2020-05-29",92,7,51,240,3512,0.387813211845102,0,0,323,214,14,2204,9,1598,12,9
"592","2020-05-30",80,7,52,231,3512,0.387813211845102,0,0,323,214,18,2222,10,1608,15,10
"593","2020-05-31",70,7,56,218,3512,0.387813211845102,0,0,323,214,22,2244,15,1623,20,15
"594","2020-06-01",71,7,42,213,3512,0.387813211845102,0,0,323,214,14,2258,18,1641,13,18
"595","2020-06-02",67,7,51,204,3512,0.387813211845102,0,0,323,214,24,2282,9,1650,23,9
"596","2020-06-03",61,7,53,194,3512,0.387813211845102,0,0,323,214,17,2299,9,1659,15,9
"597","2020-06-04",61,7,46,198,3512,0.387813211845102,0,0,323,214,16,2315,9,1668,10,9
"598","2020-06-05",59,7,48,202,3512,0.387813211845102,0,0,323,214,15,2330,4,1672,11,4
"599","2020-06-06",65,7,44,187,3512,0.387813211845102,0,0,323,214,9,2339,15,1687,9,15
"600","2020-06-07",63,7,36,190,3512,0.387813211845102,0,0,323,214,22,2361,9,1696,18,9
"601","2020-03-14",3,8,62,58,3038,0.498683344305464,0,0,260,620,18,59,10,18,3,10
"602","2020-03-15",7,8,78,77,3038,0.498683344305464,0,0,260,620,15,74,13,31,7,13
"603","2020-03-16",8,8,88,100,3038,0.498683344305464,0,0,260,620,16,90,9,40,3,9
"604","2020-03-17",10,8,86,115,3038,0.498683344305464,0,0,260,620,19,109,9,49,8,9
"605","2020-03-18",14,8,92,141,3038,0.498683344305464,0,0,260,620,17,126,6,55,7,6
"606","2020-03-19",18,8,109,177,3038,0.498683344305464,0,0,260,620,25,151,12,67,15,12
"607","2020-03-20",26,8,135,206,3038,0.498683344305464,0,0,260,620,24,175,10,77,12,10
"608","2020-03-21",30,8,153,229,3038,0.498683344305464,0,0,260,620,18,193,5,82,7,5
"609","2020-03-22",29,8,153,259,3038,0.498683344305464,0,0,260,620,22,215,7,89,8,7
"610","2020-03-23",41,8,139,281,3038,0.498683344305464,0,0,260,620,19,234,3,92,7,3
"611","2020-03-24",54,8,132,294,3038,0.498683344305464,0,0,260,620,34,268,6,98,15,6
"612","2020-03-25",60,8,137,322,3038,0.498683344305464,0,0,260,620,36,304,9,107,15,9
"613","2020-03-26",65,8,126,344,3038,0.498683344305464,0,0,260,620,25,329,8,115,14,8
"614","2020-03-27",78,8,142,359,3038,0.498683344305464,0,0,260,620,27,356,13,128,15,13
"615","2020-03-28",89,8,154,375,3038,0.498683344305464,0,0,260,620,24,380,20,148,17,20
"616","2020-03-29",100,8,168,385,3038,0.498683344305464,0,0,260,620,31,411,18,166,16,18
"617","2020-03-30",98,8,186,389,3038,0.498683344305464,0,0,260,620,26,437,23,189,15,23
"618","2020-03-31",91,8,192,394,3038,0.498683344305464,0,0,260,620,24,461,19,208,10,19
"619","2020-04-01",96,8,192,408,3038,0.498683344305464,0,0,260,620,35,496,10,218,14,10
"620","2020-04-02",107,8,204,406,3038,0.498683344305464,0,0,260,620,26,522,8,226,10,8
"621","2020-04-03",96,8,206,410,3038,0.498683344305464,0,0,260,620,26,548,7,233,11,7
"622","2020-04-04",95,8,215,418,3038,0.498683344305464,0,0,260,620,20,568,3,236,12,3
"623","2020-04-05",97,8,209,440,3038,0.498683344305464,0,0,260,620,35,603,24,260,13,24
"624","2020-04-06",112,8,206,447,3038,0.498683344305464,0,0,260,620,32,635,23,283,14,23
"625","2020-04-07",129,8,220,442,3038,0.498683344305464,0,0,260,620,27,662,18,301,15,18
"626","2020-04-08",124,8,199,458,3038,0.498683344305464,0,0,260,620,29,691,16,317,13,16
"627","2020-04-09",119,8,210,469,3038,0.498683344305464,0,0,260,620,31,722,16,333,14,16
"628","2020-04-10",131,8,210,450,3038,0.498683344305464,0,0,260,620,31,753,27,360,14,27
"629","2020-04-11",134,8,204,461,3038,0.498683344305464,0,0,260,620,38,791,18,378,12,18
"630","2020-04-12",134,8,224,467,3038,0.498683344305464,0,0,260,620,31,822,19,397,15,19
"631","2020-04-13",128,8,217,459,3038,0.498683344305464,0,0,260,620,38,860,27,424,21,27
"632","2020-04-14",124,8,235,453,3038,0.498683344305464,0,0,260,620,33,893,18,442,14,18
"633","2020-04-15",132,8,235,441,3038,0.498683344305464,0,0,260,620,24,917,14,456,12,14
"634","2020-04-16",145,8,226,454,3038,0.498683344305464,0,0,260,620,34,951,26,482,11,26
"635","2020-04-17",137,8,226,458,3038,0.498683344305464,0,0,260,620,27,978,25,507,9,25
"636","2020-04-18",129,8,221,449,3038,0.498683344305464,0,0,260,620,32,1010,20,527,13,20
"637","2020-04-19",133,8,247,454,3038,0.498683344305464,0,0,260,620,39,1049,31,558,23,31
"638","2020-04-20",128,8,240,447,3038,0.498683344305464,0,0,260,620,29,1078,34,592,15,34
"639","2020-04-21",128,8,230,460,3038,0.498683344305464,0,0,260,620,41,1119,20,612,12,20
"640","2020-04-22",132,8,239,458,3038,0.498683344305464,0,0,260,620,35,1154,23,635,9,23
"641","2020-04-23",117,8,233,453,3038,0.498683344305464,0,0,260,620,25,1179,15,650,7,15
"642","2020-04-24",116,8,231,454,3038,0.498683344305464,0,0,260,620,33,1212,27,677,12,27
"643","2020-04-25",121,8,233,429,3038,0.498683344305464,0,0,260,620,29,1241,14,691,10,14
"644","2020-04-26",114,8,191,431,3038,0.498683344305464,0,0,260,620,38,1279,25,716,13,25
"645","2020-04-27",116,8,171,430,3038,0.498683344305464,0,0,260,620,45,1324,31,747,24,31
"646","2020-04-28",113,8,170,443,3038,0.498683344305464,0,0,260,620,26,1350,17,764,14,17
"647","2020-04-29",108,8,167,436,3038,0.498683344305464,0,0,260,620,26,1376,25,789,7,25
"648","2020-04-30",118,8,171,436,3038,0.498683344305464,0,0,260,620,25,1401,34,823,9,34
"649","2020-05-01",128,8,166,447,3038,0.498683344305464,0,0,260,620,26,1427,40,863,11,40
"650","2020-05-02",134,8,162,432,3038,0.498683344305464,0,0,260,620,20,1447,27,890,7,27
"651","2020-05-03",137,8,178,424,3038,0.498683344305464,0,0,260,620,30,1477,14,904,9,14
"652","2020-05-04",134,8,219,427,3038,0.498683344305464,0,0,260,620,19,1496,16,920,7,16
"653","2020-05-05",140,8,238,450,3038,0.498683344305464,0,0,260,620,22,1518,8,928,10,8
"654","2020-05-06",138,8,235,445,3038,0.498683344305464,0,0,260,620,26,1544,7,935,8,7
"655","2020-05-07",123,8,231,448,3038,0.498683344305464,0,0,260,620,22,1566,22,957,6,22
"656","2020-05-08",126,8,230,450,3038,0.498683344305464,0,0,260,620,29,1595,18,975,5,18
"657","2020-05-09",122,8,213,437,3038,0.498683344305464,0,0,260,620,23,1618,19,994,5,19
"658","2020-05-10",115,8,227,446,3038,0.498683344305464,0,0,260,620,28,1646,24,1018,11,24
"659","2020-05-11",120,8,244,425,3038,0.498683344305464,0,0,260,620,21,1667,22,1040,7,22
"660","2020-05-12",115,8,261,425,3038,0.498683344305464,0,0,260,620,26,1693,11,1051,9,11
"661","2020-05-13",118,8,255,424,3038,0.498683344305464,0,0,260,620,26,1719,5,1056,11,5
"662","2020-05-14",117,8,253,404,3038,0.498683344305464,0,0,260,620,25,1744,10,1066,7,10
"663","2020-05-15",110,8,253,396,3038,0.498683344305464,0,0,260,620,19,1763,26,1092,5,26
"664","2020-05-16",109,8,256,386,3038,0.498683344305464,0,0,260,620,23,1786,11,1103,11,11
"665","2020-05-17",114,8,238,377,3038,0.498683344305464,0,0,260,620,26,1812,3,1106,14,3
"666","2020-05-18",108,8,233,361,3038,0.498683344305464,0,0,260,620,30,1842,7,1113,18,7
"667","2020-05-19",110,8,234,338,3038,0.498683344305464,0,0,260,620,23,1865,20,1133,11,20
"668","2020-05-20",106,8,232,321,3038,0.498683344305464,0,0,260,620,18,1883,12,1145,8,12
"669","2020-05-21",114,8,213,311,3038,0.498683344305464,0,0,260,620,18,1901,6,1151,7,6
"670","2020-05-22",111,8,212,303,3038,0.498683344305464,0,0,260,620,17,1918,16,1167,10,16
"671","2020-05-23",103,8,206,304,3038,0.498683344305464,0,0,260,620,13,1931,8,1175,7,8
"672","2020-05-24",102,8,211,305,3038,0.498683344305464,0,0,260,620,15,1946,19,1194,4,19
"673","2020-05-25",101,8,227,292,3038,0.498683344305464,0,0,260,620,18,1964,15,1209,8,15
"674","2020-05-26",91,8,229,272,3038,0.498683344305464,0,0,260,620,18,1982,16,1225,10,16
"675","2020-05-27",88,8,222,275,3038,0.498683344305464,0,0,260,620,16,1998,12,1237,4,12
"676","2020-05-28",87,8,230,257,3038,0.498683344305464,0,0,260,620,21,2019,9,1246,10,9
"677","2020-05-29",80,8,209,253,3038,0.498683344305464,0,0,260,620,14,2033,11,1257,8,11
"678","2020-05-30",82,8,216,248,3038,0.498683344305464,0,0,260,620,14,2047,5,1262,5,5
"679","2020-05-31",80,8,206,236,3038,0.498683344305464,0,0,260,620,14,2061,19,1281,5,19
"680","2020-06-01",78,8,191,233,3038,0.498683344305464,0,0,260,620,17,2078,10,1291,10,10
"681","2020-06-02",74,8,203,242,3038,0.498683344305464,0,0,260,620,20,2098,12,1303,10,12
"682","2020-06-03",67,8,205,234,3038,0.498683344305464,0,0,260,620,11,2109,11,1314,5,11
"683","2020-06-04",63,8,197,226,3038,0.498683344305464,0,0,260,620,12,2121,19,1333,7,19
"684","2020-06-05",65,8,200,229,3038,0.498683344305464,0,0,260,620,14,2135,15,1348,9,15
"685","2020-06-06",62,8,202,223,3038,0.498683344305464,0,0,260,620,11,2146,13,1361,5,13
"686","2020-06-07",62,8,183,224,3038,0.498683344305464,0,0,260,620,8,2154,6,1367,5,6
"687","2020-03-13",1,9,28,11,6953,0.972673666043435,0,0,653,498,14,28,3,14,7,3
"688","2020-03-14",1,9,25,18,6953,0.972673666043435,0,0,653,498,9,37,2,16,7,2
"689","2020-03-15",2,9,22,22,6953,0.972673666043435,0,0,653,498,9,46,4,20,8,4
"690","2020-03-16",2,9,27,33,6953,0.972673666043435,0,0,653,498,17,63,4,24,15,4
"691","2020-03-17",4,9,20,41,6953,0.972673666043435,0,0,653,498,15,78,3,27,11,3
"692","2020-03-18",4,9,16,52,6953,0.972673666043435,0,0,653,498,11,89,1,28,8,1
"693","2020-03-19",4,9,21,61,6953,0.972673666043435,0,0,653,498,20,109,3,31,15,3
"694","2020-03-20",8,9,28,75,6953,0.972673666043435,0,0,653,498,24,133,20,51,21,20
"695","2020-03-21",12,9,34,89,6953,0.972673666043435,0,0,653,498,17,150,11,62,14,11
"696","2020-03-22",13,9,42,100,6953,0.972673666043435,0,0,653,498,25,175,7,69,23,7
"697","2020-03-23",15,9,52,122,6953,0.972673666043435,0,0,653,498,25,200,4,73,20,4
"698","2020-03-24",17,9,51,145,6953,0.972673666043435,0,0,653,498,20,220,6,79,18,6
"699","2020-03-25",22,9,46,174,6953,0.972673666043435,0,0,653,498,23,243,4,83,22,4
"700","2020-03-26",30,9,36,204,6953,0.972673666043435,0,0,653,498,36,279,5,88,33,5
"701","2020-03-27",35,9,29,238,6953,0.972673666043435,0,0,653,498,34,313,2,90,34,2
"702","2020-03-28",45,9,32,263,6953,0.972673666043435,0,0,653,498,24,337,3,93,20,3
"703","2020-03-29",49,9,29,297,6953,0.972673666043435,0,0,653,498,32,369,9,102,29,9
"704","2020-03-30",58,9,34,344,6953,0.972673666043435,0,0,653,498,43,412,16,118,40,16
"705","2020-03-31",69,9,40,394,6953,0.972673666043435,0,0,653,498,44,456,29,147,37,29
"706","2020-04-01",81,9,69,435,6953,0.972673666043435,0,0,653,498,59,515,29,176,54,29
"707","2020-04-02",89,9,66,497,6953,0.972673666043435,0,0,653,498,40,555,31,207,37,31
"708","2020-04-03",101,9,74,554,6953,0.972673666043435,0,0,653,498,44,599,18,225,40,18
"709","2020-04-04",105,9,71,625,6953,0.972673666043435,0,0,653,498,44,643,20,245,41,20
"710","2020-04-05",126,9,75,709,6953,0.972673666043435,0,0,653,498,51,694,11,256,50,11
"711","2020-04-06",139,9,81,796,6953,0.972673666043435,0,0,653,498,62,756,10,266,57,10
"712","2020-04-07",153,9,97,898,6953,0.972673666043435,0,0,653,498,49,805,16,282,44,16
"713","2020-04-08",170,9,97,995,6953,0.972673666043435,0,0,653,498,64,869,32,314,57,32
"714","2020-04-09",182,9,97,1148,6953,0.972673666043435,0,0,653,498,52,921,22,336,47,22
"715","2020-04-10",208,9,116,1286,6953,0.972673666043435,0,0,653,498,70,991,33,369,69,33
"716","2020-04-11",245,9,108,1442,6953,0.972673666043435,0,0,653,498,41,1032,21,390,38,21
"717","2020-04-12",271,9,115,1590,6953,0.972673666043435,0,0,653,498,82,1114,19,409,81,19
"718","2020-04-13",311,9,131,1740,6953,0.972673666043435,0,0,653,498,48,1162,17,426,47,17
"719","2020-04-14",360,9,143,2018,6953,0.972673666043435,0,0,653,498,83,1245,37,463,80,37
"720","2020-04-15",407,9,145,2191,6953,0.972673666043435,0,0,653,498,64,1309,10,473,58,10
"721","2020-04-16",456,9,144,2391,6953,0.972673666043435,0,0,653,498,81,1390,10,483,75,10
"722","2020-04-17",503,9,130,2592,6953,0.972673666043435,0,0,653,498,80,1470,12,495,76,12
"723","2020-04-18",549,9,124,2685,6953,0.972673666043435,0,0,653,498,72,1542,44,539,68,44
"724","2020-04-19",597,9,119,2787,6953,0.972673666043435,0,0,653,498,64,1606,41,580,60,41
"725","2020-04-20",636,9,124,2849,6953,0.972673666043435,0,0,653,498,74,1680,26,606,71,26
"726","2020-04-21",684,9,120,2928,6953,0.972673666043435,0,0,653,498,79,1759,35,641,77,35
"727","2020-04-22",720,9,110,2878,6953,0.972673666043435,0,0,653,498,84,1843,20,661,82,20
"728","2020-04-23",753,9,102,2859,6953,0.972673666043435,0,0,653,498,102,1945,38,699,98,38
"729","2020-04-24",758,9,91,2828,6953,0.972673666043435,0,0,653,498,71,2016,24,723,68,24
"730","2020-04-25",785,9,85,2744,6953,0.972673666043435,0,0,653,498,91,2107,43,766,87,43
"731","2020-04-26",796,9,75,2627,6953,0.972673666043435,0,0,653,498,76,2183,24,790,69,24
"732","2020-04-27",797,9,78,2511,6953,0.972673666043435,0,0,653,498,75,2258,8,798,72,8
"733","2020-04-28",776,9,93,2344,6953,0.972673666043435,0,0,653,498,87,2345,15,813,80,15
"734","2020-04-29",773,9,92,2148,6953,0.972673666043435,0,0,653,498,67,2412,15,828,63,15
"735","2020-04-30",759,9,87,1950,6953,0.972673666043435,0,0,653,498,68,2480,9,837,64,9
"736","2020-05-01",738,9,87,1802,6953,0.972673666043435,0,0,653,498,85,2565,10,847,83,10
"737","2020-05-02",688,9,85,1631,6953,0.972673666043435,0,0,653,498,67,2632,8,855,63,8
"738","2020-05-03",645,9,115,1460,6953,0.972673666043435,0,0,653,498,82,2714,11,866,78,11
"739","2020-05-04",583,9,131,1307,6953,0.972673666043435,0,0,653,498,53,2767,16,882,52,16
"740","2020-05-05",530,9,143,1149,6953,0.972673666043435,0,0,653,498,67,2834,28,910,65,28
"741","2020-05-06",466,9,136,1015,6953,0.972673666043435,0,0,653,498,70,2904,39,949,67,39
"742","2020-05-07",403,9,173,902,6953,0.972673666043435,0,0,653,498,52,2956,19,968,52,19
"743","2020-05-08",368,9,164,769,6953,0.972673666043435,0,0,653,498,64,3020,39,1007,61,39
"744","2020-05-09",321,9,155,660,6953,0.972673666043435,0,0,653,498,50,3070,16,1023,50,16
"745","2020-05-10",274,9,169,574,6953,0.972673666043435,0,0,653,498,55,3125,33,1056,53,33
"746","2020-05-11",265,9,144,516,6953,0.972673666043435,0,0,653,498,38,3163,17,1073,35,17
"747","2020-05-12",231,9,142,443,6953,0.972673666043435,0,0,653,498,41,3204,27,1100,35,27
"748","2020-05-13",202,9,139,394,6953,0.972673666043435,0,0,653,498,50,3254,22,1122,47,22
"749","2020-05-14",190,9,138,330,6953,0.972673666043435,0,0,653,498,33,3287,10,1132,33,10
"750","2020-05-15",163,9,138,277,6953,0.972673666043435,0,0,653,498,42,3329,21,1153,38,21
"751","2020-05-16",144,9,136,248,6953,0.972673666043435,0,0,653,498,37,3366,16,1169,33,16
"752","2020-05-17",130,9,121,213,6953,0.972673666043435,0,0,653,498,23,3389,21,1190,20,21
"753","2020-05-18",106,9,113,183,6953,0.972673666043435,0,0,653,498,27,3416,22,1212,26,22
"754","2020-05-19",92,9,118,145,6953,0.972673666043435,0,0,653,498,28,3444,26,1238,28,26
"755","2020-05-20",78,9,116,122,6953,0.972673666043435,0,0,653,498,20,3464,23,1261,19,23
"756","2020-05-21",59,9,102,106,6953,0.972673666043435,0,0,653,498,20,3484,14,1275,19,14
"757","2020-05-22",46,9,83,95,6953,0.972673666043435,0,0,653,498,19,3503,6,1281,17,6
"758","2020-05-23",37,9,92,88,6953,0.972673666043435,0,0,653,498,13,3516,7,1288,12,7
"759","2020-05-24",35,9,87,76,6953,0.972673666043435,0,0,653,498,22,3538,8,1296,21,8
"760","2020-05-25",29,9,88,62,6953,0.972673666043435,0,0,653,498,23,3561,5,1301,20,5
"761","2020-05-26",30,9,81,49,6953,0.972673666043435,0,0,653,498,14,3575,7,1308,13,7
"762","2020-05-27",24,9,79,45,6953,0.972673666043435,0,0,653,498,16,3591,5,1313,13,5
"763","2020-05-28",25,9,70,42,6953,0.972673666043435,0,0,653,498,18,3609,7,1320,17,7
"764","2020-05-29",21,9,82,34,6953,0.972673666043435,0,0,653,498,10,3619,15,1335,10,15
"765","2020-05-30",18,9,85,32,6953,0.972673666043435,0,0,653,498,20,3639,29,1364,19,29
"766","2020-05-31",12,9,85,30,6953,0.972673666043435,0,0,653,498,18,3657,26,1390,16,26
"767","2020-06-01",11,9,90,28,6953,0.972673666043435,0,0,653,498,21,3678,26,1416,21,26
"768","2020-06-02",8,9,88,23,6953,0.972673666043435,0,0,653,498,19,3697,19,1435,18,19
"769","2020-06-03",7,9,102,21,6953,0.972673666043435,0,0,653,498,16,3713,17,1452,15,17
"770","2020-06-04",5,9,89,20,6953,0.972673666043435,0,0,653,498,13,3726,15,1467,12,15
"771","2020-06-05",7,9,81,18,6953,0.972673666043435,0,0,653,498,15,3741,11,1478,13,11
"772","2020-06-06",9,9,78,18,6953,0.972673666043435,0,0,653,498,13,3754,9,1487,13,9
"773","2020-06-07",12,9,71,20,6953,0.972673666043435,0,0,653,498,13,3767,21,1508,13,21
"774","2020-03-16",4,10,44,28,1863,0.782608695652174,0,0,164,463,19,84,NA,NA,7,NA
"775","2020-03-17",6,10,49,31,1863,0.782608695652174,0,0,164,463,23,107,NA,NA,13,NA
"776","2020-03-18",6,10,36,37,1863,0.782608695652174,0,0,164,463,29,136,6,21,15,6
"777","2020-03-19",8,10,39,52,1863,0.782608695652174,0,0,164,463,23,159,7,28,12,7
"778","2020-03-20",8,10,46,60,1863,0.782608695652174,0,0,164,463,26,185,7,35,18,7
"779","2020-03-21",11,10,44,71,1863,0.782608695652174,0,0,164,463,32,217,5,40,21,5
"780","2020-03-22",13,10,49,79,1863,0.782608695652174,0,0,164,463,43,260,5,45,28,5
"781","2020-03-23",10,10,47,88,1863,0.782608695652174,0,0,164,463,41,301,11,56,29,11
"782","2020-03-24",10,10,60,103,1863,0.782608695652174,0,0,164,463,23,324,10,66,16,10
"783","2020-03-25",12,10,56,115,1863,0.782608695652174,0,0,164,463,53,377,4,70,41,4
"784","2020-03-26",12,10,57,121,1863,0.782608695652174,0,0,164,463,54,431,4,74,46,4
"785","2020-03-27",18,10,71,133,1863,0.782608695652174,0,0,164,463,51,482,7,81,39,7
"786","2020-03-28",19,10,86,152,1863,0.782608695652174,0,0,164,463,43,525,6,87,35,6
"787","2020-03-29",25,10,103,167,1863,0.782608695652174,0,0,164,463,45,570,7,94,35,7
"788","2020-03-30",33,10,93,192,1863,0.782608695652174,0,0,164,463,41,611,12,106,32,12
"789","2020-03-31",37,10,91,198,1863,0.782608695652174,0,0,164,463,47,658,14,120,32,14
"790","2020-04-01",41,10,100,221,1863,0.782608695652174,0,0,164,463,46,704,12,132,34,12
"791","2020-04-02",43,10,117,230,1863,0.782608695652174,0,0,164,463,66,770,6,138,51,6
"792","2020-04-03",40,10,115,243,1863,0.782608695652174,0,0,164,463,75,845,4,142,60,4
"793","2020-04-04",45,10,123,245,1863,0.782608695652174,0,0,164,463,59,904,12,154,41,12
"794","2020-04-05",49,10,140,262,1863,0.782608695652174,0,0,164,463,77,981,16,170,56,16
"795","2020-04-06",46,10,129,258,1863,0.782608695652174,0,0,164,463,52,1033,12,182,42,12
"796","2020-04-07",52,10,109,273,1863,0.782608695652174,0,0,164,463,59,1092,11,193,47,11
"797","2020-04-08",59,10,108,284,1863,0.782608695652174,0,0,164,463,69,1161,14,207,56,14
"798","2020-04-09",67,10,108,286,1863,0.782608695652174,0,0,164,463,66,1227,16,223,54,16
"799","2020-04-10",83,10,100,297,1863,0.782608695652174,0,0,164,463,76,1303,13,236,65,13
"800","2020-04-11",88,10,104,299,1863,0.782608695652174,0,0,164,463,86,1389,15,251,70,15
"801","2020-04-12",91,10,91,299,1863,0.782608695652174,0,0,164,463,78,1467,13,264,71,13
"802","2020-04-13",95,10,76,293,1863,0.782608695652174,0,0,164,463,63,1530,26,290,50,26
"803","2020-04-14",90,10,91,291,1863,0.782608695652174,0,0,164,463,60,1590,8,298,52,8
"804","2020-04-15",85,10,99,306,1863,0.782608695652174,0,0,164,463,70,1660,4,302,52,4
"805","2020-04-16",80,10,99,307,1863,0.782608695652174,0,0,164,463,86,1746,5,307,78,5
"806","2020-04-17",74,10,91,323,1863,0.782608695652174,0,0,164,463,69,1815,14,321,60,14
"807","2020-04-18",71,10,85,326,1863,0.782608695652174,0,0,164,463,71,1886,15,336,59,15
"808","2020-04-19",73,10,74,334,1863,0.782608695652174,0,0,164,463,81,1967,25,361,64,25
"809","2020-04-20",75,10,97,341,1863,0.782608695652174,0,0,164,463,63,2030,30,391,48,30
"810","2020-04-21",77,10,125,349,1863,0.782608695652174,0,0,164,463,47,2077,23,414,36,23
"811","2020-04-22",84,10,150,345,1863,0.782608695652174,0,0,164,463,71,2148,22,436,57,22
"812","2020-04-23",92,10,159,354,1863,0.782608695652174,0,0,164,463,49,2197,13,449,42,13
"813","2020-04-24",99,10,168,352,1863,0.782608695652174,0,0,164,463,70,2267,15,464,57,15
"814","2020-04-25",102,10,181,355,1863,0.782608695652174,0,0,164,463,53,2320,16,480,41,16
"815","2020-04-26",105,10,167,346,1863,0.782608695652174,0,0,164,463,45,2365,12,492,33,12
"816","2020-04-27",112,10,143,349,1863,0.782608695652174,0,0,164,463,60,2425,16,508,51,16
"817","2020-04-28",111,10,128,334,1863,0.782608695652174,0,0,164,463,45,2470,17,525,29,17
"818","2020-04-29",112,10,122,328,1863,0.782608695652174,0,0,164,463,48,2518,20,545,38,20
"819","2020-04-30",110,10,100,301,1863,0.782608695652174,0,0,164,463,58,2576,19,564,43,19
"820","2020-05-01",103,10,107,293,1863,0.782608695652174,0,0,164,463,42,2618,10,574,34,10
"821","2020-05-02",99,10,101,289,1863,0.782608695652174,0,0,164,463,59,2677,24,598,44,24
"822","2020-05-03",98,10,99,292,1863,0.782608695652174,0,0,164,463,46,2723,8,606,39,8
"823","2020-05-04",91,10,85,285,1863,0.782608695652174,0,0,164,463,52,2775,17,623,45,17
"824","2020-05-05",92,10,110,284,1863,0.782608695652174,0,0,164,463,40,2815,33,656,30,33
"825","2020-05-06",82,10,122,268,1863,0.782608695652174,0,0,164,463,61,2876,23,679,47,23
"826","2020-05-07",84,10,121,279,1863,0.782608695652174,0,0,164,463,45,2921,24,703,33,24
"827","2020-05-08",82,10,129,281,1863,0.782608695652174,0,0,164,463,45,2966,25,728,37,25
"828","2020-05-09",86,10,142,287,1863,0.782608695652174,0,0,164,463,41,3007,8,736,29,8
"829","2020-05-10",78,10,152,285,1863,0.782608695652174,0,0,164,463,41,3048,10,746,33,10
"830","2020-05-11",78,10,133,285,1863,0.782608695652174,0,0,164,463,27,3075,12,758,19,12
"831","2020-05-12",87,10,114,273,1863,0.782608695652174,0,0,164,463,35,3110,24,782,29,24
"832","2020-05-13",93,10,110,275,1863,0.782608695652174,0,0,164,463,32,3142,16,798,24,16
"833","2020-05-14",89,10,98,264,1863,0.782608695652174,0,0,164,463,34,3176,24,822,23,24
"834","2020-05-15",90,10,88,256,1863,0.782608695652174,0,0,164,463,29,3205,16,838,20,16
"835","2020-05-16",82,10,84,264,1863,0.782608695652174,0,0,164,463,33,3238,25,863,24,25
"836","2020-05-17",81,10,83,258,1863,0.782608695652174,0,0,164,463,32,3270,14,877,21,14
"837","2020-05-18",80,10,79,263,1863,0.782608695652174,0,0,164,463,35,3305,22,899,26,22
"838","2020-05-19",75,10,76,243,1863,0.782608695652174,0,0,164,463,24,3329,23,922,13,23
"839","2020-05-20",66,10,76,240,1863,0.782608695652174,0,0,164,463,22,3351,25,947,12,25
"840","2020-05-21",64,10,81,237,1863,0.782608695652174,0,0,164,463,22,3373,13,960,17,13
"841","2020-05-22",66,10,87,224,1863,0.782608695652174,0,0,164,463,26,3399,10,970,17,10
"842","2020-05-23",66,10,94,221,1863,0.782608695652174,0,0,164,463,19,3418,12,982,13,12
"843","2020-05-24",63,10,93,211,1863,0.782608695652174,0,0,164,463,11,3429,19,1001,10,19
"844","2020-05-25",69,10,88,200,1863,0.782608695652174,0,0,164,463,14,3443,17,1018,10,17
"845","2020-05-26",64,10,83,187,1863,0.782608695652174,0,0,164,463,22,3465,9,1027,16,9
"846","2020-05-27",68,10,93,182,1863,0.782608695652174,0,0,164,463,15,3480,7,1034,12,7
"847","2020-05-28",61,10,88,175,1863,0.782608695652174,0,0,164,463,16,3496,12,1046,15,12
"848","2020-05-29",52,10,96,170,1863,0.782608695652174,0,0,164,463,24,3520,16,1062,16,16
"849","2020-05-30",51,10,94,167,1863,0.782608695652174,0,0,164,463,5,3525,9,1071,3,9
"850","2020-05-31",52,10,84,142,1863,0.782608695652174,0,0,164,463,9,3534,5,1076,6,5
"851","2020-06-01",40,10,77,135,1863,0.782608695652174,0,0,164,463,14,3548,10,1086,10,10
"852","2020-06-02",38,10,89,140,1863,0.782608695652174,0,0,164,463,17,3565,17,1103,10,17
"853","2020-06-03",38,10,93,140,1863,0.782608695652174,0,0,164,463,6,3571,9,1112,4,9
"854","2020-06-04",41,10,89,130,1863,0.782608695652174,0,0,164,463,12,3583,3,1115,5,3
"855","2020-06-05",45,10,101,130,1863,0.782608695652174,0,0,164,463,7,3590,10,1125,5,10
"856","2020-06-06",42,10,94,124,1863,0.782608695652174,0,0,164,463,3,3593,2,1127,2,2
"857","2020-06-07",41,10,82,127,1863,0.782608695652174,0,0,164,463,11,3604,4,1131,8,4
"858","2020-03-15",1,11,45,95,3100,0.548387096774194,0,0,288,430,33,119,20,65,15,20
"859","2020-03-16",3,11,44,114,3100,0.548387096774194,0,0,288,430,32,151,22,87,14,22
"860","2020-03-17",5,11,45,149,3100,0.548387096774194,0,0,288,430,34,185,19,106,12,19
"861","2020-03-18",9,11,47,182,3100,0.548387096774194,0,0,288,430,27,212,23,129,13,23
"862","2020-03-19",13,11,56,212,3100,0.548387096774194,0,0,288,430,33,245,32,161,15,32
"863","2020-03-20",19,11,56,245,3100,0.548387096774194,0,0,288,430,40,285,35,196,24,35
"864","2020-03-21",29,11,44,292,3100,0.548387096774194,0,0,288,430,39,324,31,227,26,31
"865","2020-03-22",46,11,35,333,3100,0.548387096774194,0,0,288,430,30,354,37,264,18,37
"866","2020-03-23",62,11,38,362,3100,0.548387096774194,0,0,288,430,42,396,40,304,23,40
"867","2020-03-24",71,11,57,392,3100,0.548387096774194,0,0,288,430,41,437,38,342,27,38
"868","2020-03-25",83,11,83,404,3100,0.548387096774194,0,0,288,430,52,489,50,392,27,50
"869","2020-03-26",99,11,81,435,3100,0.548387096774194,0,0,288,430,36,525,59,451,20,59
"870","2020-03-27",112,11,76,452,3100,0.548387096774194,0,0,288,430,54,579,45,496,32,45
"871","2020-03-28",122,11,91,464,3100,0.548387096774194,0,0,288,430,51,630,37,533,18,37
"872","2020-03-29",121,11,99,489,3100,0.548387096774194,0,0,288,430,52,682,27,560,29,27
"873","2020-03-30",119,11,107,493,3100,0.548387096774194,0,0,288,430,34,716,36,596,20,36
"874","2020-03-31",137,11,124,525,3100,0.548387096774194,0,0,288,430,58,774,38,634,27,38
"875","2020-04-01",140,11,147,523,3100,0.548387096774194,0,0,288,430,53,827,28,662,25,28
"876","2020-04-02",139,11,141,524,3100,0.548387096774194,0,0,288,430,52,879,48,710,28,48
"877","2020-04-03",141,11,130,511,3100,0.548387096774194,0,0,288,430,37,916,45,755,20,45
"878","2020-04-04",146,11,128,505,3100,0.548387096774194,0,0,288,430,48,964,32,787,29,32
"879","2020-04-05",151,11,141,503,3100,0.548387096774194,0,0,288,430,59,1023,29,816,33,29
"880","2020-04-06",156,11,151,522,3100,0.548387096774194,0,0,288,430,43,1066,32,848,15,32
"881","2020-04-07",138,11,145,510,3100,0.548387096774194,0,0,288,430,63,1129,29,877,36,29
"882","2020-04-08",135,11,152,499,3100,0.548387096774194,0,0,288,430,53,1182,25,902,26,25
"883","2020-04-09",130,11,145,487,3100,0.548387096774194,0,0,288,430,66,1248,29,931,35,29
"884","2020-04-10",134,11,136,473,3100,0.548387096774194,0,0,288,430,64,1312,33,964,37,33
"885","2020-04-11",131,11,116,481,3100,0.548387096774194,0,0,288,430,62,1374,21,985,33,21
"886","2020-04-12",129,11,107,462,3100,0.548387096774194,0,0,288,430,57,1431,34,1019,30,34
"887","2020-04-13",128,11,98,470,3100,0.548387096774194,0,0,288,430,86,1517,34,1053,53,34
"888","2020-04-14",145,11,94,454,3100,0.548387096774194,0,0,288,430,60,1577,55,1108,35,55
"889","2020-04-15",144,11,96,454,3100,0.548387096774194,0,0,288,430,44,1621,34,1142,26,34
"890","2020-04-16",148,11,111,451,3100,0.548387096774194,0,0,288,430,56,1677,53,1195,42,53
"891","2020-04-17",145,11,121,432,3100,0.548387096774194,0,0,288,430,59,1736,60,1255,43,60
"892","2020-04-18",139,11,139,435,3100,0.548387096774194,0,0,288,430,56,1792,58,1313,28,58
"893","2020-04-19",135,11,153,424,3100,0.548387096774194,0,0,288,430,59,1851,29,1342,31,29
"894","2020-04-20",136,11,169,411,3100,0.548387096774194,0,0,288,430,46,1897,27,1369,30,27
"895","2020-04-21",130,11,159,406,3100,0.548387096774194,0,0,288,430,42,1939,48,1417,27,48
"896","2020-04-22",131,11,160,409,3100,0.548387096774194,0,0,288,430,39,1978,42,1459,21,42
"897","2020-04-23",133,11,158,400,3100,0.548387096774194,0,0,288,430,49,2027,58,1517,25,58
"898","2020-04-24",133,11,186,411,3100,0.548387096774194,0,0,288,430,56,2083,65,1582,22,65
"899","2020-04-25",139,11,167,411,3100,0.548387096774194,0,0,288,430,55,2138,33,1615,32,33
"900","2020-04-26",138,11,149,418,3100,0.548387096774194,0,0,288,430,53,2191,48,1663,25,48
"901","2020-04-27",133,11,142,419,3100,0.548387096774194,0,0,288,430,45,2236,76,1739,18,76
"902","2020-04-28",127,11,161,397,3100,0.548387096774194,0,0,288,430,40,2276,56,1795,18,56
"903","2020-04-29",130,11,166,400,3100,0.548387096774194,0,0,288,430,44,2320,59,1854,20,59
"904","2020-04-30",128,11,157,383,3100,0.548387096774194,0,0,288,430,43,2363,49,1903,21,49
"905","2020-05-01",118,11,168,377,3100,0.548387096774194,0,0,288,430,38,2401,40,1943,8,40
"906","2020-05-02",111,11,166,378,3100,0.548387096774194,0,0,288,430,42,2443,55,1998,20,55
"907","2020-05-03",115,11,153,375,3100,0.548387096774194,0,0,288,430,43,2486,49,2047,17,49
"908","2020-05-04",116,11,169,357,3100,0.548387096774194,0,0,288,430,52,2538,33,2080,27,33
"909","2020-05-05",111,11,190,367,3100,0.548387096774194,0,0,288,430,29,2567,30,2110,15,30
"910","2020-05-06",104,11,203,369,3100,0.548387096774194,0,0,288,430,27,2594,30,2140,14,30
"911","2020-05-07",95,11,178,374,3100,0.548387096774194,0,0,288,430,43,2637,31,2171,16,31
"912","2020-05-08",101,11,150,386,3100,0.548387096774194,0,0,288,430,36,2673,38,2209,16,38
"913","2020-05-09",99,11,130,373,3100,0.548387096774194,0,0,288,430,40,2713,45,2254,18,45
"914","2020-05-10",97,11,122,390,3100,0.548387096774194,0,0,288,430,47,2760,37,2291,25,37
"915","2020-05-11",89,11,118,382,3100,0.548387096774194,0,0,288,430,36,2796,36,2327,16,36
"916","2020-05-12",87,11,132,387,3100,0.548387096774194,0,0,288,430,33,2829,23,2350,12,23
"917","2020-05-13",91,11,126,389,3100,0.548387096774194,0,0,288,430,44,2873,37,2387,16,37
"918","2020-05-14",96,11,136,375,3100,0.548387096774194,0,0,288,430,33,2906,58,2445,18,58
"919","2020-05-15",98,11,126,372,3100,0.548387096774194,0,0,288,430,39,2945,51,2496,20,51
"920","2020-05-16",99,11,115,365,3100,0.548387096774194,0,0,288,430,35,2980,60,2556,18,60
"921","2020-05-17",91,11,133,350,3100,0.548387096774194,0,0,288,430,25,3005,37,2593,18,37
"922","2020-05-18",98,11,123,358,3100,0.548387096774194,0,0,288,430,31,3036,35,2628,15,35
"923","2020-05-19",104,11,112,359,3100,0.548387096774194,0,0,288,430,21,3057,55,2683,8,55
"924","2020-05-20",108,11,130,373,3100,0.548387096774194,0,0,288,430,31,3088,50,2733,18,50
"925","2020-05-21",109,11,133,375,3100,0.548387096774194,0,0,288,430,30,3118,41,2774,14,41
"926","2020-05-22",106,11,126,362,3100,0.548387096774194,0,0,288,430,30,3148,37,2811,22,37
"927","2020-05-23",103,11,131,334,3100,0.548387096774194,0,0,288,430,22,3170,52,2863,12,52
"928","2020-05-24",103,11,142,331,3100,0.548387096774194,0,0,288,430,26,3196,41,2904,13,41
"929","2020-05-25",101,11,147,310,3100,0.548387096774194,0,0,288,430,19,3215,32,2936,12,32
"930","2020-05-26",97,11,134,293,3100,0.548387096774194,0,0,288,430,20,3235,42,2978,9,42
"931","2020-05-27",84,11,125,290,3100,0.548387096774194,0,0,288,430,31,3266,45,3023,17,45
"932","2020-05-28",87,11,94,289,3100,0.548387096774194,0,0,288,430,21,3287,52,3075,12,52
"933","2020-05-29",80,11,80,284,3100,0.548387096774194,0,0,288,430,18,3305,53,3128,7,53
"934","2020-05-30",82,11,76,284,3100,0.548387096774194,0,0,288,430,17,3322,50,3178,11,50
"935","2020-05-31",85,11,78,262,3100,0.548387096774194,0,0,288,430,16,3338,47,3225,11,47
"936","2020-06-01",82,11,78,255,3100,0.548387096774194,0,0,288,430,27,3365,34,3259,16,34
"937","2020-06-02",81,11,71,242,3100,0.548387096774194,0,0,288,430,11,3376,43,3302,5,43
"938","2020-06-03",81,11,61,231,3100,0.548387096774194,0,0,288,430,14,3390,44,3346,7,44
"939","2020-06-04",71,11,66,227,3100,0.548387096774194,0,0,288,430,11,3401,53,3399,4,53
"940","2020-06-05",69,11,81,218,3100,0.548387096774194,0,0,288,430,8,3409,45,3444,5,45
"941","2020-06-06",61,11,75,209,3100,0.548387096774194,0,0,288,430,12,3421,48,3492,5,48
"942","2020-06-07",61,11,64,201,3100,0.548387096774194,0,0,288,430,14,3435,47,3539,8,47
"943","2020-03-13",1,12,27,58,2895,0.412780656303972,0,0,259,455,7,21,17,39,1,17
"944","2020-03-14",3,12,29,84,2895,0.412780656303972,0,0,259,455,17,38,15,54,8,15
"945","2020-03-15",4,12,23,107,2895,0.412780656303972,0,0,259,455,14,52,17,71,5,17
"946","2020-03-16",9,12,20,131,2895,0.412780656303972,0,0,259,455,11,63,9,80,7,9
"947","2020-03-17",13,12,24,151,2895,0.412780656303972,0,0,259,455,16,79,8,88,6,8
"948","2020-03-18",16,12,24,182,2895,0.412780656303972,0,0,259,455,23,102,6,94,16,6
"949","2020-03-19",20,12,20,202,2895,0.412780656303972,0,0,259,455,20,122,16,110,10,16
"950","2020-03-20",31,12,28,223,2895,0.412780656303972,0,0,259,455,27,149,19,129,15,19
"951","2020-03-21",38,12,32,239,2895,0.412780656303972,0,0,259,455,28,177,21,150,14,21
"952","2020-03-22",44,12,32,256,2895,0.412780656303972,0,0,259,455,31,208,6,156,21,6
"953","2020-03-23",45,12,40,271,2895,0.412780656303972,0,0,259,455,35,243,10,166,25,10
"954","2020-03-24",47,12,39,283,2895,0.412780656303972,0,0,259,455,27,270,16,182,23,16
"955","2020-03-25",54,12,51,294,2895,0.412780656303972,0,0,259,455,41,311,22,204,32,22
"956","2020-03-26",59,12,59,304,2895,0.412780656303972,0,0,259,455,37,348,17,221,30,17
"957","2020-03-27",62,12,72,320,2895,0.412780656303972,0,0,259,455,33,381,28,249,23,28
"958","2020-03-28",62,12,72,328,2895,0.412780656303972,0,0,259,455,39,420,16,265,32,16
"959","2020-03-29",70,12,75,334,2895,0.412780656303972,0,0,259,455,33,453,27,292,22,27
"960","2020-03-30",78,12,82,354,2895,0.412780656303972,0,0,259,455,39,492,11,303,27,11
"961","2020-03-31",90,12,92,371,2895,0.412780656303972,0,0,259,455,45,537,9,312,37,9
"962","2020-04-01",96,12,97,378,2895,0.412780656303972,0,0,259,455,46,583,18,330,36,18
"963","2020-04-02",100,12,104,383,2895,0.412780656303972,0,0,259,455,44,627,20,350,33,20
"964","2020-04-03",99,12,112,392,2895,0.412780656303972,0,0,259,455,60,687,26,376,46,26
"965","2020-04-04",103,12,110,409,2895,0.412780656303972,0,0,259,455,54,741,22,398,44,22
"966","2020-04-05",111,12,119,414,2895,0.412780656303972,0,0,259,455,44,785,15,413,38,15
"967","2020-04-06",120,12,109,422,2895,0.412780656303972,0,0,259,455,58,843,1,414,40,1
"968","2020-04-07",121,12,97,416,2895,0.412780656303972,0,0,259,455,59,902,4,418,48,4
"969","2020-04-08",120,12,97,418,2895,0.412780656303972,0,0,259,455,37,939,22,440,33,22
"970","2020-04-09",125,12,97,422,2895,0.412780656303972,0,0,259,455,75,1014,28,468,59,28
"971","2020-04-10",131,12,109,406,2895,0.412780656303972,0,0,259,455,53,1067,34,502,38,34
"972","2020-04-11",135,12,120,420,2895,0.412780656303972,0,0,259,455,57,1124,19,521,41,19
"973","2020-04-12",125,12,121,429,2895,0.412780656303972,0,0,259,455,86,1210,17,538,76,17
"974","2020-04-13",123,12,131,427,2895,0.412780656303972,0,0,259,455,53,1263,22,560,46,22
"975","2020-04-14",127,12,144,431,2895,0.412780656303972,0,0,259,455,68,1331,21,581,58,21
"976","2020-04-15",128,12,140,442,2895,0.412780656303972,0,0,259,455,61,1392,5,586,50,5
"977","2020-04-16",124,12,139,440,2895,0.412780656303972,0,0,259,455,43,1435,14,600,36,14
"978","2020-04-17",121,12,131,453,2895,0.412780656303972,0,0,259,455,60,1495,26,626,43,26
"979","2020-04-18",122,12,132,459,2895,0.412780656303972,0,0,259,455,55,1550,29,655,43,29
"980","2020-04-19",125,12,126,440,2895,0.412780656303972,0,0,259,455,75,1625,43,698,62,43
"981","2020-04-20",118,12,130,439,2895,0.412780656303972,0,0,259,455,70,1695,29,727,54,29
"982","2020-04-21",108,12,127,457,2895,0.412780656303972,0,0,259,455,63,1758,27,754,51,27
"983","2020-04-22",119,12,127,474,2895,0.412780656303972,0,0,259,455,58,1816,14,768,44,14
"984","2020-04-23",123,12,138,473,2895,0.412780656303972,0,0,259,455,57,1873,12,780,48,12
"985","2020-04-24",128,12,129,461,2895,0.412780656303972,0,0,259,455,44,1917,8,788,35,8
"986","2020-04-25",125,12,127,458,2895,0.412780656303972,0,0,259,455,55,1972,29,817,47,29
"987","2020-04-26",126,12,140,455,2895,0.412780656303972,0,0,259,455,50,2022,14,831,42,14
"988","2020-04-27",129,12,128,444,2895,0.412780656303972,0,0,259,455,48,2070,37,868,34,37
"989","2020-04-28",130,12,120,428,2895,0.412780656303972,0,0,259,455,64,2134,12,880,50,12
"990","2020-04-29",115,12,115,428,2895,0.412780656303972,0,0,259,455,51,2185,11,891,43,11
"991","2020-04-30",110,12,111,399,2895,0.412780656303972,0,0,259,455,39,2224,11,902,31,11
"992","2020-05-01",106,12,134,405,2895,0.412780656303972,0,0,259,455,57,2281,9,911,50,9
"993","2020-05-02",114,12,133,417,2895,0.412780656303972,0,0,259,455,47,2328,25,936,32,25
"994","2020-05-03",123,12,133,415,2895,0.412780656303972,0,0,259,455,32,2360,39,975,23,39
"995","2020-05-04",120,12,143,433,2895,0.412780656303972,0,0,259,455,45,2405,22,997,36,22
"996","2020-05-05",125,12,142,435,2895,0.412780656303972,0,0,259,455,46,2451,29,1026,34,29
"997","2020-05-06",125,12,141,435,2895,0.412780656303972,0,0,259,455,22,2473,41,1067,18,41
"998","2020-05-07",134,12,135,431,2895,0.412780656303972,0,0,259,455,38,2511,22,1089,32,22
"999","2020-05-08",134,12,135,433,2895,0.412780656303972,0,0,259,455,34,2545,32,1121,28,32
"1000","2020-05-09",133,12,120,432,2895,0.412780656303972,0,0,259,455,34,2579,24,1145,25,24
"1001","2020-05-10",123,12,115,426,2895,0.412780656303972,0,0,259,455,36,2615,40,1185,29,40
"1002","2020-05-11",130,12,116,416,2895,0.412780656303972,0,0,259,455,41,2656,30,1215,31,30
"1003","2020-05-12",118,12,127,421,2895,0.412780656303972,0,0,259,455,41,2697,31,1246,29,31
"1004","2020-05-13",122,12,144,407,2895,0.412780656303972,0,0,259,455,38,2735,35,1281,29,35
"1005","2020-05-14",112,12,141,377,2895,0.412780656303972,0,0,259,455,34,2769,22,1303,28,22
"1006","2020-05-15",114,12,137,357,2895,0.412780656303972,0,0,259,455,38,2807,28,1331,33,28
"1007","2020-05-16",107,12,126,351,2895,0.412780656303972,0,0,259,455,38,2845,12,1343,31,12
"1008","2020-05-17",110,12,117,346,2895,0.412780656303972,0,0,259,455,30,2875,7,1350,23,7
"1009","2020-05-18",100,12,123,337,2895,0.412780656303972,0,0,259,455,30,2905,7,1357,24,7
"1010","2020-05-19",106,12,131,316,2895,0.412780656303972,0,0,259,455,25,2930,7,1364,20,7
"1011","2020-05-20",106,12,140,308,2895,0.412780656303972,0,0,259,455,33,2963,7,1371,26,7
"1012","2020-05-21",108,12,159,294,2895,0.412780656303972,0,0,259,455,30,2993,10,1381,25,10
"1013","2020-05-22",105,12,151,279,2895,0.412780656303972,0,0,259,455,33,3026,22,1403,25,22
"1014","2020-05-23",100,12,151,268,2895,0.412780656303972,0,0,259,455,30,3056,20,1423,25,20
"1015","2020-05-24",89,12,144,268,2895,0.412780656303972,0,0,259,455,33,3089,19,1442,25,19
"1016","2020-05-25",93,12,141,266,2895,0.412780656303972,0,0,259,455,28,3117,8,1450,24,8
"1017","2020-05-26",83,12,146,248,2895,0.412780656303972,0,0,259,455,20,3137,8,1458,18,8
"1018","2020-05-27",76,12,146,246,2895,0.412780656303972,0,0,259,455,21,3158,7,1465,16,7
"1019","2020-05-28",71,12,146,252,2895,0.412780656303972,0,0,259,455,28,3186,12,1477,19,12
"1020","2020-05-29",61,12,142,240,2895,0.412780656303972,0,0,259,455,17,3203,15,1492,14,15
"1021","2020-05-30",56,12,134,228,2895,0.412780656303972,0,0,259,455,23,3226,8,1500,15,8
"1022","2020-05-31",58,12,139,224,2895,0.412780656303972,0,0,259,455,23,3249,17,1517,15,17
"1023","2020-06-01",48,12,134,214,2895,0.412780656303972,0,0,259,455,21,3270,17,1534,17,17
"1024","2020-06-02",57,12,135,202,2895,0.412780656303972,0,0,259,455,19,3289,12,1546,11,12
"1025","2020-06-03",52,12,131,190,2895,0.412780656303972,0,0,259,455,13,3302,8,1554,13,8
"1026","2020-06-04",54,12,130,189,2895,0.412780656303972,0,0,259,455,14,3316,14,1568,11,14
"1027","2020-06-05",54,12,121,188,2895,0.412780656303972,0,0,259,455,21,3337,12,1580,16,12
"1028","2020-06-06",55,12,114,175,2895,0.412780656303972,0,0,259,455,18,3355,13,1593,15,13
"1029","2020-06-07",54,12,122,171,2895,0.412780656303972,0,0,259,455,10,3365,1,1594,8,1
"1030","2020-03-14",1,13,33,25,1665,0.667867867867868,0,0,126,380,15,47,6,24,2,6
"1031","2020-03-15",2,13,26,36,1665,0.667867867867868,0,0,126,380,17,64,2,26,5,2
"1032","2020-03-16",2,13,30,45,1665,0.667867867867868,0,0,126,380,24,88,2,28,9,2
"1033","2020-03-17",3,13,34,51,1665,0.667867867867868,0,0,126,380,22,110,2,30,6,2
"1034","2020-03-18",5,13,34,65,1665,0.667867867867868,0,0,126,380,23,133,9,39,9,9
"1035","2020-03-19",6,13,36,77,1665,0.667867867867868,0,0,126,380,24,157,6,45,16,6
"1036","2020-03-20",10,13,50,90,1665,0.667867867867868,0,0,126,380,24,181,6,51,10,6
"1037","2020-03-21",12,13,43,104,1665,0.667867867867868,0,0,126,380,26,207,6,57,16,6
"1038","2020-03-22",17,13,45,118,1665,0.667867867867868,0,0,126,380,24,231,4,61,16,4
"1039","2020-03-23",21,13,50,128,1665,0.667867867867868,0,0,126,380,29,260,5,66,13,5
"1040","2020-03-24",27,13,57,134,1665,0.667867867867868,0,0,126,380,33,293,12,78,17,12
"1041","2020-03-25",30,13,66,149,1665,0.667867867867868,0,0,126,380,37,330,12,90,18,12
"1042","2020-03-26",30,13,70,168,1665,0.667867867867868,0,0,126,380,31,361,7,97,18,7
"1043","2020-03-27",34,13,86,179,1665,0.667867867867868,0,0,126,380,30,391,4,101,18,4
"1044","2020-03-28",33,13,80,189,1665,0.667867867867868,0,0,126,380,32,423,4,105,16,4
"1045","2020-03-29",36,13,78,201,1665,0.667867867867868,0,0,126,380,37,460,3,108,24,3
"1046","2020-03-30",43,13,82,221,1665,0.667867867867868,0,0,126,380,43,503,6,114,30,6
"1047","2020-03-31",44,13,89,226,1665,0.667867867867868,0,0,126,380,49,552,11,125,34,11
"1048","2020-04-01",51,13,91,234,1665,0.667867867867868,0,0,126,380,42,594,13,138,28,13
"1049","2020-04-02",58,13,114,242,1665,0.667867867867868,0,0,126,380,49,643,10,148,29,10
"1050","2020-04-03",61,13,131,262,1665,0.667867867867868,0,0,126,380,41,684,12,160,30,12
"1051","2020-04-04",72,13,142,264,1665,0.667867867867868,0,0,126,380,47,731,14,174,33,14
"1052","2020-04-05",72,13,148,268,1665,0.667867867867868,0,0,126,380,40,771,22,196,27,22
"1053","2020-04-06",72,13,155,260,1665,0.667867867867868,0,0,126,380,43,814,19,215,28,19
"1054","2020-04-07",76,13,163,261,1665,0.667867867867868,0,0,126,380,37,851,14,229,27,14
"1055","2020-04-08",74,13,170,268,1665,0.667867867867868,0,0,126,380,42,893,12,241,20,12
"1056","2020-04-09",72,13,184,277,1665,0.667867867867868,0,0,126,380,51,944,15,256,34,15
"1057","2020-04-10",76,13,168,279,1665,0.667867867867868,0,0,126,380,29,973,18,274,17,18
"1058","2020-04-11",73,13,182,272,1665,0.667867867867868,0,0,126,380,43,1016,13,287,28,13
"1059","2020-04-12",78,13,197,272,1665,0.667867867867868,0,0,126,380,54,1070,10,297,36,10
"1060","2020-04-13",76,13,195,276,1665,0.667867867867868,0,0,126,380,40,1110,1,298,28,1
"1061","2020-04-14",73,13,179,269,1665,0.667867867867868,0,0,126,380,47,1157,10,308,31,10
"1062","2020-04-15",76,13,180,266,1665,0.667867867867868,0,0,126,380,45,1202,8,316,24,8
"1063","2020-04-16",75,13,180,260,1665,0.667867867867868,0,0,126,380,29,1231,7,323,17,7
"1064","2020-04-17",70,13,174,250,1665,0.667867867867868,0,0,126,380,44,1275,6,329,28,6
"1065","2020-04-18",69,13,158,244,1665,0.667867867867868,0,0,126,380,39,1314,7,336,19,7
"1066","2020-04-19",64,13,147,248,1665,0.667867867867868,0,0,126,380,35,1349,16,352,18,16
"1067","2020-04-20",68,13,140,247,1665,0.667867867867868,0,0,126,380,35,1384,17,369,20,17
"1068","2020-04-21",68,13,146,238,1665,0.667867867867868,0,0,126,380,49,1433,28,397,31,28
"1069","2020-04-22",63,13,159,229,1665,0.667867867867868,0,0,126,380,54,1487,11,408,33,11
"1070","2020-04-23",68,13,167,227,1665,0.667867867867868,0,0,126,380,37,1524,6,414,20,6
"1071","2020-04-24",72,13,153,232,1665,0.667867867867868,0,0,126,380,37,1561,10,424,21,10
"1072","2020-04-25",75,13,140,228,1665,0.667867867867868,0,0,126,380,30,1591,5,429,17,5
"1073","2020-04-26",77,13,149,225,1665,0.667867867867868,0,0,126,380,35,1626,4,433,24,4
"1074","2020-04-27",75,13,151,214,1665,0.667867867867868,0,0,126,380,33,1659,18,451,24,18
"1075","2020-04-28",70,13,153,207,1665,0.667867867867868,0,0,126,380,46,1705,15,466,26,15
"1076","2020-04-29",74,13,142,203,1665,0.667867867867868,0,0,126,380,29,1734,22,488,14,22
"1077","2020-04-30",69,13,124,210,1665,0.667867867867868,0,0,126,380,43,1777,8,496,24,8
"1078","2020-05-01",58,13,123,210,1665,0.667867867867868,0,0,126,380,40,1817,18,514,27,18
"1079","2020-05-02",54,13,137,211,1665,0.667867867867868,0,0,126,380,29,1846,17,531,14,17
"1080","2020-05-03",50,13,151,208,1665,0.667867867867868,0,0,126,380,25,1871,19,550,12,19
"1081","2020-05-04",46,13,160,208,1665,0.667867867867868,0,0,126,380,45,1916,22,572,26,22
"1082","2020-05-05",47,13,171,197,1665,0.667867867867868,0,0,126,380,30,1946,20,592,17,20
"1083","2020-05-06",45,13,164,204,1665,0.667867867867868,0,0,126,380,46,1992,25,617,31,25
"1084","2020-05-07",49,13,165,200,1665,0.667867867867868,0,0,126,380,34,2026,30,647,16,30
"1085","2020-05-08",54,13,152,191,1665,0.667867867867868,0,0,126,380,27,2053,19,666,12,19
"1086","2020-05-09",49,13,155,191,1665,0.667867867867868,0,0,126,380,31,2084,15,681,20,15
"1087","2020-05-10",46,13,155,199,1665,0.667867867867868,0,0,126,380,36,2120,21,702,20,21
"1088","2020-05-11",45,13,153,205,1665,0.667867867867868,0,0,126,380,28,2148,16,718,12,16
"1089","2020-05-12",50,13,150,208,1665,0.667867867867868,0,0,126,380,41,2189,21,739,22,21
"1090","2020-05-13",50,13,160,213,1665,0.667867867867868,0,0,126,380,27,2216,17,756,15,17
"1091","2020-05-14",49,13,165,216,1665,0.667867867867868,0,0,126,380,30,2246,13,769,22,13
"1092","2020-05-15",46,13,172,215,1665,0.667867867867868,0,0,126,380,31,2277,5,774,22,5
"1093","2020-05-16",54,13,174,215,1665,0.667867867867868,0,0,126,380,36,2313,14,788,24,14
"1094","2020-05-17",55,13,166,216,1665,0.667867867867868,0,0,126,380,33,2346,13,801,18,13
"1095","2020-05-18",60,13,157,215,1665,0.667867867867868,0,0,126,380,32,2378,18,819,19,18
"1096","2020-05-19",56,13,176,216,1665,0.667867867867868,0,0,126,380,34,2412,12,831,19,12
"1097","2020-05-20",55,13,163,212,1665,0.667867867867868,0,0,126,380,30,2442,10,841,18,10
"1098","2020-05-21",54,13,153,216,1665,0.667867867867868,0,0,126,380,29,2471,8,849,16,8
"1099","2020-05-22",58,13,142,216,1665,0.667867867867868,0,0,126,380,36,2507,7,856,22,7
"1100","2020-05-23",54,13,144,215,1665,0.667867867867868,0,0,126,380,24,2531,21,877,18,21
"1101","2020-05-24",63,13,151,199,1665,0.667867867867868,0,0,126,380,22,2553,10,887,14,10
"1102","2020-05-25",68,13,159,194,1665,0.667867867867868,0,0,126,380,27,2580,6,893,18,6
"1103","2020-05-26",71,13,167,188,1665,0.667867867867868,0,0,126,380,25,2605,12,905,19,12
"1104","2020-05-27",70,13,171,180,1665,0.667867867867868,0,0,126,380,23,2628,6,911,16,6
"1105","2020-05-28",68,13,162,180,1665,0.667867867867868,0,0,126,380,12,2640,7,918,7,7
"1106","2020-05-29",69,13,152,184,1665,0.667867867867868,0,0,126,380,25,2665,12,930,16,12
"1107","2020-05-30",66,13,154,183,1665,0.667867867867868,0,0,126,380,18,2683,9,939,11,9
"1108","2020-05-31",55,13,160,178,1665,0.667867867867868,0,0,126,380,16,2699,3,942,8,3
"1109","2020-06-01",49,13,159,175,1665,0.667867867867868,0,0,126,380,21,2720,8,950,15,8
"1110","2020-06-02",46,13,141,174,1665,0.667867867867868,0,0,126,380,14,2734,6,956,10,6
"1111","2020-06-03",45,13,123,178,1665,0.667867867867868,0,0,126,380,15,2749,5,961,9,5
"1112","2020-06-04",48,13,111,165,1665,0.667867867867868,0,0,126,380,14,2763,5,966,8,5
"1113","2020-06-05",51,13,108,158,1665,0.667867867867868,0,0,126,380,19,2782,7,973,14,7
"1114","2020-06-06",56,13,100,148,1665,0.667867867867868,0,0,126,380,13,2795,5,978,10,5
"1115","2020-06-07",59,13,102,137,1665,0.667867867867868,0,0,126,380,14,2809,4,982,12,4
"1116","2020-03-15",2,14,45,42,5750,0.923304347826087,0,0,543,448,27,95,10,52,22,10
"1117","2020-03-16",5,14,51,59,5750,0.923304347826087,0,0,543,448,28,123,2,54,19,2
"1118","2020-03-17",9,14,59,77,5750,0.923304347826087,0,0,543,448,35,158,3,57,25,3
"1119","2020-03-18",11,14,61,99,5750,0.923304347826087,0,0,543,448,35,193,2,59,26,2
"1120","2020-03-19",13,14,60,124,5750,0.923304347826087,0,0,543,448,55,248,15,74,47,15
"1121","2020-03-20",16,14,59,146,5750,0.923304347826087,0,0,543,448,53,301,22,96,41,22
"1122","2020-03-21",19,14,73,166,5750,0.923304347826087,0,0,543,448,81,382,9,105,72,9
"1123","2020-03-22",23,14,75,194,5750,0.923304347826087,0,0,543,448,75,457,22,127,64,22
"1124","2020-03-23",28,14,74,236,5750,0.923304347826087,0,0,543,448,97,554,7,134,86,7
"1125","2020-03-24",37,14,72,270,5750,0.923304347826087,0,0,543,448,105,659,31,165,94,31
"1126","2020-03-25",51,14,77,308,5750,0.923304347826087,0,0,543,448,113,772,20,185,105,20
"1127","2020-03-26",70,14,68,350,5750,0.923304347826087,0,0,543,448,227,999,12,197,216,12
"1128","2020-03-27",82,14,81,390,5750,0.923304347826087,0,0,543,448,173,1172,21,218,168,21
"1129","2020-03-28",101,14,92,432,5750,0.923304347826087,0,0,543,448,187,1359,28,246,180,28
"1130","2020-03-29",111,14,101,494,5750,0.923304347826087,0,0,543,448,271,1630,32,278,263,32
"1131","2020-03-30",132,14,118,535,5750,0.923304347826087,0,0,543,448,249,1879,27,305,244,27
"1132","2020-03-31",143,14,113,573,5750,0.923304347826087,0,0,543,448,286,2165,29,334,282,29
"1133","2020-04-01",149,14,105,626,5750,0.923304347826087,0,0,543,448,317,2482,21,355,309,21
"1134","2020-04-02",148,14,107,676,5750,0.923304347826087,0,0,543,448,356,2838,12,367,344,12
"1135","2020-04-03",163,14,92,710,5750,0.923304347826087,0,0,543,448,372,3210,34,401,363,34
"1136","2020-04-04",171,14,88,761,5750,0.923304347826087,0,0,543,448,380,3590,20,421,374,20
"1137","2020-04-05",186,14,99,818,5750,0.923304347826087,0,0,543,448,420,4010,32,453,409,32
"1138","2020-04-06",190,14,121,910,5750,0.923304347826087,0,0,543,448,400,4410,24,477,393,24
"1139","2020-04-07",201,14,134,1013,5750,0.923304347826087,0,0,543,448,355,4765,27,504,353,27
"1140","2020-04-08",212,14,148,1080,5750,0.923304347826087,0,0,543,448,376,5141,28,532,371,28
"1141","2020-04-09",233,14,141,1176,5750,0.923304347826087,0,0,543,448,296,5437,17,549,295,17
"1142","2020-04-10",252,14,137,1279,5750,0.923304347826087,0,0,543,448,327,5764,32,581,321,32
"1143","2020-04-11",290,14,138,1340,5750,0.923304347826087,0,0,543,448,292,6056,16,597,289,16
"1144","2020-04-12",316,14,130,1410,5750,0.923304347826087,0,0,543,448,196,6252,18,615,190,18
"1145","2020-04-13",336,14,120,1487,5750,0.923304347826087,0,0,543,448,161,6413,10,625,154,10
"1146","2020-04-14",368,14,107,1524,5750,0.923304347826087,0,0,543,448,167,6580,28,653,167,28
"1147","2020-04-15",397,14,110,1564,5750,0.923304347826087,0,0,543,448,103,6683,21,674,100,21
"1148","2020-04-16",413,14,122,1627,5750,0.923304347826087,0,0,543,448,95,6778,13,687,90,13
"1149","2020-04-17",419,14,117,1669,5750,0.923304347826087,0,0,543,448,67,6845,19,706,64,19
"1150","2020-04-18",433,14,111,1686,5750,0.923304347826087,0,0,543,448,85,6930,6,712,85,6
"1151","2020-04-19",432,14,117,1689,5750,0.923304347826087,0,0,543,448,76,7006,2,714,74,2
"1152","2020-04-20",452,14,127,1706,5750,0.923304347826087,0,0,543,448,43,7049,6,720,43,6
"1153","2020-04-21",456,14,146,1677,5750,0.923304347826087,0,0,543,448,30,7079,32,752,27,32
"1154","2020-04-22",468,14,140,1643,5750,0.923304347826087,0,0,543,448,26,7105,24,776,26,24
"1155","2020-04-23",476,14,127,1610,5750,0.923304347826087,0,0,543,448,25,7130,16,792,23,16
"1156","2020-04-24",482,14,138,1579,5750,0.923304347826087,0,0,543,448,22,7152,16,808,22,16
"1157","2020-04-25",456,14,149,1532,5750,0.923304347826087,0,0,543,448,22,7174,29,837,22,29
"1158","2020-04-26",461,14,151,1473,5750,0.923304347826087,0,0,543,448,10,7184,21,858,10,21
"1159","2020-04-27",443,14,141,1414,5750,0.923304347826087,0,0,543,448,16,7200,14,872,13,14
"1160","2020-04-28",439,14,154,1364,5750,0.923304347826087,0,0,543,448,7,7207,45,917,5,45
"1161","2020-04-29",413,14,155,1275,5750,0.923304347826087,0,0,543,448,9,7216,38,955,7,38
"1162","2020-04-30",384,14,176,1206,5750,0.923304347826087,0,0,543,448,12,7228,26,981,10,26
"1163","2020-05-01",367,14,182,1122,5750,0.923304347826087,0,0,543,448,5,7233,36,1017,3,36
"1164","2020-05-02",358,14,185,1057,5750,0.923304347826087,0,0,543,448,6,7239,25,1042,4,25
"1165","2020-05-03",332,14,187,992,5750,0.923304347826087,0,0,543,448,4,7243,8,1050,4,8
"1166","2020-05-04",324,14,199,950,5750,0.923304347826087,0,0,543,448,5,7248,10,1060,2,10
"1167","2020-05-05",299,14,206,892,5750,0.923304347826087,0,0,543,448,3,7251,9,1069,2,9
"1168","2020-05-06",292,14,194,834,5750,0.923304347826087,0,0,543,448,4,7255,9,1078,3,9
"1169","2020-05-07",293,14,179,777,5750,0.923304347826087,0,0,543,448,2,7257,41,1119,NA,41
"1170","2020-05-08",284,14,179,746,5750,0.923304347826087,0,0,543,448,4,7261,38,1157,3,38
"1171","2020-05-09",279,14,182,697,5750,0.923304347826087,0,0,543,448,3,7264,43,1200,3,43
"1172","2020-05-10",270,14,179,642,5750,0.923304347826087,0,0,543,448,NA,NA,32,1232,NA,32
"1173","2020-05-11",245,14,170,605,5750,0.923304347826087,0,0,543,448,4,7268,36,1268,3,36
"1174","2020-05-12",231,14,172,582,5750,0.923304347826087,0,0,543,448,2,7270,38,1306,2,38
"1175","2020-05-13",222,14,174,536,5750,0.923304347826087,0,0,543,448,2,7272,33,1339,1,33
"1176","2020-05-14",207,14,177,514,5750,0.923304347826087,0,0,543,448,2,7274,28,1367,1,28
"1177","2020-05-15",184,14,169,482,5750,0.923304347826087,0,0,543,448,4,7278,30,1397,3,30
"1178","2020-05-16",150,14,167,448,5750,0.923304347826087,0,0,543,448,2,7280,46,1443,2,46
"1179","2020-05-17",142,14,182,405,5750,0.923304347826087,0,0,543,448,4,7284,26,1469,2,26
"1180","2020-05-18",140,14,178,377,5750,0.923304347826087,0,0,543,448,3,7287,21,1490,3,21
"1181","2020-05-19",130,14,176,345,5750,0.923304347826087,0,0,543,448,1,7288,13,1503,NA,13
"1182","2020-05-20",107,14,165,322,5750,0.923304347826087,0,0,543,448,4,7292,7,1510,2,7
"1183","2020-05-21",104,14,155,291,5750,0.923304347826087,0,0,543,448,5,7297,15,1525,2,15
"1184","2020-05-22",107,14,157,270,5750,0.923304347826087,0,0,543,448,2,7299,10,1535,1,10
"1185","2020-05-23",112,14,148,253,5750,0.923304347826087,0,0,543,448,3,7302,8,1543,2,8
"1186","2020-05-24",106,14,148,235,5750,0.923304347826087,0,0,543,448,3,7305,7,1550,3,7
"1187","2020-05-25",103,14,138,226,5750,0.923304347826087,0,0,543,448,NA,NA,23,1573,NA,23
"1188","2020-05-26",88,14,131,215,5750,0.923304347826087,0,0,543,448,6,7311,18,1591,4,18
"1189","2020-05-27",90,14,128,204,5750,0.923304347826087,0,0,543,448,NA,NA,5,1596,NA,5
"1190","2020-05-28",79,14,110,192,5750,0.923304347826087,0,0,543,448,3,7314,8,1604,2,8
"1191","2020-05-29",68,14,112,171,5750,0.923304347826087,0,0,543,448,4,7318,11,1615,1,11
"1192","2020-05-30",64,14,106,165,5750,0.923304347826087,0,0,543,448,1,7319,11,1626,NA,11
"1193","2020-05-31",56,14,117,161,5750,0.923304347826087,0,0,543,448,1,7320,6,1632,1,6
"1194","2020-06-01",45,14,116,157,5750,0.923304347826087,0,0,543,448,2,7322,6,1638,1,6
"1195","2020-06-02",49,14,113,145,5750,0.923304347826087,0,0,543,448,2,7324,6,1644,NA,6
"1196","2020-06-03",45,14,111,136,5750,0.923304347826087,0,0,543,448,1,7325,8,1652,NA,8
"1197","2020-06-04",42,14,110,134,5750,0.923304347826087,0,0,543,448,NA,NA,10,1662,NA,10
"1198","2020-06-05",46,14,118,125,5750,0.923304347826087,0,0,543,448,NA,NA,14,1676,NA,14
"1199","2020-06-06",39,14,106,121,5750,0.923304347826087,0,0,543,448,2,7327,7,1683,NA,7
"1200","2020-06-07",40,14,93,110,5750,0.923304347826087,0,0,543,448,1,7328,2,1685,NA,2
"1201","2020-03-13",1,15,71,82,8125,0.893661538461539,0,0,834,742,22,60,4,14,3,4
"1202","2020-03-14",5,15,66,128,8125,0.893661538461539,0,0,834,742,26,86,11,25,2,11
"1203","2020-03-15",12,15,73,197,8125,0.893661538461539,0,0,834,742,24,110,9,34,5,9
"1204","2020-03-16",17,15,90,253,8125,0.893661538461539,0,0,834,742,39,149,5,39,12,5
"1205","2020-03-17",22,15,118,315,8125,0.893661538461539,0,0,834,742,42,191,4,43,6,4
"1206","2020-03-18",34,15,142,420,8125,0.893661538461539,0,0,834,742,37,228,2,45,13,2
"1207","2020-03-19",53,15,124,555,8125,0.893661538461539,0,0,834,742,39,267,1,46,16,1
"1208","2020-03-20",63,15,140,691,8125,0.893661538461539,0,0,834,742,38,305,6,52,23,6
"1209","2020-03-21",84,15,138,891,8125,0.893661538461539,0,0,834,742,50,355,NA,NA,23,NA
"1210","2020-03-22",110,15,129,1065,8125,0.893661538461539,0,0,834,742,37,392,3,55,16,3
"1211","2020-03-23",143,15,146,1350,8125,0.893661538461539,0,0,834,742,41,433,11,66,21,11
"1212","2020-03-24",190,15,148,1662,8125,0.893661538461539,0,0,834,742,46,479,9,75,17,9
"1213","2020-03-25",236,15,133,1988,8125,0.893661538461539,0,0,834,742,42,521,14,89,18,14
"1214","2020-03-26",300,15,134,2377,8125,0.893661538461539,0,0,834,742,48,569,3,92,28,3
"1215","2020-03-27",360,15,143,2794,8125,0.893661538461539,0,0,834,742,49,618,5,97,24,5
"1216","2020-03-28",434,15,136,3170,8125,0.893661538461539,0,0,834,742,42,660,12,109,24,12
"1217","2020-03-29",531,15,163,3584,8125,0.893661538461539,0,0,834,742,48,708,6,115,21,6
"1218","2020-03-30",621,15,169,3945,8125,0.893661538461539,0,0,834,742,39,747,2,117,19,2
"1219","2020-03-31",727,15,149,4225,8125,0.893661538461539,0,0,834,742,40,787,18,135,16,18
"1220","2020-04-01",835,15,174,4401,8125,0.893661538461539,0,0,834,742,46,833,14,149,24,14
"1221","2020-04-02",939,15,192,4479,8125,0.893661538461539,0,0,834,742,44,877,14,163,19,14
"1222","2020-04-03",1054,15,235,4590,8125,0.893661538461539,0,0,834,742,50,927,22,185,27,22
"1223","2020-04-04",1166,15,254,4533,8125,0.893661538461539,0,0,834,742,52,979,19,204,17,19
"1224","2020-04-05",1239,15,232,4356,8125,0.893661538461539,0,0,834,742,40,1019,18,222,20,18
"1225","2020-04-06",1318,15,255,4101,8125,0.893661538461539,0,0,834,742,70,1089,14,236,36,14
"1226","2020-04-07",1344,15,281,3864,8125,0.893661538461539,0,0,834,742,43,1132,6,242,19,6
"1227","2020-04-08",1330,15,270,3561,8125,0.893661538461539,0,0,834,742,41,1173,16,258,19,16
"1228","2020-04-09",1282,15,266,3193,8125,0.893661538461539,0,0,834,742,52,1225,18,276,21,18
"1229","2020-04-10",1229,15,239,2822,8125,0.893661538461539,0,0,834,742,68,1293,20,296,27,20
"1230","2020-04-11",1132,15,191,2476,8125,0.893661538461539,0,0,834,742,49,1342,14,310,17,14
"1231","2020-04-12",1032,15,177,2140,8125,0.893661538461539,0,0,834,742,48,1390,16,326,22,16
"1232","2020-04-13",904,15,182,1811,8125,0.893661538461539,0,0,834,742,45,1435,12,338,23,12
"1233","2020-04-14",783,15,186,1512,8125,0.893661538461539,0,0,834,742,50,1485,11,349,23,11
"1234","2020-04-15",696,15,170,1271,8125,0.893661538461539,0,0,834,742,57,1542,18,367,15,18
"1235","2020-04-16",606,15,165,1055,8125,0.893661538461539,0,0,834,742,51,1593,20,387,17,20
"1236","2020-04-17",511,15,142,879,8125,0.893661538461539,0,0,834,742,59,1652,15,402,27,15
"1237","2020-04-18",434,15,118,705,8125,0.893661538461539,0,0,834,742,58,1710,14,416,25,14
"1238","2020-04-19",353,15,104,566,8125,0.893661538461539,0,0,834,742,47,1757,17,433,16,17
"1239","2020-04-20",301,15,112,449,8125,0.893661538461539,0,0,834,742,49,1806,28,461,24,28
"1240","2020-04-21",256,15,140,357,8125,0.893661538461539,0,0,834,742,49,1855,14,475,21,14
"1241","2020-04-22",206,15,143,292,8125,0.893661538461539,0,0,834,742,49,1904,21,496,21,21
"1242","2020-04-23",164,15,128,230,8125,0.893661538461539,0,0,834,742,46,1950,15,511,16,15
"1243","2020-04-24",138,15,185,186,8125,0.893661538461539,0,0,834,742,48,1998,20,531,22,20
"1244","2020-04-25",104,15,195,154,8125,0.893661538461539,0,0,834,742,48,2046,13,544,16,13
"1245","2020-04-26",85,15,191,123,8125,0.893661538461539,0,0,834,742,47,2093,15,559,19,15
"1246","2020-04-27",62,15,190,100,8125,0.893661538461539,0,0,834,742,40,2133,11,570,14,11
"1247","2020-04-28",48,15,202,92,8125,0.893661538461539,0,0,834,742,52,2185,15,585,19,15
"1248","2020-04-29",37,15,195,78,8125,0.893661538461539,0,0,834,742,37,2222,6,591,15,6
"1249","2020-04-30",33,15,186,66,8125,0.893661538461539,0,0,834,742,42,2264,14,605,16,14
"1250","2020-05-01",24,15,199,59,8125,0.893661538461539,0,0,834,742,45,2309,14,619,17,14
"1251","2020-05-02",21,15,181,54,8125,0.893661538461539,0,0,834,742,38,2347,10,629,15,10
"1252","2020-05-03",20,15,176,51,8125,0.893661538461539,0,0,834,742,44,2391,11,640,15,11
"1253","2020-05-04",16,15,189,45,8125,0.893661538461539,0,0,834,742,44,2435,12,652,12,12
"1254","2020-05-05",14,15,167,40,8125,0.893661538461539,0,0,834,742,38,2473,13,665,17,13
"1255","2020-05-06",12,15,145,35,8125,0.893661538461539,0,0,834,742,54,2527,6,671,20,6
"1256","2020-05-07",9,15,141,29,8125,0.893661538461539,0,0,834,742,47,2574,6,677,18,6
"1257","2020-05-08",6,15,165,24,8125,0.893661538461539,0,0,834,742,35,2609,5,682,12,5
"1258","2020-05-09",11,15,180,26,8125,0.893661538461539,0,0,834,742,45,2654,3,685,19,3
"1259","2020-05-10",10,15,201,23,8125,0.893661538461539,0,0,834,742,44,2698,18,703,21,18
"1260","2020-05-11",10,15,200,22,8125,0.893661538461539,0,0,834,742,32,2730,20,723,10,20
"1261","2020-05-12",9,15,215,22,8125,0.893661538461539,0,0,834,742,42,2772,16,739,15,16
"1262","2020-05-13",7,15,190,23,8125,0.893661538461539,0,0,834,742,33,2805,9,748,14,9
"1263","2020-05-14",7,15,176,19,8125,0.893661538461539,0,0,834,742,22,2827,9,757,6,9
"1264","2020-05-15",7,15,154,20,8125,0.893661538461539,0,0,834,742,49,2876,17,774,22,17
"1265","2020-05-16",6,15,176,18,8125,0.893661538461539,0,0,834,742,25,2901,17,791,10,17
"1266","2020-05-17",8,15,172,20,8125,0.893661538461539,0,0,834,742,26,2927,5,796,10,5
"1267","2020-05-18",9,15,159,22,8125,0.893661538461539,0,0,834,742,36,2963,5,801,18,5
"1268","2020-05-19",8,15,147,21,8125,0.893661538461539,0,0,834,742,32,2995,1,802,19,1
"1269","2020-05-20",8,15,146,21,8125,0.893661538461539,0,0,834,742,28,3023,6,808,15,6
"1270","2020-05-21",8,15,174,19,8125,0.893661538461539,0,0,834,742,26,3049,6,814,8,6
"1271","2020-05-22",8,15,174,18,8125,0.893661538461539,0,0,834,742,28,3077,10,824,11,10
"1272","2020-05-23",4,15,164,18,8125,0.893661538461539,0,0,834,742,23,3100,16,840,12,16
"1273","2020-05-24",1,15,144,18,8125,0.893661538461539,0,0,834,742,13,3113,8,848,5,8
"1274","2020-05-25",0,15,0,0,8125,0.893661538461539,0,0,834,742,20,3133,20,868,7,20
"1275","2020-05-26",0,15,0,0,8125,0.893661538461539,0,0,834,742,18,3151,7,875,6,7
"1276","2020-05-27",1,15,124,19,8125,0.893661538461539,0,0,834,742,12,3163,6,881,3,6
"1277","2020-05-28",4,15,132,19,8125,0.893661538461539,0,0,834,742,21,3184,15,896,4,15
"1278","2020-05-29",6,15,138,20,8125,0.893661538461539,0,0,834,742,21,3205,3,899,9,3
"1279","2020-05-30",7,15,134,17,8125,0.893661538461539,0,0,834,742,15,3220,14,913,5,14
"1280","2020-05-31",7,15,115,14,8125,0.893661538461539,0,0,834,742,16,3236,13,926,7,13
"1281","2020-06-01",8,15,103,15,8125,0.893661538461539,0,0,834,742,23,3259,2,928,8,2
"1282","2020-06-02",9,15,117,15,8125,0.893661538461539,0,0,834,742,13,3272,17,945,8,17
"1283","2020-06-03",8,15,111,16,8125,0.893661538461539,0,0,834,742,17,3289,9,954,10,9
"1284","2020-06-04",5,15,133,17,8125,0.893661538461539,0,0,834,742,19,3308,7,961,6,7
"1285","2020-06-05",4,15,131,16,8125,0.893661538461539,0,0,834,742,20,3328,10,971,10,10
"1286","2020-06-06",5,15,137,16,8125,0.893661538461539,0,0,834,742,10,3338,6,977,3,6
"1287","2020-06-07",6,15,137,15,8125,0.893661538461539,0,0,834,742,13,3351,2,979,8,2
"1288","2020-03-15",1,16,61,49,2269,0.710445130013222,0,0,180,420,19,77,27,71,6,27
"1289","2020-03-16",4,16,74,63,2269,0.710445130013222,0,0,180,420,23,100,21,92,10,21
"1290","2020-03-17",5,16,79,73,2269,0.710445130013222,0,0,180,420,16,116,16,108,8,16
"1291","2020-03-18",8,16,77,88,2269,0.710445130013222,0,0,180,420,28,144,19,127,9,19
"1292","2020-03-19",12,16,71,100,2269,0.710445130013222,0,0,180,420,41,185,27,154,20,27
"1293","2020-03-20",15,16,76,120,2269,0.710445130013222,0,0,180,420,32,217,39,193,11,39
"1294","2020-03-21",21,16,73,143,2269,0.710445130013222,0,0,180,420,31,248,34,227,18,34
"1295","2020-03-22",25,16,85,162,2269,0.710445130013222,0,0,180,420,35,283,39,266,19,39
"1296","2020-03-23",30,16,90,173,2269,0.710445130013222,0,0,180,420,32,315,20,286,17,20
"1297","2020-03-24",39,16,97,187,2269,0.710445130013222,0,0,180,420,26,341,26,312,15,26
"1298","2020-03-25",39,16,92,205,2269,0.710445130013222,0,0,180,420,43,384,19,331,22,19
"1299","2020-03-26",42,16,100,222,2269,0.710445130013222,0,0,180,420,41,425,24,355,25,24
"1300","2020-03-27",45,16,100,237,2269,0.710445130013222,0,0,180,420,37,462,29,384,22,29
"1301","2020-03-28",51,16,107,245,2269,0.710445130013222,0,0,180,420,41,503,31,415,25,31
"1302","2020-03-29",53,16,108,260,2269,0.710445130013222,0,0,180,420,35,538,42,457,11,42
"1303","2020-03-30",60,16,118,272,2269,0.710445130013222,0,0,180,420,38,576,43,500,24,43
"1304","2020-03-31",58,16,132,292,2269,0.710445130013222,0,0,180,420,38,614,39,539,13,39
"1305","2020-04-01",66,16,137,289,2269,0.710445130013222,0,0,180,420,48,662,33,572,22,33
"1306","2020-04-02",74,16,125,298,2269,0.710445130013222,0,0,180,420,40,702,47,619,20,47
"1307","2020-04-03",80,16,123,299,2269,0.710445130013222,0,0,180,420,41,743,40,659,21,40
"1308","2020-04-04",74,16,132,294,2269,0.710445130013222,0,0,180,420,43,786,44,703,21,44
"1309","2020-04-05",84,16,147,304,2269,0.710445130013222,0,0,180,420,48,834,37,740,31,37
"1310","2020-04-06",80,16,159,328,2269,0.710445130013222,0,0,180,420,42,876,34,774,25,34
"1311","2020-04-07",81,16,155,336,2269,0.710445130013222,0,0,180,420,41,917,51,825,25,51
"1312","2020-04-08",90,16,175,334,2269,0.710445130013222,0,0,180,420,45,962,27,852,29,27
"1313","2020-04-09",87,16,163,345,2269,0.710445130013222,0,0,180,420,44,1006,39,891,28,39
"1314","2020-04-10",96,16,169,340,2269,0.710445130013222,0,0,180,420,35,1041,31,922,17,31
"1315","2020-04-11",99,16,164,352,2269,0.710445130013222,0,0,180,420,44,1085,29,951,24,29
"1316","2020-04-12",101,16,146,354,2269,0.710445130013222,0,0,180,420,36,1121,56,1007,17,56
"1317","2020-04-13",113,16,160,366,2269,0.710445130013222,0,0,180,420,44,1165,42,1049,19,42
"1318","2020-04-14",116,16,150,370,2269,0.710445130013222,0,0,180,420,35,1200,46,1095,20,46
"1319","2020-04-15",110,16,147,371,2269,0.710445130013222,0,0,180,420,42,1242,43,1138,22,43
"1320","2020-04-16",115,16,149,380,2269,0.710445130013222,0,0,180,420,47,1289,39,1177,29,39
"1321","2020-04-17",114,16,154,391,2269,0.710445130013222,0,0,180,420,38,1327,43,1220,21,43
"1322","2020-04-18",118,16,144,388,2269,0.710445130013222,0,0,180,420,40,1367,41,1261,17,41
"1323","2020-04-19",115,16,148,391,2269,0.710445130013222,0,0,180,420,47,1414,63,1324,26,63
"1324","2020-04-20",105,16,144,392,2269,0.710445130013222,0,0,180,420,33,1447,44,1368,18,44
"1325","2020-04-21",107,16,153,394,2269,0.710445130013222,0,0,180,420,57,1504,40,1408,32,40
"1326","2020-04-22",107,16,151,400,2269,0.710445130013222,0,0,180,420,35,1539,44,1452,16,44
"1327","2020-04-23",103,16,143,400,2269,0.710445130013222,0,0,180,420,39,1578,37,1489,13,37
"1328","2020-04-24",92,16,142,376,2269,0.710445130013222,0,0,180,420,41,1619,40,1529,23,40
"1329","2020-04-25",92,16,157,374,2269,0.710445130013222,0,0,180,420,35,1654,34,1563,18,34
"1330","2020-04-26",97,16,169,354,2269,0.710445130013222,0,0,180,420,43,1697,25,1588,21,25
"1331","2020-04-27",101,16,182,352,2269,0.710445130013222,0,0,180,420,37,1734,19,1607,20,19
"1332","2020-04-28",107,16,184,342,2269,0.710445130013222,0,0,180,420,45,1779,29,1636,23,29
"1333","2020-04-29",106,16,174,341,2269,0.710445130013222,0,0,180,420,38,1817,39,1675,19,39
"1334","2020-04-30",114,16,162,344,2269,0.710445130013222,0,0,180,420,45,1862,33,1708,27,33
"1335","2020-05-01",121,16,164,338,2269,0.710445130013222,0,0,180,420,45,1907,32,1740,20,32
"1336","2020-05-02",126,16,160,332,2269,0.710445130013222,0,0,180,420,23,1930,20,1760,13,20
"1337","2020-05-03",119,16,165,324,2269,0.710445130013222,0,0,180,420,40,1970,35,1795,25,35
"1338","2020-05-04",116,16,156,330,2269,0.710445130013222,0,0,180,420,42,2012,51,1846,24,51
"1339","2020-05-05",106,16,147,319,2269,0.710445130013222,0,0,180,420,56,2068,59,1905,21,59
"1340","2020-05-06",101,16,147,335,2269,0.710445130013222,0,0,180,420,33,2101,40,1945,17,40
"1341","2020-05-07",98,16,140,333,2269,0.710445130013222,0,0,180,420,44,2145,36,1981,22,36
"1342","2020-05-08",102,16,124,333,2269,0.710445130013222,0,0,180,420,42,2187,28,2009,18,28
"1343","2020-05-09",94,16,137,338,2269,0.710445130013222,0,0,180,420,24,2211,24,2033,16,24
"1344","2020-05-10",98,16,137,333,2269,0.710445130013222,0,0,180,420,44,2255,46,2079,22,46
"1345","2020-05-11",94,16,127,316,2269,0.710445130013222,0,0,180,420,22,2277,44,2123,9,44
"1346","2020-05-12",100,16,119,302,2269,0.710445130013222,0,0,180,420,45,2322,47,2170,23,47
"1347","2020-05-13",113,16,128,304,2269,0.710445130013222,0,0,180,420,35,2357,55,2225,24,55
"1348","2020-05-14",104,16,136,295,2269,0.710445130013222,0,0,180,420,32,2389,44,2269,13,44
"1349","2020-05-15",95,16,142,280,2269,0.710445130013222,0,0,180,420,32,2421,43,2312,17,43
"1350","2020-05-16",92,16,172,288,2269,0.710445130013222,0,0,180,420,29,2450,35,2347,9,35
"1351","2020-05-17",92,16,186,277,2269,0.710445130013222,0,0,180,420,33,2483,26,2373,18,26
"1352","2020-05-18",91,16,183,267,2269,0.710445130013222,0,0,180,420,28,2511,31,2404,13,31
"1353","2020-05-19",87,16,168,268,2269,0.710445130013222,0,0,180,420,23,2534,45,2449,11,45
"1354","2020-05-20",74,16,167,261,2269,0.710445130013222,0,0,180,420,17,2551,36,2485,12,36
"1355","2020-05-21",77,16,173,262,2269,0.710445130013222,0,0,180,420,26,2577,30,2515,14,30
"1356","2020-05-22",81,16,177,252,2269,0.710445130013222,0,0,180,420,26,2603,30,2545,16,30
"1357","2020-05-23",88,16,168,249,2269,0.710445130013222,0,0,180,420,23,2626,20,2565,14,20
"1358","2020-05-24",74,16,162,222,2269,0.710445130013222,0,0,180,420,31,2657,34,2599,16,34
"1359","2020-05-25",70,16,156,210,2269,0.710445130013222,0,0,180,420,16,2673,46,2645,7,46
"1360","2020-05-26",70,16,149,217,2269,0.710445130013222,0,0,180,420,19,2692,35,2680,8,35
"1361","2020-05-27",65,16,140,212,2269,0.710445130013222,0,0,180,420,35,2727,39,2719,22,39
"1362","2020-05-28",60,16,138,202,2269,0.710445130013222,0,0,180,420,15,2742,39,2758,8,39
"1363","2020-05-29",56,16,129,190,2269,0.710445130013222,0,0,180,420,22,2764,20,2778,9,20
"1364","2020-05-30",46,16,118,197,2269,0.710445130013222,0,0,180,420,20,2784,47,2825,12,47
"1365","2020-05-31",54,16,121,193,2269,0.710445130013222,0,0,180,420,12,2796,33,2858,7,33
"1366","2020-06-01",56,16,116,192,2269,0.710445130013222,0,0,180,420,26,2822,32,2890,15,32
"1367","2020-06-02",50,16,115,176,2269,0.710445130013222,0,0,180,420,23,2845,37,2927,13,37
"1368","2020-06-03",58,16,102,179,2269,0.710445130013222,0,0,180,420,13,2858,34,2961,7,34
"1369","2020-06-04",59,16,107,177,2269,0.710445130013222,0,0,180,420,17,2875,20,2981,10,20
"1370","2020-06-05",58,16,117,182,2269,0.710445130013222,0,0,180,420,20,2895,38,3019,13,38
"1371","2020-06-06",59,16,120,170,2269,0.710445130013222,0,0,180,420,19,2914,40,3059,13,40
"1372","2020-06-07",59,16,113,162,2269,0.710445130013222,0,0,180,420,20,2934,25,3084,15,25
"1373","2020-03-15",2,17,43,66,2299,0.460635058721183,0,0,195,417,4,22,3,28,4,3
"1374","2020-03-16",6,17,61,89,2299,0.460635058721183,0,0,195,417,11,33,3,31,9,3
"1375","2020-03-17",7,17,51,108,2299,0.460635058721183,0,0,195,417,8,41,1,32,6,1
"1376","2020-03-18",9,17,53,136,2299,0.460635058721183,0,0,195,417,11,52,NA,NA,8,NA
"1377","2020-03-19",16,17,74,151,2299,0.460635058721183,0,0,195,417,11,63,1,33,8,1
"1378","2020-03-20",20,17,76,164,2299,0.460635058721183,0,0,195,417,14,77,6,39,10,6
"1379","2020-03-21",26,17,86,187,2299,0.460635058721183,0,0,195,417,18,95,10,49,17,10
"1380","2020-03-22",32,17,113,198,2299,0.460635058721183,0,0,195,417,15,110,10,59,12,10
"1381","2020-03-23",34,17,117,225,2299,0.460635058721183,0,0,195,417,26,136,20,79,22,20
"1382","2020-03-24",43,17,103,236,2299,0.460635058721183,0,0,195,417,27,163,7,86,26,7
"1383","2020-03-25",48,17,101,244,2299,0.460635058721183,0,0,195,417,34,197,3,89,31,3
"1384","2020-03-26",51,17,111,254,2299,0.460635058721183,0,0,195,417,33,230,2,91,31,2
"1385","2020-03-27",61,17,123,265,2299,0.460635058721183,0,0,195,417,45,275,1,92,43,1
"1386","2020-03-28",69,17,115,266,2299,0.460635058721183,0,0,195,417,38,313,8,100,36,8
"1387","2020-03-29",73,17,111,272,2299,0.460635058721183,0,0,195,417,47,360,3,103,47,3
"1388","2020-03-30",75,17,114,282,2299,0.460635058721183,0,0,195,417,60,420,3,106,54,3
"1389","2020-03-31",81,17,108,288,2299,0.460635058721183,0,0,195,417,67,487,11,117,66,11
"1390","2020-04-01",81,17,113,285,2299,0.460635058721183,0,0,195,417,64,551,30,147,57,30
"1391","2020-04-02",92,17,95,289,2299,0.460635058721183,0,0,195,417,84,635,13,160,81,13
"1392","2020-04-03",95,17,100,301,2299,0.460635058721183,0,0,195,417,80,715,12,172,78,12
"1393","2020-04-04",94,17,93,297,2299,0.460635058721183,0,0,195,417,109,824,6,178,107,6
"1394","2020-04-05",91,17,119,310,2299,0.460635058721183,0,0,195,417,103,927,17,195,97,17
"1395","2020-04-06",90,17,115,320,2299,0.460635058721183,0,0,195,417,127,1054,14,209,122,14
"1396","2020-04-07",88,17,96,318,2299,0.460635058721183,0,0,195,417,149,1203,21,230,142,21
"1397","2020-04-08",89,17,82,324,2299,0.460635058721183,0,0,195,417,148,1351,17,247,145,17
"1398","2020-04-09",79,17,83,335,2299,0.460635058721183,0,0,195,417,201,1552,12,259,199,12
"1399","2020-04-10",71,17,80,338,2299,0.460635058721183,0,0,195,417,201,1753,35,294,196,35
"1400","2020-04-11",69,17,81,345,2299,0.460635058721183,0,0,195,417,218,1971,16,310,214,16
"1401","2020-04-12",73,17,86,354,2299,0.460635058721183,0,0,195,417,218,2189,18,328,214,18
"1402","2020-04-13",73,17,83,359,2299,0.460635058721183,0,0,195,417,229,2418,23,351,226,23
"1403","2020-04-14",75,17,84,365,2299,0.460635058721183,0,0,195,417,367,2785,40,391,366,40
"1404","2020-04-15",85,17,115,363,2299,0.460635058721183,0,0,195,417,282,3067,33,424,279,33
"1405","2020-04-16",97,17,138,360,2299,0.460635058721183,0,0,195,417,325,3392,24,448,322,24
"1406","2020-04-17",105,17,172,367,2299,0.460635058721183,0,0,195,417,322,3714,15,463,320,15
"1407","2020-04-18",118,17,183,369,2299,0.460635058721183,0,0,195,417,264,3978,18,481,262,18
"1408","2020-04-19",112,17,167,359,2299,0.460635058721183,0,0,195,417,263,4241,22,503,262,22
"1409","2020-04-20",117,17,152,353,2299,0.460635058721183,0,0,195,417,264,4505,20,523,263,20
"1410","2020-04-21",115,17,166,357,2299,0.460635058721183,0,0,195,417,291,4796,20,543,288,20
"1411","2020-04-22",111,17,178,341,2299,0.460635058721183,0,0,195,417,208,5004,9,552,205,9
"1412","2020-04-23",111,17,199,318,2299,0.460635058721183,0,0,195,417,236,5240,7,559,236,7
"1413","2020-04-24",110,17,191,316,2299,0.460635058721183,0,0,195,417,210,5450,8,567,208,8
"1414","2020-04-25",94,17,176,317,2299,0.460635058721183,0,0,195,417,178,5628,10,577,175,10
"1415","2020-04-26",98,17,161,318,2299,0.460635058721183,0,0,195,417,154,5782,4,581,154,4
"1416","2020-04-27",101,17,166,313,2299,0.460635058721183,0,0,195,417,140,5922,13,594,140,13
"1417","2020-04-28",97,17,163,311,2299,0.460635058721183,0,0,195,417,128,6050,27,621,125,27
"1418","2020-04-29",94,17,147,302,2299,0.460635058721183,0,0,195,417,103,6153,9,630,101,9
"1419","2020-04-30",82,17,130,289,2299,0.460635058721183,0,0,195,417,81,6234,19,649,75,19
"1420","2020-05-01",82,17,122,293,2299,0.460635058721183,0,0,195,417,83,6317,16,665,82,16
"1421","2020-05-02",85,17,118,297,2299,0.460635058721183,0,0,195,417,76,6393,13,678,75,13
"1422","2020-05-03",88,17,143,298,2299,0.460635058721183,0,0,195,417,65,6458,31,709,65,31
"1423","2020-05-04",88,17,134,301,2299,0.460635058721183,0,0,195,417,43,6501,32,741,42,32
"1424","2020-05-05",87,17,149,290,2299,0.460635058721183,0,0,195,417,52,6553,26,767,52,26
"1425","2020-05-06",85,17,144,305,2299,0.460635058721183,0,0,195,417,48,6601,20,787,48,20
"1426","2020-05-07",80,17,126,308,2299,0.460635058721183,0,0,195,417,43,6644,52,839,42,52
"1427","2020-05-08",81,17,118,311,2299,0.460635058721183,0,0,195,417,17,6661,26,865,14,26
"1428","2020-05-09",83,17,135,311,2299,0.460635058721183,0,0,195,417,22,6683,21,886,22,21
"1429","2020-05-10",86,17,134,297,2299,0.460635058721183,0,0,195,417,19,6702,40,926,19,40
"1430","2020-05-11",83,17,128,288,2299,0.460635058721183,0,0,195,417,21,6723,17,943,21,17
"1431","2020-05-12",85,17,130,288,2299,0.460635058721183,0,0,195,417,15,6738,24,967,15,24
"1432","2020-05-13",84,17,136,282,2299,0.460635058721183,0,0,195,417,12,6750,23,990,12,23
"1433","2020-05-14",87,17,128,284,2299,0.460635058721183,0,0,195,417,11,6761,20,1010,11,20
"1434","2020-05-15",79,17,126,278,2299,0.460635058721183,0,0,195,417,6,6767,24,1034,5,24
"1435","2020-05-16",75,17,126,287,2299,0.460635058721183,0,0,195,417,10,6777,22,1056,8,22
"1436","2020-05-17",71,17,128,281,2299,0.460635058721183,0,0,195,417,7,6784,16,1072,6,16
"1437","2020-05-18",70,17,113,287,2299,0.460635058721183,0,0,195,417,10,6794,22,1094,8,22
"1438","2020-05-19",72,17,127,272,2299,0.460635058721183,0,0,195,417,1,6795,25,1119,1,26
"1439","2020-05-20",71,17,120,278,2299,0.460635058721183,0,0,195,417,6,6801,28,1147,6,28
"1440","2020-05-21",69,17,136,284,2299,0.460635058721183,0,0,195,417,4,6805,7,1154,4,7
"1441","2020-05-22",65,17,122,293,2299,0.460635058721183,0,0,195,417,6,6811,8,1162,6,8
"1442","2020-05-23",67,17,112,297,2299,0.460635058721183,0,0,195,417,3,6814,20,1182,3,20
"1443","2020-05-24",63,17,117,284,2299,0.460635058721183,0,0,195,417,2,6816,12,1194,1,12
"1444","2020-05-25",64,17,131,271,2299,0.460635058721183,0,0,195,417,1,6817,17,1211,1,17
"1445","2020-05-26",60,17,132,266,2299,0.460635058721183,0,0,195,417,1,6818,13,1224,1,13
"1446","2020-05-27",61,17,143,264,2299,0.460635058721183,0,0,195,417,NA,NA,9,1233,NA,9
"1447","2020-05-28",75,17,143,261,2299,0.460635058721183,0,0,195,417,3,6821,13,1246,2,13
"1448","2020-05-29",82,17,152,252,2299,0.460635058721183,0,0,195,417,2,6823,15,1261,2,15
"1449","2020-05-30",76,17,146,241,2299,0.460635058721183,0,0,195,417,4,6827,12,1273,4,12
"1450","2020-05-31",81,17,126,232,2299,0.460635058721183,0,0,195,417,1,6828,14,1287,1,14
"1451","2020-06-01",79,17,122,215,2299,0.460635058721183,0,0,195,417,3,6831,21,1308,2,21
"1452","2020-06-02",82,17,117,205,2299,0.460635058721183,0,0,195,417,2,6833,13,1321,2,13
"1453","2020-06-03",86,17,98,194,2299,0.460635058721183,0,0,195,417,1,6834,21,1342,1,21
"1454","2020-06-04",75,17,97,185,2299,0.460635058721183,0,0,195,417,1,6835,12,1354,1,12
"1455","2020-06-05",71,17,102,178,2299,0.460635058721183,0,0,195,417,NA,NA,11,1365,NA,11
"1456","2020-06-06",73,17,100,169,2299,0.460635058721183,0,0,195,417,1,6836,6,1371,1,6
"1457","2020-06-07",69,17,97,167,2299,0.460635058721183,0,0,195,417,2,6838,8,1379,2,8
"1458","2020-03-13",1,18,61,25,2389,0.735035579740477,0,0,212,622,7,15,5,11,2,5
"1459","2020-03-14",2,18,66,32,2389,0.735035579740477,0,0,212,622,5,20,13,24,NA,13
"1460","2020-03-15",4,18,73,46,2389,0.735035579740477,0,0,212,622,7,27,1,25,2,1
"1461","2020-03-16",4,18,85,57,2389,0.735035579740477,0,0,212,622,1,28,9,34,1,9
"1462","2020-03-17",5,18,94,73,2389,0.735035579740477,0,0,212,622,3,31,9,43,2,9
"1463","2020-03-18",7,18,122,89,2389,0.735035579740477,0,0,212,622,6,37,5,48,5,5
"1464","2020-03-19",8,18,113,99,2389,0.735035579740477,0,0,212,622,18,55,3,51,9,3
"1465","2020-03-20",12,18,105,115,2389,0.735035579740477,0,0,212,622,11,66,10,61,7,10
"1466","2020-03-21",14,18,100,129,2389,0.735035579740477,0,0,212,622,14,80,8,69,9,8
"1467","2020-03-22",20,18,95,143,2389,0.735035579740477,0,0,212,622,13,93,7,76,8,7
"1468","2020-03-23",24,18,104,149,2389,0.735035579740477,0,0,212,622,12,105,9,85,9,9
"1469","2020-03-24",31,18,100,162,2389,0.735035579740477,0,0,212,622,17,122,17,102,9,17
"1470","2020-03-25",34,18,90,174,2389,0.735035579740477,0,0,212,622,15,137,8,110,8,8
"1471","2020-03-26",44,18,84,191,2389,0.735035579740477,0,0,212,622,15,152,8,118,13,8
"1472","2020-03-27",45,18,97,199,2389,0.735035579740477,0,0,212,622,20,172,17,135,13,17
"1473","2020-03-28",49,18,85,208,2389,0.735035579740477,0,0,212,622,23,195,21,156,15,21
"1474","2020-03-29",49,18,94,222,2389,0.735035579740477,0,0,212,622,26,221,25,181,17,25
"1475","2020-03-30",53,18,120,230,2389,0.735035579740477,0,0,212,622,33,254,9,190,21,9
"1476","2020-03-31",61,18,106,243,2389,0.735035579740477,0,0,212,622,16,270,9,199,14,9
"1477","2020-04-01",67,18,91,271,2389,0.735035579740477,0,0,212,622,35,305,24,223,28,24
"1478","2020-04-02",70,18,101,270,2389,0.735035579740477,0,0,212,622,22,327,29,252,22,29
"1479","2020-04-03",81,18,116,293,2389,0.735035579740477,0,0,212,622,22,349,22,274,17,22
"1480","2020-04-04",84,18,153,308,2389,0.735035579740477,0,0,212,622,23,372,27,301,22,27
"1481","2020-04-05",87,18,186,312,2389,0.735035579740477,0,0,212,622,31,403,32,333,27,32
"1482","2020-04-06",90,18,174,319,2389,0.735035579740477,0,0,212,622,24,427,24,357,21,24
"1483","2020-04-07",91,18,177,333,2389,0.735035579740477,0,0,212,622,35,462,12,369,22,12
"1484","2020-04-08",91,18,177,348,2389,0.735035579740477,0,0,212,622,29,491,13,382,28,13
"1485","2020-04-09",89,18,167,340,2389,0.735035579740477,0,0,212,622,25,516,14,396,19,14
"1486","2020-04-10",82,18,178,348,2389,0.735035579740477,0,0,212,622,31,547,10,406,26,10
"1487","2020-04-11",87,18,186,353,2389,0.735035579740477,0,0,212,622,27,574,10,416,22,10
"1488","2020-04-12",89,18,180,345,2389,0.735035579740477,0,0,212,622,25,599,7,423,21,7
"1489","2020-04-13",97,18,178,335,2389,0.735035579740477,0,0,212,622,27,626,6,429,25,6
"1490","2020-04-14",94,18,182,344,2389,0.735035579740477,0,0,212,622,24,650,23,452,20,23
"1491","2020-04-15",100,18,171,331,2389,0.735035579740477,0,0,212,622,37,687,14,466,30,14
"1492","2020-04-16",105,18,143,337,2389,0.735035579740477,0,0,212,622,28,715,17,483,22,17
"1493","2020-04-17",109,18,140,334,2389,0.735035579740477,0,0,212,622,38,753,11,494,28,11
"1494","2020-04-18",106,18,138,335,2389,0.735035579740477,0,0,212,622,34,787,11,505,25,11
"1495","2020-04-19",104,18,114,356,2389,0.735035579740477,0,0,212,622,38,825,8,513,31,8
"1496","2020-04-20",100,18,99,363,2389,0.735035579740477,0,0,212,622,36,861,21,534,35,21
"1497","2020-04-21",101,18,98,358,2389,0.735035579740477,0,0,212,622,36,897,41,575,30,41
"1498","2020-04-22",96,18,123,363,2389,0.735035579740477,0,0,212,622,34,931,41,616,27,41
"1499","2020-04-23",96,18,129,373,2389,0.735035579740477,0,0,212,622,40,971,27,643,34,27
"1500","2020-04-24",98,18,144,357,2389,0.735035579740477,0,0,212,622,22,993,31,674,19,31
"1501","2020-04-25",100,18,154,353,2389,0.735035579740477,0,0,212,622,27,1020,38,712,23,38
"1502","2020-04-26",105,18,147,371,2389,0.735035579740477,0,0,212,622,22,1042,27,739,20,27
"1503","2020-04-27",106,18,127,366,2389,0.735035579740477,0,0,212,622,26,1068,12,751,19,12
"1504","2020-04-28",111,18,104,365,2389,0.735035579740477,0,0,212,622,25,1093,11,762,15,11
"1505","2020-04-29",107,18,112,361,2389,0.735035579740477,0,0,212,622,21,1114,8,770,17,8
"1506","2020-04-30",105,18,146,369,2389,0.735035579740477,0,0,212,622,17,1131,8,778,11,8
"1507","2020-05-01",104,18,144,363,2389,0.735035579740477,0,0,212,622,26,1157,18,796,18,18
"1508","2020-05-02",105,18,149,362,2389,0.735035579740477,0,0,212,622,22,1179,14,810,14,14
"1509","2020-05-03",100,18,159,359,2389,0.735035579740477,0,0,212,622,33,1212,14,824,23,14
"1510","2020-05-04",95,18,138,358,2389,0.735035579740477,0,0,212,622,30,1242,5,829,24,5
"1511","2020-05-05",87,18,138,367,2389,0.735035579740477,0,0,212,622,26,1268,25,854,23,25
"1512","2020-05-06",103,18,146,367,2389,0.735035579740477,0,0,212,622,19,1287,30,884,14,30
"1513","2020-05-07",107,18,136,367,2389,0.735035579740477,0,0,212,622,28,1315,15,899,24,15
"1514","2020-05-08",107,18,133,375,2389,0.735035579740477,0,0,212,622,26,1341,26,925,24,26
"1515","2020-05-09",100,18,157,372,2389,0.735035579740477,0,0,212,622,33,1374,30,955,26,30
"1516","2020-05-10",107,18,154,357,2389,0.735035579740477,0,0,212,622,27,1401,30,985,25,30
"1517","2020-05-11",113,18,138,346,2389,0.735035579740477,0,0,212,622,27,1428,20,1005,20,20
"1518","2020-05-12",117,18,121,344,2389,0.735035579740477,0,0,212,622,16,1444,16,1021,12,16
"1519","2020-05-13",110,18,103,346,2389,0.735035579740477,0,0,212,622,24,1468,11,1032,22,11
"1520","2020-05-14",109,18,89,333,2389,0.735035579740477,0,0,212,622,21,1489,10,1042,20,10
"1521","2020-05-15",106,18,90,345,2389,0.735035579740477,0,0,212,622,17,1506,5,1047,12,5
"1522","2020-05-16",111,18,111,337,2389,0.735035579740477,0,0,212,622,29,1535,14,1061,26,14
"1523","2020-05-17",109,18,122,326,2389,0.735035579740477,0,0,212,622,17,1552,8,1069,10,8
"1524","2020-05-18",100,18,106,325,2389,0.735035579740477,0,0,212,622,27,1579,13,1082,21,13
"1525","2020-05-19",93,18,118,318,2389,0.735035579740477,0,0,212,622,15,1594,9,1091,13,9
"1526","2020-05-20",87,18,127,305,2389,0.735035579740477,0,0,212,622,20,1614,9,1100,16,9
"1527","2020-05-21",80,18,122,309,2389,0.735035579740477,0,0,212,622,18,1632,16,1116,16,16
"1528","2020-05-22",76,18,116,303,2389,0.735035579740477,0,0,212,622,15,1647,20,1136,14,20
"1529","2020-05-23",76,18,106,303,2389,0.735035579740477,0,0,212,622,19,1666,18,1154,16,18
"1530","2020-05-24",70,18,94,289,2389,0.735035579740477,0,0,212,622,15,1681,15,1169,12,15
"1531","2020-05-25",73,18,78,287,2389,0.735035579740477,0,0,212,622,11,1692,9,1178,11,9
"1532","2020-05-26",78,18,76,289,2389,0.735035579740477,0,0,212,622,14,1706,8,1186,12,8
"1533","2020-05-27",86,18,73,294,2389,0.735035579740477,0,0,212,622,14,1720,17,1203,12,17
"1534","2020-05-28",86,18,70,283,2389,0.735035579740477,0,0,212,622,12,1732,15,1218,9,15
"1535","2020-05-29",85,18,68,262,2389,0.735035579740477,0,0,212,622,13,1745,17,1235,13,17
"1536","2020-05-30",89,18,70,258,2389,0.735035579740477,0,0,212,622,12,1757,14,1249,11,14
"1537","2020-05-31",89,18,78,259,2389,0.735035579740477,0,0,212,622,8,1765,12,1261,6,12
"1538","2020-06-01",88,18,84,247,2389,0.735035579740477,0,0,212,622,9,1774,10,1271,8,10
"1539","2020-06-02",85,18,73,237,2389,0.735035579740477,0,0,212,622,17,1791,23,1294,12,23
"1540","2020-06-03",78,18,72,225,2389,0.735035579740477,0,0,212,622,14,1805,17,1311,13,17
"1541","2020-06-04",78,18,66,211,2389,0.735035579740477,0,0,212,622,4,1809,18,1329,2,18
"1542","2020-06-05",75,18,67,211,2389,0.735035579740477,0,0,212,622,13,1822,21,1350,11,21
"1543","2020-06-06",72,18,71,203,2389,0.735035579740477,0,0,212,622,13,1835,14,1364,10,14
"1544","2020-06-07",70,18,68,189,2389,0.735035579740477,0,0,212,622,12,1847,5,1369,11,5
"1545","2020-03-15",4,19,40,74,2214,0.404697380307136,0,0,204,321,34,95,10,49,15,10
"1546","2020-03-16",8,19,41,89,2214,0.404697380307136,0,0,204,321,19,114,5,54,13,5
"1547","2020-03-17",12,19,47,108,2214,0.404697380307136,0,0,204,321,35,149,6,60,16,6
"1548","2020-03-18",13,19,42,123,2214,0.404697380307136,0,0,204,321,34,183,13,73,15,13
"1549","2020-03-19",20,19,39,145,2214,0.404697380307136,0,0,204,321,36,219,16,89,21,16
"1550","2020-03-20",24,19,43,166,2214,0.404697380307136,0,0,204,321,40,259,7,96,31,7
"1551","2020-03-21",32,19,50,177,2214,0.404697380307136,0,0,204,321,52,311,2,98,36,2
"1552","2020-03-22",37,19,46,190,2214,0.404697380307136,0,0,204,321,53,364,1,99,36,1
"1553","2020-03-23",38,19,41,198,2214,0.404697380307136,0,0,204,321,43,407,6,105,32,6
"1554","2020-03-24",41,19,37,221,2214,0.404697380307136,0,0,204,321,41,448,15,120,25,15
"1555","2020-03-25",48,19,41,235,2214,0.404697380307136,0,0,204,321,37,485,27,147,25,27
"1556","2020-03-26",45,19,42,242,2214,0.404697380307136,0,0,204,321,54,539,14,161,45,14
"1557","2020-03-27",47,19,51,252,2214,0.404697380307136,0,0,204,321,45,584,5,166,32,5
"1558","2020-03-28",58,19,64,256,2214,0.404697380307136,0,0,204,321,45,629,23,189,29,23
"1559","2020-03-29",62,19,72,269,2214,0.404697380307136,0,0,204,321,54,683,19,208,38,19
"1560","2020-03-30",63,19,84,276,2214,0.404697380307136,0,0,204,321,44,727,31,239,34,31
"1561","2020-03-31",64,19,89,284,2214,0.404697380307136,0,0,204,321,67,794,29,268,46,29
"1562","2020-04-01",67,19,87,295,2214,0.404697380307136,0,0,204,321,39,833,39,307,23,39
"1563","2020-04-02",76,19,83,289,2214,0.404697380307136,0,0,204,321,47,880,24,331,31,24
"1564","2020-04-03",78,19,72,291,2214,0.404697380307136,0,0,204,321,37,917,16,347,23,16
"1565","2020-04-04",68,19,66,282,2214,0.404697380307136,0,0,204,321,49,966,17,364,23,17
"1566","2020-04-05",67,19,85,296,2214,0.404697380307136,0,0,204,321,46,1012,38,402,27,38
"1567","2020-04-06",78,19,92,300,2214,0.404697380307136,0,0,204,321,64,1076,37,439,35,37
"1568","2020-04-07",79,19,98,302,2214,0.404697380307136,0,0,204,321,34,1110,19,458,11,19
"1569","2020-04-08",82,19,102,308,2214,0.404697380307136,0,0,204,321,40,1150,27,485,29,27
"1570","2020-04-09",83,19,89,314,2214,0.404697380307136,0,0,204,321,40,1190,25,510,15,25
"1571","2020-04-10",85,19,96,327,2214,0.404697380307136,0,0,204,321,28,1218,15,525,11,15
"1572","2020-04-11",89,19,92,332,2214,0.404697380307136,0,0,204,321,44,1262,13,538,22,13
"1573","2020-04-12",88,19,107,332,2214,0.404697380307136,0,0,204,321,34,1296,10,548,15,10
"1574","2020-04-13",80,19,112,334,2214,0.404697380307136,0,0,204,321,47,1343,12,560,23,12
"1575","2020-04-14",82,19,112,338,2214,0.404697380307136,0,0,204,321,31,1374,9,569,13,9
"1576","2020-04-15",89,19,102,331,2214,0.404697380307136,0,0,204,321,41,1415,22,591,27,22
"1577","2020-04-16",88,19,109,337,2214,0.404697380307136,0,0,204,321,41,1456,24,615,19,24
"1578","2020-04-17",87,19,120,328,2214,0.404697380307136,0,0,204,321,31,1487,28,643,14,28
"1579","2020-04-18",92,19,115,339,2214,0.404697380307136,0,0,204,321,44,1531,45,688,24,45
"1580","2020-04-19",96,19,131,349,2214,0.404697380307136,0,0,204,321,34,1565,31,719,17,31
"1581","2020-04-20",100,19,137,352,2214,0.404697380307136,0,0,204,321,37,1602,35,754,16,35
"1582","2020-04-21",103,19,130,356,2214,0.404697380307136,0,0,204,321,29,1631,28,782,18,28
"1583","2020-04-22",91,19,133,375,2214,0.404697380307136,0,0,204,321,32,1663,15,797,16,15
"1584","2020-04-23",89,19,127,367,2214,0.404697380307136,0,0,204,321,33,1696,34,831,15,34
"1585","2020-04-24",98,19,133,368,2214,0.404697380307136,0,0,204,321,45,1741,52,883,27,52
"1586","2020-04-25",99,19,125,347,2214,0.404697380307136,0,0,204,321,30,1771,22,905,20,22
"1587","2020-04-26",98,19,122,352,2214,0.404697380307136,0,0,204,321,35,1806,15,920,18,15
"1588","2020-04-27",101,19,136,374,2214,0.404697380307136,0,0,204,321,38,1844,23,943,19,23
"1589","2020-04-28",96,19,137,359,2214,0.404697380307136,0,0,204,321,22,1866,49,992,13,49
"1590","2020-04-29",99,19,150,353,2214,0.404697380307136,0,0,204,321,36,1902,24,1016,16,24
"1591","2020-04-30",105,19,167,342,2214,0.404697380307136,0,0,204,321,29,1931,20,1036,14,20
"1592","2020-05-01",102,19,173,340,2214,0.404697380307136,0,0,204,321,36,1967,41,1077,15,41
"1593","2020-05-02",101,19,165,318,2214,0.404697380307136,0,0,204,321,31,1998,38,1115,16,38
"1594","2020-05-03",102,19,142,319,2214,0.404697380307136,0,0,204,321,41,2039,21,1136,21,21
"1595","2020-05-04",101,19,136,303,2214,0.404697380307136,0,0,204,321,29,2068,40,1176,8,40
"1596","2020-05-05",107,19,127,295,2214,0.404697380307136,0,0,204,321,35,2103,47,1223,16,47
"1597","2020-05-06",101,19,109,291,2214,0.404697380307136,0,0,204,321,45,2148,43,1266,24,43
"1598","2020-05-07",93,19,114,290,2214,0.404697380307136,0,0,204,321,36,2184,25,1291,13,25
"1599","2020-05-08",88,19,100,283,2214,0.404697380307136,0,0,204,321,46,2230,12,1303,27,12
"1600","2020-05-09",75,19,109,281,2214,0.404697380307136,0,0,204,321,27,2257,14,1317,18,14
"1601","2020-05-10",70,19,121,280,2214,0.404697380307136,0,0,204,321,39,2296,15,1332,23,15
"1602","2020-05-11",65,19,131,268,2214,0.404697380307136,0,0,204,321,42,2338,14,1346,23,14
"1603","2020-05-12",58,19,111,268,2214,0.404697380307136,0,0,204,321,36,2374,28,1374,16,28
"1604","2020-05-13",66,19,95,269,2214,0.404697380307136,0,0,204,321,32,2406,17,1391,22,17
"1605","2020-05-14",68,19,87,263,2214,0.404697380307136,0,0,204,321,28,2434,27,1418,16,27
"1606","2020-05-15",69,19,97,258,2214,0.404697380307136,0,0,204,321,32,2466,20,1438,18,20
"1607","2020-05-16",74,19,97,265,2214,0.404697380307136,0,0,204,321,29,2495,18,1456,17,18
"1608","2020-05-17",76,19,80,268,2214,0.404697380307136,0,0,204,321,22,2517,35,1491,13,35
"1609","2020-05-18",71,19,69,276,2214,0.404697380307136,0,0,204,321,38,2555,15,1506,24,15
"1610","2020-05-19",74,19,83,272,2214,0.404697380307136,0,0,204,321,40,2595,13,1519,23,13
"1611","2020-05-20",76,19,90,267,2214,0.404697380307136,0,0,204,321,43,2638,25,1544,24,25
"1612","2020-05-21",73,19,77,258,2214,0.404697380307136,0,0,204,321,30,2668,18,1562,17,18
"1613","2020-05-22",74,19,82,253,2214,0.404697380307136,0,0,204,321,29,2697,11,1573,22,11
"1614","2020-05-23",74,19,75,236,2214,0.404697380307136,0,0,204,321,16,2713,28,1601,11,28
"1615","2020-05-24",77,19,82,226,2214,0.404697380307136,0,0,204,321,24,2737,37,1638,13,37
"1616","2020-05-25",80,19,81,221,2214,0.404697380307136,0,0,204,321,20,2757,32,1670,10,32
"1617","2020-05-26",75,19,89,216,2214,0.404697380307136,0,0,204,321,14,2771,23,1693,10,23
"1618","2020-05-27",65,19,83,207,2214,0.404697380307136,0,0,204,321,27,2798,12,1705,15,12
"1619","2020-05-28",64,19,85,210,2214,0.404697380307136,0,0,204,321,20,2818,7,1712,12,7
"1620","2020-05-29",57,19,84,207,2214,0.404697380307136,0,0,204,321,29,2847,6,1718,18,6
"1621","2020-05-30",56,19,81,191,2214,0.404697380307136,0,0,204,321,20,2867,8,1726,9,8
"1622","2020-05-31",43,19,80,180,2214,0.404697380307136,0,0,204,321,20,2887,18,1744,14,18
"1623","2020-06-01",41,19,80,171,2214,0.404697380307136,0,0,204,321,21,2908,13,1757,17,13
"1624","2020-06-02",45,19,81,172,2214,0.404697380307136,0,0,204,321,17,2925,8,1765,7,8
"1625","2020-06-03",45,19,77,171,2214,0.404697380307136,0,0,204,321,16,2941,4,1769,13,4
"1626","2020-06-04",42,19,84,170,2214,0.404697380307136,0,0,204,321,19,2960,10,1779,11,10
"1627","2020-06-05",46,19,90,165,2214,0.404697380307136,0,0,204,321,17,2977,28,1807,10,28
"1628","2020-06-06",48,19,85,160,2214,0.404697380307136,0,0,204,321,13,2990,9,1816,9,9
"1629","2020-06-07",55,19,74,149,2214,0.404697380307136,0,0,204,321,19,3009,6,1822,13,6
"1630","2020-03-13",2,20,27,28,3812,0.92707240293809,0,0,357,445,4,19,9,20,1,9
"1631","2020-03-14",2,20,32,37,3812,0.92707240293809,0,0,357,445,6,25,6,26,3,6
"1632","2020-03-15",4,20,32,46,3812,0.92707240293809,0,0,357,445,12,37,3,29,2,3
"1633","2020-03-16",7,20,35,63,3812,0.92707240293809,0,0,357,445,9,46,7,36,4,7
"1634","2020-03-17",7,20,36,77,3812,0.92707240293809,0,0,357,445,6,52,7,43,3,7
"1635","2020-03-18",8,20,26,87,3812,0.92707240293809,0,0,357,445,14,66,9,52,8,9
"1636","2020-03-19",11,20,29,105,3812,0.92707240293809,0,0,357,445,16,82,6,58,8,6
"1637","2020-03-20",14,20,50,126,3812,0.92707240293809,0,0,357,445,15,97,16,74,9,16
"1638","2020-03-21",18,20,62,139,3812,0.92707240293809,0,0,357,445,17,114,8,82,12,8
"1639","2020-03-22",22,20,55,159,3812,0.92707240293809,0,0,357,445,18,132,7,89,13,7
"1640","2020-03-23",26,20,43,179,3812,0.92707240293809,0,0,357,445,18,150,11,100,11,11
"1641","2020-03-24",30,20,41,192,3812,0.92707240293809,0,0,357,445,17,167,11,111,14,11
"1642","2020-03-25",39,20,39,202,3812,0.92707240293809,0,0,357,445,19,186,19,130,14,19
"1643","2020-03-26",42,20,41,227,3812,0.92707240293809,0,0,357,445,25,211,16,146,21,16
"1644","2020-03-27",48,20,33,243,3812,0.92707240293809,0,0,357,445,21,232,26,172,13,26
"1645","2020-03-28",53,20,33,249,3812,0.92707240293809,0,0,357,445,22,254,15,187,20,15
"1646","2020-03-29",60,20,38,259,3812,0.92707240293809,0,0,357,445,26,280,14,201,14,14
"1647","2020-03-30",59,20,57,285,3812,0.92707240293809,0,0,357,445,30,310,18,219,22,18
"1648","2020-03-31",65,20,79,307,3812,0.92707240293809,0,0,357,445,24,334,31,250,18,31
"1649","2020-04-01",70,20,100,347,3812,0.92707240293809,0,0,357,445,30,364,23,273,23,23
"1650","2020-04-02",73,20,110,361,3812,0.92707240293809,0,0,357,445,17,381,23,296,14,23
"1651","2020-04-03",73,20,106,391,3812,0.92707240293809,0,0,357,445,32,413,33,329,28,33
"1652","2020-04-04",79,20,96,406,3812,0.92707240293809,0,0,357,445,21,434,28,357,20,28
"1653","2020-04-05",81,20,92,426,3812,0.92707240293809,0,0,357,445,27,461,30,387,22,30
"1654","2020-04-06",89,20,96,456,3812,0.92707240293809,0,0,357,445,20,481,39,426,17,39
"1655","2020-04-07",107,20,91,477,3812,0.92707240293809,0,0,357,445,26,507,35,461,20,35
"1656","2020-04-08",107,20,117,513,3812,0.92707240293809,0,0,357,445,28,535,43,504,15,43
"1657","2020-04-09",114,20,130,529,3812,0.92707240293809,0,0,357,445,24,559,36,540,17,36
"1658","2020-04-10",117,20,141,560,3812,0.92707240293809,0,0,357,445,26,585,28,568,18,28
"1659","2020-04-11",126,20,138,556,3812,0.92707240293809,0,0,357,445,16,601,44,612,8,44
"1660","2020-04-12",133,20,123,594,3812,0.92707240293809,0,0,357,445,21,622,39,651,12,39
"1661","2020-04-13",148,20,119,597,3812,0.92707240293809,0,0,357,445,29,651,37,688,18,37
"1662","2020-04-14",142,20,139,632,3812,0.92707240293809,0,0,357,445,25,676,27,715,14,27
"1663","2020-04-15",151,20,117,633,3812,0.92707240293809,0,0,357,445,21,697,34,749,12,34
"1664","2020-04-16",159,20,113,674,3812,0.92707240293809,0,0,357,445,17,714,36,785,10,36
"1665","2020-04-17",175,20,110,706,3812,0.92707240293809,0,0,357,445,19,733,31,816,11,31
"1666","2020-04-18",177,20,136,721,3812,0.92707240293809,0,0,357,445,31,764,28,844,19,28
"1667","2020-04-19",186,20,162,726,3812,0.92707240293809,0,0,357,445,28,792,18,862,18,18
"1668","2020-04-20",183,20,153,739,3812,0.92707240293809,0,0,357,445,20,812,19,881,11,19
"1669","2020-04-21",186,20,162,771,3812,0.92707240293809,0,0,357,445,14,826,29,910,8,29
"1670","2020-04-22",193,20,150,791,3812,0.92707240293809,0,0,357,445,23,849,31,941,16,31
"1671","2020-04-23",200,20,168,813,3812,0.92707240293809,0,0,357,445,19,868,50,991,13,50
"1672","2020-04-24",196,20,167,808,3812,0.92707240293809,0,0,357,445,20,888,22,1013,13,22
"1673","2020-04-25",204,20,203,821,3812,0.92707240293809,0,0,357,445,13,901,25,1038,8,25
"1674","2020-04-26",207,20,169,825,3812,0.92707240293809,0,0,357,445,21,922,35,1073,11,35
"1675","2020-04-27",218,20,147,843,3812,0.92707240293809,0,0,357,445,19,941,29,1102,14,29
"1676","2020-04-28",223,20,126,854,3812,0.92707240293809,0,0,357,445,21,962,26,1128,13,26
"1677","2020-04-29",226,20,117,843,3812,0.92707240293809,0,0,357,445,17,979,17,1145,10,17
"1678","2020-04-30",223,20,106,829,3812,0.92707240293809,0,0,357,445,21,1000,17,1162,14,17
"1679","2020-05-01",238,20,83,852,3812,0.92707240293809,0,0,357,445,18,1018,17,1179,9,17
"1680","2020-05-02",240,20,75,846,3812,0.92707240293809,0,0,357,445,16,1034,33,1212,15,33
"1681","2020-05-03",242,20,82,850,3812,0.92707240293809,0,0,357,445,20,1054,37,1249,11,37
"1682","2020-05-04",248,20,83,826,3812,0.92707240293809,0,0,357,445,14,1068,28,1277,4,28
"1683","2020-05-05",254,20,107,810,3812,0.92707240293809,0,0,357,445,17,1085,33,1310,14,33
"1684","2020-05-06",254,20,117,784,3812,0.92707240293809,0,0,357,445,25,1110,21,1331,15,21
"1685","2020-05-07",264,20,122,750,3812,0.92707240293809,0,0,357,445,22,1132,36,1367,15,36
"1686","2020-05-08",261,20,136,746,3812,0.92707240293809,0,0,357,445,15,1147,29,1396,10,29
"1687","2020-05-09",262,20,136,714,3812,0.92707240293809,0,0,357,445,18,1165,32,1428,12,32
"1688","2020-05-10",253,20,146,704,3812,0.92707240293809,0,0,357,445,16,1181,26,1454,13,26
"1689","2020-05-11",234,20,144,673,3812,0.92707240293809,0,0,357,445,25,1206,19,1473,21,19
"1690","2020-05-12",221,20,148,645,3812,0.92707240293809,0,0,357,445,24,1230,26,1499,10,26
"1691","2020-05-13",215,20,147,617,3812,0.92707240293809,0,0,357,445,30,1260,30,1529,25,30
"1692","2020-05-14",198,20,135,577,3812,0.92707240293809,0,0,357,445,20,1280,35,1564,16,35
"1693","2020-05-15",184,20,136,555,3812,0.92707240293809,0,0,357,445,19,1299,34,1598,12,34
"1694","2020-05-16",167,20,133,524,3812,0.92707240293809,0,0,357,445,18,1317,36,1634,10,36
"1695","2020-05-17",168,20,140,492,3812,0.92707240293809,0,0,357,445,21,1338,27,1661,12,27
"1696","2020-05-18",166,20,134,456,3812,0.92707240293809,0,0,357,445,18,1356,25,1686,15,25
"1697","2020-05-19",164,20,128,429,3812,0.92707240293809,0,0,357,445,16,1372,36,1722,14,36
"1698","2020-05-20",162,20,116,390,3812,0.92707240293809,0,0,357,445,15,1387,23,1745,11,23
"1699","2020-05-21",153,20,120,359,3812,0.92707240293809,0,0,357,445,18,1405,26,1771,15,26
"1700","2020-05-22",148,20,103,329,3812,0.92707240293809,0,0,357,445,17,1422,13,1784,11,13
"1701","2020-05-23",137,20,88,300,3812,0.92707240293809,0,0,357,445,22,1444,28,1812,17,28
"1702","2020-05-24",121,20,85,285,3812,0.92707240293809,0,0,357,445,15,1459,30,1842,7,30
"1703","2020-05-25",110,20,80,270,3812,0.92707240293809,0,0,357,445,19,1478,34,1876,15,34
"1704","2020-05-26",99,20,76,251,3812,0.92707240293809,0,0,357,445,13,1491,37,1913,9,37
"1705","2020-05-27",89,20,64,237,3812,0.92707240293809,0,0,357,445,10,1501,36,1949,7,36
"1706","2020-05-28",90,20,52,230,3812,0.92707240293809,0,0,357,445,20,1521,23,1972,12,23
"1707","2020-05-29",83,20,66,208,3812,0.92707240293809,0,0,357,445,16,1537,25,1997,12,25
"1708","2020-05-30",82,20,89,212,3812,0.92707240293809,0,0,357,445,18,1555,24,2021,14,24
"1709","2020-05-31",78,20,111,208,3812,0.92707240293809,0,0,357,445,12,1567,33,2054,8,33
"1710","2020-06-01",76,20,116,202,3812,0.92707240293809,0,0,357,445,11,1578,28,2082,9,28
"1711","2020-06-02",72,20,113,204,3812,0.92707240293809,0,0,357,445,16,1594,16,2098,13,16
"1712","2020-06-03",67,20,114,199,3812,0.92707240293809,0,0,357,445,16,1610,17,2115,10,17
"1713","2020-06-04",60,20,107,192,3812,0.92707240293809,0,0,357,445,5,1615,11,2126,5,11
"1714","2020-06-05",53,20,94,191,3812,0.92707240293809,0,0,357,445,9,1624,14,2140,9,14
"1715","2020-06-06",52,20,85,187,3812,0.92707240293809,0,0,357,445,13,1637,10,2150,10,10
"1716","2020-06-07",51,20,89,176,3812,0.92707240293809,0,0,357,445,10,1647,12,2162,6,12
