"","Date","Absents","Paramset","Infections_or_Exposed_per_day_Patient","Infections_or_Exposed_per_day_HCW","total_infections","nosocomial_proportion","PCR_pooled","LFD_pooled","HCW_symp_test","patient_symp_test","new_hcw_infs","cumulative_hcw_infs","new_pat_infs","cumulative_pats_infs","new_nosocomial_hcw_infs","new_nosocomial_pat_infs"
"1","2020-03-14",1,1,16,42,4533,0.780719170527245,0,0,372,173,11,42,4,15,NA,4
"2","2020-03-15",3,1,26,60,4533,0.780719170527245,0,0,372,173,18,60,8,23,6,8
"3","2020-03-16",5,1,26,76,4533,0.780719170527245,0,0,372,173,16,76,7,30,8,7
"4","2020-03-17",9,1,29,94,4533,0.780719170527245,0,0,372,173,18,94,5,35,4,5
"5","2020-03-18",10,1,38,113,4533,0.780719170527245,0,0,372,173,19,113,11,46,13,11
"6","2020-03-19",13,1,40,136,4533,0.780719170527245,0,0,372,173,28,141,10,56,14,10
"7","2020-03-20",18,1,37,162,4533,0.780719170527245,0,0,372,173,31,172,3,59,20,3
"8","2020-03-21",21,1,34,185,4533,0.780719170527245,0,0,372,173,29,201,3,62,22,3
"9","2020-03-22",30,1,24,212,4533,0.780719170527245,0,0,372,173,31,232,1,63,19,1
"10","2020-03-23",34,1,30,225,4533,0.780719170527245,0,0,372,173,23,255,8,71,15,8
"11","2020-03-24",38,1,27,246,4533,0.780719170527245,0,0,372,173,31,286,2,73,22,2
"12","2020-03-25",49,1,27,266,4533,0.780719170527245,0,0,372,173,31,317,7,80,24,7
"13","2020-03-26",61,1,34,272,4533,0.780719170527245,0,0,372,173,29,346,8,88,19,8
"14","2020-03-27",68,1,34,290,4533,0.780719170527245,0,0,372,173,34,380,7,95,21,7
"15","2020-03-28",75,1,29,310,4533,0.780719170527245,0,0,372,173,36,416,3,98,20,3
"16","2020-03-29",76,1,26,330,4533,0.780719170527245,0,0,372,173,43,459,5,103,33,5
"17","2020-03-30",83,1,32,342,4533,0.780719170527245,0,0,372,173,38,497,6,109,25,6
"18","2020-03-31",88,1,30,354,4533,0.780719170527245,0,0,372,173,36,533,10,119,23,10
"19","2020-04-01",85,1,37,380,4533,0.780719170527245,0,0,372,173,55,588,5,124,39,5
"20","2020-04-02",83,1,39,391,4533,0.780719170527245,0,0,372,173,41,629,8,132,30,8
"21","2020-04-03",87,1,43,403,4533,0.780719170527245,0,0,372,173,43,672,10,142,24,10
"22","2020-04-04",93,1,42,428,4533,0.780719170527245,0,0,372,173,51,723,4,146,31,4
"23","2020-04-05",97,1,43,462,4533,0.780719170527245,0,0,372,173,62,785,2,148,48,2
"24","2020-04-06",103,1,44,466,4533,0.780719170527245,0,0,372,173,45,830,7,155,33,7
"25","2020-04-07",116,1,39,486,4533,0.780719170527245,0,0,372,173,48,878,5,160,31,5
"26","2020-04-08",127,1,38,518,4533,0.780719170527245,0,0,372,173,62,940,4,164,45,4
"27","2020-04-09",134,1,40,535,4533,0.780719170527245,0,0,372,173,70,1010,7,171,54,7
"28","2020-04-10",137,1,47,564,4533,0.780719170527245,0,0,372,173,58,1068,7,178,43,7
"29","2020-04-11",140,1,36,583,4533,0.780719170527245,0,0,372,173,57,1125,11,189,44,11
"30","2020-04-12",139,1,54,597,4533,0.780719170527245,0,0,372,173,57,1182,23,212,49,23
"31","2020-04-13",140,1,50,635,4533,0.780719170527245,0,0,372,173,82,1264,5,217,66,5
"32","2020-04-14",142,1,50,644,4533,0.780719170527245,0,0,372,173,64,1328,11,228,52,11
"33","2020-04-15",146,1,60,669,4533,0.780719170527245,0,0,372,173,72,1400,15,243,55,15
"34","2020-04-16",154,1,71,694,4533,0.780719170527245,0,0,372,173,77,1477,20,263,65,20
"35","2020-04-17",162,1,64,715,4533,0.780719170527245,0,0,372,173,73,1550,14,277,58,14
"36","2020-04-18",176,1,70,720,4533,0.780719170527245,0,0,372,173,63,1613,11,288,55,11
"37","2020-04-19",184,1,76,751,4533,0.780719170527245,0,0,372,173,90,1703,16,304,75,16
"38","2020-04-20",186,1,84,762,4533,0.780719170527245,0,0,372,173,67,1770,15,319,50,15
"39","2020-04-21",196,1,88,785,4533,0.780719170527245,0,0,372,173,84,1854,17,336,69,17
"40","2020-04-22",208,1,88,805,4533,0.780719170527245,0,0,372,173,81,1935,18,354,69,18
"41","2020-04-23",210,1,80,826,4533,0.780719170527245,0,0,372,173,86,2021,12,366,77,12
"42","2020-04-24",216,1,80,832,4533,0.780719170527245,0,0,372,173,79,2100,15,381,65,15
"43","2020-04-25",216,1,66,849,4533,0.780719170527245,0,0,372,173,91,2191,11,392,73,11
"44","2020-04-26",224,1,70,874,4533,0.780719170527245,0,0,372,173,87,2278,13,405,73,13
"45","2020-04-27",226,1,61,883,4533,0.780719170527245,0,0,372,173,89,2367,10,415,74,10
"46","2020-04-28",231,1,65,884,4533,0.780719170527245,0,0,372,173,65,2432,13,428,61,13
"47","2020-04-29",239,1,64,885,4533,0.780719170527245,0,0,372,173,66,2498,10,438,57,10
"48","2020-04-30",261,1,61,885,4533,0.780719170527245,0,0,372,173,86,2584,9,447,79,9
"49","2020-05-01",260,1,70,874,4533,0.780719170527245,0,0,372,173,62,2646,19,466,53,19
"50","2020-05-02",262,1,82,867,4533,0.780719170527245,0,0,372,173,69,2715,18,484,61,18
"51","2020-05-03",268,1,90,869,4533,0.780719170527245,0,0,372,173,74,2789,22,506,65,22
"52","2020-05-04",276,1,93,871,4533,0.780719170527245,0,0,372,173,91,2880,18,524,73,18
"53","2020-05-05",265,1,89,832,4533,0.780719170527245,0,0,372,173,46,2926,13,537,40,13
"54","2020-05-06",251,1,79,817,4533,0.780719170527245,0,0,372,173,71,2997,5,542,61,5
"55","2020-05-07",238,1,78,814,4533,0.780719170527245,0,0,372,173,83,3080,14,556,69,14
"56","2020-05-08",230,1,78,790,4533,0.780719170527245,0,0,372,173,66,3146,21,577,58,21
"57","2020-05-09",218,1,76,761,4533,0.780719170527245,0,0,372,173,62,3208,9,586,51,9
"58","2020-05-10",205,1,70,753,4533,0.780719170527245,0,0,372,173,60,3268,9,595,53,9
"59","2020-05-11",212,1,74,749,4533,0.780719170527245,0,0,372,173,70,3338,14,609,63,14
"60","2020-05-12",208,1,75,743,4533,0.780719170527245,0,0,372,173,71,3409,17,626,68,17
"61","2020-05-13",198,1,81,754,4533,0.780719170527245,0,0,372,173,80,3489,19,645,65,19
"62","2020-05-14",189,1,90,739,4533,0.780719170527245,0,0,372,173,61,3550,16,661,56,16
"63","2020-05-15",206,1,89,742,4533,0.780719170527245,0,0,372,173,65,3615,16,677,61,16
"64","2020-05-16",210,1,92,756,4533,0.780719170527245,0,0,372,173,85,3700,16,693,74,16
"65","2020-05-17",220,1,92,758,4533,0.780719170527245,0,0,372,173,62,3762,15,708,54,15
"66","2020-05-18",208,1,89,745,4533,0.780719170527245,0,0,372,173,55,3817,13,721,50,13
"67","2020-05-19",213,1,90,736,4533,0.780719170527245,0,0,372,173,66,3883,16,737,60,16
"68","2020-05-20",210,1,73,718,4533,0.780719170527245,0,0,372,173,52,3935,7,744,42,7
"69","2020-05-21",214,1,62,708,4533,0.780719170527245,0,0,372,173,49,3984,4,748,46,4
"70","2020-05-22",199,1,64,670,4533,0.780719170527245,0,0,372,173,43,4027,8,756,37,8
"71","2020-05-23",209,1,58,647,4533,0.780719170527245,0,0,372,173,41,4068,8,764,35,8
"72","2020-05-24",203,1,49,614,4533,0.780719170527245,0,0,372,173,43,4111,6,770,37,6
"73","2020-05-25",189,1,53,581,4533,0.780719170527245,0,0,372,173,27,4138,8,778,23,8
"74","2020-05-26",185,1,47,543,4533,0.780719170527245,0,0,372,173,34,4172,7,785,28,7
"75","2020-05-27",192,1,40,496,4533,0.780719170527245,0,0,372,173,32,4204,3,788,29,3
"76","2020-05-28",187,1,38,461,4533,0.780719170527245,0,0,372,173,18,4222,7,795,17,7
"77","2020-05-29",181,1,42,437,4533,0.780719170527245,0,0,372,173,33,4255,5,800,23,5
"78","2020-05-30",160,1,36,409,4533,0.780719170527245,0,0,372,173,23,4278,1,801,19,1
"79","2020-05-31",153,1,31,374,4533,0.780719170527245,0,0,372,173,26,4304,6,807,24,6
"80","2020-06-01",153,1,38,353,4533,0.780719170527245,0,0,372,173,21,4325,8,815,18,8
"81","2020-06-02",136,1,36,322,4533,0.780719170527245,0,0,372,173,9,4334,5,820,8,5
"82","2020-06-03",121,1,36,294,4533,0.780719170527245,0,0,372,173,17,4351,10,830,15,10
"83","2020-06-04",102,1,38,274,4533,0.780719170527245,0,0,372,173,12,4363,5,835,8,5
"84","2020-06-05",90,1,33,251,4533,0.780719170527245,0,0,372,173,16,4379,7,842,12,7
"85","2020-06-06",83,1,43,227,4533,0.780719170527245,0,0,372,173,14,4393,9,851,9,9
"86","2020-06-07",71,1,37,215,4533,0.780719170527245,0,0,372,173,11,4404,5,856,7,5
"87","2020-03-14",1,2,8,17,2902,0.815299793246037,0,0,289,129,11,44,5,18,1,5
"88","2020-03-15",2,2,10,20,2902,0.815299793246037,0,0,289,129,10,54,2,20,3,2
"89","2020-03-16",2,2,8,30,2902,0.815299793246037,0,0,289,129,12,66,4,24,4,4
"90","2020-03-17",3,2,9,37,2902,0.815299793246037,0,0,289,129,17,83,5,29,7,5
"91","2020-03-18",4,2,10,44,2902,0.815299793246037,0,0,289,129,16,99,2,31,6,2
"92","2020-03-19",5,2,11,51,2902,0.815299793246037,0,0,289,129,18,117,5,36,10,5
"93","2020-03-20",7,2,14,61,2902,0.815299793246037,0,0,289,129,12,129,2,38,8,2
"94","2020-03-21",7,2,14,69,2902,0.815299793246037,0,0,289,129,19,148,4,42,10,4
"95","2020-03-22",7,2,23,74,2902,0.815299793246037,0,0,289,129,20,168,9,51,11,9
"96","2020-03-23",7,2,25,86,2902,0.815299793246037,0,0,289,129,23,191,3,54,12,3
"97","2020-03-24",10,2,18,96,2902,0.815299793246037,0,0,289,129,17,208,5,59,8,5
"98","2020-03-25",16,2,18,108,2902,0.815299793246037,0,0,289,129,30,238,3,62,16,3
"99","2020-03-26",21,2,17,116,2902,0.815299793246037,0,0,289,129,26,264,2,64,15,2
"100","2020-03-27",23,2,16,130,2902,0.815299793246037,0,0,289,129,18,282,7,71,10,7
"101","2020-03-28",27,2,20,140,2902,0.815299793246037,0,0,289,129,35,317,4,75,23,4
"102","2020-03-29",28,2,21,151,2902,0.815299793246037,0,0,289,129,22,339,10,85,15,10
"103","2020-03-30",36,2,24,177,2902,0.815299793246037,0,0,289,129,31,370,3,88,19,3
"104","2020-03-31",36,2,31,201,2902,0.815299793246037,0,0,289,129,23,393,9,97,13,9
"105","2020-04-01",38,2,27,212,2902,0.815299793246037,0,0,289,129,32,425,13,110,19,13
"106","2020-04-02",39,2,28,243,2902,0.815299793246037,0,0,289,129,30,455,7,117,19,7
"107","2020-04-03",46,2,31,274,2902,0.815299793246037,0,0,289,129,27,482,11,128,17,11
"108","2020-04-04",56,2,27,288,2902,0.815299793246037,0,0,289,129,22,504,12,140,10,12
"109","2020-04-05",69,2,32,306,2902,0.815299793246037,0,0,289,129,25,529,8,148,12,8
"110","2020-04-06",75,2,34,321,2902,0.815299793246037,0,0,289,129,37,566,5,153,26,5
"111","2020-04-07",82,2,28,335,2902,0.815299793246037,0,0,289,129,28,594,11,164,15,11
"112","2020-04-08",93,2,28,350,2902,0.815299793246037,0,0,289,129,19,613,13,177,11,13
"113","2020-04-09",103,2,50,368,2902,0.815299793246037,0,0,289,129,33,646,8,185,19,8
"114","2020-04-10",103,2,61,373,2902,0.815299793246037,0,0,289,129,30,676,4,189,19,4
"115","2020-04-11",109,2,63,392,2902,0.815299793246037,0,0,289,129,30,706,10,199,18,10
"116","2020-04-12",115,2,56,392,2902,0.815299793246037,0,0,289,129,35,741,5,204,24,5
"117","2020-04-13",120,2,57,400,2902,0.815299793246037,0,0,289,129,41,782,10,214,21,10
"118","2020-04-14",122,2,64,409,2902,0.815299793246037,0,0,289,129,53,835,7,221,30,7
"119","2020-04-15",120,2,54,423,2902,0.815299793246037,0,0,289,129,32,867,11,232,15,11
"120","2020-04-16",123,2,60,436,2902,0.815299793246037,0,0,289,129,35,902,11,243,19,11
"121","2020-04-17",129,2,65,433,2902,0.815299793246037,0,0,289,129,29,931,9,252,20,9
"122","2020-04-18",128,2,63,449,2902,0.815299793246037,0,0,289,129,36,967,8,260,28,8
"123","2020-04-19",116,2,50,459,2902,0.815299793246037,0,0,289,129,36,1003,23,283,21,23
"124","2020-04-20",114,2,45,461,2902,0.815299793246037,0,0,289,129,39,1042,13,296,27,13
"125","2020-04-21",114,2,38,468,2902,0.815299793246037,0,0,289,129,27,1069,14,310,11,14
"126","2020-04-22",110,2,45,480,2902,0.815299793246037,0,0,289,129,29,1098,7,317,20,7
"127","2020-04-23",110,2,49,496,2902,0.815299793246037,0,0,289,129,28,1126,15,332,14,15
"128","2020-04-24",115,2,44,491,2902,0.815299793246037,0,0,289,129,21,1147,7,339,14,7
"129","2020-04-25",117,2,37,497,2902,0.815299793246037,0,0,289,129,21,1168,11,350,12,11
"130","2020-04-26",126,2,42,504,2902,0.815299793246037,0,0,289,129,36,1204,7,357,20,7
"131","2020-04-27",135,2,50,508,2902,0.815299793246037,0,0,289,129,28,1232,13,370,11,13
"132","2020-04-28",143,2,48,536,2902,0.815299793246037,0,0,289,129,30,1262,6,376,15,6
"133","2020-04-29",146,2,50,553,2902,0.815299793246037,0,0,289,129,20,1282,12,388,11,12
"134","2020-04-30",154,2,66,563,2902,0.815299793246037,0,0,289,129,26,1308,30,418,13,30
"135","2020-05-01",149,2,68,567,2902,0.815299793246037,0,0,289,129,28,1336,11,429,16,11
"136","2020-05-02",151,2,66,582,2902,0.815299793246037,0,0,289,129,28,1364,16,445,11,16
"137","2020-05-03",161,2,60,581,2902,0.815299793246037,0,0,289,129,26,1390,16,461,12,16
"138","2020-05-04",159,2,59,572,2902,0.815299793246037,0,0,289,129,22,1412,17,478,12,17
"139","2020-05-05",162,2,53,574,2902,0.815299793246037,0,0,289,129,31,1443,25,503,22,25
"140","2020-05-06",171,2,52,574,2902,0.815299793246037,0,0,289,129,24,1467,25,528,10,25
"141","2020-05-07",166,2,63,574,2902,0.815299793246037,0,0,289,129,24,1491,25,553,8,25
"142","2020-05-08",175,2,76,552,2902,0.815299793246037,0,0,289,129,22,1513,13,566,11,13
"143","2020-05-09",170,2,74,536,2902,0.815299793246037,0,0,289,129,31,1544,19,585,20,19
"144","2020-05-10",168,2,63,539,2902,0.815299793246037,0,0,289,129,14,1558,7,592,10,7
"145","2020-05-11",171,2,64,531,2902,0.815299793246037,0,0,289,129,28,1586,18,610,18,18
"146","2020-05-12",172,2,66,508,2902,0.815299793246037,0,0,289,129,15,1601,22,632,5,22
"147","2020-05-13",165,2,64,497,2902,0.815299793246037,0,0,289,129,15,1616,29,661,6,29
"148","2020-05-14",157,2,58,478,2902,0.815299793246037,0,0,289,129,21,1637,20,681,7,20
"149","2020-05-15",153,2,64,461,2902,0.815299793246037,0,0,289,129,36,1673,14,695,20,14
"150","2020-05-16",149,2,62,456,2902,0.815299793246037,0,0,289,129,19,1692,15,710,14,15
"151","2020-05-17",142,2,57,443,2902,0.815299793246037,0,0,289,129,21,1713,16,726,17,16
"152","2020-05-18",130,2,60,430,2902,0.815299793246037,0,0,289,129,19,1732,14,740,7,14
"153","2020-05-19",122,2,53,409,2902,0.815299793246037,0,0,289,129,23,1755,7,747,12,7
"154","2020-05-20",117,2,49,401,2902,0.815299793246037,0,0,289,129,24,1779,16,763,14,16
"155","2020-05-21",116,2,52,395,2902,0.815299793246037,0,0,289,129,20,1799,17,780,9,17
"156","2020-05-22",107,2,55,390,2902,0.815299793246037,0,0,289,129,15,1814,24,804,9,24
"157","2020-05-23",105,2,61,372,2902,0.815299793246037,0,0,289,129,9,1823,19,823,4,19
"158","2020-05-24",106,2,62,348,2902,0.815299793246037,0,0,289,129,6,1829,7,830,4,7
"159","2020-05-25",99,2,59,335,2902,0.815299793246037,0,0,289,129,15,1844,12,842,6,12
"160","2020-05-26",95,2,56,335,2902,0.815299793246037,0,0,289,129,18,1862,15,857,7,15
"161","2020-05-27",99,2,59,335,2902,0.815299793246037,0,0,289,129,13,1875,13,870,6,13
"162","2020-05-28",95,2,63,303,2902,0.815299793246037,0,0,289,129,6,1881,10,880,1,10
"163","2020-05-29",97,2,61,300,2902,0.815299793246037,0,0,289,129,14,1895,13,893,4,13
"164","2020-05-30",91,2,57,305,2902,0.815299793246037,0,0,289,129,13,1908,14,907,7,14
"165","2020-05-31",83,2,57,288,2902,0.815299793246037,0,0,289,129,8,1916,20,927,4,20
"166","2020-06-01",85,2,48,288,2902,0.815299793246037,0,0,289,129,12,1928,15,942,6,15
"167","2020-06-02",80,2,52,269,2902,0.815299793246037,0,0,289,129,10,1938,10,952,6,10
"168","2020-06-03",74,2,56,269,2902,0.815299793246037,0,0,289,129,8,1946,4,956,6,4
"169","2020-06-04",74,2,56,268,2902,0.815299793246037,0,0,289,129,15,1961,9,965,6,9
"170","2020-06-05",76,2,55,258,2902,0.815299793246037,0,0,289,129,9,1970,5,970,5,5
"171","2020-06-06",84,2,49,253,2902,0.815299793246037,0,0,289,129,7,1977,5,975,4,5
"172","2020-06-07",89,2,39,249,2902,0.815299793246037,0,0,289,129,9,1986,10,985,7,10
"173","2020-03-13",2,3,39,35,2464,0.60836038961039,0,0,193,466,9,19,9,12,5,9
"174","2020-03-14",3,3,50,49,2464,0.60836038961039,0,0,193,466,5,24,4,16,1,4
"175","2020-03-15",4,3,62,67,2464,0.60836038961039,0,0,193,466,9,33,4,20,8,4
"176","2020-03-16",6,3,61,84,2464,0.60836038961039,0,0,193,466,6,39,1,21,3,1
"177","2020-03-17",7,3,75,99,2464,0.60836038961039,0,0,193,466,12,51,NA,NA,9,NA
"178","2020-03-18",10,3,80,118,2464,0.60836038961039,0,0,193,466,9,60,4,25,8,4
"179","2020-03-19",11,3,68,133,2464,0.60836038961039,0,0,193,466,13,73,6,31,9,6
"180","2020-03-20",17,3,93,151,2464,0.60836038961039,0,0,193,466,13,86,7,38,11,7
"181","2020-03-21",26,3,118,168,2464,0.60836038961039,0,0,193,466,14,100,9,47,12,9
"182","2020-03-22",33,3,118,180,2464,0.60836038961039,0,0,193,466,15,115,8,55,14,8
"183","2020-03-23",40,3,114,193,2464,0.60836038961039,0,0,193,466,12,127,13,68,9,13
"184","2020-03-24",47,3,111,203,2464,0.60836038961039,0,0,193,466,16,143,8,76,14,8
"185","2020-03-25",49,3,114,224,2464,0.60836038961039,0,0,193,466,22,165,10,86,18,10
"186","2020-03-26",54,3,132,244,2464,0.60836038961039,0,0,193,466,16,181,8,94,15,8
"187","2020-03-27",53,3,123,253,2464,0.60836038961039,0,0,193,466,19,200,10,104,16,10
"188","2020-03-28",51,3,144,270,2464,0.60836038961039,0,0,193,466,29,229,10,114,27,10
"189","2020-03-29",56,3,157,295,2464,0.60836038961039,0,0,193,466,34,263,12,126,31,12
"190","2020-03-30",56,3,161,317,2464,0.60836038961039,0,0,193,466,30,293,14,140,29,14
"191","2020-03-31",57,3,151,317,2464,0.60836038961039,0,0,193,466,35,328,15,155,33,15
"192","2020-04-01",71,3,144,330,2464,0.60836038961039,0,0,193,466,38,366,10,165,35,10
"193","2020-04-02",83,3,145,353,2464,0.60836038961039,0,0,193,466,50,416,13,178,43,13
"194","2020-04-03",88,3,156,366,2464,0.60836038961039,0,0,193,466,39,455,11,189,36,11
"195","2020-04-04",98,3,183,374,2464,0.60836038961039,0,0,193,466,57,512,11,200,54,11
"196","2020-04-05",98,3,185,385,2464,0.60836038961039,0,0,193,466,43,555,16,216,39,16
"197","2020-04-06",105,3,173,397,2464,0.60836038961039,0,0,193,466,48,603,22,238,43,22
"198","2020-04-07",111,3,170,411,2464,0.60836038961039,0,0,193,466,71,674,13,251,67,13
"199","2020-04-08",106,3,163,417,2464,0.60836038961039,0,0,193,466,76,750,25,276,74,25
"200","2020-04-09",107,3,158,432,2464,0.60836038961039,0,0,193,466,93,843,12,288,85,12
"201","2020-04-10",110,3,144,428,2464,0.60836038961039,0,0,193,466,88,931,14,302,85,14
"202","2020-04-11",115,3,154,427,2464,0.60836038961039,0,0,193,466,101,1032,15,317,99,15
"203","2020-04-12",115,3,176,401,2464,0.60836038961039,0,0,193,466,89,1121,15,332,87,15
"204","2020-04-13",117,3,173,405,2464,0.60836038961039,0,0,193,466,88,1209,23,355,85,23
"205","2020-04-14",116,3,172,411,2464,0.60836038961039,0,0,193,466,112,1321,16,371,102,16
"206","2020-04-15",123,3,166,419,2464,0.60836038961039,0,0,193,466,99,1420,24,395,96,24
"207","2020-04-16",128,3,179,425,2464,0.60836038961039,0,0,193,466,95,1515,17,412,93,17
"208","2020-04-17",134,3,194,419,2464,0.60836038961039,0,0,193,466,126,1641,24,436,121,24
"209","2020-04-18",126,3,213,413,2464,0.60836038961039,0,0,193,466,97,1738,15,451,94,15
"210","2020-04-19",132,3,223,416,2464,0.60836038961039,0,0,193,466,113,1851,16,467,108,16
"211","2020-04-20",132,3,216,394,2464,0.60836038961039,0,0,193,466,112,1963,16,483,111,16
"212","2020-04-21",128,3,194,406,2464,0.60836038961039,0,0,193,466,131,2094,11,494,128,11
"213","2020-04-22",121,3,184,394,2464,0.60836038961039,0,0,193,466,96,2190,10,504,90,10
"214","2020-04-23",116,3,186,391,2464,0.60836038961039,0,0,193,466,104,2294,16,520,98,16
"215","2020-04-24",105,3,186,381,2464,0.60836038961039,0,0,193,466,108,2402,15,535,103,15
"216","2020-04-25",102,3,196,404,2464,0.60836038961039,0,0,193,466,144,2546,13,548,143,13
"217","2020-04-26",99,3,193,396,2464,0.60836038961039,0,0,193,466,116,2662,16,564,112,16
"218","2020-04-27",95,3,188,395,2464,0.60836038961039,0,0,193,466,130,2792,15,579,128,15
"219","2020-04-28",101,3,201,394,2464,0.60836038961039,0,0,193,466,112,2904,16,595,106,16
"220","2020-04-29",102,3,212,391,2464,0.60836038961039,0,0,193,466,111,3015,19,614,108,19
"221","2020-04-30",94,3,216,389,2464,0.60836038961039,0,0,193,466,101,3116,25,639,101,25
"222","2020-05-01",96,3,209,389,2464,0.60836038961039,0,0,193,466,109,3225,17,656,106,17
"223","2020-05-02",102,3,199,388,2464,0.60836038961039,0,0,193,466,91,3316,12,668,89,12
"224","2020-05-03",102,3,191,400,2464,0.60836038961039,0,0,193,466,120,3436,14,682,117,14
"225","2020-05-04",105,3,210,395,2464,0.60836038961039,0,0,193,466,79,3515,7,689,78,7
"226","2020-05-05",111,3,219,391,2464,0.60836038961039,0,0,193,466,76,3591,12,701,73,12
"227","2020-05-06",113,3,225,370,2464,0.60836038961039,0,0,193,466,103,3694,12,713,102,12
"228","2020-05-07",118,3,236,355,2464,0.60836038961039,0,0,193,466,63,3757,8,721,61,8
"229","2020-05-08",119,3,213,350,2464,0.60836038961039,0,0,193,466,74,3831,15,736,72,15
"230","2020-05-09",124,3,223,341,2464,0.60836038961039,0,0,193,466,73,3904,11,747,72,11
"231","2020-05-10",121,3,235,336,2464,0.60836038961039,0,0,193,466,105,4009,11,758,104,11
"232","2020-05-11",121,3,228,321,2464,0.60836038961039,0,0,193,466,69,4078,20,778,66,20
"233","2020-05-12",110,3,229,313,2464,0.60836038961039,0,0,193,466,64,4142,20,798,63,20
"234","2020-05-13",108,3,231,310,2464,0.60836038961039,0,0,193,466,67,4209,10,808,66,10
"235","2020-05-14",113,3,229,308,2464,0.60836038961039,0,0,193,466,48,4257,9,817,45,9
"236","2020-05-15",111,3,236,298,2464,0.60836038961039,0,0,193,466,70,4327,11,828,67,11
"237","2020-05-16",96,3,245,277,2464,0.60836038961039,0,0,193,466,43,4370,12,840,40,12
"238","2020-05-17",89,3,246,263,2464,0.60836038961039,0,0,193,466,52,4422,10,850,48,10
"239","2020-05-18",82,3,238,247,2464,0.60836038961039,0,0,193,466,35,4457,8,858,34,8
"240","2020-05-19",79,3,222,245,2464,0.60836038961039,0,0,193,466,38,4495,7,865,37,7
"241","2020-05-20",71,3,221,242,2464,0.60836038961039,0,0,193,466,42,4537,7,872,40,7
"242","2020-05-21",60,3,217,234,2464,0.60836038961039,0,0,193,466,44,4581,8,880,43,8
"243","2020-05-22",58,3,213,226,2464,0.60836038961039,0,0,193,466,39,4620,11,891,38,11
"244","2020-05-23",56,3,219,221,2464,0.60836038961039,0,0,193,466,32,4652,13,904,30,13
"245","2020-05-24",57,3,207,219,2464,0.60836038961039,0,0,193,466,42,4694,12,916,42,12
"246","2020-05-25",53,3,186,217,2464,0.60836038961039,0,0,193,466,31,4725,20,936,30,20
"247","2020-05-26",58,3,173,212,2464,0.60836038961039,0,0,193,466,24,4749,13,949,24,13
"248","2020-05-27",65,3,180,210,2464,0.60836038961039,0,0,193,466,27,4776,10,959,27,10
"249","2020-05-28",61,3,179,189,2464,0.60836038961039,0,0,193,466,24,4800,7,966,23,7
"250","2020-05-29",56,3,185,189,2464,0.60836038961039,0,0,193,466,30,4830,9,975,29,9
"251","2020-05-30",62,3,183,181,2464,0.60836038961039,0,0,193,466,24,4854,16,991,24,16
"252","2020-05-31",59,3,188,180,2464,0.60836038961039,0,0,193,466,25,4879,10,1001,25,10
"253","2020-06-01",59,3,180,170,2464,0.60836038961039,0,0,193,466,16,4895,4,1005,15,4
"254","2020-06-02",56,3,176,169,2464,0.60836038961039,0,0,193,466,21,4916,4,1009,18,4
"255","2020-06-03",52,3,153,160,2464,0.60836038961039,0,0,193,466,20,4936,7,1016,20,7
"256","2020-06-04",50,3,146,152,2464,0.60836038961039,0,0,193,466,15,4951,6,1022,15,6
"257","2020-06-05",55,3,140,151,2464,0.60836038961039,0,0,193,466,15,4966,6,1028,15,6
"258","2020-06-06",48,3,151,138,2464,0.60836038961039,0,0,193,466,5,4971,6,1034,5,6
"259","2020-06-07",52,3,184,131,2464,0.60836038961039,0,0,193,466,12,4983,8,1042,12,8
"260","2020-03-16",1,4,23,35,2635,0.818595825426945,0,0,221,161,32,119,22,70,25,22
"261","2020-03-17",2,4,21,42,2635,0.818595825426945,0,0,221,161,36,155,22,92,29,22
"262","2020-03-18",6,4,26,52,2635,0.818595825426945,0,0,221,161,45,200,15,107,34,15
"263","2020-03-19",11,4,31,60,2635,0.818595825426945,0,0,221,161,45,245,7,114,37,7
"264","2020-03-20",17,4,31,74,2635,0.818595825426945,0,0,221,161,37,282,6,120,33,6
"265","2020-03-21",18,4,30,76,2635,0.818595825426945,0,0,221,161,58,340,15,135,52,15
"266","2020-03-22",21,4,29,88,2635,0.818595825426945,0,0,221,161,60,400,14,149,52,14
"267","2020-03-23",23,4,37,99,2635,0.818595825426945,0,0,221,161,70,470,6,155,64,6
"268","2020-03-24",25,4,43,111,2635,0.818595825426945,0,0,221,161,82,552,15,170,75,15
"269","2020-03-25",21,4,37,132,2635,0.818595825426945,0,0,221,161,98,650,21,191,90,21
"270","2020-03-26",21,4,36,146,2635,0.818595825426945,0,0,221,161,117,767,23,214,103,23
"271","2020-03-27",23,4,42,158,2635,0.818595825426945,0,0,221,161,125,892,22,236,115,22
"272","2020-03-28",28,4,46,160,2635,0.818595825426945,0,0,221,161,150,1042,34,270,136,34
"273","2020-03-29",32,4,46,168,2635,0.818595825426945,0,0,221,161,199,1241,35,305,186,35
"274","2020-03-30",37,4,55,183,2635,0.818595825426945,0,0,221,161,211,1452,19,324,200,19
"275","2020-03-31",46,4,56,204,2635,0.818595825426945,0,0,221,161,176,1628,22,346,168,22
"276","2020-04-01",54,4,51,225,2635,0.818595825426945,0,0,221,161,245,1873,12,358,237,12
"277","2020-04-02",66,4,60,229,2635,0.818595825426945,0,0,221,161,254,2127,10,368,244,10
"278","2020-04-03",64,4,60,240,2635,0.818595825426945,0,0,221,161,289,2416,11,379,279,11
"279","2020-04-04",69,4,54,252,2635,0.818595825426945,0,0,221,161,287,2703,7,386,279,7
"280","2020-04-05",77,4,64,268,2635,0.818595825426945,0,0,221,161,317,3020,7,393,306,7
"281","2020-04-06",75,4,63,277,2635,0.818595825426945,0,0,221,161,306,3326,24,417,295,24
"282","2020-04-07",76,4,68,290,2635,0.818595825426945,0,0,221,161,336,3662,18,435,329,18
"283","2020-04-08",79,4,65,303,2635,0.818595825426945,0,0,221,161,317,3979,15,450,311,15
"284","2020-04-09",71,4,63,305,2635,0.818595825426945,0,0,221,161,310,4289,35,485,303,35
"285","2020-04-10",76,4,57,317,2635,0.818595825426945,0,0,221,161,405,4694,34,519,398,34
"286","2020-04-11",75,4,65,331,2635,0.818595825426945,0,0,221,161,251,4945,21,540,246,21
"287","2020-04-12",74,4,61,351,2635,0.818595825426945,0,0,221,161,219,5164,13,553,214,13
"288","2020-04-13",82,4,57,367,2635,0.818595825426945,0,0,221,161,230,5394,14,567,228,14
"289","2020-04-14",87,4,48,386,2635,0.818595825426945,0,0,221,161,169,5563,20,587,164,20
"290","2020-04-15",88,4,43,398,2635,0.818595825426945,0,0,221,161,181,5744,11,598,180,11
"291","2020-04-16",94,4,36,394,2635,0.818595825426945,0,0,221,161,166,5910,33,631,161,33
"292","2020-04-17",102,4,30,415,2635,0.818595825426945,0,0,221,161,133,6043,38,669,127,38
"293","2020-04-18",105,4,34,416,2635,0.818595825426945,0,0,221,161,171,6214,23,692,168,23
"294","2020-04-19",106,4,35,419,2635,0.818595825426945,0,0,221,161,123,6337,29,721,123,29
"295","2020-04-20",109,4,30,426,2635,0.818595825426945,0,0,221,161,117,6454,19,740,114,19
"296","2020-04-21",106,4,32,422,2635,0.818595825426945,0,0,221,161,71,6525,39,779,68,39
"297","2020-04-22",112,4,26,408,2635,0.818595825426945,0,0,221,161,75,6600,23,802,73,23
"298","2020-04-23",120,4,32,415,2635,0.818595825426945,0,0,221,161,64,6664,11,813,63,11
"299","2020-04-24",117,4,31,411,2635,0.818595825426945,0,0,221,161,56,6720,14,827,50,14
"300","2020-04-25",124,4,31,420,2635,0.818595825426945,0,0,221,161,41,6761,21,848,38,21
"301","2020-04-26",128,4,42,426,2635,0.818595825426945,0,0,221,161,49,6810,26,874,47,26
"302","2020-04-27",132,4,36,420,2635,0.818595825426945,0,0,221,161,26,6836,18,892,23,18
"303","2020-04-28",140,4,40,419,2635,0.818595825426945,0,0,221,161,42,6878,37,929,36,37
"304","2020-04-29",139,4,40,418,2635,0.818595825426945,0,0,221,161,23,6901,24,953,21,24
"305","2020-04-30",133,4,39,412,2635,0.818595825426945,0,0,221,161,27,6928,15,968,23,15
"306","2020-05-01",132,4,44,418,2635,0.818595825426945,0,0,221,161,17,6945,15,983,15,15
"307","2020-05-02",129,4,51,420,2635,0.818595825426945,0,0,221,161,21,6966,17,1000,19,17
"308","2020-05-03",128,4,49,414,2635,0.818595825426945,0,0,221,161,17,6983,33,1033,16,33
"309","2020-05-04",126,4,47,418,2635,0.818595825426945,0,0,221,161,3,6986,21,1054,2,21
"310","2020-05-05",111,4,54,421,2635,0.818595825426945,0,0,221,161,17,7003,22,1076,13,22
"311","2020-05-06",111,4,37,428,2635,0.818595825426945,0,0,221,161,9,7012,38,1114,5,38
"312","2020-05-07",109,4,37,428,2635,0.818595825426945,0,0,221,161,11,7023,24,1138,8,24
"313","2020-05-08",113,4,34,422,2635,0.818595825426945,0,0,221,161,9,7032,17,1155,6,17
"314","2020-05-09",107,4,35,420,2635,0.818595825426945,0,0,221,161,12,7044,16,1171,10,16
"315","2020-05-10",105,4,26,427,2635,0.818595825426945,0,0,221,161,3,7047,10,1181,2,10
"316","2020-05-11",103,4,38,408,2635,0.818595825426945,0,0,221,161,7,7054,8,1189,6,8
"317","2020-05-12",116,4,42,410,2635,0.818595825426945,0,0,221,161,2,7056,7,1196,2,7
"318","2020-05-13",111,4,43,403,2635,0.818595825426945,0,0,221,161,8,7064,8,1204,5,8
"319","2020-05-14",115,4,33,412,2635,0.818595825426945,0,0,221,161,6,7070,22,1226,4,22
"320","2020-05-15",110,4,34,403,2635,0.818595825426945,0,0,221,161,3,7073,15,1241,1,15
"321","2020-05-16",113,4,32,401,2635,0.818595825426945,0,0,221,161,9,7082,6,1247,4,6
"322","2020-05-17",116,4,47,400,2635,0.818595825426945,0,0,221,161,4,7086,6,1253,NA,6
"323","2020-05-18",122,4,42,422,2635,0.818595825426945,0,0,221,161,NA,NA,17,1270,NA,17
"324","2020-05-19",128,4,45,427,2635,0.818595825426945,0,0,221,161,2,7088,9,1279,1,9
"325","2020-05-20",123,4,42,422,2635,0.818595825426945,0,0,221,161,2,7090,20,1299,2,20
"326","2020-05-21",123,4,34,428,2635,0.818595825426945,0,0,221,161,3,7093,14,1313,3,14
"327","2020-05-22",125,4,32,426,2635,0.818595825426945,0,0,221,161,4,7097,25,1338,4,25
"328","2020-05-23",132,4,33,409,2635,0.818595825426945,0,0,221,161,3,7100,16,1354,NA,16
"329","2020-05-24",128,4,39,400,2635,0.818595825426945,0,0,221,161,3,7103,12,1366,2,12
"330","2020-05-25",125,4,35,387,2635,0.818595825426945,0,0,221,161,4,7107,4,1370,2,4
"331","2020-05-26",110,4,31,378,2635,0.818595825426945,0,0,221,161,2,7109,7,1377,1,7
"332","2020-05-27",126,4,33,361,2635,0.818595825426945,0,0,221,161,4,7113,16,1393,2,16
"333","2020-05-28",119,4,28,360,2635,0.818595825426945,0,0,221,161,1,7114,12,1405,NA,12
"334","2020-05-29",115,4,32,354,2635,0.818595825426945,0,0,221,161,4,7118,26,1431,3,26
"335","2020-05-30",103,4,33,347,2635,0.818595825426945,0,0,221,161,3,7121,24,1455,1,24
"336","2020-05-31",102,4,32,327,2635,0.818595825426945,0,0,221,161,2,7123,8,1463,2,8
"337","2020-06-01",95,4,32,320,2635,0.818595825426945,0,0,221,161,5,7128,9,1472,4,9
"338","2020-06-02",98,4,30,306,2635,0.818595825426945,0,0,221,161,1,7129,2,1474,1,2
"339","2020-06-03",92,4,26,294,2635,0.818595825426945,0,0,221,161,2,7131,2,1476,1,2
"340","2020-06-04",92,4,27,278,2635,0.818595825426945,0,0,221,161,5,7136,12,1488,2,12
"341","2020-06-05",88,4,34,263,2635,0.818595825426945,0,0,221,161,2,7138,18,1506,1,18
"342","2020-06-06",82,4,36,250,2635,0.818595825426945,0,0,221,161,5,7143,14,1520,3,14
"343","2020-06-07",78,4,35,233,2635,0.818595825426945,0,0,221,161,1,7144,17,1537,NA,17
"344","2020-03-13",1,5,16,20,2075,0.705060240963855,0,0,209,140,3,14,1,11,1,1
"345","2020-03-14",1,5,17,27,2075,0.705060240963855,0,0,209,140,9,23,2,13,7,2
"346","2020-03-15",1,5,18,37,2075,0.705060240963855,0,0,209,140,8,31,6,19,5,6
"347","2020-03-16",3,5,23,43,2075,0.705060240963855,0,0,209,140,5,36,3,22,3,3
"348","2020-03-17",5,5,29,56,2075,0.705060240963855,0,0,209,140,6,42,9,31,5,9
"349","2020-03-18",6,5,24,63,2075,0.705060240963855,0,0,209,140,12,54,8,39,10,8
"350","2020-03-19",7,5,19,80,2075,0.705060240963855,0,0,209,140,12,66,7,46,11,7
"351","2020-03-20",10,5,16,93,2075,0.705060240963855,0,0,209,140,8,74,10,56,4,10
"352","2020-03-21",15,5,20,114,2075,0.705060240963855,0,0,209,140,9,83,10,66,4,10
"353","2020-03-22",20,5,23,129,2075,0.705060240963855,0,0,209,140,10,93,6,72,9,6
"354","2020-03-23",24,5,21,149,2075,0.705060240963855,0,0,209,140,15,108,15,87,11,15
"355","2020-03-24",29,5,22,158,2075,0.705060240963855,0,0,209,140,13,121,16,103,8,16
"356","2020-03-25",35,5,25,176,2075,0.705060240963855,0,0,209,140,16,137,13,116,10,13
"357","2020-03-26",38,5,30,191,2075,0.705060240963855,0,0,209,140,20,157,12,128,14,12
"358","2020-03-27",36,5,28,208,2075,0.705060240963855,0,0,209,140,16,173,12,140,12,12
"359","2020-03-28",40,5,26,220,2075,0.705060240963855,0,0,209,140,19,192,8,148,13,8
"360","2020-03-29",46,5,30,218,2075,0.705060240963855,0,0,209,140,19,211,4,152,17,4
"361","2020-03-30",50,5,28,233,2075,0.705060240963855,0,0,209,140,24,235,6,158,20,6
"362","2020-03-31",56,5,29,232,2075,0.705060240963855,0,0,209,140,18,253,4,162,15,4
"363","2020-04-01",53,5,32,249,2075,0.705060240963855,0,0,209,140,40,293,8,170,30,8
"364","2020-04-02",55,5,33,251,2075,0.705060240963855,0,0,209,140,32,325,5,175,26,5
"365","2020-04-03",63,5,38,254,2075,0.705060240963855,0,0,209,140,23,348,8,183,21,8
"366","2020-04-04",64,5,36,264,2075,0.705060240963855,0,0,209,140,29,377,13,196,24,13
"367","2020-04-05",62,5,48,262,2075,0.705060240963855,0,0,209,140,26,403,6,202,24,6
"368","2020-04-06",66,5,48,260,2075,0.705060240963855,0,0,209,140,41,444,10,212,37,10
"369","2020-04-07",64,5,37,264,2075,0.705060240963855,0,0,209,140,34,478,14,226,31,14
"370","2020-04-08",70,5,31,272,2075,0.705060240963855,0,0,209,140,39,517,14,240,35,14
"371","2020-04-09",75,5,31,281,2075,0.705060240963855,0,0,209,140,47,564,10,250,39,10
"372","2020-04-10",75,5,31,289,2075,0.705060240963855,0,0,209,140,44,608,8,258,39,8
"373","2020-04-11",75,5,33,300,2075,0.705060240963855,0,0,209,140,45,653,9,267,42,9
"374","2020-04-12",75,5,40,306,2075,0.705060240963855,0,0,209,140,51,704,15,282,44,15
"375","2020-04-13",73,5,37,305,2075,0.705060240963855,0,0,209,140,50,754,13,295,46,13
"376","2020-04-14",75,5,46,299,2075,0.705060240963855,0,0,209,140,52,806,12,307,50,12
"377","2020-04-15",80,5,50,303,2075,0.705060240963855,0,0,209,140,63,869,17,324,58,17
"378","2020-04-16",74,5,55,314,2075,0.705060240963855,0,0,209,140,36,905,10,334,35,10
"379","2020-04-17",84,5,53,308,2075,0.705060240963855,0,0,209,140,57,962,25,359,48,25
"380","2020-04-18",87,5,56,317,2075,0.705060240963855,0,0,209,140,65,1027,24,383,58,24
"381","2020-04-19",91,5,48,331,2075,0.705060240963855,0,0,209,140,45,1072,21,404,43,21
"382","2020-04-20",86,5,42,337,2075,0.705060240963855,0,0,209,140,36,1108,21,425,33,21
"383","2020-04-21",89,5,33,338,2075,0.705060240963855,0,0,209,140,48,1156,18,443,43,18
"384","2020-04-22",87,5,32,325,2075,0.705060240963855,0,0,209,140,35,1191,27,470,31,27
"385","2020-04-23",96,5,31,329,2075,0.705060240963855,0,0,209,140,36,1227,16,486,33,16
"386","2020-04-24",82,5,37,337,2075,0.705060240963855,0,0,209,140,37,1264,23,509,31,23
"387","2020-04-25",84,5,41,354,2075,0.705060240963855,0,0,209,140,39,1303,34,543,36,34
"388","2020-04-26",87,5,40,350,2075,0.705060240963855,0,0,209,140,28,1331,32,575,22,32
"389","2020-04-27",98,5,38,346,2075,0.705060240963855,0,0,209,140,35,1366,28,603,31,28
"390","2020-04-28",96,5,42,358,2075,0.705060240963855,0,0,209,140,35,1401,35,638,28,35
"391","2020-04-29",101,5,45,359,2075,0.705060240963855,0,0,209,140,35,1436,37,675,31,37
"392","2020-04-30",97,5,46,365,2075,0.705060240963855,0,0,209,140,20,1456,13,688,17,13
"393","2020-05-01",105,5,47,360,2075,0.705060240963855,0,0,209,140,22,1478,28,716,19,28
"394","2020-05-02",103,5,48,345,2075,0.705060240963855,0,0,209,140,21,1499,20,736,16,20
"395","2020-05-03",101,5,49,335,2075,0.705060240963855,0,0,209,140,15,1514,14,750,10,14
"396","2020-05-04",100,5,55,343,2075,0.705060240963855,0,0,209,140,16,1530,16,766,14,16
"397","2020-05-05",102,5,62,333,2075,0.705060240963855,0,0,209,140,22,1552,25,791,19,25
"398","2020-05-06",95,5,55,324,2075,0.705060240963855,0,0,209,140,21,1573,10,801,17,10
"399","2020-05-07",95,5,47,331,2075,0.705060240963855,0,0,209,140,25,1598,24,825,18,24
"400","2020-05-08",93,5,44,322,2075,0.705060240963855,0,0,209,140,10,1608,12,837,4,12
"401","2020-05-09",97,5,39,308,2075,0.705060240963855,0,0,209,140,19,1627,12,849,18,12
"402","2020-05-10",100,5,39,298,2075,0.705060240963855,0,0,209,140,25,1652,17,866,24,17
"403","2020-05-11",97,5,43,299,2075,0.705060240963855,0,0,209,140,26,1678,16,882,24,16
"404","2020-05-12",88,5,46,307,2075,0.705060240963855,0,0,209,140,20,1698,25,907,15,25
"405","2020-05-13",88,5,44,313,2075,0.705060240963855,0,0,209,140,24,1722,20,927,22,20
"406","2020-05-14",91,5,37,303,2075,0.705060240963855,0,0,209,140,20,1742,22,949,15,22
"407","2020-05-15",91,5,40,306,2075,0.705060240963855,0,0,209,140,20,1762,14,963,14,14
"408","2020-05-16",85,5,38,309,2075,0.705060240963855,0,0,209,140,18,1780,28,991,16,28
"409","2020-05-17",78,5,37,293,2075,0.705060240963855,0,0,209,140,19,1799,16,1007,15,16
"410","2020-05-18",76,5,43,291,2075,0.705060240963855,0,0,209,140,12,1811,20,1027,9,20
"411","2020-05-19",83,5,39,293,2075,0.705060240963855,0,0,209,140,20,1831,21,1048,17,21
"412","2020-05-20",87,5,38,285,2075,0.705060240963855,0,0,209,140,19,1850,13,1061,17,13
"413","2020-05-21",87,5,41,287,2075,0.705060240963855,0,0,209,140,16,1866,13,1074,14,13
"414","2020-05-22",87,5,36,272,2075,0.705060240963855,0,0,209,140,11,1877,15,1089,8,15
"415","2020-05-23",89,5,31,260,2075,0.705060240963855,0,0,209,140,17,1894,9,1098,15,9
"416","2020-05-24",90,5,36,256,2075,0.705060240963855,0,0,209,140,8,1902,17,1115,4,17
"417","2020-05-25",89,5,44,253,2075,0.705060240963855,0,0,209,140,9,1911,19,1134,5,19
"418","2020-05-26",83,5,54,251,2075,0.705060240963855,0,0,209,140,11,1922,11,1145,9,11
"419","2020-05-27",77,5,51,231,2075,0.705060240963855,0,0,209,140,7,1929,15,1160,6,15
"420","2020-05-28",71,5,52,215,2075,0.705060240963855,0,0,209,140,8,1937,9,1169,7,9
"421","2020-05-29",66,5,54,201,2075,0.705060240963855,0,0,209,140,10,1947,10,1179,10,10
"422","2020-05-30",64,5,55,195,2075,0.705060240963855,0,0,209,140,11,1958,7,1186,7,7
"423","2020-05-31",67,5,51,193,2075,0.705060240963855,0,0,209,140,14,1972,11,1197,13,11
"424","2020-06-01",65,5,46,176,2075,0.705060240963855,0,0,209,140,13,1985,14,1211,12,14
"425","2020-06-02",60,5,37,166,2075,0.705060240963855,0,0,209,140,11,1996,8,1219,9,8
"426","2020-06-03",59,5,39,160,2075,0.705060240963855,0,0,209,140,8,2004,20,1239,8,20
"427","2020-06-04",59,5,35,154,2075,0.705060240963855,0,0,209,140,10,2014,17,1256,6,17
"428","2020-06-05",57,5,37,145,2075,0.705060240963855,0,0,209,140,5,2019,16,1272,4,16
"429","2020-06-06",54,5,29,135,2075,0.705060240963855,0,0,209,140,6,2025,14,1286,3,14
"430","2020-06-07",45,5,25,122,2075,0.705060240963855,0,0,209,140,10,2035,7,1293,7,7
"431","2020-03-12",1,6,10,10,6236,0.942591404746632,0,0,539,329,9,14,3,7,NA,3
"432","2020-03-13",1,6,13,13,6236,0.942591404746632,0,0,539,329,4,18,3,10,2,3
"433","2020-03-14",1,6,19,20,6236,0.942591404746632,0,0,539,329,3,21,6,16,2,6
"434","2020-03-15",1,6,16,31,6236,0.942591404746632,0,0,539,329,8,29,5,21,2,5
"435","2020-03-16",4,6,19,45,6236,0.942591404746632,0,0,539,329,10,39,3,24,3,3
"436","2020-03-17",6,6,13,59,6236,0.942591404746632,0,0,539,329,12,51,6,30,8,6
"437","2020-03-18",8,6,16,71,6236,0.942591404746632,0,0,539,329,12,63,5,35,8,5
"438","2020-03-19",9,6,16,87,6236,0.942591404746632,0,0,539,329,12,75,7,42,7,7
"439","2020-03-20",11,6,25,105,6236,0.942591404746632,0,0,539,329,10,85,9,51,7,9
"440","2020-03-21",13,6,31,125,6236,0.942591404746632,0,0,539,329,19,104,2,53,9,2
"441","2020-03-22",19,6,29,152,6236,0.942591404746632,0,0,539,329,20,124,4,57,9,4
"442","2020-03-23",21,6,28,173,6236,0.942591404746632,0,0,539,329,21,145,8,65,15,8
"443","2020-03-24",27,6,22,187,6236,0.942591404746632,0,0,539,329,21,166,8,73,10,8
"444","2020-03-25",31,6,22,205,6236,0.942591404746632,0,0,539,329,23,189,10,83,16,10
"445","2020-03-26",40,6,16,224,6236,0.942591404746632,0,0,539,329,23,212,5,88,12,5
"446","2020-03-27",43,6,21,237,6236,0.942591404746632,0,0,539,329,28,240,4,92,17,4
"447","2020-03-28",53,6,23,286,6236,0.942591404746632,0,0,539,329,24,264,7,99,13,7
"448","2020-03-29",63,6,32,321,6236,0.942591404746632,0,0,539,329,34,298,9,108,22,9
"449","2020-03-30",69,6,31,344,6236,0.942591404746632,0,0,539,329,30,328,6,114,19,6
"450","2020-03-31",72,6,34,391,6236,0.942591404746632,0,0,539,329,37,365,13,127,28,13
"451","2020-04-01",86,6,28,447,6236,0.942591404746632,0,0,539,329,19,384,4,131,12,4
"452","2020-04-02",93,6,38,490,6236,0.942591404746632,0,0,539,329,24,408,9,140,18,9
"453","2020-04-03",105,6,32,552,6236,0.942591404746632,0,0,539,329,25,433,21,161,17,21
"454","2020-04-04",104,6,39,629,6236,0.942591404746632,0,0,539,329,24,457,17,178,15,17
"455","2020-04-05",107,6,37,705,6236,0.942591404746632,0,0,539,329,25,482,16,194,19,16
"456","2020-04-06",119,6,34,769,6236,0.942591404746632,0,0,539,329,31,513,18,212,20,18
"457","2020-04-07",135,6,22,825,6236,0.942591404746632,0,0,539,329,18,531,15,227,14,15
"458","2020-04-08",161,6,23,900,6236,0.942591404746632,0,0,539,329,32,563,10,237,19,10
"459","2020-04-09",176,6,26,954,6236,0.942591404746632,0,0,539,329,17,580,5,242,13,5
"460","2020-04-10",203,6,21,1004,6236,0.942591404746632,0,0,539,329,28,608,21,263,21,21
"461","2020-04-11",240,6,27,1063,6236,0.942591404746632,0,0,539,329,32,640,14,277,23,14
"462","2020-04-12",264,6,21,1104,6236,0.942591404746632,0,0,539,329,37,677,10,287,27,10
"463","2020-04-13",283,6,20,1140,6236,0.942591404746632,0,0,539,329,33,710,14,301,20,14
"464","2020-04-14",293,6,26,1176,6236,0.942591404746632,0,0,539,329,19,729,8,309,12,8
"465","2020-04-15",295,6,37,1198,6236,0.942591404746632,0,0,539,329,40,769,14,323,26,14
"466","2020-04-16",308,6,41,1241,6236,0.942591404746632,0,0,539,329,27,796,11,334,22,11
"467","2020-04-17",310,6,49,1239,6236,0.942591404746632,0,0,539,329,30,826,6,340,20,6
"468","2020-04-18",313,6,61,1264,6236,0.942591404746632,0,0,539,329,34,860,5,345,20,5
"469","2020-04-19",325,6,48,1293,6236,0.942591404746632,0,0,539,329,22,882,6,351,13,6
"470","2020-04-20",337,6,42,1330,6236,0.942591404746632,0,0,539,329,27,909,11,362,18,11
"471","2020-04-21",348,6,51,1321,6236,0.942591404746632,0,0,539,329,23,932,21,383,19,21
"472","2020-04-22",360,6,67,1324,6236,0.942591404746632,0,0,539,329,31,963,18,401,22,18
"473","2020-04-23",368,6,68,1358,6236,0.942591404746632,0,0,539,329,38,1001,14,415,22,14
"474","2020-04-24",385,6,57,1409,6236,0.942591404746632,0,0,539,329,26,1027,16,431,17,16
"475","2020-04-25",393,6,54,1431,6236,0.942591404746632,0,0,539,329,25,1052,12,443,18,12
"476","2020-04-26",403,6,45,1417,6236,0.942591404746632,0,0,539,329,36,1088,20,463,25,20
"477","2020-04-27",397,6,39,1433,6236,0.942591404746632,0,0,539,329,30,1118,15,478,18,15
"478","2020-04-28",433,6,30,1439,6236,0.942591404746632,0,0,539,329,33,1151,17,495,22,17
"479","2020-04-29",432,6,41,1424,6236,0.942591404746632,0,0,539,329,25,1176,10,505,17,10
"480","2020-04-30",433,6,59,1432,6236,0.942591404746632,0,0,539,329,30,1206,8,513,20,8
"481","2020-05-01",432,6,75,1450,6236,0.942591404746632,0,0,539,329,23,1229,19,532,14,19
"482","2020-05-02",434,6,81,1427,6236,0.942591404746632,0,0,539,329,15,1244,9,541,10,9
"483","2020-05-03",438,6,85,1431,6236,0.942591404746632,0,0,539,329,21,1265,22,563,15,22
"484","2020-05-04",435,6,83,1431,6236,0.942591404746632,0,0,539,329,25,1290,14,577,17,14
"485","2020-05-05",408,6,96,1410,6236,0.942591404746632,0,0,539,329,22,1312,12,589,17,12
"486","2020-05-06",402,6,88,1391,6236,0.942591404746632,0,0,539,329,22,1334,15,604,14,15
"487","2020-05-07",387,6,88,1385,6236,0.942591404746632,0,0,539,329,26,1360,7,611,15,7
"488","2020-05-08",365,6,87,1316,6236,0.942591404746632,0,0,539,329,19,1379,15,626,12,15
"489","2020-05-09",368,6,91,1294,6236,0.942591404746632,0,0,539,329,24,1403,24,650,11,24
"490","2020-05-10",356,6,83,1255,6236,0.942591404746632,0,0,539,329,22,1425,21,671,12,21
"491","2020-05-11",358,6,69,1229,6236,0.942591404746632,0,0,539,329,24,1449,15,686,11,15
"492","2020-05-12",347,6,59,1171,6236,0.942591404746632,0,0,539,329,23,1472,18,704,11,18
"493","2020-05-13",340,6,62,1114,6236,0.942591404746632,0,0,539,329,11,1483,26,730,3,26
"494","2020-05-14",352,6,62,1071,6236,0.942591404746632,0,0,539,329,16,1499,10,740,7,10
"495","2020-05-15",355,6,57,1003,6236,0.942591404746632,0,0,539,329,18,1517,15,755,11,15
"496","2020-05-16",328,6,76,961,6236,0.942591404746632,0,0,539,329,11,1528,17,772,4,17
"497","2020-05-17",311,6,88,906,6236,0.942591404746632,0,0,539,329,19,1547,21,793,16,21
"498","2020-05-18",300,6,91,841,6236,0.942591404746632,0,0,539,329,17,1564,16,809,11,16
"499","2020-05-19",290,6,85,771,6236,0.942591404746632,0,0,539,329,17,1581,6,815,13,6
"500","2020-05-20",268,6,92,700,6236,0.942591404746632,0,0,539,329,18,1599,20,835,13,20
"501","2020-05-21",250,6,81,655,6236,0.942591404746632,0,0,539,329,11,1610,25,860,6,25
"502","2020-05-22",234,6,78,606,6236,0.942591404746632,0,0,539,329,19,1629,16,876,14,16
"503","2020-05-23",224,6,71,555,6236,0.942591404746632,0,0,539,329,9,1638,12,888,6,12
"504","2020-05-24",206,6,53,509,6236,0.942591404746632,0,0,539,329,18,1656,17,905,11,17
"505","2020-05-25",196,6,49,484,6236,0.942591404746632,0,0,539,329,14,1670,16,921,11,16
"506","2020-05-26",184,6,46,434,6236,0.942591404746632,0,0,539,329,13,1683,13,934,8,13
"507","2020-05-27",177,6,56,408,6236,0.942591404746632,0,0,539,329,10,1693,16,950,6,16
"508","2020-05-28",153,6,52,376,6236,0.942591404746632,0,0,539,329,9,1702,13,963,8,13
"509","2020-05-29",149,6,48,344,6236,0.942591404746632,0,0,539,329,18,1720,11,974,12,11
"510","2020-05-30",140,6,39,311,6236,0.942591404746632,0,0,539,329,12,1732,4,978,7,4
"511","2020-05-31",133,6,42,275,6236,0.942591404746632,0,0,539,329,10,1742,10,988,7,10
"512","2020-06-01",115,6,45,245,6236,0.942591404746632,0,0,539,329,11,1753,11,999,9,11
"513","2020-06-02",102,6,48,212,6236,0.942591404746632,0,0,539,329,9,1762,11,1010,5,11
"514","2020-06-03",89,6,53,182,6236,0.942591404746632,0,0,539,329,24,1786,3,1013,18,3
"515","2020-06-04",82,6,52,157,6236,0.942591404746632,0,0,539,329,14,1800,6,1019,10,6
"516","2020-06-05",64,6,54,144,6236,0.942591404746632,0,0,539,329,8,1808,8,1027,5,8
"517","2020-06-06",52,6,55,123,6236,0.942591404746632,0,0,539,329,12,1820,10,1037,9,10
"518","2020-06-07",42,6,62,108,6236,0.942591404746632,0,0,539,329,12,1832,7,1044,7,7
"519","2020-03-13",1,7,12,39,2121,0.46958981612447,0,0,208,143,5,11,7,21,NA,7
"520","2020-03-14",2,7,16,54,2121,0.46958981612447,0,0,208,143,6,17,1,22,4,1
"521","2020-03-15",3,7,18,69,2121,0.46958981612447,0,0,208,143,8,25,3,25,6,3
"522","2020-03-16",5,7,19,86,2121,0.46958981612447,0,0,208,143,4,29,4,29,NA,4
"523","2020-03-17",9,7,16,104,2121,0.46958981612447,0,0,208,143,9,38,1,30,6,1
"524","2020-03-18",12,7,17,122,2121,0.46958981612447,0,0,208,143,7,45,7,37,5,7
"525","2020-03-19",20,7,19,136,2121,0.46958981612447,0,0,208,143,11,56,7,44,9,7
"526","2020-03-20",22,7,21,157,2121,0.46958981612447,0,0,208,143,16,72,10,54,11,10
"527","2020-03-21",26,7,18,172,2121,0.46958981612447,0,0,208,143,14,86,8,62,10,8
"528","2020-03-22",35,7,13,188,2121,0.46958981612447,0,0,208,143,18,104,12,74,16,12
"529","2020-03-23",39,7,12,204,2121,0.46958981612447,0,0,208,143,12,116,2,76,11,2
"530","2020-03-24",46,7,13,218,2121,0.46958981612447,0,0,208,143,26,142,6,82,22,6
"531","2020-03-25",52,7,20,224,2121,0.46958981612447,0,0,208,143,18,160,14,96,16,14
"532","2020-03-26",49,7,21,237,2121,0.46958981612447,0,0,208,143,22,182,14,110,20,14
"533","2020-03-27",55,7,22,245,2121,0.46958981612447,0,0,208,143,17,199,15,125,14,15
"534","2020-03-28",57,7,21,252,2121,0.46958981612447,0,0,208,143,27,226,5,130,20,5
"535","2020-03-29",56,7,23,253,2121,0.46958981612447,0,0,208,143,19,245,4,134,16,4
"536","2020-03-30",56,7,26,247,2121,0.46958981612447,0,0,208,143,32,277,17,151,31,17
"537","2020-03-31",61,7,24,258,2121,0.46958981612447,0,0,208,143,20,297,6,157,18,6
"538","2020-04-01",68,7,22,269,2121,0.46958981612447,0,0,208,143,30,327,18,175,27,18
"539","2020-04-02",69,7,23,281,2121,0.46958981612447,0,0,208,143,20,347,8,183,16,8
"540","2020-04-03",65,7,23,286,2121,0.46958981612447,0,0,208,143,35,382,10,193,32,10
"541","2020-04-04",70,7,20,294,2121,0.46958981612447,0,0,208,143,31,413,14,207,24,14
"542","2020-04-05",76,7,22,295,2121,0.46958981612447,0,0,208,143,33,446,10,217,31,10
"543","2020-04-06",78,7,20,293,2121,0.46958981612447,0,0,208,143,33,479,11,228,30,11
"544","2020-04-07",73,7,26,308,2121,0.46958981612447,0,0,208,143,29,508,15,243,28,15
"545","2020-04-08",65,7,21,309,2121,0.46958981612447,0,0,208,143,25,533,17,260,20,17
"546","2020-04-09",73,7,21,308,2121,0.46958981612447,0,0,208,143,33,566,10,270,32,10
"547","2020-04-10",86,7,25,307,2121,0.46958981612447,0,0,208,143,34,600,14,284,29,14
"548","2020-04-11",87,7,28,308,2121,0.46958981612447,0,0,208,143,40,640,14,298,38,14
"549","2020-04-12",87,7,43,328,2121,0.46958981612447,0,0,208,143,25,665,4,302,21,4
"550","2020-04-13",91,7,34,334,2121,0.46958981612447,0,0,208,143,44,709,4,306,40,4
"551","2020-04-14",90,7,32,334,2121,0.46958981612447,0,0,208,143,30,739,4,310,28,4
"552","2020-04-15",97,7,32,330,2121,0.46958981612447,0,0,208,143,41,780,2,312,35,2
"553","2020-04-16",96,7,33,321,2121,0.46958981612447,0,0,208,143,35,815,3,315,32,3
"554","2020-04-17",92,7,36,341,2121,0.46958981612447,0,0,208,143,43,858,3,318,36,3
"555","2020-04-18",98,7,28,341,2121,0.46958981612447,0,0,208,143,32,890,2,320,29,2
"556","2020-04-19",95,7,29,334,2121,0.46958981612447,0,0,208,143,44,934,19,339,35,19
"557","2020-04-20",96,7,31,340,2121,0.46958981612447,0,0,208,143,35,969,22,361,32,22
"558","2020-04-21",99,7,36,345,2121,0.46958981612447,0,0,208,143,34,1003,15,376,28,15
"559","2020-04-22",103,7,37,340,2121,0.46958981612447,0,0,208,143,46,1049,16,392,34,16
"560","2020-04-23",101,7,39,345,2121,0.46958981612447,0,0,208,143,45,1094,14,406,41,14
"561","2020-04-24",101,7,36,348,2121,0.46958981612447,0,0,208,143,38,1132,3,409,36,3
"562","2020-04-25",95,7,35,356,2121,0.46958981612447,0,0,208,143,47,1179,13,422,41,13
"563","2020-04-26",96,7,35,351,2121,0.46958981612447,0,0,208,143,45,1224,14,436,42,14
"564","2020-04-27",102,7,34,343,2121,0.46958981612447,0,0,208,143,33,1257,17,453,30,17
"565","2020-04-28",99,7,42,348,2121,0.46958981612447,0,0,208,143,44,1301,8,461,39,8
"566","2020-04-29",92,7,45,341,2121,0.46958981612447,0,0,208,143,57,1358,22,483,53,22
"567","2020-04-30",99,7,39,352,2121,0.46958981612447,0,0,208,143,37,1395,20,503,31,20
"568","2020-05-01",98,7,35,347,2121,0.46958981612447,0,0,208,143,49,1444,17,520,46,17
"569","2020-05-02",94,7,45,341,2121,0.46958981612447,0,0,208,143,45,1489,8,528,41,8
"570","2020-05-03",99,7,55,346,2121,0.46958981612447,0,0,208,143,45,1534,13,541,42,13
"571","2020-05-04",90,7,54,343,2121,0.46958981612447,0,0,208,143,43,1577,17,558,37,17
"572","2020-05-05",93,7,53,335,2121,0.46958981612447,0,0,208,143,35,1612,23,581,31,23
"573","2020-05-06",92,7,53,324,2121,0.46958981612447,0,0,208,143,31,1643,22,603,28,22
"574","2020-05-07",94,7,43,308,2121,0.46958981612447,0,0,208,143,31,1674,12,615,28,12
"575","2020-05-08",87,7,42,317,2121,0.46958981612447,0,0,208,143,42,1716,8,623,37,8
"576","2020-05-09",94,7,38,310,2121,0.46958981612447,0,0,208,143,39,1755,11,634,36,11
"577","2020-05-10",96,7,34,315,2121,0.46958981612447,0,0,208,143,33,1788,8,642,31,8
"578","2020-05-11",101,7,37,318,2121,0.46958981612447,0,0,208,143,32,1820,6,648,29,6
"579","2020-05-12",96,7,35,316,2121,0.46958981612447,0,0,208,143,43,1863,17,665,39,17
"580","2020-05-13",99,7,48,295,2121,0.46958981612447,0,0,208,143,39,1902,10,675,35,10
"581","2020-05-14",92,7,63,296,2121,0.46958981612447,0,0,208,143,27,1929,20,695,24,20
"582","2020-05-15",100,7,58,277,2121,0.46958981612447,0,0,208,143,26,1955,13,708,23,13
"583","2020-05-16",94,7,40,278,2121,0.46958981612447,0,0,208,143,29,1984,23,731,24,23
"584","2020-05-17",82,7,42,273,2121,0.46958981612447,0,0,208,143,22,2006,18,749,21,18
"585","2020-05-18",83,7,43,252,2121,0.46958981612447,0,0,208,143,25,2031,15,764,20,15
"586","2020-05-19",84,7,44,254,2121,0.46958981612447,0,0,208,143,30,2061,19,783,25,19
"587","2020-05-20",81,7,36,237,2121,0.46958981612447,0,0,208,143,30,2091,22,805,27,22
"588","2020-05-21",77,7,34,224,2121,0.46958981612447,0,0,208,143,26,2117,22,827,24,22
"589","2020-05-22",71,7,44,209,2121,0.46958981612447,0,0,208,143,17,2134,12,839,16,12
"590","2020-05-23",73,7,46,195,2121,0.46958981612447,0,0,208,143,21,2155,19,858,17,19
"591","2020-05-24",71,7,42,184,2121,0.46958981612447,0,0,208,143,26,2181,22,880,23,22
"592","2020-05-25",62,7,41,180,2121,0.46958981612447,0,0,208,143,22,2203,9,889,19,9
"593","2020-05-26",67,7,40,180,2121,0.46958981612447,0,0,208,143,18,2221,13,902,16,13
"594","2020-05-27",60,7,45,173,2121,0.46958981612447,0,0,208,143,22,2243,11,913,18,11
"595","2020-05-28",57,7,48,165,2121,0.46958981612447,0,0,208,143,9,2252,13,926,8,13
"596","2020-05-29",52,7,40,159,2121,0.46958981612447,0,0,208,143,18,2270,9,935,16,9
"597","2020-05-30",42,7,31,158,2121,0.46958981612447,0,0,208,143,16,2286,6,941,15,6
"598","2020-05-31",41,7,28,158,2121,0.46958981612447,0,0,208,143,16,2302,11,952,16,11
"599","2020-06-01",43,7,30,156,2121,0.46958981612447,0,0,208,143,14,2316,5,957,12,5
"600","2020-06-02",41,7,33,154,2121,0.46958981612447,0,0,208,143,16,2332,13,970,14,13
"601","2020-06-03",41,7,32,152,2121,0.46958981612447,0,0,208,143,12,2344,2,972,9,2
"602","2020-06-04",39,7,27,144,2121,0.46958981612447,0,0,208,143,12,2356,9,981,11,9
"603","2020-06-05",45,7,20,146,2121,0.46958981612447,0,0,208,143,15,2371,7,988,12,7
"604","2020-06-06",53,7,17,141,2121,0.46958981612447,0,0,208,143,15,2386,5,993,14,5
"605","2020-06-07",51,7,17,135,2121,0.46958981612447,0,0,208,143,7,2393,3,996,7,3
"606","2020-03-14",1,8,28,32,2061,0.627850557981562,0,0,186,416,6,24,6,19,NA,6
"607","2020-03-15",1,8,33,45,2061,0.627850557981562,0,0,186,416,14,38,5,24,3,5
"608","2020-03-16",2,8,37,58,2061,0.627850557981562,0,0,186,416,5,43,2,26,NA,2
"609","2020-03-17",4,8,49,71,2061,0.627850557981562,0,0,186,416,3,46,4,30,1,4
"610","2020-03-18",8,8,61,93,2061,0.627850557981562,0,0,186,416,12,58,NA,NA,3,NA
"611","2020-03-19",12,8,56,109,2061,0.627850557981562,0,0,186,416,11,69,1,31,1,1
"612","2020-03-20",16,8,60,120,2061,0.627850557981562,0,0,186,416,14,83,4,35,6,4
"613","2020-03-21",19,8,68,140,2061,0.627850557981562,0,0,186,416,7,90,5,40,5,5
"614","2020-03-22",22,8,91,163,2061,0.627850557981562,0,0,186,416,15,105,5,45,9,5
"615","2020-03-23",29,8,99,182,2061,0.627850557981562,0,0,186,416,8,113,4,49,2,4
"616","2020-03-24",40,8,98,195,2061,0.627850557981562,0,0,186,416,18,131,8,57,10,8
"617","2020-03-25",44,8,87,217,2061,0.627850557981562,0,0,186,416,11,142,3,60,5,3
"618","2020-03-26",45,8,89,237,2061,0.627850557981562,0,0,186,416,15,157,3,63,6,3
"619","2020-03-27",50,8,88,252,2061,0.627850557981562,0,0,186,416,18,175,NA,NA,7,NA
"620","2020-03-28",60,8,101,258,2061,0.627850557981562,0,0,186,416,10,185,7,70,5,7
"621","2020-03-29",67,8,91,273,2061,0.627850557981562,0,0,186,416,11,196,5,75,7,5
"622","2020-03-30",69,8,89,292,2061,0.627850557981562,0,0,186,416,21,217,8,83,13,8
"623","2020-03-31",72,8,79,297,2061,0.627850557981562,0,0,186,416,17,234,3,86,9,3
"624","2020-04-01",75,8,76,314,2061,0.627850557981562,0,0,186,416,20,254,3,89,11,3
"625","2020-04-02",76,8,79,328,2061,0.627850557981562,0,0,186,416,26,280,5,94,19,5
"626","2020-04-03",84,8,91,348,2061,0.627850557981562,0,0,186,416,28,308,9,103,16,9
"627","2020-04-04",85,8,83,377,2061,0.627850557981562,0,0,186,416,19,327,7,110,11,7
"628","2020-04-05",93,8,87,381,2061,0.627850557981562,0,0,186,416,13,340,5,115,7,5
"629","2020-04-06",98,8,96,392,2061,0.627850557981562,0,0,186,416,18,358,6,121,10,6
"630","2020-04-07",96,8,114,394,2061,0.627850557981562,0,0,186,416,24,382,2,123,12,2
"631","2020-04-08",100,8,134,402,2061,0.627850557981562,0,0,186,416,25,407,9,132,15,9
"632","2020-04-09",114,8,144,398,2061,0.627850557981562,0,0,186,416,14,421,11,143,5,11
"633","2020-04-10",119,8,146,393,2061,0.627850557981562,0,0,186,416,21,442,7,150,17,7
"634","2020-04-11",124,8,155,389,2061,0.627850557981562,0,0,186,416,18,460,6,156,8,6
"635","2020-04-12",118,8,160,388,2061,0.627850557981562,0,0,186,416,31,491,13,169,21,13
"636","2020-04-13",119,8,171,396,2061,0.627850557981562,0,0,186,416,13,504,9,178,4,9
"637","2020-04-14",128,8,161,397,2061,0.627850557981562,0,0,186,416,30,534,10,188,23,10
"638","2020-04-15",132,8,165,379,2061,0.627850557981562,0,0,186,416,27,561,8,196,16,8
"639","2020-04-16",128,8,164,364,2061,0.627850557981562,0,0,186,416,18,579,13,209,12,13
"640","2020-04-17",120,8,149,356,2061,0.627850557981562,0,0,186,416,21,600,10,219,9,10
"641","2020-04-18",108,8,140,349,2061,0.627850557981562,0,0,186,416,17,617,7,226,13,7
"642","2020-04-19",101,8,132,329,2061,0.627850557981562,0,0,186,416,25,642,7,233,12,7
"643","2020-04-20",105,8,126,324,2061,0.627850557981562,0,0,186,416,20,662,4,237,10,4
"644","2020-04-21",93,8,141,328,2061,0.627850557981562,0,0,186,416,25,687,6,243,13,6
"645","2020-04-22",94,8,160,319,2061,0.627850557981562,0,0,186,416,25,712,4,247,13,4
"646","2020-04-23",91,8,172,307,2061,0.627850557981562,0,0,186,416,25,737,2,249,17,2
"647","2020-04-24",93,8,168,305,2061,0.627850557981562,0,0,186,416,27,764,4,253,17,4
"648","2020-04-25",98,8,167,297,2061,0.627850557981562,0,0,186,416,24,788,9,262,15,9
"649","2020-04-26",105,8,159,289,2061,0.627850557981562,0,0,186,416,35,823,2,264,26,2
"650","2020-04-27",104,8,156,294,2061,0.627850557981562,0,0,186,416,23,846,NA,NA,17,NA
"651","2020-04-28",104,8,156,294,2061,0.627850557981562,0,0,186,416,27,873,8,272,18,8
"652","2020-04-29",92,8,155,296,2061,0.627850557981562,0,0,186,416,21,894,10,282,13,10
"653","2020-04-30",93,8,153,304,2061,0.627850557981562,0,0,186,416,25,919,11,293,8,11
"654","2020-05-01",88,8,150,294,2061,0.627850557981562,0,0,186,416,34,953,7,300,20,7
"655","2020-05-02",91,8,160,293,2061,0.627850557981562,0,0,186,416,19,972,6,306,9,6
"656","2020-05-03",94,8,166,288,2061,0.627850557981562,0,0,186,416,18,990,5,311,8,5
"657","2020-05-04",87,8,178,285,2061,0.627850557981562,0,0,186,416,22,1012,5,316,15,5
"658","2020-05-05",90,8,186,275,2061,0.627850557981562,0,0,186,416,25,1037,4,320,14,4
"659","2020-05-06",98,8,181,271,2061,0.627850557981562,0,0,186,416,14,1051,3,323,6,3
"660","2020-05-07",94,8,185,265,2061,0.627850557981562,0,0,186,416,27,1078,7,330,11,7
"661","2020-05-08",92,8,186,261,2061,0.627850557981562,0,0,186,416,20,1098,15,345,9,15
"662","2020-05-09",88,8,199,255,2061,0.627850557981562,0,0,186,416,17,1115,16,361,8,16
"663","2020-05-10",80,8,203,253,2061,0.627850557981562,0,0,186,416,19,1134,8,369,14,8
"664","2020-05-11",77,8,187,245,2061,0.627850557981562,0,0,186,416,16,1150,15,384,11,15
"665","2020-05-12",75,8,177,252,2061,0.627850557981562,0,0,186,416,18,1168,11,395,10,11
"666","2020-05-13",66,8,168,239,2061,0.627850557981562,0,0,186,416,22,1190,8,403,11,8
"667","2020-05-14",68,8,183,238,2061,0.627850557981562,0,0,186,416,16,1206,6,409,11,6
"668","2020-05-15",67,8,177,231,2061,0.627850557981562,0,0,186,416,16,1222,16,425,9,16
"669","2020-05-16",67,8,200,225,2061,0.627850557981562,0,0,186,416,10,1232,15,440,6,15
"670","2020-05-17",64,8,195,221,2061,0.627850557981562,0,0,186,416,14,1246,10,450,8,10
"671","2020-05-18",65,8,197,224,2061,0.627850557981562,0,0,186,416,16,1262,11,461,11,11
"672","2020-05-19",64,8,192,219,2061,0.627850557981562,0,0,186,416,9,1271,14,475,8,14
"673","2020-05-20",62,8,194,217,2061,0.627850557981562,0,0,186,416,11,1282,11,486,4,11
"674","2020-05-21",63,8,189,203,2061,0.627850557981562,0,0,186,416,10,1292,14,500,4,14
"675","2020-05-22",62,8,185,199,2061,0.627850557981562,0,0,186,416,12,1304,8,508,7,8
"676","2020-05-23",62,8,189,202,2061,0.627850557981562,0,0,186,416,16,1320,15,523,7,15
"677","2020-05-24",68,8,183,205,2061,0.627850557981562,0,0,186,416,11,1331,11,534,4,11
"678","2020-05-25",64,8,176,203,2061,0.627850557981562,0,0,186,416,16,1347,7,541,10,7
"679","2020-05-26",63,8,171,195,2061,0.627850557981562,0,0,186,416,13,1360,7,548,6,7
"680","2020-05-27",66,8,168,189,2061,0.627850557981562,0,0,186,416,12,1372,4,552,3,4
"681","2020-05-28",58,8,174,186,2061,0.627850557981562,0,0,186,416,11,1383,2,554,7,2
"682","2020-05-29",62,8,175,181,2061,0.627850557981562,0,0,186,416,7,1390,9,563,4,9
"683","2020-05-30",52,8,184,172,2061,0.627850557981562,0,0,186,416,6,1396,2,565,4,2
"684","2020-05-31",48,8,178,166,2061,0.627850557981562,0,0,186,416,9,1405,5,570,5,5
"685","2020-06-01",51,8,184,164,2061,0.627850557981562,0,0,186,416,8,1413,9,579,2,9
"686","2020-06-02",50,8,184,151,2061,0.627850557981562,0,0,186,416,5,1418,6,585,2,6
"687","2020-06-03",45,8,170,150,2061,0.627850557981562,0,0,186,416,6,1424,10,595,4,10
"688","2020-06-04",43,8,160,147,2061,0.627850557981562,0,0,186,416,12,1436,4,599,6,4
"689","2020-06-05",37,8,143,141,2061,0.627850557981562,0,0,186,416,11,1447,4,603,7,4
"690","2020-06-06",40,8,128,135,2061,0.627850557981562,0,0,186,416,6,1453,6,609,4,6
"691","2020-06-07",44,8,126,137,2061,0.627850557981562,0,0,186,416,6,1459,9,618,3,9
"692","2020-03-17",1,9,31,39,6687,0.984596979213399,0,0,620,245,3,26,9,59,2,9
"693","2020-03-18",6,9,39,55,6687,0.984596979213399,0,0,620,245,7,33,5,64,7,5
"694","2020-03-19",6,9,43,66,6687,0.984596979213399,0,0,620,245,7,40,1,65,7,1
"695","2020-03-20",12,9,40,78,6687,0.984596979213399,0,0,620,245,11,51,3,68,9,3
"696","2020-03-21",15,9,35,103,6687,0.984596979213399,0,0,620,245,9,60,3,71,4,3
"697","2020-03-22",19,9,30,120,6687,0.984596979213399,0,0,620,245,18,78,3,74,14,3
"698","2020-03-23",27,9,31,139,6687,0.984596979213399,0,0,620,245,9,87,4,78,7,4
"699","2020-03-24",31,9,33,167,6687,0.984596979213399,0,0,620,245,16,103,11,89,13,11
"700","2020-03-25",29,9,31,189,6687,0.984596979213399,0,0,620,245,11,114,10,99,10,10
"701","2020-03-26",30,9,36,217,6687,0.984596979213399,0,0,620,245,23,137,5,104,21,5
"702","2020-03-27",30,9,36,244,6687,0.984596979213399,0,0,620,245,26,163,6,110,22,6
"703","2020-03-28",35,9,41,277,6687,0.984596979213399,0,0,620,245,24,187,3,113,24,3
"704","2020-03-29",37,9,48,312,6687,0.984596979213399,0,0,620,245,27,214,9,122,22,9
"705","2020-03-30",38,9,45,336,6687,0.984596979213399,0,0,620,245,35,249,9,131,35,9
"706","2020-03-31",49,9,41,372,6687,0.984596979213399,0,0,620,245,29,278,4,135,28,4
"707","2020-04-01",57,9,33,434,6687,0.984596979213399,0,0,620,245,27,305,17,152,26,17
"708","2020-04-02",77,9,35,509,6687,0.984596979213399,0,0,620,245,55,360,10,162,54,10
"709","2020-04-03",90,9,38,564,6687,0.984596979213399,0,0,620,245,52,412,3,165,50,3
"710","2020-04-04",95,9,27,631,6687,0.984596979213399,0,0,620,245,39,451,2,167,39,2
"711","2020-04-05",118,9,23,711,6687,0.984596979213399,0,0,620,245,41,492,5,172,41,5
"712","2020-04-06",140,9,27,788,6687,0.984596979213399,0,0,620,245,34,526,2,174,33,2
"713","2020-04-07",164,9,25,843,6687,0.984596979213399,0,0,620,245,55,581,4,178,54,4
"714","2020-04-08",185,9,25,950,6687,0.984596979213399,0,0,620,245,53,634,3,181,53,3
"715","2020-04-09",198,9,25,1016,6687,0.984596979213399,0,0,620,245,63,697,9,190,58,9
"716","2020-04-10",218,9,34,1082,6687,0.984596979213399,0,0,620,245,53,750,13,203,49,13
"717","2020-04-11",239,9,43,1152,6687,0.984596979213399,0,0,620,245,63,813,9,212,63,9
"718","2020-04-12",265,9,46,1221,6687,0.984596979213399,0,0,620,245,63,876,7,219,62,7
"719","2020-04-13",285,9,58,1319,6687,0.984596979213399,0,0,620,245,74,950,18,237,70,18
"720","2020-04-14",299,9,62,1415,6687,0.984596979213399,0,0,620,245,62,1012,3,240,57,3
"721","2020-04-15",319,9,65,1496,6687,0.984596979213399,0,0,620,245,84,1096,4,244,82,4
"722","2020-04-16",357,9,84,1589,6687,0.984596979213399,0,0,620,245,66,1162,10,254,64,10
"723","2020-04-17",389,9,87,1759,6687,0.984596979213399,0,0,620,245,80,1242,9,263,79,9
"724","2020-04-18",435,9,94,1845,6687,0.984596979213399,0,0,620,245,79,1321,5,268,78,5
"725","2020-04-19",445,9,94,1931,6687,0.984596979213399,0,0,620,245,69,1390,3,271,68,3
"726","2020-04-20",461,9,100,2014,6687,0.984596979213399,0,0,620,245,77,1467,20,291,76,20
"727","2020-04-21",465,9,94,2114,6687,0.984596979213399,0,0,620,245,75,1542,7,298,73,7
"728","2020-04-22",503,9,97,2275,6687,0.984596979213399,0,0,620,245,87,1629,8,306,85,8
"729","2020-04-23",526,9,93,2427,6687,0.984596979213399,0,0,620,245,71,1700,6,312,69,6
"730","2020-04-24",549,9,81,2524,6687,0.984596979213399,0,0,620,245,103,1803,6,318,103,6
"731","2020-04-25",568,9,66,2589,6687,0.984596979213399,0,0,620,245,80,1883,21,339,78,21
"732","2020-04-26",615,9,68,2592,6687,0.984596979213399,0,0,620,245,107,1990,4,343,106,4
"733","2020-04-27",639,9,75,2583,6687,0.984596979213399,0,0,620,245,84,2074,8,351,80,8
"734","2020-04-28",694,9,72,2546,6687,0.984596979213399,0,0,620,245,85,2159,11,362,84,11
"735","2020-04-29",702,9,59,2475,6687,0.984596979213399,0,0,620,245,67,2226,24,386,66,24
"736","2020-04-30",724,9,51,2422,6687,0.984596979213399,0,0,620,245,85,2311,13,399,82,13
"737","2020-05-01",724,9,40,2304,6687,0.984596979213399,0,0,620,245,83,2394,18,417,82,18
"738","2020-05-02",725,9,44,2175,6687,0.984596979213399,0,0,620,245,80,2474,16,433,76,16
"739","2020-05-03",709,9,44,2018,6687,0.984596979213399,0,0,620,245,79,2553,5,438,77,5
"740","2020-05-04",706,9,42,1892,6687,0.984596979213399,0,0,620,245,84,2637,11,449,82,11
"741","2020-05-05",677,9,46,1713,6687,0.984596979213399,0,0,620,245,68,2705,8,457,66,8
"742","2020-05-06",651,9,42,1518,6687,0.984596979213399,0,0,620,245,66,2771,25,482,63,25
"743","2020-05-07",593,9,43,1349,6687,0.984596979213399,0,0,620,245,86,2857,9,491,86,9
"744","2020-05-08",561,9,37,1196,6687,0.984596979213399,0,0,620,245,83,2940,9,500,82,9
"745","2020-05-09",517,9,39,1055,6687,0.984596979213399,0,0,620,245,65,3005,2,502,63,2
"746","2020-05-10",466,9,39,940,6687,0.984596979213399,0,0,620,245,52,3057,5,507,49,5
"747","2020-05-11",407,9,39,806,6687,0.984596979213399,0,0,620,245,59,3116,17,524,59,17
"748","2020-05-12",364,9,40,680,6687,0.984596979213399,0,0,620,245,40,3156,18,542,39,18
"749","2020-05-13",319,9,34,576,6687,0.984596979213399,0,0,620,245,58,3214,19,561,57,19
"750","2020-05-14",292,9,38,484,6687,0.984596979213399,0,0,620,245,53,3267,6,567,53,6
"751","2020-05-15",249,9,39,416,6687,0.984596979213399,0,0,620,245,45,3312,5,572,44,5
"752","2020-05-16",211,9,43,345,6687,0.984596979213399,0,0,620,245,39,3351,6,578,39,6
"753","2020-05-17",183,9,43,283,6687,0.984596979213399,0,0,620,245,40,3391,11,589,40,11
"754","2020-05-18",161,9,43,231,6687,0.984596979213399,0,0,620,245,37,3428,9,598,37,9
"755","2020-05-19",125,9,46,196,6687,0.984596979213399,0,0,620,245,39,3467,3,601,39,3
"756","2020-05-20",105,9,48,167,6687,0.984596979213399,0,0,620,245,44,3511,2,603,44,2
"757","2020-05-21",80,9,53,140,6687,0.984596979213399,0,0,620,245,42,3553,9,612,40,9
"758","2020-05-22",69,9,59,113,6687,0.984596979213399,0,0,620,245,40,3593,19,631,40,19
"759","2020-05-23",57,9,63,98,6687,0.984596979213399,0,0,620,245,34,3627,14,645,34,14
"760","2020-05-24",44,9,55,79,6687,0.984596979213399,0,0,620,245,20,3647,13,658,20,13
"761","2020-05-25",39,9,59,63,6687,0.984596979213399,0,0,620,245,28,3675,9,667,28,9
"762","2020-05-26",35,9,61,58,6687,0.984596979213399,0,0,620,245,29,3704,7,674,29,7
"763","2020-05-27",29,9,56,45,6687,0.984596979213399,0,0,620,245,25,3729,11,685,25,11
"764","2020-05-28",24,9,51,39,6687,0.984596979213399,0,0,620,245,21,3750,9,694,21,9
"765","2020-05-29",17,9,45,31,6687,0.984596979213399,0,0,620,245,24,3774,3,697,23,3
"766","2020-05-30",11,9,41,24,6687,0.984596979213399,0,0,620,245,29,3803,2,699,29,2
"767","2020-05-31",7,9,34,21,6687,0.984596979213399,0,0,620,245,28,3831,5,704,28,5
"768","2020-06-01",9,9,29,23,6687,0.984596979213399,0,0,620,245,20,3851,3,707,20,3
"769","2020-06-02",12,9,27,23,6687,0.984596979213399,0,0,620,245,29,3880,3,710,29,3
"770","2020-06-03",12,9,24,22,6687,0.984596979213399,0,0,620,245,23,3903,2,712,22,2
"771","2020-06-04",10,9,25,18,6687,0.984596979213399,0,0,620,245,21,3924,6,718,21,6
"772","2020-06-05",10,9,17,17,6687,0.984596979213399,0,0,620,245,17,3941,1,719,17,1
"773","2020-06-06",12,9,19,12,6687,0.984596979213399,0,0,620,245,24,3965,10,729,24,10
"774","2020-06-07",14,9,17,13,6687,0.984596979213399,0,0,620,245,20,3985,5,734,19,5
"775","2020-03-14",1,10,23,8,1942,0.899073120494336,0,0,138,201,7,17,1,7,2,1
"776","2020-03-15",1,10,29,10,1942,0.899073120494336,0,0,138,201,3,20,2,9,2,2
"777","2020-03-16",2,10,26,13,1942,0.899073120494336,0,0,138,201,10,30,NA,NA,2,NA
"778","2020-03-17",2,10,38,18,1942,0.899073120494336,0,0,138,201,7,37,NA,NA,2,NA
"779","2020-03-18",2,10,41,21,1942,0.899073120494336,0,0,138,201,7,44,1,10,2,1
"780","2020-03-19",3,10,40,21,1942,0.899073120494336,0,0,138,201,7,51,2,12,1,2
"781","2020-03-20",3,10,39,25,1942,0.899073120494336,0,0,138,201,11,62,2,14,8,2
"782","2020-03-21",3,10,36,29,1942,0.899073120494336,0,0,138,201,9,71,2,16,6,2
"783","2020-03-22",3,10,34,34,1942,0.899073120494336,0,0,138,201,10,81,9,25,7,9
"784","2020-03-23",5,10,28,39,1942,0.899073120494336,0,0,138,201,17,98,3,28,10,3
"785","2020-03-24",5,10,26,38,1942,0.899073120494336,0,0,138,201,16,114,1,29,10,1
"786","2020-03-25",6,10,28,41,1942,0.899073120494336,0,0,138,201,18,132,4,33,13,4
"787","2020-03-26",6,10,23,47,1942,0.899073120494336,0,0,138,201,13,145,3,36,10,3
"788","2020-03-27",7,10,21,55,1942,0.899073120494336,0,0,138,201,18,163,5,41,9,5
"789","2020-03-28",8,10,22,59,1942,0.899073120494336,0,0,138,201,20,183,3,44,11,3
"790","2020-03-29",14,10,21,64,1942,0.899073120494336,0,0,138,201,21,204,3,47,12,3
"791","2020-03-30",15,10,16,70,1942,0.899073120494336,0,0,138,201,36,240,5,52,25,5
"792","2020-03-31",20,10,23,73,1942,0.899073120494336,0,0,138,201,33,273,11,63,19,11
"793","2020-04-01",22,10,26,81,1942,0.899073120494336,0,0,138,201,22,295,3,66,18,3
"794","2020-04-02",23,10,37,82,1942,0.899073120494336,0,0,138,201,42,337,1,67,33,1
"795","2020-04-03",27,10,34,88,1942,0.899073120494336,0,0,138,201,42,379,7,74,39,7
"796","2020-04-04",27,10,35,91,1942,0.899073120494336,0,0,138,201,30,409,6,80,25,6
"797","2020-04-05",24,10,29,99,1942,0.899073120494336,0,0,138,201,34,443,4,84,26,4
"798","2020-04-06",23,10,23,113,1942,0.899073120494336,0,0,138,201,35,478,6,90,27,6
"799","2020-04-07",22,10,38,113,1942,0.899073120494336,0,0,138,201,36,514,3,93,29,3
"800","2020-04-08",22,10,40,125,1942,0.899073120494336,0,0,138,201,29,543,5,98,27,5
"801","2020-04-09",25,10,45,139,1942,0.899073120494336,0,0,138,201,44,587,17,115,34,17
"802","2020-04-10",23,10,49,148,1942,0.899073120494336,0,0,138,201,34,621,16,131,28,16
"803","2020-04-11",32,10,52,156,1942,0.899073120494336,0,0,138,201,39,660,14,145,31,14
"804","2020-04-12",31,10,50,174,1942,0.899073120494336,0,0,138,201,34,694,11,156,28,11
"805","2020-04-13",38,10,48,186,1942,0.899073120494336,0,0,138,201,41,735,9,165,32,9
"806","2020-04-14",44,10,45,208,1942,0.899073120494336,0,0,138,201,45,780,13,178,35,13
"807","2020-04-15",53,10,50,219,1942,0.899073120494336,0,0,138,201,53,833,6,184,43,6
"808","2020-04-16",56,10,54,231,1942,0.899073120494336,0,0,138,201,42,875,14,198,36,14
"809","2020-04-17",67,10,56,235,1942,0.899073120494336,0,0,138,201,42,917,16,214,34,16
"810","2020-04-18",69,10,61,252,1942,0.899073120494336,0,0,138,201,46,963,7,221,42,7
"811","2020-04-19",78,10,68,269,1942,0.899073120494336,0,0,138,201,53,1016,5,226,45,5
"812","2020-04-20",80,10,82,292,1942,0.899073120494336,0,0,138,201,36,1052,4,230,32,4
"813","2020-04-21",78,10,101,296,1942,0.899073120494336,0,0,138,201,54,1106,7,237,46,7
"814","2020-04-22",73,10,113,300,1942,0.899073120494336,0,0,138,201,46,1152,10,247,37,10
"815","2020-04-23",74,10,104,309,1942,0.899073120494336,0,0,138,201,60,1212,8,255,52,8
"816","2020-04-24",71,10,86,315,1942,0.899073120494336,0,0,138,201,34,1246,4,259,31,4
"817","2020-04-25",69,10,77,326,1942,0.899073120494336,0,0,138,201,60,1306,4,263,54,4
"818","2020-04-26",70,10,70,326,1942,0.899073120494336,0,0,138,201,48,1354,13,276,39,13
"819","2020-04-27",70,10,65,322,1942,0.899073120494336,0,0,138,201,46,1400,11,287,39,11
"820","2020-04-28",78,10,60,330,1942,0.899073120494336,0,0,138,201,61,1461,5,292,54,5
"821","2020-04-29",84,10,59,342,1942,0.899073120494336,0,0,138,201,57,1518,14,306,53,14
"822","2020-04-30",98,10,61,345,1942,0.899073120494336,0,0,138,201,59,1577,21,327,54,21
"823","2020-05-01",102,10,61,351,1942,0.899073120494336,0,0,138,201,50,1627,13,340,43,13
"824","2020-05-02",106,10,55,340,1942,0.899073120494336,0,0,138,201,61,1688,8,348,55,8
"825","2020-05-03",109,10,61,353,1942,0.899073120494336,0,0,138,201,49,1737,10,358,41,10
"826","2020-05-04",108,10,52,353,1942,0.899073120494336,0,0,138,201,47,1784,8,366,40,8
"827","2020-05-05",107,10,58,358,1942,0.899073120494336,0,0,138,201,55,1839,4,370,45,4
"828","2020-05-06",108,10,55,363,1942,0.899073120494336,0,0,138,201,48,1887,10,380,41,10
"829","2020-05-07",99,10,63,363,1942,0.899073120494336,0,0,138,201,51,1938,17,397,44,17
"830","2020-05-08",95,10,72,366,1942,0.899073120494336,0,0,138,201,32,1970,20,417,27,20
"831","2020-05-09",91,10,67,372,1942,0.899073120494336,0,0,138,201,42,2012,13,430,39,13
"832","2020-05-10",88,10,77,382,1942,0.899073120494336,0,0,138,201,53,2065,4,434,41,4
"833","2020-05-11",89,10,81,381,1942,0.899073120494336,0,0,138,201,36,2101,7,441,28,7
"834","2020-05-12",97,10,77,389,1942,0.899073120494336,0,0,138,201,38,2139,12,453,34,12
"835","2020-05-13",100,10,61,383,1942,0.899073120494336,0,0,138,201,33,2172,13,466,28,13
"836","2020-05-14",104,10,53,364,1942,0.899073120494336,0,0,138,201,33,2205,10,476,30,10
"837","2020-05-15",109,10,62,369,1942,0.899073120494336,0,0,138,201,42,2247,13,489,37,13
"838","2020-05-16",114,10,59,362,1942,0.899073120494336,0,0,138,201,42,2289,9,498,35,9
"839","2020-05-17",118,10,60,378,1942,0.899073120494336,0,0,138,201,45,2334,10,508,36,10
"840","2020-05-18",116,10,67,376,1942,0.899073120494336,0,0,138,201,24,2358,7,515,20,7
"841","2020-05-19",110,10,67,380,1942,0.899073120494336,0,0,138,201,26,2384,6,521,22,6
"842","2020-05-20",108,10,66,384,1942,0.899073120494336,0,0,138,201,37,2421,9,530,33,9
"843","2020-05-21",107,10,63,369,1942,0.899073120494336,0,0,138,201,39,2460,14,544,34,14
"844","2020-05-22",109,10,67,371,1942,0.899073120494336,0,0,138,201,28,2488,10,554,25,10
"845","2020-05-23",107,10,71,358,1942,0.899073120494336,0,0,138,201,27,2515,13,567,23,13
"846","2020-05-24",104,10,64,331,1942,0.899073120494336,0,0,138,201,26,2541,16,583,24,16
"847","2020-05-25",112,10,59,318,1942,0.899073120494336,0,0,138,201,26,2567,9,592,23,9
"848","2020-05-26",112,10,50,307,1942,0.899073120494336,0,0,138,201,29,2596,4,596,23,4
"849","2020-05-27",111,10,51,309,1942,0.899073120494336,0,0,138,201,29,2625,10,606,25,10
"850","2020-05-28",110,10,43,309,1942,0.899073120494336,0,0,138,201,17,2642,10,616,12,10
"851","2020-05-29",101,10,56,309,1942,0.899073120494336,0,0,138,201,33,2675,15,631,27,15
"852","2020-05-30",95,10,58,302,1942,0.899073120494336,0,0,138,201,29,2704,8,639,23,8
"853","2020-05-31",95,10,68,284,1942,0.899073120494336,0,0,138,201,17,2721,10,649,15,10
"854","2020-06-01",89,10,76,280,1942,0.899073120494336,0,0,138,201,27,2748,5,654,25,5
"855","2020-06-02",82,10,79,257,1942,0.899073120494336,0,0,138,201,15,2763,13,667,11,13
"856","2020-06-03",82,10,78,257,1942,0.899073120494336,0,0,138,201,29,2792,9,676,26,9
"857","2020-06-04",84,10,70,241,1942,0.899073120494336,0,0,138,201,29,2821,12,688,26,12
"858","2020-06-05",82,10,70,236,1942,0.899073120494336,0,0,138,201,14,2835,9,697,14,9
"859","2020-06-06",81,10,86,229,1942,0.899073120494336,0,0,138,201,24,2859,5,702,21,5
"860","2020-06-07",75,10,78,221,1942,0.899073120494336,0,0,138,201,15,2874,1,703,12,1
"861","2020-03-14",1,11,18,37,2862,0.776729559748428,0,0,237,207,14,49,16,49,3,16
"862","2020-03-15",2,11,30,49,2862,0.776729559748428,0,0,237,207,18,67,17,66,7,17
"863","2020-03-16",5,11,40,60,2862,0.776729559748428,0,0,237,207,17,84,18,84,5,18
"864","2020-03-17",9,11,40,70,2862,0.776729559748428,0,0,237,207,16,100,18,102,12,18
"865","2020-03-18",10,11,41,87,2862,0.776729559748428,0,0,237,207,20,120,20,122,9,20
"866","2020-03-19",13,11,34,104,2862,0.776729559748428,0,0,237,207,18,138,14,136,11,14
"867","2020-03-20",15,11,28,113,2862,0.776729559748428,0,0,237,207,23,161,27,163,14,27
"868","2020-03-21",19,11,23,124,2862,0.776729559748428,0,0,237,207,22,183,39,202,8,39
"869","2020-03-22",26,11,20,149,2862,0.776729559748428,0,0,237,207,23,206,22,224,16,22
"870","2020-03-23",31,11,19,171,2862,0.776729559748428,0,0,237,207,23,229,24,248,12,24
"871","2020-03-24",33,11,20,197,2862,0.776729559748428,0,0,237,207,20,249,18,266,9,18
"872","2020-03-25",35,11,19,210,2862,0.776729559748428,0,0,237,207,35,284,19,285,18,19
"873","2020-03-26",41,11,18,232,2862,0.776729559748428,0,0,237,207,35,319,33,318,24,33
"874","2020-03-27",46,11,23,269,2862,0.776729559748428,0,0,237,207,27,346,17,335,12,17
"875","2020-03-28",51,11,21,282,2862,0.776729559748428,0,0,237,207,33,379,38,373,20,38
"876","2020-03-29",51,11,29,308,2862,0.776729559748428,0,0,237,207,45,424,36,409,26,36
"877","2020-03-30",53,11,31,333,2862,0.776729559748428,0,0,237,207,35,459,36,445,22,36
"878","2020-03-31",65,11,27,364,2862,0.776729559748428,0,0,237,207,27,486,28,473,18,28
"879","2020-04-01",73,11,22,393,2862,0.776729559748428,0,0,237,207,35,521,20,493,22,20
"880","2020-04-02",76,11,25,421,2862,0.776729559748428,0,0,237,207,44,565,32,525,29,32
"881","2020-04-03",89,11,34,446,2862,0.776729559748428,0,0,237,207,36,601,29,554,27,29
"882","2020-04-04",95,11,49,468,2862,0.776729559748428,0,0,237,207,42,643,52,606,28,52
"883","2020-04-05",106,11,62,501,2862,0.776729559748428,0,0,237,207,34,677,31,637,21,31
"884","2020-04-06",125,11,72,528,2862,0.776729559748428,0,0,237,207,44,721,28,665,31,28
"885","2020-04-07",127,11,64,549,2862,0.776729559748428,0,0,237,207,47,768,33,698,40,33
"886","2020-04-08",140,11,59,573,2862,0.776729559748428,0,0,237,207,37,805,27,725,29,27
"887","2020-04-09",147,11,58,581,2862,0.776729559748428,0,0,237,207,42,847,21,746,28,21
"888","2020-04-10",153,11,62,603,2862,0.776729559748428,0,0,237,207,30,877,24,770,21,24
"889","2020-04-11",165,11,52,600,2862,0.776729559748428,0,0,237,207,43,920,36,806,30,36
"890","2020-04-12",176,11,54,574,2862,0.776729559748428,0,0,237,207,28,948,40,846,21,40
"891","2020-04-13",176,11,70,590,2862,0.776729559748428,0,0,237,207,41,989,31,877,33,31
"892","2020-04-14",173,11,71,611,2862,0.776729559748428,0,0,237,207,38,1027,28,905,28,28
"893","2020-04-15",171,11,74,589,2862,0.776729559748428,0,0,237,207,51,1078,31,936,34,31
"894","2020-04-16",179,11,66,581,2862,0.776729559748428,0,0,237,207,42,1120,35,971,34,35
"895","2020-04-17",181,11,63,572,2862,0.776729559748428,0,0,237,207,31,1151,39,1010,22,39
"896","2020-04-18",172,11,69,559,2862,0.776729559748428,0,0,237,207,34,1185,45,1055,24,45
"897","2020-04-19",165,11,66,568,2862,0.776729559748428,0,0,237,207,38,1223,49,1104,26,49
"898","2020-04-20",158,11,65,553,2862,0.776729559748428,0,0,237,207,26,1249,36,1140,20,36
"899","2020-04-21",162,11,61,538,2862,0.776729559748428,0,0,237,207,38,1287,27,1167,23,27
"900","2020-04-22",163,11,61,547,2862,0.776729559748428,0,0,237,207,36,1323,32,1199,22,32
"901","2020-04-23",152,11,53,546,2862,0.776729559748428,0,0,237,207,38,1361,33,1232,20,33
"902","2020-04-24",148,11,51,559,2862,0.776729559748428,0,0,237,207,34,1395,25,1257,20,25
"903","2020-04-25",147,11,49,554,2862,0.776729559748428,0,0,237,207,54,1449,41,1298,27,41
"904","2020-04-26",147,11,52,547,2862,0.776729559748428,0,0,237,207,35,1484,28,1326,22,28
"905","2020-04-27",150,11,59,547,2862,0.776729559748428,0,0,237,207,32,1516,28,1354,16,28
"906","2020-04-28",151,11,50,543,2862,0.776729559748428,0,0,237,207,40,1556,41,1395,22,41
"907","2020-04-29",156,11,65,542,2862,0.776729559748428,0,0,237,207,33,1589,47,1442,22,47
"908","2020-04-30",161,11,81,529,2862,0.776729559748428,0,0,237,207,33,1622,33,1475,20,33
"909","2020-05-01",161,11,86,523,2862,0.776729559748428,0,0,237,207,40,1662,40,1515,25,40
"910","2020-05-02",163,11,86,489,2862,0.776729559748428,0,0,237,207,34,1696,26,1541,23,26
"911","2020-05-03",162,11,90,464,2862,0.776729559748428,0,0,237,207,36,1732,33,1574,21,33
"912","2020-05-04",152,11,90,452,2862,0.776729559748428,0,0,237,207,37,1769,46,1620,25,46
"913","2020-05-05",159,11,111,432,2862,0.776729559748428,0,0,237,207,33,1802,42,1662,22,42
"914","2020-05-06",146,11,96,409,2862,0.776729559748428,0,0,237,207,21,1823,47,1709,14,47
"915","2020-05-07",143,11,88,385,2862,0.776729559748428,0,0,237,207,22,1845,44,1753,16,44
"916","2020-05-08",137,11,78,375,2862,0.776729559748428,0,0,237,207,30,1875,38,1791,15,38
"917","2020-05-09",135,11,63,363,2862,0.776729559748428,0,0,237,207,23,1898,31,1822,13,31
"918","2020-05-10",132,11,55,331,2862,0.776729559748428,0,0,237,207,24,1922,45,1867,13,45
"919","2020-05-11",128,11,57,316,2862,0.776729559748428,0,0,237,207,24,1946,38,1905,18,38
"920","2020-05-12",108,11,48,303,2862,0.776729559748428,0,0,237,207,26,1972,42,1947,16,42
"921","2020-05-13",112,11,47,303,2862,0.776729559748428,0,0,237,207,27,1999,39,1986,17,39
"922","2020-05-14",113,11,54,288,2862,0.776729559748428,0,0,237,207,29,2028,42,2028,16,42
"923","2020-05-15",108,11,54,272,2862,0.776729559748428,0,0,237,207,25,2053,41,2069,12,41
"924","2020-05-16",100,11,65,270,2862,0.776729559748428,0,0,237,207,18,2071,49,2118,11,49
"925","2020-05-17",95,11,62,261,2862,0.776729559748428,0,0,237,207,17,2088,47,2165,11,47
"926","2020-05-18",93,11,52,263,2862,0.776729559748428,0,0,237,207,18,2106,31,2196,14,31
"927","2020-05-19",97,11,65,262,2862,0.776729559748428,0,0,237,207,21,2127,26,2222,11,26
"928","2020-05-20",87,11,64,254,2862,0.776729559748428,0,0,237,207,17,2144,35,2257,10,35
"929","2020-05-21",78,11,71,247,2862,0.776729559748428,0,0,237,207,20,2164,40,2297,10,40
"930","2020-05-22",80,11,66,241,2862,0.776729559748428,0,0,237,207,21,2185,29,2326,12,29
"931","2020-05-23",78,11,67,235,2862,0.776729559748428,0,0,237,207,19,2204,36,2362,11,36
"932","2020-05-24",73,11,72,229,2862,0.776729559748428,0,0,237,207,14,2218,28,2390,10,28
"933","2020-05-25",77,11,74,222,2862,0.776729559748428,0,0,237,207,22,2240,17,2407,14,17
"934","2020-05-26",73,11,76,220,2862,0.776729559748428,0,0,237,207,18,2258,21,2428,12,21
"935","2020-05-27",79,11,73,217,2862,0.776729559748428,0,0,237,207,14,2272,32,2460,10,32
"936","2020-05-28",84,11,70,211,2862,0.776729559748428,0,0,237,207,10,2282,25,2485,6,25
"937","2020-05-29",72,11,68,216,2862,0.776729559748428,0,0,237,207,21,2303,33,2518,8,33
"938","2020-05-30",70,11,68,205,2862,0.776729559748428,0,0,237,207,12,2315,23,2541,10,23
"939","2020-05-31",72,11,62,200,2862,0.776729559748428,0,0,237,207,17,2332,33,2574,12,33
"940","2020-06-01",66,11,61,183,2862,0.776729559748428,0,0,237,207,8,2340,25,2599,5,25
"941","2020-06-02",64,11,60,177,2862,0.776729559748428,0,0,237,207,16,2356,29,2628,9,29
"942","2020-06-03",57,11,54,164,2862,0.776729559748428,0,0,237,207,10,2366,22,2650,6,22
"943","2020-06-04",51,11,43,149,2862,0.776729559748428,0,0,237,207,12,2378,28,2678,10,28
"944","2020-06-05",53,11,40,136,2862,0.776729559748428,0,0,237,207,11,2389,22,2700,6,22
"945","2020-06-06",52,11,45,125,2862,0.776729559748428,0,0,237,207,8,2397,26,2726,4,26
"946","2020-06-07",46,11,42,132,2862,0.776729559748428,0,0,237,207,12,2409,46,2772,7,46
"947","2020-03-12",1,12,12,16,2020,0.534653465346535,0,0,170,205,3,7,3,8,NA,3
"948","2020-03-13",2,12,11,33,2020,0.534653465346535,0,0,170,205,5,12,3,11,1,3
"949","2020-03-14",4,12,17,44,2020,0.534653465346535,0,0,170,205,5,17,6,17,2,6
"950","2020-03-15",4,12,15,54,2020,0.534653465346535,0,0,170,205,9,26,NA,NA,6,NA
"951","2020-03-16",4,12,19,66,2020,0.534653465346535,0,0,170,205,9,35,10,27,3,10
"952","2020-03-17",7,12,19,83,2020,0.534653465346535,0,0,170,205,7,42,3,30,2,3
"953","2020-03-18",11,12,20,99,2020,0.534653465346535,0,0,170,205,10,52,9,39,5,9
"954","2020-03-19",13,12,21,113,2020,0.534653465346535,0,0,170,205,9,61,10,49,9,10
"955","2020-03-20",20,12,22,120,2020,0.534653465346535,0,0,170,205,14,75,4,53,12,4
"956","2020-03-21",25,12,22,136,2020,0.534653465346535,0,0,170,205,7,82,3,56,4,3
"957","2020-03-22",32,12,31,152,2020,0.534653465346535,0,0,170,205,15,97,5,61,11,5
"958","2020-03-23",41,12,28,170,2020,0.534653465346535,0,0,170,205,16,113,11,72,11,11
"959","2020-03-24",45,12,30,177,2020,0.534653465346535,0,0,170,205,15,128,11,83,13,11
"960","2020-03-25",45,12,26,201,2020,0.534653465346535,0,0,170,205,25,153,8,91,18,8
"961","2020-03-26",50,12,24,211,2020,0.534653465346535,0,0,170,205,22,175,8,99,14,8
"962","2020-03-27",49,12,27,215,2020,0.534653465346535,0,0,170,205,19,194,10,109,14,10
"963","2020-03-28",47,12,30,236,2020,0.534653465346535,0,0,170,205,13,207,11,120,9,11
"964","2020-03-29",48,12,33,243,2020,0.534653465346535,0,0,170,205,22,229,11,131,16,11
"965","2020-03-30",51,12,34,249,2020,0.534653465346535,0,0,170,205,24,253,14,145,20,14
"966","2020-03-31",50,12,35,253,2020,0.534653465346535,0,0,170,205,33,286,9,154,30,9
"967","2020-04-01",59,12,46,262,2020,0.534653465346535,0,0,170,205,32,318,10,164,26,10
"968","2020-04-02",58,12,42,279,2020,0.534653465346535,0,0,170,205,16,334,17,181,11,17
"969","2020-04-03",59,12,49,286,2020,0.534653465346535,0,0,170,205,27,361,8,189,25,8
"970","2020-04-04",69,12,57,285,2020,0.534653465346535,0,0,170,205,27,388,14,203,18,14
"971","2020-04-05",76,12,53,280,2020,0.534653465346535,0,0,170,205,32,420,15,218,26,15
"972","2020-04-06",74,12,53,289,2020,0.534653465346535,0,0,170,205,28,448,13,231,23,13
"973","2020-04-07",79,12,53,291,2020,0.534653465346535,0,0,170,205,35,483,10,241,27,10
"974","2020-04-08",78,12,57,289,2020,0.534653465346535,0,0,170,205,37,520,11,252,31,11
"975","2020-04-09",85,12,52,294,2020,0.534653465346535,0,0,170,205,28,548,9,261,20,9
"976","2020-04-10",89,12,51,302,2020,0.534653465346535,0,0,170,205,34,582,6,267,29,6
"977","2020-04-11",86,12,56,303,2020,0.534653465346535,0,0,170,205,40,622,14,281,29,14
"978","2020-04-12",81,12,55,309,2020,0.534653465346535,0,0,170,205,44,666,12,293,34,12
"979","2020-04-13",78,12,60,318,2020,0.534653465346535,0,0,170,205,44,710,4,297,38,4
"980","2020-04-14",75,12,55,342,2020,0.534653465346535,0,0,170,205,49,759,5,302,36,5
"981","2020-04-15",76,12,59,353,2020,0.534653465346535,0,0,170,205,33,792,7,309,26,7
"982","2020-04-16",70,12,61,353,2020,0.534653465346535,0,0,170,205,28,820,5,314,26,5
"983","2020-04-17",75,12,64,359,2020,0.534653465346535,0,0,170,205,53,873,4,318,45,4
"984","2020-04-18",77,12,55,368,2020,0.534653465346535,0,0,170,205,37,910,13,331,33,13
"985","2020-04-19",83,12,74,374,2020,0.534653465346535,0,0,170,205,36,946,6,337,32,6
"986","2020-04-20",98,12,76,376,2020,0.534653465346535,0,0,170,205,44,990,3,340,38,3
"987","2020-04-21",103,12,73,383,2020,0.534653465346535,0,0,170,205,39,1029,4,344,33,4
"988","2020-04-22",100,12,62,374,2020,0.534653465346535,0,0,170,205,36,1065,1,345,32,1
"989","2020-04-23",111,12,66,365,2020,0.534653465346535,0,0,170,205,35,1100,3,348,25,3
"990","2020-04-24",105,12,62,346,2020,0.534653465346535,0,0,170,205,40,1140,5,353,30,5
"991","2020-04-25",101,12,61,330,2020,0.534653465346535,0,0,170,205,39,1179,8,361,32,8
"992","2020-04-26",101,12,59,328,2020,0.534653465346535,0,0,170,205,43,1222,17,378,33,17
"993","2020-04-27",92,12,60,325,2020,0.534653465346535,0,0,170,205,34,1256,7,385,27,7
"994","2020-04-28",97,12,62,327,2020,0.534653465346535,0,0,170,205,39,1295,4,389,32,4
"995","2020-04-29",104,12,61,316,2020,0.534653465346535,0,0,170,205,33,1328,11,400,29,11
"996","2020-04-30",93,12,78,306,2020,0.534653465346535,0,0,170,205,38,1366,7,407,35,7
"997","2020-05-01",95,12,83,302,2020,0.534653465346535,0,0,170,205,40,1406,7,414,33,7
"998","2020-05-02",95,12,84,307,2020,0.534653465346535,0,0,170,205,37,1443,14,428,31,14
"999","2020-05-03",93,12,85,295,2020,0.534653465346535,0,0,170,205,33,1476,8,436,24,8
"1000","2020-05-04",95,12,91,289,2020,0.534653465346535,0,0,170,205,42,1518,4,440,34,4
"1001","2020-05-05",87,12,97,287,2020,0.534653465346535,0,0,170,205,40,1558,11,451,33,11
"1002","2020-05-06",82,12,110,279,2020,0.534653465346535,0,0,170,205,46,1604,1,452,40,1
"1003","2020-05-07",84,12,115,273,2020,0.534653465346535,0,0,170,205,39,1643,4,456,29,4
"1004","2020-05-08",79,12,103,271,2020,0.534653465346535,0,0,170,205,35,1678,2,458,27,2
"1005","2020-05-09",85,12,101,281,2020,0.534653465346535,0,0,170,205,37,1715,5,463,33,5
"1006","2020-05-10",83,12,90,268,2020,0.534653465346535,0,0,170,205,47,1762,1,464,41,1
"1007","2020-05-11",75,12,104,270,2020,0.534653465346535,0,0,170,205,27,1789,14,478,21,14
"1008","2020-05-12",75,12,112,262,2020,0.534653465346535,0,0,170,205,38,1827,9,487,33,9
"1009","2020-05-13",71,12,117,251,2020,0.534653465346535,0,0,170,205,34,1861,8,495,32,8
"1010","2020-05-14",75,12,113,241,2020,0.534653465346535,0,0,170,205,44,1905,2,497,39,2
"1011","2020-05-15",76,12,104,251,2020,0.534653465346535,0,0,170,205,38,1943,3,500,32,3
"1012","2020-05-16",74,12,101,247,2020,0.534653465346535,0,0,170,205,31,1974,2,502,29,2
"1013","2020-05-17",69,12,100,247,2020,0.534653465346535,0,0,170,205,41,2015,13,515,31,13
"1014","2020-05-18",73,12,96,245,2020,0.534653465346535,0,0,170,205,48,2063,4,519,41,4
"1015","2020-05-19",74,12,86,243,2020,0.534653465346535,0,0,170,205,41,2104,10,529,36,10
"1016","2020-05-20",75,12,86,244,2020,0.534653465346535,0,0,170,205,38,2142,2,531,31,2
"1017","2020-05-21",76,12,83,251,2020,0.534653465346535,0,0,170,205,42,2184,4,535,37,4
"1018","2020-05-22",72,12,98,231,2020,0.534653465346535,0,0,170,205,35,2219,2,537,31,2
"1019","2020-05-23",69,12,102,219,2020,0.534653465346535,0,0,170,205,25,2244,2,539,23,2
"1020","2020-05-24",72,12,92,202,2020,0.534653465346535,0,0,170,205,25,2269,6,545,23,6
"1021","2020-05-25",70,12,83,198,2020,0.534653465346535,0,0,170,205,31,2300,3,548,26,3
"1022","2020-05-26",65,12,93,192,2020,0.534653465346535,0,0,170,205,36,2336,3,551,34,3
"1023","2020-05-27",64,12,84,180,2020,0.534653465346535,0,0,170,205,28,2364,2,553,26,2
"1024","2020-05-28",56,12,78,167,2020,0.534653465346535,0,0,170,205,34,2398,3,556,30,3
"1025","2020-05-29",62,12,83,154,2020,0.534653465346535,0,0,170,205,36,2434,5,561,34,5
"1026","2020-05-30",54,12,85,154,2020,0.534653465346535,0,0,170,205,27,2461,4,565,25,4
"1027","2020-05-31",49,12,88,146,2020,0.534653465346535,0,0,170,205,22,2483,6,571,19,6
"1028","2020-06-01",47,12,88,139,2020,0.534653465346535,0,0,170,205,29,2512,7,578,26,7
"1029","2020-06-02",42,12,79,136,2020,0.534653465346535,0,0,170,205,17,2529,3,581,17,3
"1030","2020-06-03",38,12,67,126,2020,0.534653465346535,0,0,170,205,19,2548,4,585,18,4
"1031","2020-06-04",37,12,61,126,2020,0.534653465346535,0,0,170,205,19,2567,6,591,17,6
"1032","2020-06-05",30,12,54,121,2020,0.534653465346535,0,0,170,205,16,2583,10,601,14,10
"1033","2020-06-06",31,12,54,117,2020,0.534653465346535,0,0,170,205,11,2594,6,607,7,6
"1034","2020-06-07",31,12,57,118,2020,0.534653465346535,0,0,170,205,16,2610,4,611,14,4
"1035","2020-03-19",2,13,25,29,1803,0.841930116472546,0,0,145,199,20,86,1,34,10,1
"1036","2020-03-20",3,13,32,41,1803,0.841930116472546,0,0,145,199,15,101,NA,NA,14,NA
"1037","2020-03-21",4,13,40,49,1803,0.841930116472546,0,0,145,199,21,122,4,38,10,4
"1038","2020-03-22",5,13,40,62,1803,0.841930116472546,0,0,145,199,20,142,8,46,12,8
"1039","2020-03-23",8,13,41,74,1803,0.841930116472546,0,0,145,199,21,163,4,50,13,4
"1040","2020-03-24",10,13,42,86,1803,0.841930116472546,0,0,145,199,17,180,3,53,9,3
"1041","2020-03-25",13,13,41,98,1803,0.841930116472546,0,0,145,199,27,207,7,60,20,7
"1042","2020-03-26",15,13,42,104,1803,0.841930116472546,0,0,145,199,22,229,6,66,13,6
"1043","2020-03-27",15,13,41,114,1803,0.841930116472546,0,0,145,199,25,254,5,71,10,5
"1044","2020-03-28",20,13,42,138,1803,0.841930116472546,0,0,145,199,25,279,5,76,21,5
"1045","2020-03-29",21,13,42,147,1803,0.841930116472546,0,0,145,199,15,294,4,80,12,4
"1046","2020-03-30",26,13,41,158,1803,0.841930116472546,0,0,145,199,24,318,5,85,18,5
"1047","2020-03-31",27,13,34,171,1803,0.841930116472546,0,0,145,199,21,339,7,92,18,7
"1048","2020-04-01",30,13,37,178,1803,0.841930116472546,0,0,145,199,33,372,8,100,26,8
"1049","2020-04-02",35,13,32,182,1803,0.841930116472546,0,0,145,199,26,398,8,108,18,8
"1050","2020-04-03",40,13,43,187,1803,0.841930116472546,0,0,145,199,26,424,8,116,21,8
"1051","2020-04-04",45,13,41,193,1803,0.841930116472546,0,0,145,199,27,451,5,121,18,5
"1052","2020-04-05",52,13,46,200,1803,0.841930116472546,0,0,145,199,21,472,14,135,16,14
"1053","2020-04-06",55,13,48,207,1803,0.841930116472546,0,0,145,199,29,501,7,142,22,7
"1054","2020-04-07",59,13,51,217,1803,0.841930116472546,0,0,145,199,25,526,2,144,19,2
"1055","2020-04-08",62,13,61,231,1803,0.841930116472546,0,0,145,199,34,560,5,149,26,5
"1056","2020-04-09",63,13,65,221,1803,0.841930116472546,0,0,145,199,28,588,2,151,23,2
"1057","2020-04-10",71,13,78,222,1803,0.841930116472546,0,0,145,199,27,615,4,155,22,4
"1058","2020-04-11",64,13,83,225,1803,0.841930116472546,0,0,145,199,35,650,7,162,29,7
"1059","2020-04-12",65,13,94,230,1803,0.841930116472546,0,0,145,199,32,682,10,172,21,10
"1060","2020-04-13",68,13,88,216,1803,0.841930116472546,0,0,145,199,21,703,7,179,13,7
"1061","2020-04-14",74,13,85,207,1803,0.841930116472546,0,0,145,199,28,731,12,191,21,12
"1062","2020-04-15",77,13,76,212,1803,0.841930116472546,0,0,145,199,30,761,15,206,22,15
"1063","2020-04-16",76,13,74,212,1803,0.841930116472546,0,0,145,199,39,800,8,214,25,8
"1064","2020-04-17",72,13,77,216,1803,0.841930116472546,0,0,145,199,18,818,7,221,13,7
"1065","2020-04-18",79,13,80,224,1803,0.841930116472546,0,0,145,199,33,851,11,232,23,11
"1066","2020-04-19",77,13,90,228,1803,0.841930116472546,0,0,145,199,34,885,10,242,26,10
"1067","2020-04-20",69,13,84,217,1803,0.841930116472546,0,0,145,199,34,919,7,249,25,7
"1068","2020-04-21",57,13,79,207,1803,0.841930116472546,0,0,145,199,30,949,4,253,26,4
"1069","2020-04-22",52,13,69,207,1803,0.841930116472546,0,0,145,199,26,975,6,259,15,6
"1070","2020-04-23",51,13,71,200,1803,0.841930116472546,0,0,145,199,33,1008,6,265,17,6
"1071","2020-04-24",45,13,70,189,1803,0.841930116472546,0,0,145,199,37,1045,8,273,30,8
"1072","2020-04-25",47,13,70,188,1803,0.841930116472546,0,0,145,199,43,1088,10,283,35,10
"1073","2020-04-26",49,13,77,199,1803,0.841930116472546,0,0,145,199,26,1114,6,289,17,6
"1074","2020-04-27",50,13,75,197,1803,0.841930116472546,0,0,145,199,33,1147,4,293,27,4
"1075","2020-04-28",59,13,72,201,1803,0.841930116472546,0,0,145,199,41,1188,8,301,33,8
"1076","2020-04-29",61,13,69,209,1803,0.841930116472546,0,0,145,199,28,1216,9,310,24,9
"1077","2020-04-30",59,13,71,217,1803,0.841930116472546,0,0,145,199,30,1246,7,317,21,7
"1078","2020-05-01",58,13,81,219,1803,0.841930116472546,0,0,145,199,28,1274,10,327,23,10
"1079","2020-05-02",53,13,90,221,1803,0.841930116472546,0,0,145,199,26,1300,7,334,21,7
"1080","2020-05-03",52,13,92,227,1803,0.841930116472546,0,0,145,199,22,1322,7,341,14,7
"1081","2020-05-04",55,13,99,230,1803,0.841930116472546,0,0,145,199,37,1359,16,357,29,16
"1082","2020-05-05",53,13,98,249,1803,0.841930116472546,0,0,145,199,25,1384,17,374,19,17
"1083","2020-05-06",52,13,93,258,1803,0.841930116472546,0,0,145,199,28,1412,5,379,19,5
"1084","2020-05-07",58,13,96,267,1803,0.841930116472546,0,0,145,199,28,1440,8,387,19,8
"1085","2020-05-08",66,13,104,281,1803,0.841930116472546,0,0,145,199,27,1467,6,393,21,6
"1086","2020-05-09",69,13,98,280,1803,0.841930116472546,0,0,145,199,27,1494,6,399,18,6
"1087","2020-05-10",69,13,91,287,1803,0.841930116472546,0,0,145,199,26,1520,10,409,22,10
"1088","2020-05-11",66,13,91,300,1803,0.841930116472546,0,0,145,199,27,1547,10,419,22,10
"1089","2020-05-12",74,13,99,299,1803,0.841930116472546,0,0,145,199,33,1580,12,431,21,12
"1090","2020-05-13",77,13,99,302,1803,0.841930116472546,0,0,145,199,33,1613,5,436,21,5
"1091","2020-05-14",83,13,104,302,1803,0.841930116472546,0,0,145,199,22,1635,6,442,16,6
"1092","2020-05-15",87,13,101,298,1803,0.841930116472546,0,0,145,199,29,1664,5,447,26,5
"1093","2020-05-16",89,13,98,306,1803,0.841930116472546,0,0,145,199,28,1692,7,454,20,7
"1094","2020-05-17",94,13,87,304,1803,0.841930116472546,0,0,145,199,23,1715,7,461,20,7
"1095","2020-05-18",104,13,78,302,1803,0.841930116472546,0,0,145,199,23,1738,9,470,17,9
"1096","2020-05-19",103,13,79,301,1803,0.841930116472546,0,0,145,199,21,1759,6,476,12,6
"1097","2020-05-20",111,13,81,302,1803,0.841930116472546,0,0,145,199,15,1774,6,482,8,6
"1098","2020-05-21",108,13,79,286,1803,0.841930116472546,0,0,145,199,29,1803,6,488,23,6
"1099","2020-05-22",99,13,79,286,1803,0.841930116472546,0,0,145,199,16,1819,3,491,11,3
"1100","2020-05-23",100,13,83,282,1803,0.841930116472546,0,0,145,199,20,1839,5,496,19,5
"1101","2020-05-24",97,13,83,271,1803,0.841930116472546,0,0,145,199,24,1863,3,499,19,3
"1102","2020-05-25",86,13,85,255,1803,0.841930116472546,0,0,145,199,20,1883,12,511,14,12
"1103","2020-05-26",82,13,93,260,1803,0.841930116472546,0,0,145,199,20,1903,10,521,14,10
"1104","2020-05-27",69,13,85,272,1803,0.841930116472546,0,0,145,199,12,1915,8,529,7,8
"1105","2020-05-28",68,13,86,269,1803,0.841930116472546,0,0,145,199,16,1931,9,538,11,9
"1106","2020-05-29",70,13,78,266,1803,0.841930116472546,0,0,145,199,18,1949,12,550,13,12
"1107","2020-05-30",64,13,79,258,1803,0.841930116472546,0,0,145,199,13,1962,13,563,7,13
"1108","2020-05-31",63,13,80,252,1803,0.841930116472546,0,0,145,199,16,1978,4,567,11,4
"1109","2020-06-01",65,13,75,247,1803,0.841930116472546,0,0,145,199,6,1984,4,571,5,4
"1110","2020-06-02",59,13,78,245,1803,0.841930116472546,0,0,145,199,11,1995,4,575,9,4
"1111","2020-06-03",64,13,71,252,1803,0.841930116472546,0,0,145,199,7,2002,7,582,6,7
"1112","2020-06-04",58,13,57,255,1803,0.841930116472546,0,0,145,199,15,2017,8,590,9,8
"1113","2020-06-05",63,13,53,262,1803,0.841930116472546,0,0,145,199,11,2028,3,593,11,3
"1114","2020-06-06",65,13,53,266,1803,0.841930116472546,0,0,145,199,9,2037,2,595,7,2
"1115","2020-06-07",66,13,50,280,1803,0.841930116472546,0,0,145,199,6,2043,3,598,5,3
"1116","2020-03-12",1,14,11,10,5047,0.94987121062017,0,0,458,298,3,10,4,4,3,4
"1117","2020-03-13",1,14,19,19,5047,0.94987121062017,0,0,458,298,3,13,1,5,NA,1
"1118","2020-03-14",3,14,20,24,5047,0.94987121062017,0,0,458,298,7,20,1,6,3,1
"1119","2020-03-15",4,14,23,33,5047,0.94987121062017,0,0,458,298,11,31,1,7,8,1
"1120","2020-03-16",4,14,21,39,5047,0.94987121062017,0,0,458,298,14,45,3,10,10,3
"1121","2020-03-17",5,14,14,51,5047,0.94987121062017,0,0,458,298,15,60,1,11,11,1
"1122","2020-03-18",5,14,17,60,5047,0.94987121062017,0,0,458,298,13,73,3,14,5,3
"1123","2020-03-19",4,14,21,70,5047,0.94987121062017,0,0,458,298,16,89,2,16,11,2
"1124","2020-03-20",6,14,27,81,5047,0.94987121062017,0,0,458,298,19,108,8,24,16,8
"1125","2020-03-21",8,14,31,89,5047,0.94987121062017,0,0,458,298,23,131,9,33,16,9
"1126","2020-03-22",11,14,33,100,5047,0.94987121062017,0,0,458,298,30,161,2,35,25,2
"1127","2020-03-23",19,14,36,106,5047,0.94987121062017,0,0,458,298,27,188,2,37,21,2
"1128","2020-03-24",22,14,42,120,5047,0.94987121062017,0,0,458,298,22,210,2,39,18,2
"1129","2020-03-25",23,14,44,135,5047,0.94987121062017,0,0,458,298,30,240,1,40,24,1
"1130","2020-03-26",28,14,43,142,5047,0.94987121062017,0,0,458,298,31,271,NA,NA,27,NA
"1131","2020-03-27",31,14,54,151,5047,0.94987121062017,0,0,458,298,27,298,2,42,24,2
"1132","2020-03-28",34,14,55,172,5047,0.94987121062017,0,0,458,298,59,357,1,43,55,1
"1133","2020-03-29",36,14,56,192,5047,0.94987121062017,0,0,458,298,49,406,11,54,47,11
"1134","2020-03-30",33,14,62,212,5047,0.94987121062017,0,0,458,298,43,449,4,58,41,4
"1135","2020-03-31",38,14,62,229,5047,0.94987121062017,0,0,458,298,63,512,3,61,58,3
"1136","2020-04-01",47,14,59,257,5047,0.94987121062017,0,0,458,298,73,585,1,62,66,1
"1137","2020-04-02",50,14,68,295,5047,0.94987121062017,0,0,458,298,73,658,8,70,68,8
"1138","2020-04-03",57,14,60,321,5047,0.94987121062017,0,0,458,298,89,747,3,73,82,3
"1139","2020-04-04",60,14,61,358,5047,0.94987121062017,0,0,458,298,109,856,4,77,102,4
"1140","2020-04-05",69,14,67,383,5047,0.94987121062017,0,0,458,298,102,958,2,79,96,2
"1141","2020-04-06",79,14,77,404,5047,0.94987121062017,0,0,458,298,113,1071,NA,NA,106,NA
"1142","2020-04-07",83,14,85,447,5047,0.94987121062017,0,0,458,298,90,1161,NA,NA,80,NA
"1143","2020-04-08",86,14,99,500,5047,0.94987121062017,0,0,458,298,122,1283,3,82,117,3
"1144","2020-04-09",98,14,78,555,5047,0.94987121062017,0,0,458,298,106,1389,4,86,100,4
"1145","2020-04-10",112,14,76,610,5047,0.94987121062017,0,0,458,298,101,1490,NA,NA,97,NA
"1146","2020-04-11",119,14,78,676,5047,0.94987121062017,0,0,458,298,116,1606,1,87,112,1
"1147","2020-04-12",138,14,89,732,5047,0.94987121062017,0,0,458,298,122,1728,NA,NA,120,NA
"1148","2020-04-13",149,14,94,782,5047,0.94987121062017,0,0,458,298,123,1851,NA,NA,119,NA
"1149","2020-04-14",162,14,89,848,5047,0.94987121062017,0,0,458,298,118,1969,11,98,115,11
"1150","2020-04-15",178,14,98,890,5047,0.94987121062017,0,0,458,298,124,2093,10,108,118,10
"1151","2020-04-16",192,14,96,934,5047,0.94987121062017,0,0,458,298,122,2215,9,117,120,9
"1152","2020-04-17",211,14,112,986,5047,0.94987121062017,0,0,458,298,122,2337,9,126,117,9
"1153","2020-04-18",232,14,102,1008,5047,0.94987121062017,0,0,458,298,122,2459,8,134,120,8
"1154","2020-04-19",236,14,102,1045,5047,0.94987121062017,0,0,458,298,151,2610,4,138,146,4
"1155","2020-04-20",255,14,102,1077,5047,0.94987121062017,0,0,458,298,137,2747,2,140,135,2
"1156","2020-04-21",278,14,89,1106,5047,0.94987121062017,0,0,458,298,106,2853,12,152,101,12
"1157","2020-04-22",300,14,83,1116,5047,0.94987121062017,0,0,458,298,116,2969,18,170,113,18
"1158","2020-04-23",309,14,86,1137,5047,0.94987121062017,0,0,458,298,141,3110,9,179,135,9
"1159","2020-04-24",314,14,85,1156,5047,0.94987121062017,0,0,458,298,150,3260,7,186,146,7
"1160","2020-04-25",335,14,85,1204,5047,0.94987121062017,0,0,458,298,153,3413,6,192,146,6
"1161","2020-04-26",338,14,91,1224,5047,0.94987121062017,0,0,458,298,140,3553,1,193,134,1
"1162","2020-04-27",342,14,81,1248,5047,0.94987121062017,0,0,458,298,141,3694,3,196,134,3
"1163","2020-04-28",347,14,85,1239,5047,0.94987121062017,0,0,458,298,137,3831,1,197,134,1
"1164","2020-04-29",345,14,94,1253,5047,0.94987121062017,0,0,458,298,93,3924,10,207,89,10
"1165","2020-04-30",352,14,104,1248,5047,0.94987121062017,0,0,458,298,122,4046,16,223,119,16
"1166","2020-05-01",344,14,104,1243,5047,0.94987121062017,0,0,458,298,151,4197,23,246,144,23
"1167","2020-05-02",334,14,85,1223,5047,0.94987121062017,0,0,458,298,110,4307,15,261,109,15
"1168","2020-05-03",328,14,92,1224,5047,0.94987121062017,0,0,458,298,144,4451,21,282,141,21
"1169","2020-05-04",330,14,84,1203,5047,0.94987121062017,0,0,458,298,129,4580,22,304,125,22
"1170","2020-05-05",328,14,83,1155,5047,0.94987121062017,0,0,458,298,110,4690,27,331,104,27
"1171","2020-05-06",319,14,86,1140,5047,0.94987121062017,0,0,458,298,111,4801,12,343,107,12
"1172","2020-05-07",322,14,80,1088,5047,0.94987121062017,0,0,458,298,122,4923,15,358,120,15
"1173","2020-05-08",318,14,91,1042,5047,0.94987121062017,0,0,458,298,76,4999,19,377,75,19
"1174","2020-05-09",308,14,85,1004,5047,0.94987121062017,0,0,458,298,121,5120,21,398,121,21
"1175","2020-05-10",301,14,76,997,5047,0.94987121062017,0,0,458,298,97,5217,8,406,93,8
"1176","2020-05-11",304,14,93,955,5047,0.94987121062017,0,0,458,298,96,5313,2,408,94,2
"1177","2020-05-12",293,14,93,912,5047,0.94987121062017,0,0,458,298,75,5388,2,410,73,2
"1178","2020-05-13",286,14,92,881,5047,0.94987121062017,0,0,458,298,74,5462,11,421,69,11
"1179","2020-05-14",272,14,80,831,5047,0.94987121062017,0,0,458,298,78,5540,11,432,75,11
"1180","2020-05-15",280,14,79,825,5047,0.94987121062017,0,0,458,298,62,5602,5,437,59,5
"1181","2020-05-16",265,14,77,783,5047,0.94987121062017,0,0,458,298,64,5666,23,460,62,23
"1182","2020-05-17",273,14,76,744,5047,0.94987121062017,0,0,458,298,43,5709,24,484,41,24
"1183","2020-05-18",241,14,71,703,5047,0.94987121062017,0,0,458,298,47,5756,11,495,46,11
"1184","2020-05-19",218,14,63,646,5047,0.94987121062017,0,0,458,298,31,5787,14,509,28,14
"1185","2020-05-20",206,14,51,616,5047,0.94987121062017,0,0,458,298,39,5826,20,529,38,20
"1186","2020-05-21",191,14,53,579,5047,0.94987121062017,0,0,458,298,34,5860,11,540,34,11
"1187","2020-05-22",171,14,57,548,5047,0.94987121062017,0,0,458,298,41,5901,9,549,40,9
"1188","2020-05-23",165,14,61,504,5047,0.94987121062017,0,0,458,298,33,5934,10,559,31,10
"1189","2020-05-24",155,14,63,482,5047,0.94987121062017,0,0,458,298,27,5961,1,560,26,1
"1190","2020-05-25",159,14,68,454,5047,0.94987121062017,0,0,458,298,36,5997,2,562,36,2
"1191","2020-05-26",160,14,74,431,5047,0.94987121062017,0,0,458,298,18,6015,9,571,17,9
"1192","2020-05-27",152,14,69,410,5047,0.94987121062017,0,0,458,298,23,6038,12,583,22,12
"1193","2020-05-28",143,14,60,388,5047,0.94987121062017,0,0,458,298,26,6064,8,591,25,8
"1194","2020-05-29",132,14,58,369,5047,0.94987121062017,0,0,458,298,13,6077,7,598,13,7
"1195","2020-05-30",133,14,73,349,5047,0.94987121062017,0,0,458,298,10,6087,2,600,10,2
"1196","2020-05-31",120,14,65,341,5047,0.94987121062017,0,0,458,298,8,6095,11,611,8,11
"1197","2020-06-01",107,14,59,319,5047,0.94987121062017,0,0,458,298,12,6107,9,620,12,9
"1198","2020-06-02",98,14,44,296,5047,0.94987121062017,0,0,458,298,3,6110,11,631,3,11
"1199","2020-06-03",94,14,47,286,5047,0.94987121062017,0,0,458,298,9,6119,13,644,7,13
"1200","2020-06-04",88,14,45,268,5047,0.94987121062017,0,0,458,298,5,6124,10,654,5,10
"1201","2020-06-05",87,14,43,252,5047,0.94987121062017,0,0,458,298,8,6132,12,666,7,12
"1202","2020-06-06",77,14,43,220,5047,0.94987121062017,0,0,458,298,5,6137,7,673,3,7
"1203","2020-06-07",70,14,45,203,5047,0.94987121062017,0,0,458,298,3,6140,11,684,2,11
"1204","2020-03-12",1,15,34,26,7364,0.92123845736013,0,0,622,306,14,24,4,8,NA,4
"1205","2020-03-13",3,15,35,44,7364,0.92123845736013,0,0,622,306,15,39,5,13,NA,5
"1206","2020-03-14",3,15,35,65,7364,0.92123845736013,0,0,622,306,15,54,3,16,4,3
"1207","2020-03-15",3,15,43,87,7364,0.92123845736013,0,0,622,306,15,69,4,20,5,4
"1208","2020-03-16",8,15,63,119,7364,0.92123845736013,0,0,622,306,18,87,4,24,6,4
"1209","2020-03-17",12,15,79,155,7364,0.92123845736013,0,0,622,306,18,105,2,26,8,2
"1210","2020-03-18",17,15,78,197,7364,0.92123845736013,0,0,622,306,18,123,2,28,6,2
"1211","2020-03-19",20,15,68,230,7364,0.92123845736013,0,0,622,306,16,139,1,29,11,1
"1212","2020-03-20",21,15,66,261,7364,0.92123845736013,0,0,622,306,24,163,3,32,11,3
"1213","2020-03-21",29,15,55,313,7364,0.92123845736013,0,0,622,306,24,187,4,36,10,4
"1214","2020-03-22",41,15,64,364,7364,0.92123845736013,0,0,622,306,22,209,2,38,6,2
"1215","2020-03-23",43,15,61,416,7364,0.92123845736013,0,0,622,306,27,236,2,40,14,2
"1216","2020-03-24",57,15,70,479,7364,0.92123845736013,0,0,622,306,24,260,3,43,13,3
"1217","2020-03-25",66,15,77,555,7364,0.92123845736013,0,0,622,306,21,281,9,52,6,9
"1218","2020-03-26",81,15,86,645,7364,0.92123845736013,0,0,622,306,23,304,4,56,13,4
"1219","2020-03-27",105,15,100,742,7364,0.92123845736013,0,0,622,306,23,327,3,59,13,3
"1220","2020-03-28",124,15,106,851,7364,0.92123845736013,0,0,622,306,29,356,7,66,11,7
"1221","2020-03-29",146,15,122,1013,7364,0.92123845736013,0,0,622,306,28,384,6,72,13,6
"1222","2020-03-30",181,15,110,1176,7364,0.92123845736013,0,0,622,306,20,404,6,78,9,6
"1223","2020-03-31",210,15,111,1294,7364,0.92123845736013,0,0,622,306,27,431,6,84,15,6
"1224","2020-04-01",244,15,103,1485,7364,0.92123845736013,0,0,622,306,34,465,5,89,12,5
"1225","2020-04-02",286,15,93,1674,7364,0.92123845736013,0,0,622,306,31,496,4,93,18,4
"1226","2020-04-03",308,15,85,1880,7364,0.92123845736013,0,0,622,306,28,524,6,99,17,6
"1227","2020-04-04",354,15,88,2071,7364,0.92123845736013,0,0,622,306,36,560,4,103,18,4
"1228","2020-04-05",400,15,70,2267,7364,0.92123845736013,0,0,622,306,24,584,4,107,16,4
"1229","2020-04-06",450,15,78,2440,7364,0.92123845736013,0,0,622,306,20,604,1,108,6,1
"1230","2020-04-07",487,15,81,2648,7364,0.92123845736013,0,0,622,306,41,645,3,111,25,3
"1231","2020-04-08",562,15,92,2789,7364,0.92123845736013,0,0,622,306,24,669,2,113,13,2
"1232","2020-04-09",611,15,105,2927,7364,0.92123845736013,0,0,622,306,27,696,3,116,17,3
"1233","2020-04-10",678,15,130,3136,7364,0.92123845736013,0,0,622,306,30,726,8,124,14,8
"1234","2020-04-11",715,15,121,3149,7364,0.92123845736013,0,0,622,306,32,758,3,127,21,3
"1235","2020-04-12",777,15,107,3136,7364,0.92123845736013,0,0,622,306,38,796,19,146,19,19
"1236","2020-04-13",817,15,97,3150,7364,0.92123845736013,0,0,622,306,33,829,5,151,21,5
"1237","2020-04-14",867,15,97,3058,7364,0.92123845736013,0,0,622,306,30,859,4,155,17,4
"1238","2020-04-15",865,15,91,2941,7364,0.92123845736013,0,0,622,306,33,892,7,162,17,7
"1239","2020-04-16",878,15,115,2841,7364,0.92123845736013,0,0,622,306,17,909,6,168,12,6
"1240","2020-04-17",885,15,141,2690,7364,0.92123845736013,0,0,622,306,39,948,9,177,20,9
"1241","2020-04-18",885,15,141,2524,7364,0.92123845736013,0,0,622,306,36,984,5,182,12,5
"1242","2020-04-19",839,15,143,2355,7364,0.92123845736013,0,0,622,306,23,1007,8,190,11,8
"1243","2020-04-20",824,15,136,2195,7364,0.92123845736013,0,0,622,306,35,1042,7,197,18,7
"1244","2020-04-21",779,15,148,1963,7364,0.92123845736013,0,0,622,306,27,1069,9,206,15,9
"1245","2020-04-22",754,15,141,1779,7364,0.92123845736013,0,0,622,306,26,1095,8,214,11,8
"1246","2020-04-23",690,15,116,1603,7364,0.92123845736013,0,0,622,306,33,1128,6,220,17,6
"1247","2020-04-24",627,15,105,1401,7364,0.92123845736013,0,0,622,306,31,1159,5,225,21,5
"1248","2020-04-25",586,15,107,1248,7364,0.92123845736013,0,0,622,306,35,1194,5,230,14,5
"1249","2020-04-26",544,15,116,1117,7364,0.92123845736013,0,0,622,306,34,1228,7,237,21,7
"1250","2020-04-27",471,15,112,990,7364,0.92123845736013,0,0,622,306,27,1255,9,246,11,9
"1251","2020-04-28",419,15,133,880,7364,0.92123845736013,0,0,622,306,33,1288,15,261,15,15
"1252","2020-04-29",360,15,136,770,7364,0.92123845736013,0,0,622,306,25,1313,8,269,14,8
"1253","2020-04-30",330,15,104,657,7364,0.92123845736013,0,0,622,306,37,1350,3,272,17,3
"1254","2020-05-01",292,15,95,573,7364,0.92123845736013,0,0,622,306,37,1387,7,279,15,7
"1255","2020-05-02",245,15,87,490,7364,0.92123845736013,0,0,622,306,29,1416,11,290,14,11
"1256","2020-05-03",213,15,110,428,7364,0.92123845736013,0,0,622,306,30,1446,17,307,12,17
"1257","2020-05-04",189,15,107,364,7364,0.92123845736013,0,0,622,306,25,1471,10,317,11,10
"1258","2020-05-05",171,15,112,311,7364,0.92123845736013,0,0,622,306,25,1496,8,325,16,8
"1259","2020-05-06",146,15,128,264,7364,0.92123845736013,0,0,622,306,24,1520,15,340,12,15
"1260","2020-05-07",121,15,128,236,7364,0.92123845736013,0,0,622,306,13,1533,2,342,7,2
"1261","2020-05-08",108,15,115,205,7364,0.92123845736013,0,0,622,306,43,1576,6,348,25,6
"1262","2020-05-09",93,15,107,195,7364,0.92123845736013,0,0,622,306,29,1605,6,354,15,6
"1263","2020-05-10",84,15,93,159,7364,0.92123845736013,0,0,622,306,37,1642,5,359,19,5
"1264","2020-05-11",71,15,83,135,7364,0.92123845736013,0,0,622,306,23,1665,9,368,11,9
"1265","2020-05-12",58,15,75,122,7364,0.92123845736013,0,0,622,306,27,1692,1,369,14,1
"1266","2020-05-13",51,15,64,111,7364,0.92123845736013,0,0,622,306,13,1705,12,381,4,12
"1267","2020-05-14",52,15,79,96,7364,0.92123845736013,0,0,622,306,22,1727,16,397,9,16
"1268","2020-05-15",46,15,78,81,7364,0.92123845736013,0,0,622,306,17,1744,10,407,8,10
"1269","2020-05-16",42,15,66,77,7364,0.92123845736013,0,0,622,306,25,1769,2,409,9,2
"1270","2020-05-17",32,15,61,72,7364,0.92123845736013,0,0,622,306,20,1789,5,414,8,5
"1271","2020-05-18",27,15,64,69,7364,0.92123845736013,0,0,622,306,15,1804,7,421,5,7
"1272","2020-05-19",25,15,57,60,7364,0.92123845736013,0,0,622,306,20,1824,11,432,4,11
"1273","2020-05-20",23,15,69,57,7364,0.92123845736013,0,0,622,306,14,1838,1,433,7,1
"1274","2020-05-21",19,15,74,50,7364,0.92123845736013,0,0,622,306,12,1850,3,436,6,3
"1275","2020-05-22",17,15,82,46,7364,0.92123845736013,0,0,622,306,11,1861,12,448,2,12
"1276","2020-05-23",15,15,84,41,7364,0.92123845736013,0,0,622,306,17,1878,9,457,7,9
"1277","2020-05-24",13,15,74,41,7364,0.92123845736013,0,0,622,306,15,1893,7,464,9,7
"1278","2020-05-25",16,15,60,40,7364,0.92123845736013,0,0,622,306,11,1904,6,470,6,6
"1279","2020-05-26",13,15,63,38,7364,0.92123845736013,0,0,622,306,20,1924,6,476,9,6
"1280","2020-05-27",13,15,67,38,7364,0.92123845736013,0,0,622,306,13,1937,5,481,9,5
"1281","2020-05-28",14,15,73,35,7364,0.92123845736013,0,0,622,306,10,1947,8,489,5,8
"1282","2020-05-29",14,15,87,35,7364,0.92123845736013,0,0,622,306,11,1958,1,490,3,1
"1283","2020-05-30",13,15,95,33,7364,0.92123845736013,0,0,622,306,14,1972,1,491,7,1
"1284","2020-05-31",12,15,83,32,7364,0.92123845736013,0,0,622,306,15,1987,3,494,10,3
"1285","2020-06-01",7,15,61,34,7364,0.92123845736013,0,0,622,306,14,2001,6,500,4,6
"1286","2020-06-02",7,15,50,32,7364,0.92123845736013,0,0,622,306,12,2013,8,508,6,8
"1287","2020-06-03",7,15,48,31,7364,0.92123845736013,0,0,622,306,14,2027,4,512,10,4
"1288","2020-06-04",6,15,54,33,7364,0.92123845736013,0,0,622,306,10,2037,1,513,7,1
"1289","2020-06-05",6,15,64,31,7364,0.92123845736013,0,0,622,306,14,2051,2,515,5,2
"1290","2020-06-06",7,15,73,35,7364,0.92123845736013,0,0,622,306,11,2062,1,516,7,1
"1291","2020-06-07",9,15,77,35,7364,0.92123845736013,0,0,622,306,11,2073,4,520,5,4
"1292","2020-03-14",1,16,15,23,2051,0.837152608483666,0,0,177,331,6,32,7,21,1,7
"1293","2020-03-15",1,16,20,31,2051,0.837152608483666,0,0,177,331,13,45,9,30,4,9
"1294","2020-03-16",5,16,18,36,2051,0.837152608483666,0,0,177,331,13,58,7,37,6,7
"1295","2020-03-17",6,16,26,41,2051,0.837152608483666,0,0,177,331,13,71,14,51,7,14
"1296","2020-03-18",9,16,32,53,2051,0.837152608483666,0,0,177,331,22,93,15,66,16,15
"1297","2020-03-19",11,16,35,64,2051,0.837152608483666,0,0,177,331,18,111,11,77,13,11
"1298","2020-03-20",14,16,45,70,2051,0.837152608483666,0,0,177,331,17,128,12,89,10,12
"1299","2020-03-21",16,16,46,77,2051,0.837152608483666,0,0,177,331,20,148,17,106,13,17
"1300","2020-03-22",20,16,45,84,2051,0.837152608483666,0,0,177,331,24,172,30,136,18,30
"1301","2020-03-23",18,16,59,96,2051,0.837152608483666,0,0,177,331,28,200,22,158,14,22
"1302","2020-03-24",20,16,62,106,2051,0.837152608483666,0,0,177,331,21,221,15,173,17,15
"1303","2020-03-25",24,16,69,114,2051,0.837152608483666,0,0,177,331,29,250,17,190,20,17
"1304","2020-03-26",26,16,63,127,2051,0.837152608483666,0,0,177,331,33,283,17,207,22,17
"1305","2020-03-27",25,16,63,132,2051,0.837152608483666,0,0,177,331,33,316,20,227,23,20
"1306","2020-03-28",30,16,56,138,2051,0.837152608483666,0,0,177,331,29,345,22,249,22,22
"1307","2020-03-29",33,16,43,149,2051,0.837152608483666,0,0,177,331,26,371,14,263,18,14
"1308","2020-03-30",35,16,50,162,2051,0.837152608483666,0,0,177,331,35,406,16,279,26,16
"1309","2020-03-31",37,16,44,174,2051,0.837152608483666,0,0,177,331,31,437,8,287,19,8
"1310","2020-04-01",41,16,44,201,2051,0.837152608483666,0,0,177,331,39,476,10,297,28,10
"1311","2020-04-02",45,16,40,227,2051,0.837152608483666,0,0,177,331,37,513,18,315,25,18
"1312","2020-04-03",50,16,39,232,2051,0.837152608483666,0,0,177,331,38,551,16,331,27,16
"1313","2020-04-04",52,16,48,242,2051,0.837152608483666,0,0,177,331,46,597,16,347,26,16
"1314","2020-04-05",49,16,51,246,2051,0.837152608483666,0,0,177,331,34,631,19,366,24,19
"1315","2020-04-06",54,16,52,274,2051,0.837152608483666,0,0,177,331,43,674,23,389,31,23
"1316","2020-04-07",65,16,58,286,2051,0.837152608483666,0,0,177,331,37,711,28,417,24,28
"1317","2020-04-08",61,16,64,306,2051,0.837152608483666,0,0,177,331,36,747,28,445,25,28
"1318","2020-04-09",59,16,59,328,2051,0.837152608483666,0,0,177,331,31,778,41,486,25,41
"1319","2020-04-10",61,16,58,346,2051,0.837152608483666,0,0,177,331,30,808,26,512,21,26
"1320","2020-04-11",67,16,49,366,2051,0.837152608483666,0,0,177,331,29,837,28,540,23,28
"1321","2020-04-12",81,16,57,401,2051,0.837152608483666,0,0,177,331,39,876,37,577,26,37
"1322","2020-04-13",95,16,53,420,2051,0.837152608483666,0,0,177,331,40,916,35,612,26,35
"1323","2020-04-14",96,16,58,436,2051,0.837152608483666,0,0,177,331,33,949,29,641,18,29
"1324","2020-04-15",106,16,65,472,2051,0.837152608483666,0,0,177,331,18,967,34,675,10,34
"1325","2020-04-16",116,16,63,485,2051,0.837152608483666,0,0,177,331,23,990,26,701,18,26
"1326","2020-04-17",129,16,86,509,2051,0.837152608483666,0,0,177,331,31,1021,34,735,19,34
"1327","2020-04-18",136,16,97,539,2051,0.837152608483666,0,0,177,331,26,1047,20,755,20,20
"1328","2020-04-19",152,16,101,547,2051,0.837152608483666,0,0,177,331,21,1068,18,773,16,18
"1329","2020-04-20",152,16,106,540,2051,0.837152608483666,0,0,177,331,30,1098,20,793,20,20
"1330","2020-04-21",159,16,110,533,2051,0.837152608483666,0,0,177,331,35,1133,32,825,24,32
"1331","2020-04-22",155,16,121,519,2051,0.837152608483666,0,0,177,331,29,1162,48,873,19,48
"1332","2020-04-23",168,16,118,503,2051,0.837152608483666,0,0,177,331,19,1181,34,907,11,34
"1333","2020-04-24",172,16,116,507,2051,0.837152608483666,0,0,177,331,25,1206,27,934,15,27
"1334","2020-04-25",172,16,129,491,2051,0.837152608483666,0,0,177,331,26,1232,22,956,14,22
"1335","2020-04-26",153,16,143,467,2051,0.837152608483666,0,0,177,331,22,1254,19,975,15,19
"1336","2020-04-27",151,16,145,452,2051,0.837152608483666,0,0,177,331,32,1286,21,996,18,21
"1337","2020-04-28",147,16,161,437,2051,0.837152608483666,0,0,177,331,30,1316,21,1017,21,21
"1338","2020-04-29",152,16,172,426,2051,0.837152608483666,0,0,177,331,26,1342,32,1049,16,32
"1339","2020-04-30",138,16,146,395,2051,0.837152608483666,0,0,177,331,29,1371,27,1076,23,27
"1340","2020-05-01",124,16,147,381,2051,0.837152608483666,0,0,177,331,18,1389,18,1094,8,18
"1341","2020-05-02",116,16,130,352,2051,0.837152608483666,0,0,177,331,31,1420,43,1137,17,43
"1342","2020-05-03",122,16,117,319,2051,0.837152608483666,0,0,177,331,24,1444,36,1173,16,36
"1343","2020-05-04",118,16,114,297,2051,0.837152608483666,0,0,177,331,18,1462,38,1211,7,38
"1344","2020-05-05",111,16,125,282,2051,0.837152608483666,0,0,177,331,26,1488,43,1254,17,43
"1345","2020-05-06",100,16,108,271,2051,0.837152608483666,0,0,177,331,18,1506,35,1289,9,35
"1346","2020-05-07",97,16,111,265,2051,0.837152608483666,0,0,177,331,23,1529,34,1323,14,34
"1347","2020-05-08",104,16,102,251,2051,0.837152608483666,0,0,177,331,23,1552,29,1352,15,29
"1348","2020-05-09",102,16,104,245,2051,0.837152608483666,0,0,177,331,21,1573,42,1394,10,42
"1349","2020-05-10",89,16,96,239,2051,0.837152608483666,0,0,177,331,19,1592,40,1434,5,40
"1350","2020-05-11",81,16,99,241,2051,0.837152608483666,0,0,177,331,17,1609,24,1458,11,24
"1351","2020-05-12",76,16,105,230,2051,0.837152608483666,0,0,177,331,25,1634,29,1487,12,29
"1352","2020-05-13",83,16,107,231,2051,0.837152608483666,0,0,177,331,17,1651,34,1521,9,34
"1353","2020-05-14",77,16,98,227,2051,0.837152608483666,0,0,177,331,23,1674,36,1557,14,36
"1354","2020-05-15",70,16,101,223,2051,0.837152608483666,0,0,177,331,16,1690,37,1594,10,37
"1355","2020-05-16",65,16,106,221,2051,0.837152608483666,0,0,177,331,18,1708,46,1640,8,46
"1356","2020-05-17",62,16,109,229,2051,0.837152608483666,0,0,177,331,18,1726,30,1670,10,30
"1357","2020-05-18",63,16,110,220,2051,0.837152608483666,0,0,177,331,17,1743,46,1716,7,46
"1358","2020-05-19",65,16,110,209,2051,0.837152608483666,0,0,177,331,21,1764,33,1749,12,33
"1359","2020-05-20",63,16,104,210,2051,0.837152608483666,0,0,177,331,20,1784,28,1777,13,28
"1360","2020-05-21",63,16,100,200,2051,0.837152608483666,0,0,177,331,9,1793,39,1816,6,39
"1361","2020-05-22",56,16,100,190,2051,0.837152608483666,0,0,177,331,13,1806,34,1850,7,34
"1362","2020-05-23",57,16,90,186,2051,0.837152608483666,0,0,177,331,21,1827,34,1884,12,34
"1363","2020-05-24",62,16,91,171,2051,0.837152608483666,0,0,177,331,23,1850,32,1916,15,32
"1364","2020-05-25",58,16,92,158,2051,0.837152608483666,0,0,177,331,16,1866,30,1946,12,30
"1365","2020-05-26",55,16,91,151,2051,0.837152608483666,0,0,177,331,17,1883,30,1976,10,30
"1366","2020-05-27",51,16,90,144,2051,0.837152608483666,0,0,177,331,11,1894,34,2010,10,34
"1367","2020-05-28",58,16,82,141,2051,0.837152608483666,0,0,177,331,14,1908,36,2046,8,36
"1368","2020-05-29",58,16,82,139,2051,0.837152608483666,0,0,177,331,11,1919,38,2084,7,38
"1369","2020-05-30",54,16,72,131,2051,0.837152608483666,0,0,177,331,13,1932,44,2128,11,44
"1370","2020-05-31",45,16,70,123,2051,0.837152608483666,0,0,177,331,19,1951,30,2158,12,30
"1371","2020-06-01",43,16,67,123,2051,0.837152608483666,0,0,177,331,13,1964,32,2190,10,32
"1372","2020-06-02",41,16,73,115,2051,0.837152608483666,0,0,177,331,6,1970,29,2219,5,29
"1373","2020-06-03",40,16,74,108,2051,0.837152608483666,0,0,177,331,12,1982,25,2244,9,25
"1374","2020-06-04",31,16,78,108,2051,0.837152608483666,0,0,177,331,12,1994,19,2263,10,19
"1375","2020-06-05",30,16,82,100,2051,0.837152608483666,0,0,177,331,6,2000,26,2289,5,26
"1376","2020-06-06",29,16,81,96,2051,0.837152608483666,0,0,177,331,9,2009,10,2299,4,10
"1377","2020-06-07",31,16,74,101,2051,0.837152608483666,0,0,177,331,16,2025,19,2318,10,19
"1378","2020-03-13",1,17,14,18,1856,0.633081896551724,0,0,149,236,3,8,5,12,2,5
"1379","2020-03-14",1,17,19,21,1856,0.633081896551724,0,0,149,236,4,12,4,16,2,4
"1380","2020-03-15",1,17,25,29,1856,0.633081896551724,0,0,149,236,9,21,6,22,6,6
"1381","2020-03-16",2,17,24,39,1856,0.633081896551724,0,0,149,236,10,31,3,25,9,3
"1382","2020-03-17",3,17,28,51,1856,0.633081896551724,0,0,149,236,9,40,10,35,7,10
"1383","2020-03-18",4,17,27,62,1856,0.633081896551724,0,0,149,236,16,56,9,44,14,9
"1384","2020-03-19",7,17,30,73,1856,0.633081896551724,0,0,149,236,13,69,10,54,12,10
"1385","2020-03-20",7,17,34,79,1856,0.633081896551724,0,0,149,236,14,83,5,59,14,5
"1386","2020-03-21",13,17,27,95,1856,0.633081896551724,0,0,149,236,27,110,5,64,25,5
"1387","2020-03-22",15,17,30,113,1856,0.633081896551724,0,0,149,236,17,127,3,67,16,3
"1388","2020-03-23",18,17,36,130,1856,0.633081896551724,0,0,149,236,25,152,5,72,22,5
"1389","2020-03-24",20,17,39,146,1856,0.633081896551724,0,0,149,236,31,183,10,82,30,10
"1390","2020-03-25",28,17,39,163,1856,0.633081896551724,0,0,149,236,26,209,5,87,25,5
"1391","2020-03-26",35,17,37,174,1856,0.633081896551724,0,0,149,236,34,243,7,94,34,7
"1392","2020-03-27",45,17,35,192,1856,0.633081896551724,0,0,149,236,36,279,5,99,34,5
"1393","2020-03-28",48,17,35,204,1856,0.633081896551724,0,0,149,236,46,325,8,107,44,8
"1394","2020-03-29",56,17,37,226,1856,0.633081896551724,0,0,149,236,55,380,8,115,54,8
"1395","2020-03-30",59,17,35,243,1856,0.633081896551724,0,0,149,236,47,427,5,120,45,5
"1396","2020-03-31",68,17,42,262,1856,0.633081896551724,0,0,149,236,59,486,4,124,58,4
"1397","2020-04-01",70,17,42,265,1856,0.633081896551724,0,0,149,236,77,563,3,127,75,3
"1398","2020-04-02",73,17,42,276,1856,0.633081896551724,0,0,149,236,91,654,9,136,90,9
"1399","2020-04-03",73,17,56,287,1856,0.633081896551724,0,0,149,236,78,732,5,141,77,5
"1400","2020-04-04",71,17,71,286,1856,0.633081896551724,0,0,149,236,95,827,3,144,94,3
"1401","2020-04-05",73,17,69,288,1856,0.633081896551724,0,0,149,236,112,939,4,148,111,4
"1402","2020-04-06",79,17,66,295,1856,0.633081896551724,0,0,149,236,112,1051,5,153,110,5
"1403","2020-04-07",79,17,73,285,1856,0.633081896551724,0,0,149,236,96,1147,2,155,93,2
"1404","2020-04-08",81,17,66,281,1856,0.633081896551724,0,0,149,236,149,1296,2,157,148,2
"1405","2020-04-09",78,17,54,265,1856,0.633081896551724,0,0,149,236,119,1415,2,159,116,2
"1406","2020-04-10",76,17,64,271,1856,0.633081896551724,0,0,149,236,142,1557,10,169,142,10
"1407","2020-04-11",78,17,65,266,1856,0.633081896551724,0,0,149,236,143,1700,11,180,143,11
"1408","2020-04-12",71,17,66,279,1856,0.633081896551724,0,0,149,236,136,1836,8,188,135,8
"1409","2020-04-13",77,17,69,287,1856,0.633081896551724,0,0,149,236,187,2023,12,200,187,12
"1410","2020-04-14",71,17,67,289,1856,0.633081896551724,0,0,149,236,190,2213,14,214,188,14
"1411","2020-04-15",67,17,67,300,1856,0.633081896551724,0,0,149,236,171,2384,16,230,169,16
"1412","2020-04-16",63,17,68,301,1856,0.633081896551724,0,0,149,236,190,2574,24,254,187,24
"1413","2020-04-17",66,17,63,307,1856,0.633081896551724,0,0,149,236,276,2850,14,268,273,14
"1414","2020-04-18",71,17,52,310,1856,0.633081896551724,0,0,149,236,211,3061,12,280,211,12
"1415","2020-04-19",74,17,50,305,1856,0.633081896551724,0,0,149,236,208,3269,17,297,207,17
"1416","2020-04-20",67,17,58,304,1856,0.633081896551724,0,0,149,236,230,3499,19,316,230,19
"1417","2020-04-21",76,17,77,305,1856,0.633081896551724,0,0,149,236,232,3731,14,330,228,14
"1418","2020-04-22",82,17,88,316,1856,0.633081896551724,0,0,149,236,304,4035,18,348,304,18
"1419","2020-04-23",93,17,81,331,1856,0.633081896551724,0,0,149,236,294,4329,7,355,294,7
"1420","2020-04-24",90,17,77,330,1856,0.633081896551724,0,0,149,236,252,4581,8,363,251,8
"1421","2020-04-25",97,17,69,318,1856,0.633081896551724,0,0,149,236,248,4829,4,367,247,4
"1422","2020-04-26",105,17,81,323,1856,0.633081896551724,0,0,149,236,206,5035,10,377,206,10
"1423","2020-04-27",105,17,83,319,1856,0.633081896551724,0,0,149,236,213,5248,14,391,212,14
"1424","2020-04-28",100,17,84,326,1856,0.633081896551724,0,0,149,236,174,5422,12,403,172,12
"1425","2020-04-29",99,17,77,324,1856,0.633081896551724,0,0,149,236,160,5582,6,409,158,6
"1426","2020-04-30",98,17,72,325,1856,0.633081896551724,0,0,149,236,176,5758,3,412,176,3
"1427","2020-05-01",105,17,80,313,1856,0.633081896551724,0,0,149,236,128,5886,2,414,127,2
"1428","2020-05-02",98,17,67,307,1856,0.633081896551724,0,0,149,236,127,6013,12,426,127,12
"1429","2020-05-03",93,17,80,303,1856,0.633081896551724,0,0,149,236,99,6112,7,433,99,7
"1430","2020-05-04",91,17,82,296,1856,0.633081896551724,0,0,149,236,88,6200,7,440,88,7
"1431","2020-05-05",89,17,76,286,1856,0.633081896551724,0,0,149,236,56,6256,10,450,56,10
"1432","2020-05-06",92,17,78,277,1856,0.633081896551724,0,0,149,236,65,6321,6,456,64,6
"1433","2020-05-07",88,17,68,272,1856,0.633081896551724,0,0,149,236,57,6378,8,464,57,8
"1434","2020-05-08",92,17,72,259,1856,0.633081896551724,0,0,149,236,36,6414,1,465,36,1
"1435","2020-05-09",91,17,91,257,1856,0.633081896551724,0,0,149,236,37,6451,10,475,37,10
"1436","2020-05-10",93,17,100,261,1856,0.633081896551724,0,0,149,236,34,6485,5,480,34,5
"1437","2020-05-11",90,17,99,256,1856,0.633081896551724,0,0,149,236,26,6511,6,486,25,6
"1438","2020-05-12",96,17,98,247,1856,0.633081896551724,0,0,149,236,15,6526,4,490,15,4
"1439","2020-05-13",90,17,107,233,1856,0.633081896551724,0,0,149,236,20,6546,6,496,20,6
"1440","2020-05-14",88,17,95,227,1856,0.633081896551724,0,0,149,236,13,6559,5,501,12,5
"1441","2020-05-15",78,17,93,226,1856,0.633081896551724,0,0,149,236,12,6571,6,507,11,6
"1442","2020-05-16",75,17,92,217,1856,0.633081896551724,0,0,149,236,11,6582,10,517,11,10
"1443","2020-05-17",69,17,97,214,1856,0.633081896551724,0,0,149,236,6,6588,7,524,6,7
"1444","2020-05-18",68,17,93,205,1856,0.633081896551724,0,0,149,236,5,6593,5,529,5,5
"1445","2020-05-19",61,17,76,201,1856,0.633081896551724,0,0,149,236,6,6599,11,540,6,11
"1446","2020-05-20",64,17,82,198,1856,0.633081896551724,0,0,149,236,3,6602,9,549,3,9
"1447","2020-05-21",60,17,94,185,1856,0.633081896551724,0,0,149,236,5,6607,14,563,5,14
"1448","2020-05-22",55,17,91,185,1856,0.633081896551724,0,0,149,236,3,6610,11,574,3,11
"1449","2020-05-23",49,17,86,173,1856,0.633081896551724,0,0,149,236,3,6613,16,590,3,16
"1450","2020-05-24",47,17,86,170,1856,0.633081896551724,0,0,149,236,2,6615,8,598,1,8
"1451","2020-05-25",48,17,81,165,1856,0.633081896551724,0,0,149,236,2,6617,8,606,2,8
"1452","2020-05-26",46,17,81,158,1856,0.633081896551724,0,0,149,236,5,6622,10,616,5,10
"1453","2020-05-27",39,17,80,154,1856,0.633081896551724,0,0,149,236,NA,NA,9,625,NA,9
"1454","2020-05-28",38,17,67,148,1856,0.633081896551724,0,0,149,236,2,6624,8,633,2,8
"1455","2020-05-29",46,17,75,156,1856,0.633081896551724,0,0,149,236,NA,NA,5,638,NA,5
"1456","2020-05-30",46,17,58,148,1856,0.633081896551724,0,0,149,236,3,6627,NA,NA,3,NA
"1457","2020-05-31",47,17,57,143,1856,0.633081896551724,0,0,149,236,1,6628,2,640,1,2
"1458","2020-06-01",42,17,58,139,1856,0.633081896551724,0,0,149,236,3,6631,2,642,2,2
"1459","2020-06-02",45,17,57,130,1856,0.633081896551724,0,0,149,236,1,6632,5,647,1,5
"1460","2020-06-03",45,17,48,137,1856,0.633081896551724,0,0,149,236,NA,NA,NA,NA,NA,NA
"1461","2020-06-04",45,17,39,141,1856,0.633081896551724,0,0,149,236,NA,NA,3,650,NA,3
"1462","2020-06-05",37,17,45,135,1856,0.633081896551724,0,0,149,236,1,6633,1,651,1,1
"1463","2020-06-06",38,17,49,137,1856,0.633081896551724,0,0,149,236,NA,NA,2,653,NA,2
"1464","2020-06-07",41,17,41,137,1856,0.633081896551724,0,0,149,236,1,6634,1,654,NA,1
"1465","2020-03-14",1,18,21,17,2416,0.868791390728477,0,0,186,343,3,8,3,22,2,3
"1466","2020-03-15",3,18,26,25,2416,0.868791390728477,0,0,186,343,2,10,9,31,1,9
"1467","2020-03-16",4,18,26,29,2416,0.868791390728477,0,0,186,343,3,13,1,32,2,1
"1468","2020-03-17",4,18,26,38,2416,0.868791390728477,0,0,186,343,5,18,14,46,1,14
"1469","2020-03-18",7,18,33,45,2416,0.868791390728477,0,0,186,343,3,21,9,55,2,9
"1470","2020-03-19",12,18,30,56,2416,0.868791390728477,0,0,186,343,3,24,9,64,1,9
"1471","2020-03-20",13,18,37,71,2416,0.868791390728477,0,0,186,343,4,28,8,72,3,8
"1472","2020-03-21",13,18,41,82,2416,0.868791390728477,0,0,186,343,4,32,5,77,2,5
"1473","2020-03-22",14,18,46,97,2416,0.868791390728477,0,0,186,343,5,37,5,82,5,5
"1474","2020-03-23",14,18,42,105,2416,0.868791390728477,0,0,186,343,7,44,3,85,4,3
"1475","2020-03-24",19,18,38,125,2416,0.868791390728477,0,0,186,343,3,47,3,88,3,3
"1476","2020-03-25",21,18,49,139,2416,0.868791390728477,0,0,186,343,6,53,2,90,5,2
"1477","2020-03-26",18,18,57,155,2416,0.868791390728477,0,0,186,343,9,62,1,91,6,1
"1478","2020-03-27",25,18,60,162,2416,0.868791390728477,0,0,186,343,10,72,2,93,8,2
"1479","2020-03-28",30,18,57,178,2416,0.868791390728477,0,0,186,343,7,79,2,95,5,2
"1480","2020-03-29",38,18,50,186,2416,0.868791390728477,0,0,186,343,8,87,1,96,5,1
"1481","2020-03-30",42,18,63,208,2416,0.868791390728477,0,0,186,343,9,96,NA,NA,6,NA
"1482","2020-03-31",44,18,55,220,2416,0.868791390728477,0,0,186,343,8,104,2,98,6,2
"1483","2020-04-01",50,18,65,229,2416,0.868791390728477,0,0,186,343,11,115,7,105,11,7
"1484","2020-04-02",53,18,60,234,2416,0.868791390728477,0,0,186,343,7,122,12,117,6,12
"1485","2020-04-03",56,18,65,252,2416,0.868791390728477,0,0,186,343,10,132,4,121,7,4
"1486","2020-04-04",59,18,71,258,2416,0.868791390728477,0,0,186,343,11,143,4,125,10,4
"1487","2020-04-05",57,18,72,270,2416,0.868791390728477,0,0,186,343,14,157,3,128,14,3
"1488","2020-04-06",61,18,68,282,2416,0.868791390728477,0,0,186,343,20,177,3,131,16,3
"1489","2020-04-07",60,18,77,293,2416,0.868791390728477,0,0,186,343,11,188,14,145,9,14
"1490","2020-04-08",66,18,76,291,2416,0.868791390728477,0,0,186,343,21,209,7,152,16,7
"1491","2020-04-09",70,18,74,314,2416,0.868791390728477,0,0,186,343,21,230,6,158,20,6
"1492","2020-04-10",74,18,78,324,2416,0.868791390728477,0,0,186,343,20,250,11,169,16,11
"1493","2020-04-11",78,18,78,335,2416,0.868791390728477,0,0,186,343,15,265,9,178,11,9
"1494","2020-04-12",82,18,69,324,2416,0.868791390728477,0,0,186,343,27,292,9,187,20,9
"1495","2020-04-13",89,18,62,346,2416,0.868791390728477,0,0,186,343,30,322,4,191,26,4
"1496","2020-04-14",98,18,49,347,2416,0.868791390728477,0,0,186,343,34,356,6,197,27,6
"1497","2020-04-15",96,18,48,360,2416,0.868791390728477,0,0,186,343,19,375,6,203,18,6
"1498","2020-04-16",98,18,46,367,2416,0.868791390728477,0,0,186,343,27,402,12,215,25,12
"1499","2020-04-17",99,18,42,368,2416,0.868791390728477,0,0,186,343,22,424,17,232,21,17
"1500","2020-04-18",97,18,33,379,2416,0.868791390728477,0,0,186,343,28,452,11,243,26,11
"1501","2020-04-19",100,18,56,383,2416,0.868791390728477,0,0,186,343,36,488,12,255,33,12
"1502","2020-04-20",107,18,81,393,2416,0.868791390728477,0,0,186,343,37,525,22,277,34,22
"1503","2020-04-21",105,18,76,394,2416,0.868791390728477,0,0,186,343,31,556,26,303,29,26
"1504","2020-04-22",104,18,86,400,2416,0.868791390728477,0,0,186,343,26,582,23,326,24,23
"1505","2020-04-23",106,18,79,411,2416,0.868791390728477,0,0,186,343,26,608,8,334,25,8
"1506","2020-04-24",106,18,64,416,2416,0.868791390728477,0,0,186,343,26,634,10,344,23,10
"1507","2020-04-25",112,18,75,419,2416,0.868791390728477,0,0,186,343,40,674,7,351,38,7
"1508","2020-04-26",110,18,69,429,2416,0.868791390728477,0,0,186,343,30,704,6,357,28,6
"1509","2020-04-27",101,18,74,428,2416,0.868791390728477,0,0,186,343,27,731,6,363,26,6
"1510","2020-04-28",105,18,73,426,2416,0.868791390728477,0,0,186,343,35,766,10,373,32,10
"1511","2020-04-29",119,18,82,452,2416,0.868791390728477,0,0,186,343,40,806,12,385,38,12
"1512","2020-04-30",126,18,87,456,2416,0.868791390728477,0,0,186,343,25,831,12,397,24,12
"1513","2020-05-01",118,18,97,467,2416,0.868791390728477,0,0,186,343,35,866,9,406,31,9
"1514","2020-05-02",118,18,83,468,2416,0.868791390728477,0,0,186,343,25,891,7,413,20,7
"1515","2020-05-03",119,18,86,469,2416,0.868791390728477,0,0,186,343,38,929,14,427,36,14
"1516","2020-05-04",126,18,83,470,2416,0.868791390728477,0,0,186,343,32,961,6,433,32,6
"1517","2020-05-05",123,18,87,468,2416,0.868791390728477,0,0,186,343,39,1000,7,440,38,7
"1518","2020-05-06",117,18,94,453,2416,0.868791390728477,0,0,186,343,35,1035,11,451,29,11
"1519","2020-05-07",114,18,87,443,2416,0.868791390728477,0,0,186,343,41,1076,14,465,37,14
"1520","2020-05-08",125,18,80,438,2416,0.868791390728477,0,0,186,343,33,1109,15,480,30,15
"1521","2020-05-09",128,18,76,440,2416,0.868791390728477,0,0,186,343,40,1149,8,488,34,8
"1522","2020-05-10",136,18,66,435,2416,0.868791390728477,0,0,186,343,32,1181,17,505,29,17
"1523","2020-05-11",127,18,69,421,2416,0.868791390728477,0,0,186,343,39,1220,9,514,36,9
"1524","2020-05-12",128,18,76,414,2416,0.868791390728477,0,0,186,343,39,1259,2,516,33,2
"1525","2020-05-13",116,18,79,409,2416,0.868791390728477,0,0,186,343,32,1291,2,518,31,2
"1526","2020-05-14",117,18,88,389,2416,0.868791390728477,0,0,186,343,28,1319,6,524,27,6
"1527","2020-05-15",123,18,87,382,2416,0.868791390728477,0,0,186,343,39,1358,10,534,38,10
"1528","2020-05-16",125,18,93,375,2416,0.868791390728477,0,0,186,343,22,1380,11,545,22,11
"1529","2020-05-17",119,18,97,359,2416,0.868791390728477,0,0,186,343,47,1427,13,558,47,13
"1530","2020-05-18",120,18,93,338,2416,0.868791390728477,0,0,186,343,32,1459,16,574,32,16
"1531","2020-05-19",122,18,95,338,2416,0.868791390728477,0,0,186,343,36,1495,9,583,35,9
"1532","2020-05-20",126,18,105,333,2416,0.868791390728477,0,0,186,343,37,1532,12,595,36,12
"1533","2020-05-21",112,18,108,324,2416,0.868791390728477,0,0,186,343,26,1558,11,606,25,11
"1534","2020-05-22",97,18,102,311,2416,0.868791390728477,0,0,186,343,27,1585,12,618,25,12
"1535","2020-05-23",82,18,103,290,2416,0.868791390728477,0,0,186,343,27,1612,11,629,25,11
"1536","2020-05-24",78,18,108,276,2416,0.868791390728477,0,0,186,343,22,1634,4,633,20,4
"1537","2020-05-25",81,18,95,274,2416,0.868791390728477,0,0,186,343,27,1661,7,640,26,7
"1538","2020-05-26",76,18,91,260,2416,0.868791390728477,0,0,186,343,28,1689,6,646,28,6
"1539","2020-05-27",75,18,83,254,2416,0.868791390728477,0,0,186,343,25,1714,7,653,24,7
"1540","2020-05-28",83,18,76,237,2416,0.868791390728477,0,0,186,343,29,1743,5,658,26,5
"1541","2020-05-29",82,18,71,235,2416,0.868791390728477,0,0,186,343,27,1770,14,672,24,14
"1542","2020-05-30",86,18,64,225,2416,0.868791390728477,0,0,186,343,25,1795,12,684,20,12
"1543","2020-05-31",86,18,63,206,2416,0.868791390728477,0,0,186,343,16,1811,15,699,13,15
"1544","2020-06-01",78,18,59,197,2416,0.868791390728477,0,0,186,343,27,1838,16,715,27,16
"1545","2020-06-02",73,18,57,194,2416,0.868791390728477,0,0,186,343,9,1847,20,735,9,20
"1546","2020-06-03",74,18,46,185,2416,0.868791390728477,0,0,186,343,26,1873,17,752,26,17
"1547","2020-06-04",65,18,44,179,2416,0.868791390728477,0,0,186,343,16,1889,8,760,14,8
"1548","2020-06-05",60,18,43,169,2416,0.868791390728477,0,0,186,343,17,1906,10,770,16,10
"1549","2020-06-06",58,18,39,168,2416,0.868791390728477,0,0,186,343,11,1917,26,796,11,26
"1550","2020-06-07",49,18,28,158,2416,0.868791390728477,0,0,186,343,17,1934,9,805,14,9
"1551","2020-03-11",1,19,1,8,1477,0.536222071767095,0,0,144,176,12,12,2,3,NA,2
"1552","2020-03-12",1,19,11,13,1477,0.536222071767095,0,0,144,176,9,21,12,15,NA,12
"1553","2020-03-13",1,19,17,18,1477,0.536222071767095,0,0,144,176,9,30,5,20,2,5
"1554","2020-03-14",2,19,22,24,1477,0.536222071767095,0,0,144,176,7,37,2,22,5,2
"1555","2020-03-15",3,19,20,38,1477,0.536222071767095,0,0,144,176,12,49,11,33,4,11
"1556","2020-03-16",5,19,19,43,1477,0.536222071767095,0,0,144,176,12,61,12,45,7,12
"1557","2020-03-17",8,19,19,45,1477,0.536222071767095,0,0,144,176,10,71,7,52,4,7
"1558","2020-03-18",8,19,18,55,1477,0.536222071767095,0,0,144,176,19,90,6,58,9,6
"1559","2020-03-19",9,19,19,64,1477,0.536222071767095,0,0,144,176,18,108,NA,NA,11,NA
"1560","2020-03-20",11,19,17,76,1477,0.536222071767095,0,0,144,176,15,123,2,60,12,2
"1561","2020-03-21",11,19,21,81,1477,0.536222071767095,0,0,144,176,16,139,1,61,7,1
"1562","2020-03-22",13,19,21,91,1477,0.536222071767095,0,0,144,176,29,168,2,63,23,2
"1563","2020-03-23",14,19,20,96,1477,0.536222071767095,0,0,144,176,25,193,1,64,16,1
"1564","2020-03-24",19,19,26,105,1477,0.536222071767095,0,0,144,176,34,227,5,69,21,5
"1565","2020-03-25",19,19,23,111,1477,0.536222071767095,0,0,144,176,27,254,2,71,17,2
"1566","2020-03-26",22,19,21,119,1477,0.536222071767095,0,0,144,176,32,286,NA,NA,24,NA
"1567","2020-03-27",28,19,20,131,1477,0.536222071767095,0,0,144,176,45,331,7,78,38,7
"1568","2020-03-28",32,19,14,128,1477,0.536222071767095,0,0,144,176,31,362,1,79,22,1
"1569","2020-03-29",33,19,18,135,1477,0.536222071767095,0,0,144,176,40,402,11,90,36,11
"1570","2020-03-30",32,19,25,146,1477,0.536222071767095,0,0,144,176,46,448,6,96,36,6
"1571","2020-03-31",27,19,19,147,1477,0.536222071767095,0,0,144,176,50,498,NA,NA,42,NA
"1572","2020-04-01",27,19,18,157,1477,0.536222071767095,0,0,144,176,51,549,1,97,41,1
"1573","2020-04-02",32,19,22,163,1477,0.536222071767095,0,0,144,176,55,604,NA,NA,50,NA
"1574","2020-04-03",30,19,30,183,1477,0.536222071767095,0,0,144,176,47,651,15,112,41,15
"1575","2020-04-04",35,19,28,189,1477,0.536222071767095,0,0,144,176,51,702,17,129,43,17
"1576","2020-04-05",42,19,28,191,1477,0.536222071767095,0,0,144,176,58,760,21,150,49,21
"1577","2020-04-06",49,19,33,196,1477,0.536222071767095,0,0,144,176,64,824,16,166,56,16
"1578","2020-04-07",54,19,30,206,1477,0.536222071767095,0,0,144,176,54,878,8,174,47,8
"1579","2020-04-08",60,19,29,218,1477,0.536222071767095,0,0,144,176,70,948,4,178,64,4
"1580","2020-04-09",58,19,37,214,1477,0.536222071767095,0,0,144,176,55,1003,12,190,47,12
"1581","2020-04-10",59,19,43,221,1477,0.536222071767095,0,0,144,176,67,1070,11,201,61,11
"1582","2020-04-11",55,19,41,221,1477,0.536222071767095,0,0,144,176,46,1116,6,207,36,6
"1583","2020-04-12",55,19,50,229,1477,0.536222071767095,0,0,144,176,31,1147,11,218,26,11
"1584","2020-04-13",57,19,53,213,1477,0.536222071767095,0,0,144,176,51,1198,22,240,42,22
"1585","2020-04-14",58,19,63,222,1477,0.536222071767095,0,0,144,176,73,1271,12,252,61,12
"1586","2020-04-15",62,19,61,231,1477,0.536222071767095,0,0,144,176,29,1300,16,268,26,16
"1587","2020-04-16",63,19,68,238,1477,0.536222071767095,0,0,144,176,46,1346,11,279,37,11
"1588","2020-04-17",67,19,64,235,1477,0.536222071767095,0,0,144,176,39,1385,9,288,35,9
"1589","2020-04-18",67,19,55,234,1477,0.536222071767095,0,0,144,176,57,1442,10,298,47,10
"1590","2020-04-19",66,19,53,237,1477,0.536222071767095,0,0,144,176,61,1503,8,306,49,8
"1591","2020-04-20",62,19,48,239,1477,0.536222071767095,0,0,144,176,45,1548,12,318,38,12
"1592","2020-04-21",62,19,38,240,1477,0.536222071767095,0,0,144,176,44,1592,6,324,31,6
"1593","2020-04-22",67,19,33,243,1477,0.536222071767095,0,0,144,176,68,1660,10,334,56,10
"1594","2020-04-23",65,19,27,242,1477,0.536222071767095,0,0,144,176,45,1705,10,344,36,10
"1595","2020-04-24",59,19,31,251,1477,0.536222071767095,0,0,144,176,55,1760,7,351,46,7
"1596","2020-04-25",65,19,34,246,1477,0.536222071767095,0,0,144,176,47,1807,7,358,37,7
"1597","2020-04-26",67,19,26,262,1477,0.536222071767095,0,0,144,176,52,1859,6,364,46,6
"1598","2020-04-27",72,19,26,258,1477,0.536222071767095,0,0,144,176,54,1913,14,378,44,14
"1599","2020-04-28",68,19,30,255,1477,0.536222071767095,0,0,144,176,41,1954,4,382,36,4
"1600","2020-04-29",62,19,34,252,1477,0.536222071767095,0,0,144,176,48,2002,20,402,40,20
"1601","2020-04-30",62,19,39,270,1477,0.536222071767095,0,0,144,176,33,2035,19,421,27,19
"1602","2020-05-01",68,19,48,287,1477,0.536222071767095,0,0,144,176,46,2081,20,441,36,20
"1603","2020-05-02",73,19,46,286,1477,0.536222071767095,0,0,144,176,28,2109,15,456,22,15
"1604","2020-05-03",68,19,43,279,1477,0.536222071767095,0,0,144,176,27,2136,17,473,21,17
"1605","2020-05-04",67,19,40,273,1477,0.536222071767095,0,0,144,176,33,2169,16,489,26,16
"1606","2020-05-05",76,19,39,264,1477,0.536222071767095,0,0,144,176,31,2200,29,518,26,29
"1607","2020-05-06",83,19,40,251,1477,0.536222071767095,0,0,144,176,29,2229,13,531,19,13
"1608","2020-05-07",83,19,37,257,1477,0.536222071767095,0,0,144,176,27,2256,10,541,24,10
"1609","2020-05-08",87,19,49,253,1477,0.536222071767095,0,0,144,176,28,2284,14,555,23,14
"1610","2020-05-09",83,19,64,249,1477,0.536222071767095,0,0,144,176,25,2309,4,559,21,4
"1611","2020-05-10",87,19,62,235,1477,0.536222071767095,0,0,144,176,12,2321,8,567,8,8
"1612","2020-05-11",88,19,71,230,1477,0.536222071767095,0,0,144,176,32,2353,11,578,19,11
"1613","2020-05-12",79,19,69,224,1477,0.536222071767095,0,0,144,176,18,2371,4,582,11,4
"1614","2020-05-13",69,19,59,217,1477,0.536222071767095,0,0,144,176,26,2397,NA,NA,22,NA
"1615","2020-05-14",73,19,56,208,1477,0.536222071767095,0,0,144,176,22,2419,13,595,16,13
"1616","2020-05-15",70,19,64,204,1477,0.536222071767095,0,0,144,176,26,2445,8,603,18,8
"1617","2020-05-16",65,19,68,193,1477,0.536222071767095,0,0,144,176,23,2468,20,623,18,20
"1618","2020-05-17",59,19,71,195,1477,0.536222071767095,0,0,144,176,25,2493,7,630,18,7
"1619","2020-05-18",56,19,62,188,1477,0.536222071767095,0,0,144,176,27,2520,5,635,21,5
"1620","2020-05-19",55,19,66,176,1477,0.536222071767095,0,0,144,176,21,2541,21,656,16,21
"1621","2020-05-20",51,19,60,171,1477,0.536222071767095,0,0,144,176,21,2562,11,667,19,11
"1622","2020-05-21",43,19,69,159,1477,0.536222071767095,0,0,144,176,20,2582,13,680,13,13
"1623","2020-05-22",38,19,66,149,1477,0.536222071767095,0,0,144,176,18,2600,10,690,12,10
"1624","2020-05-23",34,19,70,143,1477,0.536222071767095,0,0,144,176,16,2616,12,702,11,12
"1625","2020-05-24",38,19,62,145,1477,0.536222071767095,0,0,144,176,18,2634,18,720,13,18
"1626","2020-05-25",38,19,49,143,1477,0.536222071767095,0,0,144,176,19,2653,12,732,13,12
"1627","2020-05-26",37,19,50,144,1477,0.536222071767095,0,0,144,176,17,2670,20,752,12,20
"1628","2020-05-27",41,19,47,141,1477,0.536222071767095,0,0,144,176,19,2689,13,765,14,13
"1629","2020-05-28",44,19,42,137,1477,0.536222071767095,0,0,144,176,13,2702,12,777,10,12
"1630","2020-05-29",42,19,44,135,1477,0.536222071767095,0,0,144,176,21,2723,10,787,16,10
"1631","2020-05-30",39,19,35,126,1477,0.536222071767095,0,0,144,176,10,2733,9,796,9,9
"1632","2020-05-31",34,19,34,112,1477,0.536222071767095,0,0,144,176,13,2746,11,807,10,11
"1633","2020-06-01",32,19,35,108,1477,0.536222071767095,0,0,144,176,11,2757,11,818,9,11
"1634","2020-06-02",32,19,33,98,1477,0.536222071767095,0,0,144,176,14,2771,9,827,11,9
"1635","2020-06-03",29,19,36,91,1477,0.536222071767095,0,0,144,176,10,2781,11,838,7,11
"1636","2020-06-04",27,19,34,95,1477,0.536222071767095,0,0,144,176,6,2787,5,843,4,5
"1637","2020-06-05",24,19,31,96,1477,0.536222071767095,0,0,144,176,8,2795,7,850,6,7
"1638","2020-06-06",26,19,31,96,1477,0.536222071767095,0,0,144,176,6,2801,9,859,3,9
"1639","2020-06-07",29,19,33,94,1477,0.536222071767095,0,0,144,176,17,2818,8,867,14,8
"1640","2020-03-13",1,20,30,9,4006,0.967049425861208,0,0,406,290,4,8,1,5,1,1
"1641","2020-03-14",2,20,32,14,4006,0.967049425861208,0,0,406,290,1,9,5,10,NA,5
"1642","2020-03-15",2,20,40,21,4006,0.967049425861208,0,0,406,290,2,11,5,15,1,5
"1643","2020-03-16",2,20,38,23,4006,0.967049425861208,0,0,406,290,1,12,6,21,NA,6
"1644","2020-03-17",2,20,39,26,4006,0.967049425861208,0,0,406,290,6,18,8,29,3,8
"1645","2020-03-18",3,20,29,32,4006,0.967049425861208,0,0,406,290,5,23,5,34,4,5
"1646","2020-03-19",4,20,25,39,4006,0.967049425861208,0,0,406,290,7,30,4,38,5,4
"1647","2020-03-20",5,20,22,49,4006,0.967049425861208,0,0,406,290,13,43,8,46,9,8
"1648","2020-03-21",6,20,21,58,4006,0.967049425861208,0,0,406,290,11,54,9,55,8,9
"1649","2020-03-22",11,20,18,73,4006,0.967049425861208,0,0,406,290,15,69,7,62,11,7
"1650","2020-03-23",15,20,24,78,4006,0.967049425861208,0,0,406,290,13,82,7,69,8,7
"1651","2020-03-24",16,20,31,88,4006,0.967049425861208,0,0,406,290,16,98,9,78,14,9
"1652","2020-03-25",15,20,38,94,4006,0.967049425861208,0,0,406,290,13,111,6,84,11,6
"1653","2020-03-26",17,20,38,111,4006,0.967049425861208,0,0,406,290,10,121,7,91,7,7
"1654","2020-03-27",21,20,45,135,4006,0.967049425861208,0,0,406,290,13,134,10,101,9,10
"1655","2020-03-28",24,20,32,149,4006,0.967049425861208,0,0,406,290,28,162,7,108,25,7
"1656","2020-03-29",23,20,35,169,4006,0.967049425861208,0,0,406,290,16,178,8,116,11,8
"1657","2020-03-30",23,20,39,197,4006,0.967049425861208,0,0,406,290,16,194,9,125,11,9
"1658","2020-03-31",26,20,45,216,4006,0.967049425861208,0,0,406,290,20,214,6,131,16,6
"1659","2020-04-01",33,20,51,228,4006,0.967049425861208,0,0,406,290,23,237,9,140,19,9
"1660","2020-04-02",40,20,45,276,4006,0.967049425861208,0,0,406,290,16,253,5,145,12,5
"1661","2020-04-03",46,20,36,311,4006,0.967049425861208,0,0,406,290,18,271,16,161,17,16
"1662","2020-04-04",51,20,34,335,4006,0.967049425861208,0,0,406,290,21,292,6,167,18,6
"1663","2020-04-05",59,20,36,353,4006,0.967049425861208,0,0,406,290,22,314,11,178,22,11
"1664","2020-04-06",69,20,34,361,4006,0.967049425861208,0,0,406,290,24,338,10,188,18,10
"1665","2020-04-07",80,20,30,398,4006,0.967049425861208,0,0,406,290,23,361,7,195,21,7
"1666","2020-04-08",85,20,29,422,4006,0.967049425861208,0,0,406,290,26,387,15,210,18,15
"1667","2020-04-09",96,20,33,457,4006,0.967049425861208,0,0,406,290,15,402,11,221,13,11
"1668","2020-04-10",103,20,36,474,4006,0.967049425861208,0,0,406,290,22,424,15,236,19,15
"1669","2020-04-11",115,20,39,512,4006,0.967049425861208,0,0,406,290,25,449,21,257,22,21
"1670","2020-04-12",119,20,45,531,4006,0.967049425861208,0,0,406,290,24,473,27,284,19,27
"1671","2020-04-13",123,20,51,564,4006,0.967049425861208,0,0,406,290,12,485,10,294,12,10
"1672","2020-04-14",125,20,39,582,4006,0.967049425861208,0,0,406,290,12,497,12,306,10,12
"1673","2020-04-15",138,20,34,629,4006,0.967049425861208,0,0,406,290,24,521,11,317,14,11
"1674","2020-04-16",147,20,47,645,4006,0.967049425861208,0,0,406,290,14,535,17,334,11,17
"1675","2020-04-17",157,20,47,675,4006,0.967049425861208,0,0,406,290,18,553,18,352,12,18
"1676","2020-04-18",165,20,45,715,4006,0.967049425861208,0,0,406,290,27,580,15,367,24,15
"1677","2020-04-19",175,20,40,727,4006,0.967049425861208,0,0,406,290,20,600,22,389,17,22
"1678","2020-04-20",190,20,55,754,4006,0.967049425861208,0,0,406,290,16,616,15,404,13,15
"1679","2020-04-21",205,20,51,763,4006,0.967049425861208,0,0,406,290,13,629,14,418,12,14
"1680","2020-04-22",217,20,48,798,4006,0.967049425861208,0,0,406,290,20,649,11,429,16,11
"1681","2020-04-23",208,20,46,799,4006,0.967049425861208,0,0,406,290,21,670,18,447,18,18
"1682","2020-04-24",218,20,46,838,4006,0.967049425861208,0,0,406,290,18,688,16,463,12,16
"1683","2020-04-25",218,20,60,854,4006,0.967049425861208,0,0,406,290,20,708,13,476,20,13
"1684","2020-04-26",231,20,57,899,4006,0.967049425861208,0,0,406,290,25,733,14,490,16,14
"1685","2020-04-27",240,20,51,903,4006,0.967049425861208,0,0,406,290,18,751,12,502,17,12
"1686","2020-04-28",251,20,55,915,4006,0.967049425861208,0,0,406,290,21,772,17,519,14,17
"1687","2020-04-29",246,20,74,902,4006,0.967049425861208,0,0,406,290,21,793,9,528,19,9
"1688","2020-04-30",259,20,74,907,4006,0.967049425861208,0,0,406,290,27,820,12,540,24,12
"1689","2020-05-01",256,20,74,904,4006,0.967049425861208,0,0,406,290,24,844,23,563,19,23
"1690","2020-05-02",262,20,77,910,4006,0.967049425861208,0,0,406,290,28,872,18,581,24,18
"1691","2020-05-03",258,20,65,908,4006,0.967049425861208,0,0,406,290,20,892,23,604,18,23
"1692","2020-05-04",255,20,68,904,4006,0.967049425861208,0,0,406,290,22,914,20,624,17,20
"1693","2020-05-05",250,20,62,888,4006,0.967049425861208,0,0,406,290,29,943,19,643,24,19
"1694","2020-05-06",251,20,86,872,4006,0.967049425861208,0,0,406,290,19,962,11,654,14,11
"1695","2020-05-07",250,20,82,854,4006,0.967049425861208,0,0,406,290,31,993,15,669,27,15
"1696","2020-05-08",243,20,76,846,4006,0.967049425861208,0,0,406,290,36,1029,22,691,31,22
"1697","2020-05-09",234,20,62,826,4006,0.967049425861208,0,0,406,290,32,1061,19,710,24,19
"1698","2020-05-10",225,20,50,794,4006,0.967049425861208,0,0,406,290,26,1087,15,725,24,15
"1699","2020-05-11",207,20,69,773,4006,0.967049425861208,0,0,406,290,40,1127,19,744,35,19
"1700","2020-05-12",195,20,77,731,4006,0.967049425861208,0,0,406,290,24,1151,18,762,19,18
"1701","2020-05-13",199,20,75,711,4006,0.967049425861208,0,0,406,290,28,1179,20,782,24,20
"1702","2020-05-14",199,20,77,674,4006,0.967049425861208,0,0,406,290,28,1207,22,804,26,22
"1703","2020-05-15",200,20,67,637,4006,0.967049425861208,0,0,406,290,22,1229,18,822,16,18
"1704","2020-05-16",199,20,52,611,4006,0.967049425861208,0,0,406,290,32,1261,14,836,28,14
"1705","2020-05-17",196,20,59,580,4006,0.967049425861208,0,0,406,290,29,1290,9,845,27,9
"1706","2020-05-18",193,20,59,551,4006,0.967049425861208,0,0,406,290,24,1314,14,859,21,14
"1707","2020-05-19",190,20,52,524,4006,0.967049425861208,0,0,406,290,20,1334,17,876,20,17
"1708","2020-05-20",176,20,44,514,4006,0.967049425861208,0,0,406,290,25,1359,14,890,21,14
"1709","2020-05-21",166,20,50,493,4006,0.967049425861208,0,0,406,290,13,1372,13,903,12,13
"1710","2020-05-22",155,20,63,470,4006,0.967049425861208,0,0,406,290,24,1396,18,921,20,18
"1711","2020-05-23",149,20,67,449,4006,0.967049425861208,0,0,406,290,33,1429,15,936,28,15
"1712","2020-05-24",143,20,71,412,4006,0.967049425861208,0,0,406,290,19,1448,14,950,17,14
"1713","2020-05-25",140,20,65,399,4006,0.967049425861208,0,0,406,290,19,1467,18,968,16,18
"1714","2020-05-26",139,20,63,383,4006,0.967049425861208,0,0,406,290,25,1492,25,993,23,25
"1715","2020-05-27",132,20,55,370,4006,0.967049425861208,0,0,406,290,38,1530,10,1003,34,10
"1716","2020-05-28",122,20,54,345,4006,0.967049425861208,0,0,406,290,20,1550,15,1018,19,15
"1717","2020-05-29",117,20,45,337,4006,0.967049425861208,0,0,406,290,17,1567,14,1032,17,14
"1718","2020-05-30",111,20,43,339,4006,0.967049425861208,0,0,406,290,25,1592,12,1044,22,12
"1719","2020-05-31",107,20,38,332,4006,0.967049425861208,0,0,406,290,13,1605,16,1060,12,16
"1720","2020-06-01",102,20,34,316,4006,0.967049425861208,0,0,406,290,28,1633,11,1071,26,11
"1721","2020-06-02",89,20,24,305,4006,0.967049425861208,0,0,406,290,20,1653,11,1082,19,11
"1722","2020-06-03",84,20,26,298,4006,0.967049425861208,0,0,406,290,33,1686,12,1094,32,12
"1723","2020-06-04",83,20,31,279,4006,0.967049425861208,0,0,406,290,21,1707,7,1101,21,7
"1724","2020-06-05",76,20,23,260,4006,0.967049425861208,0,0,406,290,28,1735,3,1104,27,3
"1725","2020-06-06",76,20,34,256,4006,0.967049425861208,0,0,406,290,25,1760,7,1111,24,7
"1726","2020-06-07",75,20,29,247,4006,0.967049425861208,0,0,406,290,38,1798,9,1120,37,9
