"","Date","Absents","Paramset","Infections_or_Exposed_per_day_Patient","Infections_or_Exposed_per_day_HCW","total_infections","nosocomial_proportion","PCR_pooled","LFD_pooled","HCW_symp_test","patient_symp_test","new_hcw_infs","cumulative_hcw_infs","new_pat_infs","cumulative_pats_infs","new_nosocomial_hcw_infs","new_nosocomial_pat_infs"
"1","2020-03-13",1,1,54,136,7767,0.669756662804171,0,0,681,562,48,136,18,35,12,18
"2","2020-03-14",7,1,63,198,7767,0.669756662804171,0,0,681,562,62,198,19,54,14,19
"3","2020-03-15",14,1,70,259,7767,0.669756662804171,0,0,681,562,61,259,14,68,17,14
"4","2020-03-16",26,1,64,329,7767,0.669756662804171,0,0,681,562,71,330,10,78,27,10
"5","2020-03-17",34,1,69,415,7767,0.669756662804171,0,0,681,562,88,418,12,90,44,12
"6","2020-03-18",47,1,76,497,7767,0.669756662804171,0,0,681,562,89,507,17,107,39,17
"7","2020-03-19",64,1,70,577,7767,0.669756662804171,0,0,681,562,99,606,7,114,49,7
"8","2020-03-20",89,1,66,680,7767,0.669756662804171,0,0,681,562,121,727,16,130,80,16
"9","2020-03-21",111,1,74,752,7767,0.669756662804171,0,0,681,562,98,825,11,141,62,11
"10","2020-03-22",130,1,94,833,7767,0.669756662804171,0,0,681,562,108,933,21,162,73,21
"11","2020-03-23",144,1,113,926,7767,0.669756662804171,0,0,681,562,127,1060,36,198,94,36
"12","2020-03-24",171,1,127,1017,7767,0.669756662804171,0,0,681,562,146,1206,28,226,105,28
"13","2020-03-25",190,1,133,1116,7767,0.669756662804171,0,0,681,562,158,1364,26,252,121,26
"14","2020-03-26",214,1,120,1206,7767,0.669756662804171,0,0,681,562,147,1511,18,270,106,18
"15","2020-03-27",240,1,120,1332,7767,0.669756662804171,0,0,681,562,194,1705,14,284,160,14
"16","2020-03-28",254,1,134,1467,7767,0.669756662804171,0,0,681,562,211,1916,27,311,162,27
"17","2020-03-29",286,1,142,1603,7767,0.669756662804171,0,0,681,562,216,2132,31,342,173,31
"18","2020-03-30",321,1,157,1735,7767,0.669756662804171,0,0,681,562,227,2359,38,380,182,38
"19","2020-03-31",351,1,166,1903,7767,0.669756662804171,0,0,681,562,264,2623,44,424,219,44
"20","2020-04-01",400,1,152,2016,7767,0.669756662804171,0,0,681,562,221,2844,23,447,188,23
"21","2020-04-02",431,1,163,2145,7767,0.669756662804171,0,0,681,562,255,3099,25,472,215,25
"22","2020-04-03",460,1,151,2228,7767,0.669756662804171,0,0,681,562,233,3332,26,498,196,26
"23","2020-04-04",511,1,175,2332,7767,0.669756662804171,0,0,681,562,234,3566,40,538,203,40
"24","2020-04-05",547,1,185,2424,7767,0.669756662804171,0,0,681,562,243,3809,27,565,208,27
"25","2020-04-06",591,1,175,2524,7767,0.669756662804171,0,0,681,562,270,4079,27,592,246,27
"26","2020-04-07",628,1,185,2544,7767,0.669756662804171,0,0,681,562,207,4286,41,633,177,41
"27","2020-04-08",659,1,179,2563,7767,0.669756662804171,0,0,681,562,228,4514,30,663,202,30
"28","2020-04-09",703,1,167,2553,7767,0.669756662804171,0,0,681,562,170,4684,19,682,135,19
"29","2020-04-10",721,1,167,2522,7767,0.669756662804171,0,0,681,562,187,4871,21,703,161,21
"30","2020-04-11",739,1,166,2486,7767,0.669756662804171,0,0,681,562,186,5057,35,738,161,35
"31","2020-04-12",741,1,160,2446,7767,0.669756662804171,0,0,681,562,198,5255,29,767,162,29
"32","2020-04-13",739,1,157,2387,7767,0.669756662804171,0,0,681,562,144,5399,33,800,123,33
"33","2020-04-14",722,1,176,2280,7767,0.669756662804171,0,0,681,562,128,5527,46,846,101,46
"34","2020-04-15",690,1,192,2167,7767,0.669756662804171,0,0,681,562,122,5649,42,888,107,42
"35","2020-04-16",651,1,156,2028,7767,0.669756662804171,0,0,681,562,93,5742,12,900,78,12
"36","2020-04-17",626,1,146,1919,7767,0.669756662804171,0,0,681,562,94,5836,17,917,67,17
"37","2020-04-18",588,1,141,1763,7767,0.669756662804171,0,0,681,562,76,5912,9,926,60,9
"38","2020-04-19",564,1,117,1615,7767,0.669756662804171,0,0,681,562,70,5982,12,938,56,12
"39","2020-04-20",525,1,118,1491,7767,0.669756662804171,0,0,681,562,76,6058,10,948,61,10
"40","2020-04-21",493,1,143,1374,7767,0.669756662804171,0,0,681,562,58,6116,30,978,49,30
"41","2020-04-22",483,1,155,1280,7767,0.669756662804171,0,0,681,562,73,6189,41,1019,56,41
"42","2020-04-23",470,1,160,1184,7767,0.669756662804171,0,0,681,562,58,6247,36,1055,45,36
"43","2020-04-24",444,1,149,1079,7767,0.669756662804171,0,0,681,562,45,6292,17,1072,29,17
"44","2020-04-25",422,1,147,999,7767,0.669756662804171,0,0,681,562,44,6336,16,1088,28,16
"45","2020-04-26",393,1,151,913,7767,0.669756662804171,0,0,681,562,33,6369,16,1104,22,16
"46","2020-04-27",367,1,181,803,7767,0.669756662804171,0,0,681,562,25,6394,42,1146,12,42
"47","2020-04-28",354,1,202,718,7767,0.669756662804171,0,0,681,562,32,6426,47,1193,12,47
"48","2020-04-29",304,1,219,661,7767,0.669756662804171,0,0,681,562,38,6464,39,1232,26,39
"49","2020-04-30",264,1,238,590,7767,0.669756662804171,0,0,681,562,35,6499,51,1283,17,51
"50","2020-05-01",244,1,234,570,7767,0.669756662804171,0,0,681,562,37,6536,48,1331,21,48
"51","2020-05-02",222,1,233,529,7767,0.669756662804171,0,0,681,562,27,6563,36,1367,11,36
"52","2020-05-03",197,1,212,488,7767,0.669756662804171,0,0,681,562,25,6588,24,1391,12,24
"53","2020-05-04",178,1,202,443,7767,0.669756662804171,0,0,681,562,22,6610,36,1427,12,36
"54","2020-05-05",150,1,211,413,7767,0.669756662804171,0,0,681,562,26,6636,40,1467,15,40
"55","2020-05-06",146,1,201,390,7767,0.669756662804171,0,0,681,562,25,6661,23,1490,12,23
"56","2020-05-07",137,1,176,359,7767,0.669756662804171,0,0,681,562,20,6681,20,1510,7,20
"57","2020-05-08",124,1,168,338,7767,0.669756662804171,0,0,681,562,26,6707,22,1532,12,22
"58","2020-05-09",105,1,172,304,7767,0.669756662804171,0,0,681,562,16,6723,35,1567,6,35
"59","2020-05-10",100,1,165,293,7767,0.669756662804171,0,0,681,562,18,6741,27,1594,5,27
"60","2020-05-11",90,1,189,295,7767,0.669756662804171,0,0,681,562,19,6760,42,1636,8,42
"61","2020-05-12",94,1,209,266,7767,0.669756662804171,0,0,681,562,11,6771,44,1680,5,44
"62","2020-05-13",86,1,195,252,7767,0.669756662804171,0,0,681,562,21,6792,25,1705,9,25
"63","2020-05-14",81,1,206,240,7767,0.669756662804171,0,0,681,562,13,6805,33,1738,4,33
"64","2020-05-15",71,1,198,224,7767,0.669756662804171,0,0,681,562,13,6818,27,1765,6,27
"65","2020-05-16",71,1,213,217,7767,0.669756662804171,0,0,681,562,12,6830,47,1812,4,47
"66","2020-05-17",65,1,207,206,7767,0.669756662804171,0,0,681,562,11,6841,27,1839,4,27
"67","2020-05-18",63,1,214,194,7767,0.669756662804171,0,0,681,562,11,6852,31,1870,2,31
"68","2020-05-19",54,1,228,182,7767,0.669756662804171,0,0,681,562,12,6864,31,1901,5,31
"69","2020-05-20",55,1,222,177,7767,0.669756662804171,0,0,681,562,21,6885,45,1946,9,45
"70","2020-05-21",47,1,222,166,7767,0.669756662804171,0,0,681,562,7,6892,43,1989,2,43
"71","2020-05-22",47,1,203,153,7767,0.669756662804171,0,0,681,562,6,6898,32,2021,2,32
"72","2020-05-23",41,1,181,153,7767,0.669756662804171,0,0,681,562,9,6907,28,2049,3,28
"73","2020-05-24",43,1,172,149,7767,0.669756662804171,0,0,681,562,14,6921,19,2068,1,19
"74","2020-05-25",42,1,161,146,7767,0.669756662804171,0,0,681,562,10,6931,22,2090,3,22
"75","2020-05-26",44,1,151,140,7767,0.669756662804171,0,0,681,562,8,6939,18,2108,2,18
"76","2020-05-27",38,1,165,122,7767,0.669756662804171,0,0,681,562,9,6948,31,2139,2,31
"77","2020-05-28",47,1,158,121,7767,0.669756662804171,0,0,681,562,11,6959,24,2163,4,24
"78","2020-05-29",46,1,159,121,7767,0.669756662804171,0,0,681,562,10,6969,22,2185,2,22
"79","2020-05-30",49,1,181,116,7767,0.669756662804171,0,0,681,562,9,6978,43,2228,6,43
"80","2020-05-31",45,1,202,109,7767,0.669756662804171,0,0,681,562,6,6984,45,2273,1,45
"81","2020-06-01",42,1,179,102,7767,0.669756662804171,0,0,681,562,5,6989,25,2298,2,25
"82","2020-06-02",36,1,164,105,7767,0.669756662804171,0,0,681,562,8,6997,17,2315,3,17
"83","2020-06-03",38,1,163,99,7767,0.669756662804171,0,0,681,562,2,6999,25,2340,NA,25
"84","2020-06-04",34,1,169,96,7767,0.669756662804171,0,0,681,562,5,7004,28,2368,3,28
"85","2020-06-05",34,1,171,92,7767,0.669756662804171,0,0,681,562,7,7011,31,2399,2,31
"86","2020-06-06",33,1,176,88,7767,0.669756662804171,0,0,681,562,10,7021,31,2430,3,31
"87","2020-06-07",37,1,165,74,7767,0.669756662804171,0,0,681,562,NA,NA,24,2454,NA,24
"88","2020-03-14",3,2,55,96,4829,0.63387864982398,0,0,437,486,42,150,20,38,11,20
"89","2020-03-15",5,2,58,133,4829,0.63387864982398,0,0,437,486,48,198,12,50,9,12
"90","2020-03-16",9,2,67,182,4829,0.63387864982398,0,0,437,486,57,255,18,68,18,18
"91","2020-03-17",16,2,72,220,4829,0.63387864982398,0,0,437,486,58,313,21,89,24,21
"92","2020-03-18",21,2,71,255,4829,0.63387864982398,0,0,437,486,38,351,11,100,15,11
"93","2020-03-19",32,2,73,313,4829,0.63387864982398,0,0,437,486,51,402,10,110,18,10
"94","2020-03-20",48,2,74,373,4829,0.63387864982398,0,0,437,486,46,448,14,124,25,14
"95","2020-03-21",59,2,80,437,4829,0.63387864982398,0,0,437,486,56,504,24,148,32,24
"96","2020-03-22",77,2,73,479,4829,0.63387864982398,0,0,437,486,50,554,19,167,17,19
"97","2020-03-23",95,2,89,503,4829,0.63387864982398,0,0,437,486,77,631,33,200,40,33
"98","2020-03-24",107,2,90,558,4829,0.63387864982398,0,0,437,486,64,695,26,226,24,26
"99","2020-03-25",125,2,89,606,4829,0.63387864982398,0,0,437,486,60,755,31,257,17,31
"100","2020-03-26",131,2,85,657,4829,0.63387864982398,0,0,437,486,65,820,31,288,23,31
"101","2020-03-27",136,2,98,690,4829,0.63387864982398,0,0,437,486,78,898,30,318,29,30
"102","2020-03-28",150,2,121,712,4829,0.63387864982398,0,0,437,486,54,952,32,350,16,32
"103","2020-03-29",167,2,116,727,4829,0.63387864982398,0,0,437,486,61,1013,34,384,26,34
"104","2020-03-30",175,2,120,745,4829,0.63387864982398,0,0,437,486,50,1063,36,420,20,36
"105","2020-03-31",193,2,118,783,4829,0.63387864982398,0,0,437,486,58,1121,37,457,32,37
"106","2020-04-01",204,2,109,780,4829,0.63387864982398,0,0,437,486,64,1185,41,498,25,41
"107","2020-04-02",217,2,114,799,4829,0.63387864982398,0,0,437,486,59,1244,37,535,26,37
"108","2020-04-03",225,2,110,808,4829,0.63387864982398,0,0,437,486,69,1313,23,558,34,23
"109","2020-04-04",233,2,114,849,4829,0.63387864982398,0,0,437,486,48,1361,18,576,16,18
"110","2020-04-05",238,2,104,848,4829,0.63387864982398,0,0,437,486,53,1414,31,607,15,31
"111","2020-04-06",239,2,96,875,4829,0.63387864982398,0,0,437,486,53,1467,33,640,20,33
"112","2020-04-07",231,2,103,892,4829,0.63387864982398,0,0,437,486,57,1524,45,685,22,45
"113","2020-04-08",229,2,101,908,4829,0.63387864982398,0,0,437,486,51,1575,31,716,16,31
"114","2020-04-09",225,2,114,934,4829,0.63387864982398,0,0,437,486,74,1649,34,750,21,34
"115","2020-04-10",239,2,124,940,4829,0.63387864982398,0,0,437,486,68,1717,35,785,21,35
"116","2020-04-11",232,2,125,952,4829,0.63387864982398,0,0,437,486,63,1780,28,813,15,28
"117","2020-04-12",238,2,120,948,4829,0.63387864982398,0,0,437,486,55,1835,31,844,13,31
"118","2020-04-13",245,2,117,959,4829,0.63387864982398,0,0,437,486,75,1910,24,868,22,24
"119","2020-04-14",253,2,112,970,4829,0.63387864982398,0,0,437,486,60,1970,43,911,19,43
"120","2020-04-15",255,2,131,944,4829,0.63387864982398,0,0,437,486,52,2022,51,962,17,51
"121","2020-04-16",274,2,130,930,4829,0.63387864982398,0,0,437,486,49,2071,26,988,17,26
"122","2020-04-17",262,2,145,909,4829,0.63387864982398,0,0,437,486,55,2126,36,1024,25,36
"123","2020-04-18",278,2,137,887,4829,0.63387864982398,0,0,437,486,58,2184,34,1058,18,34
"124","2020-04-19",261,2,129,856,4829,0.63387864982398,0,0,437,486,70,2254,32,1090,23,32
"125","2020-04-20",257,2,135,841,4829,0.63387864982398,0,0,437,486,54,2308,28,1118,19,28
"126","2020-04-21",245,2,126,845,4829,0.63387864982398,0,0,437,486,49,2357,47,1165,17,47
"127","2020-04-22",243,2,134,837,4829,0.63387864982398,0,0,437,486,69,2426,41,1206,16,41
"128","2020-04-23",227,2,157,831,4829,0.63387864982398,0,0,437,486,51,2477,40,1246,13,40
"129","2020-04-24",225,2,158,827,4829,0.63387864982398,0,0,437,486,64,2541,30,1276,20,30
"130","2020-04-25",208,2,155,802,4829,0.63387864982398,0,0,437,486,63,2604,27,1303,24,27
"131","2020-04-26",201,2,123,774,4829,0.63387864982398,0,0,437,486,52,2656,18,1321,17,18
"132","2020-04-27",200,2,131,775,4829,0.63387864982398,0,0,437,486,44,2700,46,1367,11,46
"133","2020-04-28",207,2,118,768,4829,0.63387864982398,0,0,437,486,59,2759,26,1393,9,26
"134","2020-04-29",206,2,121,738,4829,0.63387864982398,0,0,437,486,67,2826,39,1432,21,39
"135","2020-04-30",216,2,114,709,4829,0.63387864982398,0,0,437,486,64,2890,39,1471,15,39
"136","2020-05-01",215,2,101,661,4829,0.63387864982398,0,0,437,486,41,2931,52,1523,7,52
"137","2020-05-02",217,2,101,655,4829,0.63387864982398,0,0,437,486,53,2984,42,1565,16,42
"138","2020-05-03",219,2,97,654,4829,0.63387864982398,0,0,437,486,49,3033,40,1605,9,40
"139","2020-05-04",208,2,98,659,4829,0.63387864982398,0,0,437,486,44,3077,61,1666,11,61
"140","2020-05-05",201,2,94,635,4829,0.63387864982398,0,0,437,486,51,3128,37,1703,12,37
"141","2020-05-06",192,2,94,620,4829,0.63387864982398,0,0,437,486,45,3173,47,1750,16,47
"142","2020-05-07",180,2,125,620,4829,0.63387864982398,0,0,437,486,60,3233,57,1807,21,57
"143","2020-05-08",180,2,139,621,4829,0.63387864982398,0,0,437,486,36,3269,42,1849,11,42
"144","2020-05-09",175,2,150,605,4829,0.63387864982398,0,0,437,486,51,3320,34,1883,16,34
"145","2020-05-10",173,2,138,590,4829,0.63387864982398,0,0,437,486,44,3364,30,1913,15,30
"146","2020-05-11",166,2,155,545,4829,0.63387864982398,0,0,437,486,37,3401,38,1951,9,38
"147","2020-05-12",167,2,167,527,4829,0.63387864982398,0,0,437,486,46,3447,31,1982,12,31
"148","2020-05-13",166,2,191,512,4829,0.63387864982398,0,0,437,486,44,3491,36,2018,12,36
"149","2020-05-14",161,2,190,490,4829,0.63387864982398,0,0,437,486,39,3530,47,2065,9,47
"150","2020-05-15",147,2,201,491,4829,0.63387864982398,0,0,437,486,38,3568,35,2100,10,35
"151","2020-05-16",141,2,200,474,4829,0.63387864982398,0,0,437,486,38,3606,38,2138,5,38
"152","2020-05-17",141,2,185,438,4829,0.63387864982398,0,0,437,486,32,3638,39,2177,10,39
"153","2020-05-18",140,2,187,416,4829,0.63387864982398,0,0,437,486,33,3671,29,2206,7,29
"154","2020-05-19",131,2,170,400,4829,0.63387864982398,0,0,437,486,39,3710,20,2226,11,20
"155","2020-05-20",131,2,155,390,4829,0.63387864982398,0,0,437,486,37,3747,14,2240,11,14
"156","2020-05-21",120,2,139,368,4829,0.63387864982398,0,0,437,486,22,3769,16,2256,5,16
"157","2020-05-22",119,2,130,356,4829,0.63387864982398,0,0,437,486,27,3796,19,2275,11,19
"158","2020-05-23",123,2,147,343,4829,0.63387864982398,0,0,437,486,29,3825,13,2288,7,13
"159","2020-05-24",114,2,142,329,4829,0.63387864982398,0,0,437,486,22,3847,17,2305,9,17
"160","2020-05-25",116,2,135,314,4829,0.63387864982398,0,0,437,486,23,3870,14,2319,6,14
"161","2020-05-26",110,2,145,295,4829,0.63387864982398,0,0,437,486,25,3895,24,2343,6,24
"162","2020-05-27",100,2,156,276,4829,0.63387864982398,0,0,437,486,15,3910,28,2371,5,28
"163","2020-05-28",96,2,152,262,4829,0.63387864982398,0,0,437,486,14,3924,24,2395,2,24
"164","2020-05-29",96,2,136,254,4829,0.63387864982398,0,0,437,486,19,3943,17,2412,7,17
"165","2020-05-30",80,2,114,215,4829,0.63387864982398,0,0,437,486,35,3978,19,2431,12,19
"166","2020-05-31",75,2,104,197,4829,0.63387864982398,0,0,437,486,18,3996,27,2458,6,27
"167","2020-06-01",61,2,98,180,4829,0.63387864982398,0,0,437,486,25,4021,22,2480,7,22
"168","2020-06-02",56,2,95,182,4829,0.63387864982398,0,0,437,486,19,4040,20,2500,5,20
"169","2020-06-03",57,2,93,179,4829,0.63387864982398,0,0,437,486,17,4057,37,2537,4,37
"170","2020-06-04",55,2,97,179,4829,0.63387864982398,0,0,437,486,20,4077,32,2569,6,32
"171","2020-06-05",50,2,107,165,4829,0.63387864982398,0,0,437,486,13,4090,23,2592,4,23
"172","2020-06-06",51,2,121,170,4829,0.63387864982398,0,0,437,486,21,4111,19,2611,6,19
"173","2020-06-07",45,2,104,171,4829,0.63387864982398,0,0,437,486,11,4122,17,2628,3,17
"174","2020-03-13",2,3,61,120,5161,0.381321449331525,0,0,446,1046,16,57,17,46,7,17
"175","2020-03-14",3,3,92,157,5161,0.381321449331525,0,0,446,1046,22,79,18,64,13,18
"176","2020-03-15",10,3,107,210,5161,0.381321449331525,0,0,446,1046,37,116,15,79,22,15
"177","2020-03-16",19,3,116,270,5161,0.381321449331525,0,0,446,1046,33,149,19,98,26,19
"178","2020-03-17",30,3,145,321,5161,0.381321449331525,0,0,446,1046,39,188,14,112,24,14
"179","2020-03-18",40,3,178,367,5161,0.381321449331525,0,0,446,1046,47,235,26,138,35,26
"180","2020-03-19",55,3,177,412,5161,0.381321449331525,0,0,446,1046,49,284,28,166,40,28
"181","2020-03-20",80,3,173,471,5161,0.381321449331525,0,0,446,1046,38,322,41,207,29,41
"182","2020-03-21",95,3,210,499,5161,0.381321449331525,0,0,446,1046,61,383,31,238,54,31
"183","2020-03-22",108,3,225,547,5161,0.381321449331525,0,0,446,1046,79,462,33,271,67,33
"184","2020-03-23",119,3,223,604,5161,0.381321449331525,0,0,446,1046,89,551,22,293,73,22
"185","2020-03-24",138,3,238,621,5161,0.381321449331525,0,0,446,1046,79,630,35,328,68,35
"186","2020-03-25",147,3,266,666,5161,0.381321449331525,0,0,446,1046,104,734,38,366,94,38
"187","2020-03-26",150,3,298,705,5161,0.381321449331525,0,0,446,1046,94,828,43,409,83,43
"188","2020-03-27",141,3,311,737,5161,0.381321449331525,0,0,446,1046,133,961,51,460,114,51
"189","2020-03-28",156,3,290,773,5161,0.381321449331525,0,0,446,1046,125,1086,41,501,118,41
"190","2020-03-29",173,3,267,779,5161,0.381321449331525,0,0,446,1046,104,1190,26,527,92,26
"191","2020-03-30",191,3,263,817,5161,0.381321449331525,0,0,446,1046,165,1355,27,554,157,27
"192","2020-03-31",190,3,268,825,5161,0.381321449331525,0,0,446,1046,154,1509,24,578,140,24
"193","2020-04-01",207,3,240,837,5161,0.381321449331525,0,0,446,1046,154,1663,36,614,142,36
"194","2020-04-02",218,3,237,837,5161,0.381321449331525,0,0,446,1046,162,1825,54,668,153,54
"195","2020-04-03",225,3,241,858,5161,0.381321449331525,0,0,446,1046,150,1975,59,727,143,59
"196","2020-04-04",227,3,269,859,5161,0.381321449331525,0,0,446,1046,211,2186,23,750,193,23
"197","2020-04-05",224,3,283,863,5161,0.381321449331525,0,0,446,1046,172,2358,34,784,165,34
"198","2020-04-06",211,3,293,886,5161,0.381321449331525,0,0,446,1046,139,2497,22,806,128,22
"199","2020-04-07",228,3,299,882,5161,0.381321449331525,0,0,446,1046,206,2703,20,826,190,20
"200","2020-04-08",222,3,288,862,5161,0.381321449331525,0,0,446,1046,162,2865,20,846,146,20
"201","2020-04-09",232,3,266,877,5161,0.381321449331525,0,0,446,1046,167,3032,30,876,156,30
"202","2020-04-10",240,3,307,870,5161,0.381321449331525,0,0,446,1046,181,3213,23,899,166,23
"203","2020-04-11",242,3,292,880,5161,0.381321449331525,0,0,446,1046,157,3370,17,916,150,17
"204","2020-04-12",244,3,292,877,5161,0.381321449331525,0,0,446,1046,174,3544,29,945,157,29
"205","2020-04-13",250,3,264,877,5161,0.381321449331525,0,0,446,1046,144,3688,18,963,134,18
"206","2020-04-14",237,3,283,875,5161,0.381321449331525,0,0,446,1046,176,3864,24,987,166,24
"207","2020-04-15",249,3,278,861,5161,0.381321449331525,0,0,446,1046,155,4019,21,1008,146,21
"208","2020-04-16",237,3,297,866,5161,0.381321449331525,0,0,446,1046,138,4157,31,1039,125,31
"209","2020-04-17",236,3,293,856,5161,0.381321449331525,0,0,446,1046,153,4310,46,1085,144,46
"210","2020-04-18",239,3,285,854,5161,0.381321449331525,0,0,446,1046,97,4407,22,1107,95,22
"211","2020-04-19",230,3,261,847,5161,0.381321449331525,0,0,446,1046,106,4513,39,1146,96,39
"212","2020-04-20",234,3,256,838,5161,0.381321449331525,0,0,446,1046,99,4612,28,1174,95,28
"213","2020-04-21",233,3,243,846,5161,0.381321449331525,0,0,446,1046,85,4697,27,1201,80,27
"214","2020-04-22",223,3,260,822,5161,0.381321449331525,0,0,446,1046,97,4794,10,1211,90,10
"215","2020-04-23",239,3,260,824,5161,0.381321449331525,0,0,446,1046,85,4879,22,1233,79,22
"216","2020-04-24",245,3,278,819,5161,0.381321449331525,0,0,446,1046,75,4954,13,1246,63,13
"217","2020-04-25",238,3,273,815,5161,0.381321449331525,0,0,446,1046,76,5030,27,1273,67,27
"218","2020-04-26",249,3,276,803,5161,0.381321449331525,0,0,446,1046,78,5108,37,1310,70,37
"219","2020-04-27",240,3,281,775,5161,0.381321449331525,0,0,446,1046,52,5160,46,1356,46,46
"220","2020-04-28",245,3,272,756,5161,0.381321449331525,0,0,446,1046,62,5222,40,1396,54,40
"221","2020-04-29",238,3,257,750,5161,0.381321449331525,0,0,446,1046,55,5277,32,1428,51,32
"222","2020-04-30",213,3,264,735,5161,0.381321449331525,0,0,446,1046,51,5328,30,1458,49,30
"223","2020-05-01",213,3,266,724,5161,0.381321449331525,0,0,446,1046,61,5389,20,1478,53,20
"224","2020-05-02",217,3,255,700,5161,0.381321449331525,0,0,446,1046,50,5439,20,1498,43,20
"225","2020-05-03",200,3,261,681,5161,0.381321449331525,0,0,446,1046,35,5474,8,1506,31,8
"226","2020-05-04",197,3,247,674,5161,0.381321449331525,0,0,446,1046,39,5513,25,1531,28,25
"227","2020-05-05",182,3,295,649,5161,0.381321449331525,0,0,446,1046,32,5545,18,1549,28,18
"228","2020-05-06",188,3,323,632,5161,0.381321449331525,0,0,446,1046,38,5583,16,1565,28,16
"229","2020-05-07",198,3,315,631,5161,0.381321449331525,0,0,446,1046,31,5614,11,1576,26,11
"230","2020-05-08",191,3,351,624,5161,0.381321449331525,0,0,446,1046,38,5652,33,1609,33,33
"231","2020-05-09",176,3,355,600,5161,0.381321449331525,0,0,446,1046,28,5680,40,1649,18,40
"232","2020-05-10",178,3,358,601,5161,0.381321449331525,0,0,446,1046,27,5707,32,1681,21,32
"233","2020-05-11",185,3,343,598,5161,0.381321449331525,0,0,446,1046,39,5746,22,1703,36,22
"234","2020-05-12",195,3,354,581,5161,0.381321449331525,0,0,446,1046,35,5781,17,1720,30,17
"235","2020-05-13",190,3,369,560,5161,0.381321449331525,0,0,446,1046,24,5805,16,1736,17,16
"236","2020-05-14",182,3,371,554,5161,0.381321449331525,0,0,446,1046,24,5829,21,1757,18,21
"237","2020-05-15",168,3,342,532,5161,0.381321449331525,0,0,446,1046,19,5848,14,1771,16,14
"238","2020-05-16",166,3,332,519,5161,0.381321449331525,0,0,446,1046,21,5869,24,1795,19,24
"239","2020-05-17",166,3,345,485,5161,0.381321449331525,0,0,446,1046,19,5888,31,1826,17,31
"240","2020-05-18",161,3,315,470,5161,0.381321449331525,0,0,446,1046,23,5911,59,1885,16,59
"241","2020-05-19",152,3,290,453,5161,0.381321449331525,0,0,446,1046,18,5929,44,1929,15,44
"242","2020-05-20",146,3,295,435,5161,0.381321449331525,0,0,446,1046,25,5954,48,1977,19,48
"243","2020-05-21",148,3,266,410,5161,0.381321449331525,0,0,446,1046,10,5964,51,2028,8,51
"244","2020-05-22",148,3,262,387,5161,0.381321449331525,0,0,446,1046,13,5977,25,2053,12,25
"245","2020-05-23",137,3,276,360,5161,0.381321449331525,0,0,446,1046,15,5992,13,2066,12,13
"246","2020-05-24",123,3,263,335,5161,0.381321449331525,0,0,446,1046,15,6007,23,2089,11,23
"247","2020-05-25",113,3,258,323,5161,0.381321449331525,0,0,446,1046,11,6018,42,2131,9,42
"248","2020-05-26",97,3,256,319,5161,0.381321449331525,0,0,446,1046,15,6033,28,2159,12,28
"249","2020-05-27",93,3,259,306,5161,0.381321449331525,0,0,446,1046,11,6044,25,2184,7,25
"250","2020-05-28",82,3,254,297,5161,0.381321449331525,0,0,446,1046,14,6058,30,2214,13,30
"251","2020-05-29",74,3,263,289,5161,0.381321449331525,0,0,446,1046,6,6064,21,2235,6,21
"252","2020-05-30",78,3,271,270,5161,0.381321449331525,0,0,446,1046,17,6081,25,2260,12,25
"253","2020-05-31",84,3,301,254,5161,0.381321449331525,0,0,446,1046,11,6092,22,2282,8,22
"254","2020-06-01",74,3,294,250,5161,0.381321449331525,0,0,446,1046,7,6099,23,2305,6,23
"255","2020-06-02",81,3,295,244,5161,0.381321449331525,0,0,446,1046,9,6108,35,2340,9,35
"256","2020-06-03",73,3,276,219,5161,0.381321449331525,0,0,446,1046,16,6124,29,2369,11,29
"257","2020-06-04",67,3,277,202,5161,0.381321449331525,0,0,446,1046,8,6132,30,2399,6,30
"258","2020-06-05",59,3,272,192,5161,0.381321449331525,0,0,446,1046,8,6140,27,2426,7,27
"259","2020-06-06",54,3,283,184,5161,0.381321449331525,0,0,446,1046,9,6149,28,2454,7,28
"260","2020-06-07",46,3,301,184,5161,0.381321449331525,0,0,446,1046,7,6156,37,2491,6,37
"261","2020-03-12",1,4,40,39,4748,0.671019376579612,0,0,387,457,64,117,46,93,17,46
"262","2020-03-13",3,4,44,67,4748,0.671019376579612,0,0,387,457,72,189,17,110,38,17
"263","2020-03-14",3,4,46,93,4748,0.671019376579612,0,0,387,457,92,281,12,122,49,12
"264","2020-03-15",9,4,43,129,4748,0.671019376579612,0,0,387,457,118,399,8,130,87,8
"265","2020-03-16",15,4,54,151,4748,0.671019376579612,0,0,387,457,137,536,8,138,91,8
"266","2020-03-17",19,4,56,179,4748,0.671019376579612,0,0,387,457,174,710,10,148,140,10
"267","2020-03-18",25,4,63,209,4748,0.671019376579612,0,0,387,457,237,947,70,218,193,70
"268","2020-03-19",36,4,64,245,4748,0.671019376579612,0,0,387,457,298,1245,78,296,272,78
"269","2020-03-20",41,4,90,269,4748,0.671019376579612,0,0,387,457,341,1586,30,326,305,30
"270","2020-03-21",55,4,85,306,4748,0.671019376579612,0,0,387,457,466,2052,17,343,444,17
"271","2020-03-22",66,4,110,342,4748,0.671019376579612,0,0,387,457,417,2469,11,354,385,11
"272","2020-03-23",79,4,101,377,4748,0.671019376579612,0,0,387,457,536,3005,53,407,506,53
"273","2020-03-24",90,4,122,416,4748,0.671019376579612,0,0,387,457,585,3590,43,450,549,43
"274","2020-03-25",95,4,105,448,4748,0.671019376579612,0,0,387,457,470,4060,63,513,453,63
"275","2020-03-26",108,4,111,466,4748,0.671019376579612,0,0,387,457,628,4688,54,567,608,54
"276","2020-03-27",120,4,112,514,4748,0.671019376579612,0,0,387,457,498,5186,32,599,478,32
"277","2020-03-28",127,4,106,545,4748,0.671019376579612,0,0,387,457,524,5710,16,615,503,16
"278","2020-03-29",125,4,129,579,4748,0.671019376579612,0,0,387,457,409,6119,23,638,398,23
"279","2020-03-30",134,4,150,617,4748,0.671019376579612,0,0,387,457,357,6476,22,660,350,22
"280","2020-03-31",151,4,150,647,4748,0.671019376579612,0,0,387,457,235,6711,54,714,225,54
"281","2020-04-01",169,4,177,675,4748,0.671019376579612,0,0,387,457,216,6927,36,750,204,36
"282","2020-04-02",166,4,164,691,4748,0.671019376579612,0,0,387,457,187,7114,38,788,181,38
"283","2020-04-03",169,4,143,729,4748,0.671019376579612,0,0,387,457,115,7229,65,853,108,65
"284","2020-04-04",178,4,125,763,4748,0.671019376579612,0,0,387,457,104,7333,43,896,96,43
"285","2020-04-05",195,4,147,790,4748,0.671019376579612,0,0,387,457,91,7424,53,949,81,53
"286","2020-04-06",205,4,147,826,4748,0.671019376579612,0,0,387,457,66,7490,26,975,63,26
"287","2020-04-07",201,4,155,849,4748,0.671019376579612,0,0,387,457,51,7541,18,993,44,18
"288","2020-04-08",198,4,144,887,4748,0.671019376579612,0,0,387,457,40,7581,25,1018,37,25
"289","2020-04-09",202,4,141,893,4748,0.671019376579612,0,0,387,457,35,7616,18,1036,28,18
"290","2020-04-10",218,4,143,908,4748,0.671019376579612,0,0,387,457,21,7637,42,1078,15,42
"291","2020-04-11",229,4,167,911,4748,0.671019376579612,0,0,387,457,22,7659,71,1149,19,71
"292","2020-04-12",225,4,221,934,4748,0.671019376579612,0,0,387,457,15,7674,30,1179,13,30
"293","2020-04-13",223,4,242,950,4748,0.671019376579612,0,0,387,457,13,7687,27,1206,10,27
"294","2020-04-14",218,4,226,957,4748,0.671019376579612,0,0,387,457,17,7704,12,1218,10,12
"295","2020-04-15",238,4,220,962,4748,0.671019376579612,0,0,387,457,11,7715,27,1245,6,27
"296","2020-04-16",252,4,230,946,4748,0.671019376579612,0,0,387,457,7,7722,51,1296,5,51
"297","2020-04-17",240,4,251,895,4748,0.671019376579612,0,0,387,457,NA,NA,32,1328,NA,32
"298","2020-04-18",241,4,259,868,4748,0.671019376579612,0,0,387,457,6,7728,19,1347,3,19
"299","2020-04-19",250,4,267,890,4748,0.671019376579612,0,0,387,457,2,7730,16,1363,1,16
"300","2020-04-20",249,4,255,884,4748,0.671019376579612,0,0,387,457,3,7733,28,1391,2,28
"301","2020-04-21",261,4,227,883,4748,0.671019376579612,0,0,387,457,6,7739,18,1409,1,18
"302","2020-04-22",242,4,222,861,4748,0.671019376579612,0,0,387,457,7,7746,9,1418,2,9
"303","2020-04-23",246,4,199,845,4748,0.671019376579612,0,0,387,457,4,7750,9,1427,1,9
"304","2020-04-24",242,4,176,841,4748,0.671019376579612,0,0,387,457,5,7755,16,1443,1,16
"305","2020-04-25",235,4,166,825,4748,0.671019376579612,0,0,387,457,1,7756,84,1527,1,84
"306","2020-04-26",222,4,188,792,4748,0.671019376579612,0,0,387,457,1,7757,38,1565,1,38
"307","2020-04-27",215,4,192,791,4748,0.671019376579612,0,0,387,457,3,7760,37,1602,1,37
"308","2020-04-28",214,4,189,773,4748,0.671019376579612,0,0,387,457,4,7764,26,1628,2,26
"309","2020-04-29",211,4,207,750,4748,0.671019376579612,0,0,387,457,3,7767,22,1650,1,22
"310","2020-04-30",192,4,192,747,4748,0.671019376579612,0,0,387,457,3,7770,37,1687,2,37
"311","2020-05-01",199,4,184,741,4748,0.671019376579612,0,0,387,457,4,7774,25,1712,2,25
"312","2020-05-02",190,4,191,732,4748,0.671019376579612,0,0,387,457,2,7776,53,1765,1,53
"313","2020-05-03",197,4,204,725,4748,0.671019376579612,0,0,387,457,5,7781,31,1796,2,31
"314","2020-05-04",208,4,205,699,4748,0.671019376579612,0,0,387,457,3,7784,16,1812,2,16
"315","2020-05-05",203,4,188,689,4748,0.671019376579612,0,0,387,457,5,7789,44,1856,2,44
"316","2020-05-06",210,4,216,662,4748,0.671019376579612,0,0,387,457,2,7791,63,1919,1,63
"317","2020-05-07",219,4,225,657,4748,0.671019376579612,0,0,387,457,3,7794,36,1955,1,36
"318","2020-05-08",213,4,249,656,4748,0.671019376579612,0,0,387,457,7,7801,53,2008,3,53
"319","2020-05-09",217,4,273,656,4748,0.671019376579612,0,0,387,457,NA,NA,28,2036,NA,28
"320","2020-05-10",205,4,284,644,4748,0.671019376579612,0,0,387,457,6,7807,22,2058,3,22
"321","2020-05-11",189,4,266,614,4748,0.671019376579612,0,0,387,457,1,7808,66,2124,1,66
"322","2020-05-12",182,4,250,599,4748,0.671019376579612,0,0,387,457,NA,NA,57,2181,NA,57
"323","2020-05-13",163,4,246,571,4748,0.671019376579612,0,0,387,457,1,7809,30,2211,NA,30
"324","2020-05-14",156,4,239,544,4748,0.671019376579612,0,0,387,457,3,7812,42,2253,NA,42
"325","2020-05-15",148,4,223,510,4748,0.671019376579612,0,0,387,457,2,7814,25,2278,NA,25
"326","2020-05-16",140,4,201,481,4748,0.671019376579612,0,0,387,457,2,7816,16,2294,1,16
"327","2020-05-17",139,4,191,475,4748,0.671019376579612,0,0,387,457,1,7817,18,2312,NA,18
"328","2020-05-18",135,4,177,452,4748,0.671019376579612,0,0,387,457,3,7820,26,2338,1,26
"329","2020-05-19",130,4,162,417,4748,0.671019376579612,0,0,387,457,3,7823,62,2400,1,62
"330","2020-05-20",138,4,146,407,4748,0.671019376579612,0,0,387,457,5,7828,81,2481,1,81
"331","2020-05-21",135,4,164,390,4748,0.671019376579612,0,0,387,457,NA,NA,58,2539,NA,58
"332","2020-05-22",136,4,167,369,4748,0.671019376579612,0,0,387,457,1,7829,48,2587,NA,48
"333","2020-05-23",123,4,179,348,4748,0.671019376579612,0,0,387,457,NA,NA,44,2631,NA,44
"334","2020-05-24",115,4,203,333,4748,0.671019376579612,0,0,387,457,3,7832,27,2658,1,27
"335","2020-05-25",114,4,211,315,4748,0.671019376579612,0,0,387,457,3,7835,38,2696,2,38
"336","2020-05-26",103,4,206,302,4748,0.671019376579612,0,0,387,457,3,7838,53,2749,NA,53
"337","2020-05-27",96,4,187,296,4748,0.671019376579612,0,0,387,457,2,7840,33,2782,NA,33
"338","2020-05-28",79,4,191,285,4748,0.671019376579612,0,0,387,457,2,7842,68,2850,NA,68
"339","2020-05-29",78,4,178,277,4748,0.671019376579612,0,0,387,457,2,7844,31,2881,2,31
"340","2020-05-30",82,4,169,268,4748,0.671019376579612,0,0,387,457,1,7845,24,2905,NA,24
"341","2020-05-31",89,4,144,253,4748,0.671019376579612,0,0,387,457,1,7846,38,2943,NA,38
"342","2020-06-01",83,4,112,247,4748,0.671019376579612,0,0,387,457,2,7848,18,2961,1,18
"343","2020-06-02",86,4,115,239,4748,0.671019376579612,0,0,387,457,NA,NA,59,3020,NA,59
"344","2020-06-03",85,4,105,234,4748,0.671019376579612,0,0,387,457,1,7849,58,3078,1,58
"345","2020-06-04",84,4,114,233,4748,0.671019376579612,0,0,387,457,3,7852,23,3101,2,23
"346","2020-06-05",80,4,129,227,4748,0.671019376579612,0,0,387,457,1,7853,18,3119,NA,18
"347","2020-06-06",78,4,125,220,4748,0.671019376579612,0,0,387,457,NA,NA,15,3134,NA,15
"348","2020-06-07",73,4,121,204,4748,0.671019376579612,0,0,387,457,1,7854,21,3155,NA,21
"349","2020-03-14",3,5,41,103,4113,0.442499392171165,0,0,367,379,18,53,9,46,4,9
"350","2020-03-15",6,5,45,135,4113,0.442499392171165,0,0,367,379,14,67,21,67,8,21
"351","2020-03-16",11,5,37,181,4113,0.442499392171165,0,0,367,379,24,91,14,81,14,14
"352","2020-03-17",21,5,35,218,4113,0.442499392171165,0,0,367,379,24,115,16,97,10,16
"353","2020-03-18",34,5,46,247,4113,0.442499392171165,0,0,367,379,36,151,15,112,18,15
"354","2020-03-19",42,5,46,277,4113,0.442499392171165,0,0,367,379,38,189,24,136,25,24
"355","2020-03-20",48,5,51,309,4113,0.442499392171165,0,0,367,379,41,230,25,161,27,25
"356","2020-03-21",56,5,53,348,4113,0.442499392171165,0,0,367,379,35,265,19,180,16,19
"357","2020-03-22",65,5,43,395,4113,0.442499392171165,0,0,367,379,36,301,22,202,27,22
"358","2020-03-23",84,5,56,434,4113,0.442499392171165,0,0,367,379,36,337,21,223,25,21
"359","2020-03-24",95,5,76,473,4113,0.442499392171165,0,0,367,379,35,372,34,257,24,34
"360","2020-03-25",96,5,88,500,4113,0.442499392171165,0,0,367,379,36,408,29,286,23,29
"361","2020-03-26",108,5,92,543,4113,0.442499392171165,0,0,367,379,37,445,39,325,26,39
"362","2020-03-27",120,5,97,572,4113,0.442499392171165,0,0,367,379,41,486,43,368,27,43
"363","2020-03-28",140,5,89,599,4113,0.442499392171165,0,0,367,379,32,518,37,405,18,37
"364","2020-03-29",148,5,86,610,4113,0.442499392171165,0,0,367,379,38,556,27,432,25,27
"365","2020-03-30",153,5,91,654,4113,0.442499392171165,0,0,367,379,36,592,27,459,24,27
"366","2020-03-31",165,5,115,680,4113,0.442499392171165,0,0,367,379,23,615,39,498,10,39
"367","2020-04-01",188,5,131,694,4113,0.442499392171165,0,0,367,379,29,644,20,518,18,20
"368","2020-04-02",195,5,117,723,4113,0.442499392171165,0,0,367,379,41,685,22,540,31,22
"369","2020-04-03",198,5,108,726,4113,0.442499392171165,0,0,367,379,51,736,22,562,35,22
"370","2020-04-04",199,5,111,722,4113,0.442499392171165,0,0,367,379,53,789,54,616,30,54
"371","2020-04-05",207,5,103,701,4113,0.442499392171165,0,0,367,379,45,834,61,677,28,61
"372","2020-04-06",206,5,132,719,4113,0.442499392171165,0,0,367,379,41,875,31,708,25,31
"373","2020-04-07",200,5,154,716,4113,0.442499392171165,0,0,367,379,31,906,24,732,19,24
"374","2020-04-08",199,5,157,717,4113,0.442499392171165,0,0,367,379,50,956,30,762,32,30
"375","2020-04-09",197,5,157,709,4113,0.442499392171165,0,0,367,379,53,1009,48,810,34,48
"376","2020-04-10",204,5,142,695,4113,0.442499392171165,0,0,367,379,29,1038,27,837,22,27
"377","2020-04-11",204,5,131,675,4113,0.442499392171165,0,0,367,379,40,1078,35,872,25,35
"378","2020-04-12",205,5,123,677,4113,0.442499392171165,0,0,367,379,39,1117,35,907,26,35
"379","2020-04-13",198,5,118,659,4113,0.442499392171165,0,0,367,379,43,1160,52,959,24,52
"380","2020-04-14",207,5,117,635,4113,0.442499392171165,0,0,367,379,33,1193,26,985,17,26
"381","2020-04-15",202,5,115,635,4113,0.442499392171165,0,0,367,379,38,1231,22,1007,24,22
"382","2020-04-16",203,5,103,623,4113,0.442499392171165,0,0,367,379,36,1267,23,1030,25,23
"383","2020-04-17",195,5,98,609,4113,0.442499392171165,0,0,367,379,40,1307,43,1073,21,43
"384","2020-04-18",177,5,95,609,4113,0.442499392171165,0,0,367,379,45,1352,20,1093,17,20
"385","2020-04-19",182,5,115,618,4113,0.442499392171165,0,0,367,379,37,1389,45,1138,20,45
"386","2020-04-20",178,5,151,597,4113,0.442499392171165,0,0,367,379,37,1426,59,1197,19,59
"387","2020-04-21",162,5,150,593,4113,0.442499392171165,0,0,367,379,32,1458,40,1237,16,40
"388","2020-04-22",149,5,146,570,4113,0.442499392171165,0,0,367,379,35,1493,28,1265,22,28
"389","2020-04-23",142,5,172,554,4113,0.442499392171165,0,0,367,379,39,1532,35,1300,17,35
"390","2020-04-24",145,5,166,567,4113,0.442499392171165,0,0,367,379,40,1572,47,1347,23,47
"391","2020-04-25",153,5,138,561,4113,0.442499392171165,0,0,367,379,34,1606,43,1390,25,43
"392","2020-04-26",148,5,124,547,4113,0.442499392171165,0,0,367,379,32,1638,40,1430,17,40
"393","2020-04-27",162,5,121,530,4113,0.442499392171165,0,0,367,379,38,1676,53,1483,22,53
"394","2020-04-28",167,5,100,540,4113,0.442499392171165,0,0,367,379,35,1711,37,1520,19,37
"395","2020-04-29",176,5,97,543,4113,0.442499392171165,0,0,367,379,36,1747,42,1562,16,42
"396","2020-04-30",176,5,111,543,4113,0.442499392171165,0,0,367,379,28,1775,36,1598,13,36
"397","2020-05-01",179,5,109,563,4113,0.442499392171165,0,0,367,379,29,1804,39,1637,14,39
"398","2020-05-02",179,5,115,559,4113,0.442499392171165,0,0,367,379,42,1846,39,1676,28,39
"399","2020-05-03",172,5,119,555,4113,0.442499392171165,0,0,367,379,51,1897,38,1714,30,38
"400","2020-05-04",162,5,133,562,4113,0.442499392171165,0,0,367,379,40,1937,48,1762,19,48
"401","2020-05-05",158,5,139,556,4113,0.442499392171165,0,0,367,379,44,1981,36,1798,26,36
"402","2020-05-06",151,5,122,551,4113,0.442499392171165,0,0,367,379,39,2020,39,1837,22,39
"403","2020-05-07",152,5,107,556,4113,0.442499392171165,0,0,367,379,43,2063,33,1870,22,33
"404","2020-05-08",148,5,113,565,4113,0.442499392171165,0,0,367,379,35,2098,42,1912,25,42
"405","2020-05-09",148,5,115,567,4113,0.442499392171165,0,0,367,379,32,2130,48,1960,18,48
"406","2020-05-10",151,5,109,563,4113,0.442499392171165,0,0,367,379,34,2164,34,1994,19,34
"407","2020-05-11",145,5,110,538,4113,0.442499392171165,0,0,367,379,31,2195,47,2041,21,47
"408","2020-05-12",141,5,116,515,4113,0.442499392171165,0,0,367,379,38,2233,46,2087,23,46
"409","2020-05-13",142,5,130,502,4113,0.442499392171165,0,0,367,379,23,2256,22,2109,15,22
"410","2020-05-14",140,5,137,496,4113,0.442499392171165,0,0,367,379,30,2286,29,2138,19,29
"411","2020-05-15",146,5,121,489,4113,0.442499392171165,0,0,367,379,28,2314,30,2168,16,30
"412","2020-05-16",152,5,113,476,4113,0.442499392171165,0,0,367,379,13,2327,31,2199,5,31
"413","2020-05-17",152,5,121,456,4113,0.442499392171165,0,0,367,379,30,2357,32,2231,16,32
"414","2020-05-18",159,5,120,449,4113,0.442499392171165,0,0,367,379,28,2385,27,2258,20,27
"415","2020-05-19",157,5,112,428,4113,0.442499392171165,0,0,367,379,21,2406,15,2273,9,15
"416","2020-05-20",149,5,104,420,4113,0.442499392171165,0,0,367,379,20,2426,20,2293,11,20
"417","2020-05-21",145,5,96,401,4113,0.442499392171165,0,0,367,379,29,2455,48,2341,17,48
"418","2020-05-22",135,5,94,385,4113,0.442499392171165,0,0,367,379,21,2476,28,2369,13,28
"419","2020-05-23",119,5,87,376,4113,0.442499392171165,0,0,367,379,20,2496,28,2397,11,28
"420","2020-05-24",108,5,98,368,4113,0.442499392171165,0,0,367,379,25,2521,19,2416,15,19
"421","2020-05-25",100,5,94,357,4113,0.442499392171165,0,0,367,379,25,2546,12,2428,14,12
"422","2020-05-26",104,5,92,338,4113,0.442499392171165,0,0,367,379,14,2560,25,2453,10,25
"423","2020-05-27",95,5,89,329,4113,0.442499392171165,0,0,367,379,18,2578,32,2485,11,32
"424","2020-05-28",97,5,89,328,4113,0.442499392171165,0,0,367,379,19,2597,32,2517,9,32
"425","2020-05-29",92,5,80,319,4113,0.442499392171165,0,0,367,379,20,2617,25,2542,9,25
"426","2020-05-30",93,5,85,311,4113,0.442499392171165,0,0,367,379,11,2628,30,2572,6,30
"427","2020-05-31",91,5,100,302,4113,0.442499392171165,0,0,367,379,20,2648,36,2608,10,36
"428","2020-06-01",95,5,109,277,4113,0.442499392171165,0,0,367,379,15,2663,28,2636,11,28
"429","2020-06-02",84,5,111,267,4113,0.442499392171165,0,0,367,379,10,2673,28,2664,6,28
"430","2020-06-03",89,5,112,248,4113,0.442499392171165,0,0,367,379,14,2687,31,2695,9,31
"431","2020-06-04",83,5,115,232,4113,0.442499392171165,0,0,367,379,16,2703,32,2727,8,32
"432","2020-06-05",78,5,108,228,4113,0.442499392171165,0,0,367,379,10,2713,24,2751,4,24
"433","2020-06-06",72,5,104,212,4113,0.442499392171165,0,0,367,379,12,2725,22,2773,5,22
"434","2020-06-07",71,5,96,203,4113,0.442499392171165,0,0,367,379,10,2735,23,2796,9,23
"435","2020-03-13",1,6,71,94,8049,0.905205615604423,0,0,650,1092,18,68,20,54,1,20
"436","2020-03-14",4,6,91,141,8049,0.905205615604423,0,0,650,1092,37,105,25,79,3,25
"437","2020-03-15",5,6,98,197,8049,0.905205615604423,0,0,650,1092,35,140,46,125,7,46
"438","2020-03-16",8,6,127,283,8049,0.905205615604423,0,0,650,1092,39,179,37,162,8,37
"439","2020-03-17",20,6,133,371,8049,0.905205615604423,0,0,650,1092,39,218,16,178,13,16
"440","2020-03-18",27,6,134,512,8049,0.905205615604423,0,0,650,1092,30,248,45,223,9,45
"441","2020-03-19",44,6,122,672,8049,0.905205615604423,0,0,650,1092,42,290,46,269,21,46
"442","2020-03-20",68,6,108,854,8049,0.905205615604423,0,0,650,1092,36,326,30,299,18,30
"443","2020-03-21",100,6,122,1087,8049,0.905205615604423,0,0,650,1092,34,360,12,311,10,12
"444","2020-03-22",139,6,134,1371,8049,0.905205615604423,0,0,650,1092,40,400,17,328,18,17
"445","2020-03-23",185,6,170,1584,8049,0.905205615604423,0,0,650,1092,56,456,42,370,24,42
"446","2020-03-24",229,6,216,1911,8049,0.905205615604423,0,0,650,1092,41,497,27,397,15,27
"447","2020-03-25",280,6,207,2289,8049,0.905205615604423,0,0,650,1092,44,541,22,419,17,22
"448","2020-03-26",356,6,182,2714,8049,0.905205615604423,0,0,650,1092,49,590,25,444,23,25
"449","2020-03-27",440,6,174,3091,8049,0.905205615604423,0,0,650,1092,37,627,22,466,17,22
"450","2020-03-28",529,6,150,3515,8049,0.905205615604423,0,0,650,1092,54,681,15,481,25,15
"451","2020-03-29",624,6,136,3826,8049,0.905205615604423,0,0,650,1092,63,744,28,509,29,28
"452","2020-03-30",728,6,107,4069,8049,0.905205615604423,0,0,650,1092,56,800,37,546,17,37
"453","2020-03-31",819,6,115,4256,8049,0.905205615604423,0,0,650,1092,56,856,42,588,30,42
"454","2020-04-01",931,6,118,4369,8049,0.905205615604423,0,0,650,1092,49,905,56,644,16,56
"455","2020-04-02",1011,6,153,4378,8049,0.905205615604423,0,0,650,1092,46,951,52,696,10,52
"456","2020-04-03",1089,6,161,4322,8049,0.905205615604423,0,0,650,1092,47,998,47,743,21,47
"457","2020-04-04",1155,6,187,4177,8049,0.905205615604423,0,0,650,1092,36,1034,31,774,9,31
"458","2020-04-05",1201,6,181,3999,8049,0.905205615604423,0,0,650,1092,62,1096,57,831,23,57
"459","2020-04-06",1203,6,207,3790,8049,0.905205615604423,0,0,650,1092,35,1131,23,854,5,23
"460","2020-04-07",1218,6,237,3542,8049,0.905205615604423,0,0,650,1092,39,1170,20,874,8,20
"461","2020-04-08",1210,6,270,3164,8049,0.905205615604423,0,0,650,1092,33,1203,42,916,14,42
"462","2020-04-09",1168,6,253,2823,8049,0.905205615604423,0,0,650,1092,37,1240,19,935,5,19
"463","2020-04-10",1122,6,251,2497,8049,0.905205615604423,0,0,650,1092,40,1280,16,951,10,16
"464","2020-04-11",1023,6,223,2178,8049,0.905205615604423,0,0,650,1092,42,1322,21,972,12,21
"465","2020-04-12",934,6,184,1861,8049,0.905205615604423,0,0,650,1092,53,1375,44,1016,16,44
"466","2020-04-13",850,6,172,1624,8049,0.905205615604423,0,0,650,1092,43,1418,18,1034,13,18
"467","2020-04-14",750,6,172,1378,8049,0.905205615604423,0,0,650,1092,41,1459,15,1049,12,15
"468","2020-04-15",636,6,189,1160,8049,0.905205615604423,0,0,650,1092,45,1504,11,1060,10,11
"469","2020-04-16",546,6,170,968,8049,0.905205615604423,0,0,650,1092,48,1552,7,1067,16,7
"470","2020-04-17",428,6,149,802,8049,0.905205615604423,0,0,650,1092,43,1595,8,1075,12,8
"471","2020-04-18",375,6,144,646,8049,0.905205615604423,0,0,650,1092,52,1647,13,1088,11,13
"472","2020-04-19",305,6,126,537,8049,0.905205615604423,0,0,650,1092,44,1691,48,1136,22,48
"473","2020-04-20",249,6,171,439,8049,0.905205615604423,0,0,650,1092,50,1741,58,1194,19,58
"474","2020-04-21",201,6,143,361,8049,0.905205615604423,0,0,650,1092,55,1796,39,1233,14,39
"475","2020-04-22",168,6,146,303,8049,0.905205615604423,0,0,650,1092,49,1845,55,1288,16,55
"476","2020-04-23",137,6,134,246,8049,0.905205615604423,0,0,650,1092,55,1900,27,1315,21,27
"477","2020-04-24",126,6,136,211,8049,0.905205615604423,0,0,650,1092,41,1941,20,1335,7,20
"478","2020-04-25",96,6,129,172,8049,0.905205615604423,0,0,650,1092,51,1992,21,1356,10,21
"479","2020-04-26",79,6,122,142,8049,0.905205615604423,0,0,650,1092,42,2034,41,1397,6,41
"480","2020-04-27",68,6,114,120,8049,0.905205615604423,0,0,650,1092,46,2080,18,1415,13,18
"481","2020-04-28",58,6,114,105,8049,0.905205615604423,0,0,650,1092,32,2112,15,1430,7,15
"482","2020-04-29",46,6,108,82,8049,0.905205615604423,0,0,650,1092,42,2154,26,1456,17,26
"483","2020-04-30",41,6,87,69,8049,0.905205615604423,0,0,650,1092,42,2196,40,1496,12,40
"484","2020-05-01",32,6,93,64,8049,0.905205615604423,0,0,650,1092,47,2243,34,1530,9,34
"485","2020-05-02",26,6,95,56,8049,0.905205615604423,0,0,650,1092,39,2282,24,1554,12,24
"486","2020-05-03",21,6,84,48,8049,0.905205615604423,0,0,650,1092,32,2314,39,1593,10,39
"487","2020-05-04",18,6,88,43,8049,0.905205615604423,0,0,650,1092,40,2354,23,1616,13,23
"488","2020-05-05",16,6,103,39,8049,0.905205615604423,0,0,650,1092,54,2408,10,1626,20,10
"489","2020-05-06",16,6,141,32,8049,0.905205615604423,0,0,650,1092,47,2455,9,1635,18,9
"490","2020-05-07",11,6,145,32,8049,0.905205615604423,0,0,650,1092,34,2489,9,1644,13,9
"491","2020-05-08",8,6,147,29,8049,0.905205615604423,0,0,650,1092,38,2527,21,1665,12,21
"492","2020-05-09",7,6,136,27,8049,0.905205615604423,0,0,650,1092,43,2570,22,1687,16,22
"493","2020-05-10",8,6,166,30,8049,0.905205615604423,0,0,650,1092,47,2617,18,1705,17,18
"494","2020-05-11",8,6,232,33,8049,0.905205615604423,0,0,650,1092,41,2658,43,1748,16,43
"495","2020-05-12",8,6,218,30,8049,0.905205615604423,0,0,650,1092,40,2698,37,1785,15,37
"496","2020-05-13",5,6,183,25,8049,0.905205615604423,0,0,650,1092,26,2724,20,1805,10,20
"497","2020-05-14",6,6,165,27,8049,0.905205615604423,0,0,650,1092,36,2760,41,1846,9,41
"498","2020-05-15",7,6,140,28,8049,0.905205615604423,0,0,650,1092,42,2802,32,1878,18,32
"499","2020-05-16",8,6,128,26,8049,0.905205615604423,0,0,650,1092,51,2853,39,1917,29,39
"500","2020-05-17",7,6,121,28,8049,0.905205615604423,0,0,650,1092,38,2891,29,1946,12,29
"501","2020-05-18",6,6,146,26,8049,0.905205615604423,0,0,650,1092,32,2923,23,1969,9,23
"502","2020-05-19",4,6,153,24,8049,0.905205615604423,0,0,650,1092,28,2951,53,2022,10,53
"503","2020-05-20",8,6,178,25,8049,0.905205615604423,0,0,650,1092,17,2968,27,2049,4,27
"504","2020-05-21",7,6,204,23,8049,0.905205615604423,0,0,650,1092,28,2996,11,2060,5,11
"505","2020-05-22",6,6,217,22,8049,0.905205615604423,0,0,650,1092,26,3022,12,2072,7,12
"506","2020-05-23",5,6,208,23,8049,0.905205615604423,0,0,650,1092,27,3049,41,2113,7,41
"507","2020-05-24",6,6,191,21,8049,0.905205615604423,0,0,650,1092,28,3077,22,2135,9,22
"508","2020-05-25",6,6,182,22,8049,0.905205615604423,0,0,650,1092,26,3103,45,2180,13,45
"509","2020-05-26",6,6,164,24,8049,0.905205615604423,0,0,650,1092,23,3126,63,2243,5,63
"510","2020-05-27",2,6,149,23,8049,0.905205615604423,0,0,650,1092,17,3143,37,2280,6,37
"511","2020-05-28",3,6,145,23,8049,0.905205615604423,0,0,650,1092,19,3162,30,2310,3,30
"512","2020-05-29",5,6,143,21,8049,0.905205615604423,0,0,650,1092,27,3189,46,2356,7,46
"513","2020-05-30",6,6,139,21,8049,0.905205615604423,0,0,650,1092,24,3213,30,2386,5,30
"514","2020-05-31",6,6,165,20,8049,0.905205615604423,0,0,650,1092,17,3230,15,2401,6,15
"515","2020-06-01",9,6,150,22,8049,0.905205615604423,0,0,650,1092,17,3247,40,2441,6,40
"516","2020-06-02",9,6,160,20,8049,0.905205615604423,0,0,650,1092,15,3262,50,2491,6,50
"517","2020-06-03",9,6,151,18,8049,0.905205615604423,0,0,650,1092,15,3277,26,2517,2,26
"518","2020-06-04",8,6,145,17,8049,0.905205615604423,0,0,650,1092,18,3295,38,2555,9,38
"519","2020-06-05",7,6,165,14,8049,0.905205615604423,0,0,650,1092,18,3313,46,2601,7,46
"520","2020-06-06",5,6,184,14,8049,0.905205615604423,0,0,650,1092,11,3324,34,2635,5,34
"521","2020-06-07",4,6,182,16,8049,0.905205615604423,0,0,650,1092,16,3340,32,2667,5,32
"522","2020-03-14",3,7,52,194,5200,0.281538461538462,0,0,449,464,17,60,14,37,4,14
"523","2020-03-15",9,7,50,247,5200,0.281538461538462,0,0,449,464,25,85,9,46,12,9
"524","2020-03-16",12,7,53,302,5200,0.281538461538462,0,0,449,464,24,109,6,52,10,6
"525","2020-03-17",25,7,52,377,5200,0.281538461538462,0,0,449,464,26,135,7,59,16,7
"526","2020-03-18",43,7,59,431,5200,0.281538461538462,0,0,449,464,31,166,11,70,20,11
"527","2020-03-19",57,7,56,477,5200,0.281538461538462,0,0,449,464,31,197,34,104,16,34
"528","2020-03-20",79,7,73,531,5200,0.281538461538462,0,0,449,464,30,227,47,151,20,47
"529","2020-03-21",99,7,85,565,5200,0.281538461538462,0,0,449,464,36,263,41,192,20,41
"530","2020-03-22",116,7,83,598,5200,0.281538461538462,0,0,449,464,37,300,25,217,22,25
"531","2020-03-23",148,7,81,635,5200,0.281538461538462,0,0,449,464,36,336,36,253,21,36
"532","2020-03-24",161,7,81,667,5200,0.281538461538462,0,0,449,464,42,378,25,278,29,25
"533","2020-03-25",165,7,99,690,5200,0.281538461538462,0,0,449,464,47,425,30,308,34,30
"534","2020-03-26",179,7,77,692,5200,0.281538461538462,0,0,449,464,43,468,38,346,27,38
"535","2020-03-27",184,7,78,711,5200,0.281538461538462,0,0,449,464,44,512,26,372,28,26
"536","2020-03-28",188,7,79,728,5200,0.281538461538462,0,0,449,464,43,555,22,394,31,22
"537","2020-03-29",195,7,72,757,5200,0.281538461538462,0,0,449,464,42,597,13,407,25,13
"538","2020-03-30",191,7,83,762,5200,0.281538461538462,0,0,449,464,35,632,14,421,25,14
"539","2020-03-31",200,7,91,784,5200,0.281538461538462,0,0,449,464,68,700,33,454,52,33
"540","2020-04-01",208,7,85,777,5200,0.281538461538462,0,0,449,464,35,735,49,503,24,49
"541","2020-04-02",212,7,80,784,5200,0.281538461538462,0,0,449,464,42,777,44,547,32,44
"542","2020-04-03",221,7,67,800,5200,0.281538461538462,0,0,449,464,39,816,28,575,26,28
"543","2020-04-04",228,7,91,820,5200,0.281538461538462,0,0,449,464,40,856,21,596,22,21
"544","2020-04-05",231,7,111,822,5200,0.281538461538462,0,0,449,464,45,901,36,632,30,36
"545","2020-04-06",231,7,132,841,5200,0.281538461538462,0,0,449,464,48,949,26,658,33,26
"546","2020-04-07",220,7,124,832,5200,0.281538461538462,0,0,449,464,50,999,19,677,30,19
"547","2020-04-08",219,7,110,849,5200,0.281538461538462,0,0,449,464,52,1051,56,733,31,56
"548","2020-04-09",223,7,113,855,5200,0.281538461538462,0,0,449,464,50,1101,34,767,32,34
"549","2020-04-10",224,7,119,852,5200,0.281538461538462,0,0,449,464,69,1170,18,785,42,18
"550","2020-04-11",231,7,129,862,5200,0.281538461538462,0,0,449,464,53,1223,29,814,30,29
"551","2020-04-12",222,7,135,879,5200,0.281538461538462,0,0,449,464,55,1278,15,829,36,15
"552","2020-04-13",224,7,138,880,5200,0.281538461538462,0,0,449,464,70,1348,43,872,41,43
"553","2020-04-14",245,7,144,876,5200,0.281538461538462,0,0,449,464,32,1380,37,909,25,37
"554","2020-04-15",258,7,132,869,5200,0.281538461538462,0,0,449,464,47,1427,16,925,28,16
"555","2020-04-16",252,7,118,881,5200,0.281538461538462,0,0,449,464,57,1484,14,939,48,14
"556","2020-04-17",248,7,114,860,5200,0.281538461538462,0,0,449,464,40,1524,43,982,26,43
"557","2020-04-18",247,7,134,842,5200,0.281538461538462,0,0,449,464,65,1589,24,1006,38,24
"558","2020-04-19",246,7,134,846,5200,0.281538461538462,0,0,449,464,44,1633,26,1032,32,26
"559","2020-04-20",253,7,138,843,5200,0.281538461538462,0,0,449,464,39,1672,14,1046,27,14
"560","2020-04-21",234,7,142,822,5200,0.281538461538462,0,0,449,464,40,1712,19,1065,28,19
"561","2020-04-22",218,7,143,806,5200,0.281538461538462,0,0,449,464,52,1764,12,1077,37,12
"562","2020-04-23",218,7,149,783,5200,0.281538461538462,0,0,449,464,68,1832,25,1102,48,25
"563","2020-04-24",219,7,152,774,5200,0.281538461538462,0,0,449,464,49,1881,39,1141,36,39
"564","2020-04-25",218,7,152,763,5200,0.281538461538462,0,0,449,464,42,1923,23,1164,32,23
"565","2020-04-26",234,7,150,778,5200,0.281538461538462,0,0,449,464,53,1976,39,1203,32,39
"566","2020-04-27",225,7,157,755,5200,0.281538461538462,0,0,449,464,54,2030,45,1248,42,45
"567","2020-04-28",227,7,147,748,5200,0.281538461538462,0,0,449,464,51,2081,40,1288,32,40
"568","2020-04-29",229,7,143,727,5200,0.281538461538462,0,0,449,464,51,2132,29,1317,34,29
"569","2020-04-30",234,7,140,725,5200,0.281538461538462,0,0,449,464,37,2169,23,1340,18,23
"570","2020-05-01",229,7,141,719,5200,0.281538461538462,0,0,449,464,39,2208,19,1359,24,19
"571","2020-05-02",208,7,136,700,5200,0.281538461538462,0,0,449,464,37,2245,20,1379,25,20
"572","2020-05-03",200,7,134,689,5200,0.281538461538462,0,0,449,464,43,2288,30,1409,30,30
"573","2020-05-04",200,7,123,687,5200,0.281538461538462,0,0,449,464,50,2338,21,1430,31,21
"574","2020-05-05",192,7,114,669,5200,0.281538461538462,0,0,449,464,38,2376,17,1447,27,17
"575","2020-05-06",190,7,111,667,5200,0.281538461538462,0,0,449,464,32,2408,13,1460,18,13
"576","2020-05-07",185,7,108,664,5200,0.281538461538462,0,0,449,464,38,2446,45,1505,23,45
"577","2020-05-08",186,7,105,661,5200,0.281538461538462,0,0,449,464,38,2484,61,1566,26,61
"578","2020-05-09",195,7,98,659,5200,0.281538461538462,0,0,449,464,36,2520,32,1598,16,32
"579","2020-05-10",191,7,104,638,5200,0.281538461538462,0,0,449,464,34,2554,28,1626,23,28
"580","2020-05-11",179,7,109,642,5200,0.281538461538462,0,0,449,464,32,2586,47,1673,17,47
"581","2020-05-12",182,7,132,618,5200,0.281538461538462,0,0,449,464,26,2612,29,1702,14,29
"582","2020-05-13",181,7,142,584,5200,0.281538461538462,0,0,449,464,29,2641,17,1719,17,17
"583","2020-05-14",173,7,159,566,5200,0.281538461538462,0,0,449,464,31,2672,40,1759,24,40
"584","2020-05-15",164,7,169,543,5200,0.281538461538462,0,0,449,464,24,2696,40,1799,13,40
"585","2020-05-16",155,7,162,524,5200,0.281538461538462,0,0,449,464,26,2722,34,1833,17,34
"586","2020-05-17",151,7,151,519,5200,0.281538461538462,0,0,449,464,29,2751,34,1867,13,34
"587","2020-05-18",151,7,148,487,5200,0.281538461538462,0,0,449,464,19,2770,16,1883,14,16
"588","2020-05-19",139,7,151,460,5200,0.281538461538462,0,0,449,464,27,2797,48,1931,21,48
"589","2020-05-20",134,7,144,437,5200,0.281538461538462,0,0,449,464,26,2823,43,1974,16,43
"590","2020-05-21",129,7,137,416,5200,0.281538461538462,0,0,449,464,25,2848,47,2021,15,47
"591","2020-05-22",114,7,109,386,5200,0.281538461538462,0,0,449,464,22,2870,21,2042,16,21
"592","2020-05-23",111,7,106,375,5200,0.281538461538462,0,0,449,464,28,2898,11,2053,14,11
"593","2020-05-24",105,7,101,370,5200,0.281538461538462,0,0,449,464,29,2927,12,2065,16,12
"594","2020-05-25",106,7,102,346,5200,0.281538461538462,0,0,449,464,23,2950,12,2077,16,12
"595","2020-05-26",112,7,101,347,5200,0.281538461538462,0,0,449,464,22,2972,13,2090,11,13
"596","2020-05-27",110,7,107,338,5200,0.281538461538462,0,0,449,464,14,2986,6,2096,10,6
"597","2020-05-28",104,7,94,329,5200,0.281538461538462,0,0,449,464,22,3008,10,2106,18,10
"598","2020-05-29",108,7,95,316,5200,0.281538461538462,0,0,449,464,13,3021,10,2116,10,10
"599","2020-05-30",110,7,100,316,5200,0.281538461538462,0,0,449,464,19,3040,18,2134,11,18
"600","2020-05-31",105,7,95,293,5200,0.281538461538462,0,0,449,464,23,3063,31,2165,7,31
"601","2020-06-01",98,7,105,269,5200,0.281538461538462,0,0,449,464,16,3079,34,2199,11,34
"602","2020-06-02",92,7,97,254,5200,0.281538461538462,0,0,449,464,14,3093,44,2243,9,44
"603","2020-06-03",78,7,92,250,5200,0.281538461538462,0,0,449,464,9,3102,45,2288,5,45
"604","2020-06-04",82,7,95,238,5200,0.281538461538462,0,0,449,464,13,3115,23,2311,6,23
"605","2020-06-05",81,7,99,226,5200,0.281538461538462,0,0,449,464,15,3130,10,2321,8,10
"606","2020-06-06",75,7,97,210,5200,0.281538461538462,0,0,449,464,18,3148,28,2349,15,28
"607","2020-06-07",66,7,87,199,5200,0.281538461538462,0,0,449,464,20,3168,14,2363,12,14
"608","2020-03-14",1,8,151,111,4563,0.401709401709402,0,0,392,885,28,122,10,31,4,10
"609","2020-03-15",1,8,164,153,4563,0.401709401709402,0,0,392,885,33,155,7,38,8,7
"610","2020-03-16",5,8,148,191,4563,0.401709401709402,0,0,392,885,38,193,15,53,14,15
"611","2020-03-17",11,8,178,223,4563,0.401709401709402,0,0,392,885,30,223,18,71,10,18
"612","2020-03-18",20,8,223,269,4563,0.401709401709402,0,0,392,885,41,264,15,86,19,15
"613","2020-03-19",26,8,220,315,4563,0.401709401709402,0,0,392,885,44,308,15,101,19,15
"614","2020-03-20",31,8,203,357,4563,0.401709401709402,0,0,392,885,33,341,9,110,9,9
"615","2020-03-21",48,8,213,392,4563,0.401709401709402,0,0,392,885,48,389,6,116,14,6
"616","2020-03-22",68,8,232,427,4563,0.401709401709402,0,0,392,885,43,432,17,133,18,17
"617","2020-03-23",78,8,235,467,4563,0.401709401709402,0,0,392,885,34,466,21,154,14,21
"618","2020-03-24",94,8,219,504,4563,0.401709401709402,0,0,392,885,48,514,14,168,21,14
"619","2020-03-25",104,8,216,540,4563,0.401709401709402,0,0,392,885,52,566,28,196,16,28
"620","2020-03-26",113,8,220,569,4563,0.401709401709402,0,0,392,885,53,619,19,215,20,19
"621","2020-03-27",132,8,196,602,4563,0.401709401709402,0,0,392,885,43,662,17,232,12,17
"622","2020-03-28",132,8,209,613,4563,0.401709401709402,0,0,392,885,52,714,29,261,16,29
"623","2020-03-29",138,8,230,628,4563,0.401709401709402,0,0,392,885,35,749,24,285,16,24
"624","2020-03-30",149,8,230,638,4563,0.401709401709402,0,0,392,885,41,790,29,314,11,29
"625","2020-03-31",148,8,222,639,4563,0.401709401709402,0,0,392,885,33,823,32,346,7,32
"626","2020-04-01",159,8,215,654,4563,0.401709401709402,0,0,392,885,43,866,15,361,14,15
"627","2020-04-02",170,8,215,663,4563,0.401709401709402,0,0,392,885,53,919,29,390,13,29
"628","2020-04-03",166,8,243,656,4563,0.401709401709402,0,0,392,885,45,964,22,412,13,22
"629","2020-04-04",173,8,274,664,4563,0.401709401709402,0,0,392,885,36,1000,10,422,8,10
"630","2020-04-05",169,8,283,684,4563,0.401709401709402,0,0,392,885,41,1041,6,428,5,6
"631","2020-04-06",168,8,307,659,4563,0.401709401709402,0,0,392,885,37,1078,13,441,9,13
"632","2020-04-07",171,8,288,666,4563,0.401709401709402,0,0,392,885,56,1134,8,449,18,8
"633","2020-04-08",172,8,287,700,4563,0.401709401709402,0,0,392,885,46,1180,13,462,15,13
"634","2020-04-09",168,8,274,709,4563,0.401709401709402,0,0,392,885,50,1230,26,488,21,26
"635","2020-04-10",175,8,291,728,4563,0.401709401709402,0,0,392,885,48,1278,27,515,22,27
"636","2020-04-11",189,8,296,725,4563,0.401709401709402,0,0,392,885,57,1335,15,530,14,15
"637","2020-04-12",197,8,288,750,4563,0.401709401709402,0,0,392,885,51,1386,38,568,24,38
"638","2020-04-13",207,8,274,771,4563,0.401709401709402,0,0,392,885,49,1435,17,585,23,17
"639","2020-04-14",211,8,253,770,4563,0.401709401709402,0,0,392,885,43,1478,8,593,14,8
"640","2020-04-15",212,8,239,767,4563,0.401709401709402,0,0,392,885,48,1526,29,622,17,29
"641","2020-04-16",223,8,234,781,4563,0.401709401709402,0,0,392,885,49,1575,22,644,20,22
"642","2020-04-17",240,8,227,794,4563,0.401709401709402,0,0,392,885,59,1634,21,665,14,21
"643","2020-04-18",232,8,211,797,4563,0.401709401709402,0,0,392,885,49,1683,40,705,14,40
"644","2020-04-19",231,8,253,801,4563,0.401709401709402,0,0,392,885,31,1714,39,744,13,39
"645","2020-04-20",223,8,281,795,4563,0.401709401709402,0,0,392,885,38,1752,22,766,8,22
"646","2020-04-21",226,8,277,768,4563,0.401709401709402,0,0,392,885,44,1796,39,805,9,39
"647","2020-04-22",230,8,263,769,4563,0.401709401709402,0,0,392,885,44,1840,21,826,8,21
"648","2020-04-23",225,8,244,767,4563,0.401709401709402,0,0,392,885,36,1876,16,842,11,16
"649","2020-04-24",212,8,251,766,4563,0.401709401709402,0,0,392,885,46,1922,39,881,12,39
"650","2020-04-25",211,8,299,770,4563,0.401709401709402,0,0,392,885,41,1963,39,920,7,39
"651","2020-04-26",220,8,348,761,4563,0.401709401709402,0,0,392,885,38,2001,34,954,10,34
"652","2020-04-27",225,8,333,747,4563,0.401709401709402,0,0,392,885,49,2050,22,976,10,22
"653","2020-04-28",225,8,327,731,4563,0.401709401709402,0,0,392,885,37,2087,17,993,10,17
"654","2020-04-29",222,8,327,714,4563,0.401709401709402,0,0,392,885,31,2118,41,1034,6,41
"655","2020-04-30",224,8,305,702,4563,0.401709401709402,0,0,392,885,45,2163,34,1068,15,34
"656","2020-05-01",219,8,306,685,4563,0.401709401709402,0,0,392,885,42,2205,37,1105,9,37
"657","2020-05-02",214,8,288,672,4563,0.401709401709402,0,0,392,885,35,2240,46,1151,10,46
"658","2020-05-03",204,8,299,646,4563,0.401709401709402,0,0,392,885,39,2279,28,1179,10,28
"659","2020-05-04",194,8,297,644,4563,0.401709401709402,0,0,392,885,45,2324,41,1220,11,41
"660","2020-05-05",189,8,262,633,4563,0.401709401709402,0,0,392,885,44,2368,58,1278,19,58
"661","2020-05-06",188,8,296,617,4563,0.401709401709402,0,0,392,885,39,2407,43,1321,10,43
"662","2020-05-07",186,8,318,586,4563,0.401709401709402,0,0,392,885,43,2450,49,1370,9,49
"663","2020-05-08",185,8,304,576,4563,0.401709401709402,0,0,392,885,29,2479,31,1401,3,31
"664","2020-05-09",187,8,299,565,4563,0.401709401709402,0,0,392,885,44,2523,34,1435,7,34
"665","2020-05-10",186,8,305,549,4563,0.401709401709402,0,0,392,885,44,2567,27,1462,16,27
"666","2020-05-11",189,8,299,544,4563,0.401709401709402,0,0,392,885,35,2602,49,1511,6,49
"667","2020-05-12",188,8,313,531,4563,0.401709401709402,0,0,392,885,30,2632,31,1542,6,31
"668","2020-05-13",168,8,325,501,4563,0.401709401709402,0,0,392,885,38,2670,16,1558,7,16
"669","2020-05-14",163,8,313,491,4563,0.401709401709402,0,0,392,885,39,2709,39,1597,12,39
"670","2020-05-15",152,8,277,478,4563,0.401709401709402,0,0,392,885,24,2733,43,1640,1,43
"671","2020-05-16",143,8,261,465,4563,0.401709401709402,0,0,392,885,30,2763,20,1660,11,20
"672","2020-05-17",126,8,268,437,4563,0.401709401709402,0,0,392,885,36,2799,16,1676,7,16
"673","2020-05-18",121,8,289,415,4563,0.401709401709402,0,0,392,885,22,2821,16,1692,4,16
"674","2020-05-19",116,8,260,416,4563,0.401709401709402,0,0,392,885,32,2853,28,1720,6,28
"675","2020-05-20",124,8,245,418,4563,0.401709401709402,0,0,392,885,32,2885,17,1737,6,17
"676","2020-05-21",125,8,265,419,4563,0.401709401709402,0,0,392,885,20,2905,10,1747,4,10
"677","2020-05-22",137,8,291,420,4563,0.401709401709402,0,0,392,885,21,2926,30,1777,5,30
"678","2020-05-23",137,8,273,402,4563,0.401709401709402,0,0,392,885,20,2946,22,1799,4,22
"679","2020-05-24",131,8,257,389,4563,0.401709401709402,0,0,392,885,17,2963,15,1814,4,15
"680","2020-05-25",133,8,250,395,4563,0.401709401709402,0,0,392,885,25,2988,10,1824,2,10
"681","2020-05-26",125,8,247,374,4563,0.401709401709402,0,0,392,885,18,3006,12,1836,5,12
"682","2020-05-27",121,8,238,361,4563,0.401709401709402,0,0,392,885,23,3029,27,1863,6,27
"683","2020-05-28",114,8,240,359,4563,0.401709401709402,0,0,392,885,20,3049,28,1891,12,28
"684","2020-05-29",105,8,242,341,4563,0.401709401709402,0,0,392,885,24,3073,29,1920,4,29
"685","2020-05-30",96,8,236,331,4563,0.401709401709402,0,0,392,885,16,3089,27,1947,10,27
"686","2020-05-31",113,8,239,314,4563,0.401709401709402,0,0,392,885,14,3103,29,1976,7,29
"687","2020-06-01",102,8,228,300,4563,0.401709401709402,0,0,392,885,13,3116,26,2002,2,26
"688","2020-06-02",107,8,211,283,4563,0.401709401709402,0,0,392,885,8,3124,15,2017,5,15
"689","2020-06-03",106,8,200,259,4563,0.401709401709402,0,0,392,885,12,3136,12,2029,2,12
"690","2020-06-04",101,8,224,242,4563,0.401709401709402,0,0,392,885,12,3148,15,2044,3,15
"691","2020-06-05",91,8,231,229,4563,0.401709401709402,0,0,392,885,20,3168,14,2058,5,14
"692","2020-06-06",92,8,226,222,4563,0.401709401709402,0,0,392,885,10,3178,12,2070,1,12
"693","2020-06-07",78,8,239,211,4563,0.401709401709402,0,0,392,885,17,3195,23,2093,5,23
"694","2020-03-14",1,9,47,47,7577,0.959878579912894,0,0,652,759,14,35,22,91,6,22
"695","2020-03-15",1,9,52,69,7577,0.959878579912894,0,0,652,759,20,55,15,106,14,15
"696","2020-03-16",6,9,42,98,7577,0.959878579912894,0,0,652,759,13,68,12,118,11,12
"697","2020-03-17",9,9,41,132,7577,0.959878579912894,0,0,652,759,21,89,14,132,15,14
"698","2020-03-18",16,9,53,168,7577,0.959878579912894,0,0,652,759,18,107,9,141,12,9
"699","2020-03-19",23,9,75,210,7577,0.959878579912894,0,0,652,759,20,127,40,181,14,40
"700","2020-03-20",28,9,79,267,7577,0.959878579912894,0,0,652,759,16,143,27,208,13,27
"701","2020-03-21",41,9,88,328,7577,0.959878579912894,0,0,652,759,17,160,61,269,14,61
"702","2020-03-22",54,9,114,403,7577,0.959878579912894,0,0,652,759,43,203,19,288,34,19
"703","2020-03-23",64,9,123,510,7577,0.959878579912894,0,0,652,759,32,235,19,307,30,19
"704","2020-03-24",74,9,121,597,7577,0.959878579912894,0,0,652,759,35,270,13,320,29,13
"705","2020-03-25",81,9,110,705,7577,0.959878579912894,0,0,652,759,45,315,10,330,36,10
"706","2020-03-26",102,9,136,861,7577,0.959878579912894,0,0,652,759,48,363,9,339,43,9
"707","2020-03-27",131,9,160,1021,7577,0.959878579912894,0,0,652,759,57,420,49,388,47,49
"708","2020-03-28",156,9,161,1177,7577,0.959878579912894,0,0,652,759,53,473,52,440,46,52
"709","2020-03-29",188,9,188,1359,7577,0.959878579912894,0,0,652,759,54,527,35,475,50,35
"710","2020-03-30",242,9,190,1564,7577,0.959878579912894,0,0,652,759,55,582,41,516,49,41
"711","2020-03-31",293,9,184,1800,7577,0.959878579912894,0,0,652,759,64,646,13,529,59,13
"712","2020-04-01",341,9,181,2022,7577,0.959878579912894,0,0,652,759,68,714,27,556,63,27
"713","2020-04-02",381,9,172,2314,7577,0.959878579912894,0,0,652,759,49,763,42,598,44,42
"714","2020-04-03",436,9,194,2572,7577,0.959878579912894,0,0,652,759,58,821,68,666,52,68
"715","2020-04-04",488,9,220,2821,7577,0.959878579912894,0,0,652,759,65,886,70,736,63,70
"716","2020-04-05",553,9,228,3121,7577,0.959878579912894,0,0,652,759,79,965,56,792,75,56
"717","2020-04-06",594,9,225,3338,7577,0.959878579912894,0,0,652,759,65,1030,31,823,57,31
"718","2020-04-07",666,9,219,3563,7577,0.959878579912894,0,0,652,759,72,1102,24,847,60,24
"719","2020-04-08",754,9,222,3691,7577,0.959878579912894,0,0,652,759,67,1169,20,867,59,20
"720","2020-04-09",852,9,217,3752,7577,0.959878579912894,0,0,652,759,84,1253,51,918,78,51
"721","2020-04-10",927,9,191,3751,7577,0.959878579912894,0,0,652,759,78,1331,31,949,70,31
"722","2020-04-11",988,9,183,3744,7577,0.959878579912894,0,0,652,759,87,1418,23,972,84,23
"723","2020-04-12",1036,9,179,3659,7577,0.959878579912894,0,0,652,759,65,1483,48,1020,61,48
"724","2020-04-13",1075,9,203,3475,7577,0.959878579912894,0,0,652,759,79,1562,29,1049,71,29
"725","2020-04-14",1088,9,227,3291,7577,0.959878579912894,0,0,652,759,75,1637,17,1066,68,17
"726","2020-04-15",1062,9,246,3052,7577,0.959878579912894,0,0,652,759,79,1716,49,1115,73,49
"727","2020-04-16",1040,9,256,2772,7577,0.959878579912894,0,0,652,759,74,1790,41,1156,68,41
"728","2020-04-17",990,9,272,2514,7577,0.959878579912894,0,0,652,759,82,1872,28,1184,76,28
"729","2020-04-18",942,9,288,2196,7577,0.959878579912894,0,0,652,759,94,1966,18,1202,86,18
"730","2020-04-19",879,9,284,1956,7577,0.959878579912894,0,0,652,759,85,2051,28,1230,80,28
"731","2020-04-20",809,9,271,1699,7577,0.959878579912894,0,0,652,759,82,2133,26,1256,78,26
"732","2020-04-21",719,9,247,1459,7577,0.959878579912894,0,0,652,759,93,2226,49,1305,85,49
"733","2020-04-22",664,9,215,1233,7577,0.959878579912894,0,0,652,759,87,2313,62,1367,81,62
"734","2020-04-23",572,9,186,1033,7577,0.959878579912894,0,0,652,759,85,2398,33,1400,79,33
"735","2020-04-24",492,9,194,879,7577,0.959878579912894,0,0,652,759,73,2471,15,1415,65,15
"736","2020-04-25",428,9,181,748,7577,0.959878579912894,0,0,652,759,54,2525,16,1431,51,16
"737","2020-04-26",354,9,186,617,7577,0.959878579912894,0,0,652,759,78,2603,65,1496,67,65
"738","2020-04-27",301,9,164,513,7577,0.959878579912894,0,0,652,759,80,2683,63,1559,69,63
"739","2020-04-28",256,9,192,433,7577,0.959878579912894,0,0,652,759,79,2762,44,1603,70,44
"740","2020-04-29",204,9,192,352,7577,0.959878579912894,0,0,652,759,80,2842,23,1626,76,23
"741","2020-04-30",169,9,172,295,7577,0.959878579912894,0,0,652,759,68,2910,21,1647,62,21
"742","2020-05-01",144,9,164,245,7577,0.959878579912894,0,0,652,759,60,2970,10,1657,58,10
"743","2020-05-02",107,9,208,214,7577,0.959878579912894,0,0,652,759,81,3051,20,1677,69,20
"744","2020-05-03",97,9,212,176,7577,0.959878579912894,0,0,652,759,55,3106,62,1739,51,62
"745","2020-05-04",75,9,186,144,7577,0.959878579912894,0,0,652,759,54,3160,31,1770,45,31
"746","2020-05-05",69,9,174,121,7577,0.959878579912894,0,0,652,759,61,3221,16,1786,55,16
"747","2020-05-06",62,9,149,110,7577,0.959878579912894,0,0,652,759,61,3282,23,1809,51,23
"748","2020-05-07",49,9,126,92,7577,0.959878579912894,0,0,652,759,37,3319,27,1836,34,27
"749","2020-05-08",45,9,126,79,7577,0.959878579912894,0,0,652,759,61,3380,66,1902,52,66
"750","2020-05-09",47,9,134,63,7577,0.959878579912894,0,0,652,759,71,3451,31,1933,67,31
"751","2020-05-10",38,9,177,61,7577,0.959878579912894,0,0,652,759,36,3487,20,1953,33,20
"752","2020-05-11",36,9,194,46,7577,0.959878579912894,0,0,652,759,67,3554,56,2009,62,56
"753","2020-05-12",28,9,210,41,7577,0.959878579912894,0,0,652,759,51,3605,28,2037,46,28
"754","2020-05-13",20,9,189,42,7577,0.959878579912894,0,0,652,759,52,3657,54,2091,49,54
"755","2020-05-14",17,9,176,38,7577,0.959878579912894,0,0,652,759,53,3710,18,2109,42,18
"756","2020-05-15",12,9,209,33,7577,0.959878579912894,0,0,652,759,42,3752,12,2121,38,12
"757","2020-05-16",9,9,204,31,7577,0.959878579912894,0,0,652,759,47,3799,10,2131,40,10
"758","2020-05-17",8,9,220,30,7577,0.959878579912894,0,0,652,759,34,3833,60,2191,29,60
"759","2020-05-18",8,9,197,31,7577,0.959878579912894,0,0,652,759,43,3876,45,2236,40,45
"760","2020-05-19",10,9,178,34,7577,0.959878579912894,0,0,652,759,31,3907,23,2259,30,23
"761","2020-05-20",9,9,184,30,7577,0.959878579912894,0,0,652,759,48,3955,56,2315,47,56
"762","2020-05-21",9,9,181,26,7577,0.959878579912894,0,0,652,759,44,3999,48,2363,38,48
"763","2020-05-22",10,9,177,27,7577,0.959878579912894,0,0,652,759,32,4031,34,2397,30,34
"764","2020-05-23",8,9,184,26,7577,0.959878579912894,0,0,652,759,44,4075,44,2441,40,44
"765","2020-05-24",8,9,173,27,7577,0.959878579912894,0,0,652,759,27,4102,38,2479,26,38
"766","2020-05-25",8,9,177,28,7577,0.959878579912894,0,0,652,759,27,4129,35,2514,25,35
"767","2020-05-26",6,9,184,27,7577,0.959878579912894,0,0,652,759,34,4163,35,2549,31,35
"768","2020-05-27",5,9,201,25,7577,0.959878579912894,0,0,652,759,35,4198,38,2587,29,38
"769","2020-05-28",5,9,200,22,7577,0.959878579912894,0,0,652,759,35,4233,28,2615,33,28
"770","2020-05-29",5,9,208,21,7577,0.959878579912894,0,0,652,759,27,4260,48,2663,21,48
"771","2020-05-30",7,9,228,20,7577,0.959878579912894,0,0,652,759,17,4277,20,2683,15,20
"772","2020-05-31",6,9,220,17,7577,0.959878579912894,0,0,652,759,25,4302,21,2704,25,21
"773","2020-06-01",5,9,191,16,7577,0.959878579912894,0,0,652,759,17,4319,47,2751,17,47
"774","2020-06-02",6,9,179,17,7577,0.959878579912894,0,0,652,759,24,4343,18,2769,23,18
"775","2020-06-03",6,9,162,16,7577,0.959878579912894,0,0,652,759,16,4359,22,2791,16,22
"776","2020-06-04",7,9,173,18,7577,0.959878579912894,0,0,652,759,16,4375,38,2829,15,38
"777","2020-06-05",7,9,163,14,7577,0.959878579912894,0,0,652,759,20,4395,43,2872,19,43
"778","2020-06-06",6,9,168,16,7577,0.959878579912894,0,0,652,759,19,4414,19,2891,17,19
"779","2020-06-07",6,9,151,16,7577,0.959878579912894,0,0,652,759,21,4435,15,2906,20,15
"780","2020-03-14",1,10,42,39,1912,0.587866108786611,0,0,161,780,29,96,17,45,14,17
"781","2020-03-15",4,10,62,51,1912,0.587866108786611,0,0,161,780,37,133,9,54,18,9
"782","2020-03-16",4,10,65,67,1912,0.587866108786611,0,0,161,780,49,182,17,71,25,17
"783","2020-03-17",6,10,88,92,1912,0.587866108786611,0,0,161,780,39,221,23,94,23,23
"784","2020-03-18",11,10,101,105,1912,0.587866108786611,0,0,161,780,40,261,7,101,23,7
"785","2020-03-19",17,10,115,125,1912,0.587866108786611,0,0,161,780,64,325,18,119,43,18
"786","2020-03-20",23,10,122,138,1912,0.587866108786611,0,0,161,780,68,393,8,127,40,8
"787","2020-03-21",24,10,120,152,1912,0.587866108786611,0,0,161,780,72,465,14,141,47,14
"788","2020-03-22",29,10,133,170,1912,0.587866108786611,0,0,161,780,56,521,10,151,33,10
"789","2020-03-23",32,10,139,180,1912,0.587866108786611,0,0,161,780,48,569,20,171,34,20
"790","2020-03-24",37,10,154,187,1912,0.587866108786611,0,0,161,780,84,653,18,189,55,18
"791","2020-03-25",39,10,155,187,1912,0.587866108786611,0,0,161,780,78,731,11,200,54,11
"792","2020-03-26",45,10,180,191,1912,0.587866108786611,0,0,161,780,72,803,14,214,51,14
"793","2020-03-27",45,10,192,200,1912,0.587866108786611,0,0,161,780,79,882,28,242,57,28
"794","2020-03-28",52,10,213,206,1912,0.587866108786611,0,0,161,780,78,960,25,267,56,25
"795","2020-03-29",54,10,194,208,1912,0.587866108786611,0,0,161,780,71,1031,14,281,57,14
"796","2020-03-30",56,10,189,206,1912,0.587866108786611,0,0,161,780,70,1101,27,308,54,27
"797","2020-03-31",54,10,201,204,1912,0.587866108786611,0,0,161,780,83,1184,15,323,63,15
"798","2020-04-01",55,10,180,202,1912,0.587866108786611,0,0,161,780,59,1243,20,343,45,20
"799","2020-04-02",51,10,177,205,1912,0.587866108786611,0,0,161,780,81,1324,24,367,61,24
"800","2020-04-03",55,10,175,197,1912,0.587866108786611,0,0,161,780,89,1413,15,382,68,15
"801","2020-04-04",54,10,169,195,1912,0.587866108786611,0,0,161,780,92,1505,16,398,62,16
"802","2020-04-05",53,10,187,197,1912,0.587866108786611,0,0,161,780,80,1585,13,411,55,13
"803","2020-04-06",55,10,186,193,1912,0.587866108786611,0,0,161,780,96,1681,13,424,72,13
"804","2020-04-07",56,10,202,191,1912,0.587866108786611,0,0,161,780,83,1764,19,443,60,19
"805","2020-04-08",54,10,199,189,1912,0.587866108786611,0,0,161,780,88,1852,18,461,66,18
"806","2020-04-09",55,10,186,189,1912,0.587866108786611,0,0,161,780,105,1957,20,481,79,20
"807","2020-04-10",51,10,200,198,1912,0.587866108786611,0,0,161,780,91,2048,25,506,69,25
"808","2020-04-11",51,10,227,204,1912,0.587866108786611,0,0,161,780,82,2130,23,529,57,23
"809","2020-04-12",55,10,246,208,1912,0.587866108786611,0,0,161,780,85,2215,20,549,63,20
"810","2020-04-13",57,10,223,213,1912,0.587866108786611,0,0,161,780,87,2302,14,563,60,14
"811","2020-04-14",66,10,195,214,1912,0.587866108786611,0,0,161,780,80,2382,14,577,56,14
"812","2020-04-15",68,10,175,216,1912,0.587866108786611,0,0,161,780,71,2453,31,608,52,31
"813","2020-04-16",68,10,209,222,1912,0.587866108786611,0,0,161,780,75,2528,15,623,49,15
"814","2020-04-17",76,10,218,222,1912,0.587866108786611,0,0,161,780,76,2604,38,661,58,38
"815","2020-04-18",75,10,199,222,1912,0.587866108786611,0,0,161,780,71,2675,23,684,45,23
"816","2020-04-19",66,10,228,237,1912,0.587866108786611,0,0,161,780,58,2733,8,692,36,8
"817","2020-04-20",68,10,258,241,1912,0.587866108786611,0,0,161,780,68,2801,28,720,48,28
"818","2020-04-21",57,10,269,248,1912,0.587866108786611,0,0,161,780,79,2880,15,735,56,15
"819","2020-04-22",59,10,255,257,1912,0.587866108786611,0,0,161,780,82,2962,18,753,60,18
"820","2020-04-23",58,10,223,277,1912,0.587866108786611,0,0,161,780,79,3041,39,792,58,39
"821","2020-04-24",58,10,224,278,1912,0.587866108786611,0,0,161,780,67,3108,22,814,45,22
"822","2020-04-25",59,10,243,282,1912,0.587866108786611,0,0,161,780,57,3165,14,828,36,14
"823","2020-04-26",64,10,259,287,1912,0.587866108786611,0,0,161,780,55,3220,11,839,37,11
"824","2020-04-27",64,10,239,301,1912,0.587866108786611,0,0,161,780,71,3291,28,867,44,28
"825","2020-04-28",75,10,251,304,1912,0.587866108786611,0,0,161,780,67,3358,16,883,49,16
"826","2020-04-29",76,10,226,304,1912,0.587866108786611,0,0,161,780,55,3413,11,894,39,11
"827","2020-04-30",78,10,207,301,1912,0.587866108786611,0,0,161,780,54,3467,15,909,38,15
"828","2020-05-01",74,10,191,293,1912,0.587866108786611,0,0,161,780,40,3507,10,919,17,10
"829","2020-05-02",76,10,173,293,1912,0.587866108786611,0,0,161,780,47,3554,11,930,28,11
"830","2020-05-03",84,10,182,290,1912,0.587866108786611,0,0,161,780,63,3617,15,945,42,15
"831","2020-05-04",91,10,157,283,1912,0.587866108786611,0,0,161,780,62,3679,8,953,40,8
"832","2020-05-05",85,10,156,297,1912,0.587866108786611,0,0,161,780,54,3733,7,960,33,7
"833","2020-05-06",85,10,150,301,1912,0.587866108786611,0,0,161,780,54,3787,16,976,36,16
"834","2020-05-07",87,10,138,311,1912,0.587866108786611,0,0,161,780,54,3841,37,1013,36,37
"835","2020-05-08",92,10,163,317,1912,0.587866108786611,0,0,161,780,59,3900,36,1049,40,36
"836","2020-05-09",92,10,172,305,1912,0.587866108786611,0,0,161,780,39,3939,29,1078,16,29
"837","2020-05-10",86,10,178,305,1912,0.587866108786611,0,0,161,780,45,3984,13,1091,31,13
"838","2020-05-11",83,10,166,314,1912,0.587866108786611,0,0,161,780,26,4010,37,1128,20,37
"839","2020-05-12",83,10,145,314,1912,0.587866108786611,0,0,161,780,39,4049,44,1172,20,44
"840","2020-05-13",80,10,163,297,1912,0.587866108786611,0,0,161,780,37,4086,36,1208,19,36
"841","2020-05-14",88,10,143,291,1912,0.587866108786611,0,0,161,780,24,4110,43,1251,14,43
"842","2020-05-15",83,10,146,285,1912,0.587866108786611,0,0,161,780,41,4151,46,1297,23,46
"843","2020-05-16",80,10,125,292,1912,0.587866108786611,0,0,161,780,39,4190,27,1324,27,27
"844","2020-05-17",78,10,124,294,1912,0.587866108786611,0,0,161,780,25,4215,12,1336,13,12
"845","2020-05-18",82,10,151,286,1912,0.587866108786611,0,0,161,780,38,4253,38,1374,26,38
"846","2020-05-19",86,10,176,274,1912,0.587866108786611,0,0,161,780,27,4280,21,1395,13,21
"847","2020-05-20",94,10,185,266,1912,0.587866108786611,0,0,161,780,25,4305,21,1416,14,21
"848","2020-05-21",88,10,179,251,1912,0.587866108786611,0,0,161,780,22,4327,17,1433,12,17
"849","2020-05-22",90,10,172,255,1912,0.587866108786611,0,0,161,780,24,4351,17,1450,17,17
"850","2020-05-23",92,10,179,247,1912,0.587866108786611,0,0,161,780,24,4375,32,1482,13,32
"851","2020-05-24",91,10,172,244,1912,0.587866108786611,0,0,161,780,23,4398,23,1505,13,23
"852","2020-05-25",78,10,162,228,1912,0.587866108786611,0,0,161,780,21,4419,19,1524,8,19
"853","2020-05-26",71,10,151,225,1912,0.587866108786611,0,0,161,780,18,4437,30,1554,12,30
"854","2020-05-27",65,10,147,224,1912,0.587866108786611,0,0,161,780,15,4452,37,1591,10,37
"855","2020-05-28",59,10,158,205,1912,0.587866108786611,0,0,161,780,13,4465,14,1605,7,14
"856","2020-05-29",56,10,148,202,1912,0.587866108786611,0,0,161,780,16,4481,14,1619,8,14
"857","2020-05-30",51,10,146,203,1912,0.587866108786611,0,0,161,780,10,4491,11,1630,3,11
"858","2020-05-31",53,10,131,198,1912,0.587866108786611,0,0,161,780,14,4505,7,1637,9,7
"859","2020-06-01",57,10,126,191,1912,0.587866108786611,0,0,161,780,14,4519,11,1648,7,11
"860","2020-06-02",56,10,116,187,1912,0.587866108786611,0,0,161,780,20,4539,10,1658,11,10
"861","2020-06-03",51,10,134,188,1912,0.587866108786611,0,0,161,780,17,4556,11,1669,6,11
"862","2020-06-04",51,10,141,183,1912,0.587866108786611,0,0,161,780,16,4572,16,1685,9,16
"863","2020-06-05",48,10,145,182,1912,0.587866108786611,0,0,161,780,9,4581,24,1709,5,24
"864","2020-06-06",52,10,138,175,1912,0.587866108786611,0,0,161,780,18,4599,27,1736,12,27
"865","2020-06-07",48,10,132,176,1912,0.587866108786611,0,0,161,780,16,4615,11,1747,9,11
"866","2020-03-13",1,11,108,102,4234,0.39348134152102,0,0,402,727,44,121,13,39,6,13
"867","2020-03-14",4,11,120,141,4234,0.39348134152102,0,0,402,727,39,160,31,70,8,31
"868","2020-03-15",11,11,107,180,4234,0.39348134152102,0,0,402,727,53,213,25,95,20,25
"869","2020-03-16",16,11,102,227,4234,0.39348134152102,0,0,402,727,60,273,31,126,17,31
"870","2020-03-17",29,11,99,269,4234,0.39348134152102,0,0,402,727,52,325,39,165,20,39
"871","2020-03-18",37,11,99,310,4234,0.39348134152102,0,0,402,727,51,376,48,213,18,48
"872","2020-03-19",49,11,116,357,4234,0.39348134152102,0,0,402,727,58,434,28,241,17,28
"873","2020-03-20",61,11,131,388,4234,0.39348134152102,0,0,402,727,76,510,24,265,32,24
"874","2020-03-21",76,11,136,426,4234,0.39348134152102,0,0,402,727,54,564,57,322,18,57
"875","2020-03-22",91,11,162,468,4234,0.39348134152102,0,0,402,727,67,631,49,371,35,49
"876","2020-03-23",105,11,180,502,4234,0.39348134152102,0,0,402,727,79,710,45,416,36,45
"877","2020-03-24",114,11,199,548,4234,0.39348134152102,0,0,402,727,59,769,45,461,31,45
"878","2020-03-25",130,11,201,583,4234,0.39348134152102,0,0,402,727,77,846,57,518,37,57
"879","2020-03-26",143,11,197,596,4234,0.39348134152102,0,0,402,727,89,935,71,589,38,71
"880","2020-03-27",155,11,237,605,4234,0.39348134152102,0,0,402,727,79,1014,54,643,45,54
"881","2020-03-28",168,11,232,603,4234,0.39348134152102,0,0,402,727,84,1098,44,687,44,44
"882","2020-03-29",169,11,258,621,4234,0.39348134152102,0,0,402,727,69,1167,40,727,30,40
"883","2020-03-30",188,11,270,642,4234,0.39348134152102,0,0,402,727,100,1267,39,766,56,39
"884","2020-03-31",191,11,276,636,4234,0.39348134152102,0,0,402,727,72,1339,46,812,39,46
"885","2020-04-01",193,11,252,633,4234,0.39348134152102,0,0,402,727,68,1407,31,843,28,31
"886","2020-04-02",188,11,218,622,4234,0.39348134152102,0,0,402,727,67,1474,31,874,39,31
"887","2020-04-03",186,11,172,611,4234,0.39348134152102,0,0,402,727,91,1565,46,920,55,46
"888","2020-04-04",174,11,148,619,4234,0.39348134152102,0,0,402,727,78,1643,51,971,37,51
"889","2020-04-05",175,11,146,623,4234,0.39348134152102,0,0,402,727,76,1719,59,1030,27,59
"890","2020-04-06",159,11,134,629,4234,0.39348134152102,0,0,402,727,85,1804,59,1089,45,59
"891","2020-04-07",159,11,117,619,4234,0.39348134152102,0,0,402,727,75,1879,57,1146,31,57
"892","2020-04-08",161,11,100,606,4234,0.39348134152102,0,0,402,727,77,1956,40,1186,32,40
"893","2020-04-09",168,11,92,621,4234,0.39348134152102,0,0,402,727,80,2036,33,1219,37,33
"894","2020-04-10",161,11,75,646,4234,0.39348134152102,0,0,402,727,64,2100,60,1279,29,60
"895","2020-04-11",161,11,92,664,4234,0.39348134152102,0,0,402,727,73,2173,50,1329,30,50
"896","2020-04-12",159,11,155,673,4234,0.39348134152102,0,0,402,727,80,2253,38,1367,39,38
"897","2020-04-13",156,11,191,674,4234,0.39348134152102,0,0,402,727,79,2332,35,1402,35,35
"898","2020-04-14",164,11,177,665,4234,0.39348134152102,0,0,402,727,69,2401,49,1451,29,49
"899","2020-04-15",175,11,224,682,4234,0.39348134152102,0,0,402,727,73,2474,52,1503,26,52
"900","2020-04-16",185,11,227,703,4234,0.39348134152102,0,0,402,727,89,2563,51,1554,43,51
"901","2020-04-17",202,11,240,731,4234,0.39348134152102,0,0,402,727,67,2630,36,1590,32,36
"902","2020-04-18",209,11,263,719,4234,0.39348134152102,0,0,402,727,69,2699,37,1627,26,37
"903","2020-04-19",213,11,265,694,4234,0.39348134152102,0,0,402,727,83,2782,34,1661,31,34
"904","2020-04-20",218,11,236,700,4234,0.39348134152102,0,0,402,727,61,2843,25,1686,21,25
"905","2020-04-21",225,11,208,707,4234,0.39348134152102,0,0,402,727,77,2920,31,1717,40,31
"906","2020-04-22",211,11,226,706,4234,0.39348134152102,0,0,402,727,57,2977,37,1754,19,37
"907","2020-04-23",211,11,207,673,4234,0.39348134152102,0,0,402,727,71,3048,47,1801,36,47
"908","2020-04-24",208,11,200,664,4234,0.39348134152102,0,0,402,727,74,3122,44,1845,30,44
"909","2020-04-25",201,11,201,647,4234,0.39348134152102,0,0,402,727,68,3190,46,1891,28,46
"910","2020-04-26",201,11,180,651,4234,0.39348134152102,0,0,402,727,65,3255,41,1932,27,41
"911","2020-04-27",202,11,199,654,4234,0.39348134152102,0,0,402,727,40,3295,40,1972,15,40
"912","2020-04-28",182,11,196,637,4234,0.39348134152102,0,0,402,727,68,3363,35,2007,21,35
"913","2020-04-29",174,11,189,599,4234,0.39348134152102,0,0,402,727,63,3426,27,2034,26,27
"914","2020-04-30",169,11,181,581,4234,0.39348134152102,0,0,402,727,58,3484,37,2071,26,37
"915","2020-05-01",169,11,208,571,4234,0.39348134152102,0,0,402,727,62,3546,40,2111,22,40
"916","2020-05-02",170,11,211,573,4234,0.39348134152102,0,0,402,727,51,3597,25,2136,14,25
"917","2020-05-03",166,11,191,557,4234,0.39348134152102,0,0,402,727,42,3639,41,2177,19,41
"918","2020-05-04",170,11,177,571,4234,0.39348134152102,0,0,402,727,68,3707,35,2212,28,35
"919","2020-05-05",171,11,168,571,4234,0.39348134152102,0,0,402,727,42,3749,59,2271,18,59
"920","2020-05-06",182,11,148,561,4234,0.39348134152102,0,0,402,727,47,3796,64,2335,21,64
"921","2020-05-07",177,11,135,561,4234,0.39348134152102,0,0,402,727,57,3853,50,2385,22,50
"922","2020-05-08",168,11,121,557,4234,0.39348134152102,0,0,402,727,55,3908,77,2462,24,77
"923","2020-05-09",174,11,127,544,4234,0.39348134152102,0,0,402,727,51,3959,57,2519,17,57
"924","2020-05-10",180,11,196,526,4234,0.39348134152102,0,0,402,727,46,4005,45,2564,17,45
"925","2020-05-11",169,11,240,515,4234,0.39348134152102,0,0,402,727,42,4047,51,2615,15,51
"926","2020-05-12",162,11,268,513,4234,0.39348134152102,0,0,402,727,43,4090,53,2668,20,53
"927","2020-05-13",149,11,282,505,4234,0.39348134152102,0,0,402,727,30,4120,63,2731,14,63
"928","2020-05-14",138,11,280,464,4234,0.39348134152102,0,0,402,727,48,4168,56,2787,16,56
"929","2020-05-15",134,11,275,452,4234,0.39348134152102,0,0,402,727,41,4209,40,2827,11,40
"930","2020-05-16",124,11,284,426,4234,0.39348134152102,0,0,402,727,33,4242,50,2877,9,50
"931","2020-05-17",111,11,280,412,4234,0.39348134152102,0,0,402,727,35,4277,51,2928,9,51
"932","2020-05-18",111,11,273,395,4234,0.39348134152102,0,0,402,727,25,4302,36,2964,13,36
"933","2020-05-19",113,11,237,369,4234,0.39348134152102,0,0,402,727,31,4333,34,2998,8,34
"934","2020-05-20",109,11,210,362,4234,0.39348134152102,0,0,402,727,29,4362,40,3038,11,40
"935","2020-05-21",107,11,170,344,4234,0.39348134152102,0,0,402,727,33,4395,33,3071,10,33
"936","2020-05-22",97,11,178,344,4234,0.39348134152102,0,0,402,727,25,4420,32,3103,4,32
"937","2020-05-23",95,11,174,330,4234,0.39348134152102,0,0,402,727,15,4435,51,3154,3,51
"938","2020-05-24",90,11,155,323,4234,0.39348134152102,0,0,402,727,21,4456,32,3186,13,32
"939","2020-05-25",85,11,122,297,4234,0.39348134152102,0,0,402,727,25,4481,47,3233,5,47
"940","2020-05-26",86,11,102,300,4234,0.39348134152102,0,0,402,727,31,4512,37,3270,10,37
"941","2020-05-27",91,11,94,289,4234,0.39348134152102,0,0,402,727,28,4540,40,3310,5,40
"942","2020-05-28",86,11,83,286,4234,0.39348134152102,0,0,402,727,22,4562,37,3347,8,37
"943","2020-05-29",85,11,85,293,4234,0.39348134152102,0,0,402,727,28,4590,40,3387,13,40
"944","2020-05-30",80,11,108,284,4234,0.39348134152102,0,0,402,727,18,4608,34,3421,6,34
"945","2020-05-31",86,11,103,276,4234,0.39348134152102,0,0,402,727,13,4621,65,3486,5,65
"946","2020-06-01",86,11,96,269,4234,0.39348134152102,0,0,402,727,19,4640,51,3537,5,51
"947","2020-06-02",77,11,94,269,4234,0.39348134152102,0,0,402,727,15,4655,38,3575,7,38
"948","2020-06-03",76,11,110,273,4234,0.39348134152102,0,0,402,727,10,4665,42,3617,4,42
"949","2020-06-04",82,11,120,270,4234,0.39348134152102,0,0,402,727,17,4682,48,3665,6,48
"950","2020-06-05",83,11,114,255,4234,0.39348134152102,0,0,402,727,10,4692,44,3709,6,44
"951","2020-06-06",83,11,124,254,4234,0.39348134152102,0,0,402,727,14,4706,52,3761,6,52
"952","2020-06-07",75,11,134,243,4234,0.39348134152102,0,0,402,727,16,4722,52,3813,7,52
"953","2020-03-12",1,12,17,76,4397,0.298840118262452,0,0,376,580,21,39,17,27,3,17
"954","2020-03-13",3,12,36,108,4397,0.298840118262452,0,0,376,580,28,67,5,32,11,5
"955","2020-03-14",6,12,56,150,4397,0.298840118262452,0,0,376,580,26,93,2,34,8,2
"956","2020-03-15",9,12,59,198,4397,0.298840118262452,0,0,376,580,36,129,2,36,16,2
"957","2020-03-16",16,12,64,255,4397,0.298840118262452,0,0,376,580,22,151,19,55,8,19
"958","2020-03-17",26,12,86,312,4397,0.298840118262452,0,0,376,580,29,180,10,65,15,10
"959","2020-03-18",38,12,84,346,4397,0.298840118262452,0,0,376,580,33,213,7,72,23,7
"960","2020-03-19",52,12,72,386,4397,0.298840118262452,0,0,376,580,44,257,4,76,28,4
"961","2020-03-20",62,12,74,415,4397,0.298840118262452,0,0,376,580,34,291,34,110,23,34
"962","2020-03-21",73,12,84,460,4397,0.298840118262452,0,0,376,580,57,348,13,123,32,13
"963","2020-03-22",86,12,97,489,4397,0.298840118262452,0,0,376,580,47,395,42,165,32,42
"964","2020-03-23",99,12,117,529,4397,0.298840118262452,0,0,376,580,51,446,15,180,32,15
"965","2020-03-24",104,12,128,552,4397,0.298840118262452,0,0,376,580,53,499,31,211,39,31
"966","2020-03-25",119,12,132,577,4397,0.298840118262452,0,0,376,580,52,551,12,223,35,12
"967","2020-03-26",125,12,148,599,4397,0.298840118262452,0,0,376,580,54,605,18,241,34,18
"968","2020-03-27",140,12,156,642,4397,0.298840118262452,0,0,376,580,77,682,27,268,58,27
"969","2020-03-28",152,12,153,651,4397,0.298840118262452,0,0,376,580,59,741,21,289,37,21
"970","2020-03-29",162,12,163,666,4397,0.298840118262452,0,0,376,580,73,814,36,325,49,36
"971","2020-03-30",167,12,165,650,4397,0.298840118262452,0,0,376,580,76,890,33,358,46,33
"972","2020-03-31",185,12,157,657,4397,0.298840118262452,0,0,376,580,69,959,33,391,54,33
"973","2020-04-01",192,12,176,670,4397,0.298840118262452,0,0,376,580,71,1030,39,430,52,39
"974","2020-04-02",206,12,179,676,4397,0.298840118262452,0,0,376,580,66,1096,14,444,45,14
"975","2020-04-03",201,12,168,689,4397,0.298840118262452,0,0,376,580,97,1193,15,459,73,15
"976","2020-04-04",206,12,154,685,4397,0.298840118262452,0,0,376,580,87,1280,13,472,64,13
"977","2020-04-05",201,12,158,661,4397,0.298840118262452,0,0,376,580,85,1365,33,505,62,33
"978","2020-04-06",197,12,162,648,4397,0.298840118262452,0,0,376,580,88,1453,27,532,66,27
"979","2020-04-07",183,12,175,637,4397,0.298840118262452,0,0,376,580,76,1529,39,571,56,39
"980","2020-04-08",173,12,180,622,4397,0.298840118262452,0,0,376,580,97,1626,19,590,77,19
"981","2020-04-09",162,12,180,637,4397,0.298840118262452,0,0,376,580,76,1702,14,604,61,14
"982","2020-04-10",164,12,200,645,4397,0.298840118262452,0,0,376,580,95,1797,24,628,76,24
"983","2020-04-11",157,12,202,648,4397,0.298840118262452,0,0,376,580,83,1880,50,678,56,50
"984","2020-04-12",166,12,184,642,4397,0.298840118262452,0,0,376,580,90,1970,66,744,66,66
"985","2020-04-13",166,12,186,649,4397,0.298840118262452,0,0,376,580,96,2066,50,794,74,50
"986","2020-04-14",173,12,200,666,4397,0.298840118262452,0,0,376,580,82,2148,35,829,64,35
"987","2020-04-15",172,12,217,671,4397,0.298840118262452,0,0,376,580,81,2229,33,862,71,33
"988","2020-04-16",173,12,209,653,4397,0.298840118262452,0,0,376,580,70,2299,46,908,57,46
"989","2020-04-17",182,12,211,655,4397,0.298840118262452,0,0,376,580,53,2352,54,962,44,54
"990","2020-04-18",189,12,206,640,4397,0.298840118262452,0,0,376,580,63,2415,44,1006,48,44
"991","2020-04-19",183,12,217,666,4397,0.298840118262452,0,0,376,580,92,2507,56,1062,74,56
"992","2020-04-20",177,12,214,662,4397,0.298840118262452,0,0,376,580,80,2587,36,1098,51,36
"993","2020-04-21",189,12,228,650,4397,0.298840118262452,0,0,376,580,78,2665,26,1124,55,26
"994","2020-04-22",191,12,231,654,4397,0.298840118262452,0,0,376,580,68,2733,36,1160,49,36
"995","2020-04-23",200,12,225,653,4397,0.298840118262452,0,0,376,580,65,2798,25,1185,50,25
"996","2020-04-24",196,12,216,661,4397,0.298840118262452,0,0,376,580,71,2869,25,1210,49,25
"997","2020-04-25",204,12,214,665,4397,0.298840118262452,0,0,376,580,62,2931,18,1228,45,18
"998","2020-04-26",203,12,200,660,4397,0.298840118262452,0,0,376,580,57,2988,43,1271,36,43
"999","2020-04-27",215,12,215,648,4397,0.298840118262452,0,0,376,580,81,3069,35,1306,60,35
"1000","2020-04-28",203,12,207,652,4397,0.298840118262452,0,0,376,580,69,3138,25,1331,45,25
"1001","2020-04-29",191,12,210,668,4397,0.298840118262452,0,0,376,580,50,3188,54,1385,36,54
"1002","2020-04-30",181,12,227,670,4397,0.298840118262452,0,0,376,580,70,3258,26,1411,54,26
"1003","2020-05-01",184,12,245,659,4397,0.298840118262452,0,0,376,580,69,3327,18,1429,48,18
"1004","2020-05-02",176,12,245,646,4397,0.298840118262452,0,0,376,580,62,3389,40,1469,47,40
"1005","2020-05-03",167,12,248,642,4397,0.298840118262452,0,0,376,580,56,3445,29,1498,40,29
"1006","2020-05-04",173,12,273,616,4397,0.298840118262452,0,0,376,580,47,3492,45,1543,30,45
"1007","2020-05-05",166,12,281,621,4397,0.298840118262452,0,0,376,580,58,3550,27,1570,35,27
"1008","2020-05-06",171,12,272,598,4397,0.298840118262452,0,0,376,580,49,3599,55,1625,32,55
"1009","2020-05-07",171,12,274,591,4397,0.298840118262452,0,0,376,580,52,3651,46,1671,42,46
"1010","2020-05-08",164,12,271,551,4397,0.298840118262452,0,0,376,580,59,3710,64,1735,43,64
"1011","2020-05-09",156,12,250,547,4397,0.298840118262452,0,0,376,580,55,3765,73,1808,39,73
"1012","2020-05-10",155,12,243,535,4397,0.298840118262452,0,0,376,580,45,3810,55,1863,34,55
"1013","2020-05-11",143,12,248,525,4397,0.298840118262452,0,0,376,580,39,3849,39,1902,27,39
"1014","2020-05-12",147,12,232,520,4397,0.298840118262452,0,0,376,580,39,3888,45,1947,30,45
"1015","2020-05-13",156,12,240,513,4397,0.298840118262452,0,0,376,580,38,3926,32,1979,24,32
"1016","2020-05-14",154,12,241,508,4397,0.298840118262452,0,0,376,580,43,3969,41,2020,24,41
"1017","2020-05-15",147,12,234,499,4397,0.298840118262452,0,0,376,580,32,4001,25,2045,27,25
"1018","2020-05-16",145,12,238,484,4397,0.298840118262452,0,0,376,580,45,4046,22,2067,34,22
"1019","2020-05-17",152,12,246,466,4397,0.298840118262452,0,0,376,580,31,4077,23,2090,20,23
"1020","2020-05-18",143,12,241,449,4397,0.298840118262452,0,0,376,580,32,4109,19,2109,21,19
"1021","2020-05-19",142,12,212,452,4397,0.298840118262452,0,0,376,580,27,4136,29,2138,20,29
"1022","2020-05-20",133,12,187,431,4397,0.298840118262452,0,0,376,580,28,4164,13,2151,15,13
"1023","2020-05-21",123,12,181,404,4397,0.298840118262452,0,0,376,580,18,4182,48,2199,9,48
"1024","2020-05-22",126,12,172,386,4397,0.298840118262452,0,0,376,580,19,4201,35,2234,12,35
"1025","2020-05-23",118,12,157,376,4397,0.298840118262452,0,0,376,580,28,4229,40,2274,15,40
"1026","2020-05-24",112,12,144,353,4397,0.298840118262452,0,0,376,580,25,4254,45,2319,16,45
"1027","2020-05-25",115,12,141,346,4397,0.298840118262452,0,0,376,580,28,4282,44,2363,18,44
"1028","2020-05-26",102,12,151,334,4397,0.298840118262452,0,0,376,580,26,4308,29,2392,16,29
"1029","2020-05-27",99,12,155,311,4397,0.298840118262452,0,0,376,580,27,4335,22,2414,17,22
"1030","2020-05-28",105,12,161,291,4397,0.298840118262452,0,0,376,580,22,4357,32,2446,13,32
"1031","2020-05-29",104,12,155,276,4397,0.298840118262452,0,0,376,580,18,4375,22,2468,9,22
"1032","2020-05-30",106,12,155,290,4397,0.298840118262452,0,0,376,580,20,4395,23,2491,15,23
"1033","2020-05-31",97,12,157,276,4397,0.298840118262452,0,0,376,580,15,4410,8,2499,12,8
"1034","2020-06-01",94,12,158,262,4397,0.298840118262452,0,0,376,580,20,4430,9,2508,14,9
"1035","2020-06-02",94,12,155,248,4397,0.298840118262452,0,0,376,580,21,4451,15,2523,11,15
"1036","2020-06-03",90,12,171,241,4397,0.298840118262452,0,0,376,580,19,4470,20,2543,13,20
"1037","2020-06-04",84,12,168,235,4397,0.298840118262452,0,0,376,580,21,4491,22,2565,8,22
"1038","2020-06-05",76,12,167,234,4397,0.298840118262452,0,0,376,580,14,4505,27,2592,12,27
"1039","2020-06-06",72,12,155,232,4397,0.298840118262452,0,0,376,580,17,4522,21,2613,11,21
"1040","2020-06-07",78,12,144,216,4397,0.298840118262452,0,0,376,580,12,4534,23,2636,9,23
"1041","2020-03-14",1,13,63,61,2069,0.492508458192363,0,0,191,573,26,103,8,32,3,8
"1042","2020-03-15",2,13,81,84,2069,0.492508458192363,0,0,191,573,32,135,10,42,11,10
"1043","2020-03-16",8,13,89,105,2069,0.492508458192363,0,0,191,573,46,181,6,48,15,6
"1044","2020-03-17",12,13,91,125,2069,0.492508458192363,0,0,191,573,38,219,4,52,18,4
"1045","2020-03-18",13,13,84,143,2069,0.492508458192363,0,0,191,573,31,250,11,63,9,11
"1046","2020-03-19",19,13,92,165,2069,0.492508458192363,0,0,191,573,37,287,11,74,9,11
"1047","2020-03-20",30,13,91,185,2069,0.492508458192363,0,0,191,573,44,331,9,83,23,9
"1048","2020-03-21",39,13,117,197,2069,0.492508458192363,0,0,191,573,52,383,3,86,23,3
"1049","2020-03-22",45,13,156,223,2069,0.492508458192363,0,0,191,573,59,442,2,88,40,2
"1050","2020-03-23",47,13,161,242,2069,0.492508458192363,0,0,191,573,62,504,15,103,34,15
"1051","2020-03-24",53,13,176,255,2069,0.492508458192363,0,0,191,573,62,566,17,120,36,17
"1052","2020-03-25",57,13,178,263,2069,0.492508458192363,0,0,191,573,56,622,21,141,34,21
"1053","2020-03-26",63,13,184,278,2069,0.492508458192363,0,0,191,573,76,698,23,164,42,23
"1054","2020-03-27",64,13,186,281,2069,0.492508458192363,0,0,191,573,57,755,20,184,34,20
"1055","2020-03-28",67,13,205,285,2069,0.492508458192363,0,0,191,573,69,824,14,198,41,14
"1056","2020-03-29",64,13,195,297,2069,0.492508458192363,0,0,191,573,58,882,12,210,33,12
"1057","2020-03-30",73,13,180,292,2069,0.492508458192363,0,0,191,573,77,959,17,227,40,17
"1058","2020-03-31",78,13,187,292,2069,0.492508458192363,0,0,191,573,68,1027,32,259,34,32
"1059","2020-04-01",86,13,177,292,2069,0.492508458192363,0,0,191,573,71,1098,31,290,40,31
"1060","2020-04-02",90,13,167,293,2069,0.492508458192363,0,0,191,573,76,1174,9,299,44,9
"1061","2020-04-03",93,13,169,288,2069,0.492508458192363,0,0,191,573,73,1247,10,309,37,10
"1062","2020-04-04",85,13,181,299,2069,0.492508458192363,0,0,191,573,56,1303,18,327,28,18
"1063","2020-04-05",95,13,190,310,2069,0.492508458192363,0,0,191,573,53,1356,18,345,29,18
"1064","2020-04-06",96,13,220,321,2069,0.492508458192363,0,0,191,573,62,1418,37,382,36,37
"1065","2020-04-07",89,13,231,329,2069,0.492508458192363,0,0,191,573,63,1481,44,426,37,44
"1066","2020-04-08",85,13,266,327,2069,0.492508458192363,0,0,191,573,64,1545,24,450,42,24
"1067","2020-04-09",84,13,243,322,2069,0.492508458192363,0,0,191,573,56,1601,31,481,27,31
"1068","2020-04-10",81,13,239,320,2069,0.492508458192363,0,0,191,573,54,1655,19,500,24,19
"1069","2020-04-11",95,13,252,313,2069,0.492508458192363,0,0,191,573,51,1706,12,512,21,12
"1070","2020-04-12",93,13,232,311,2069,0.492508458192363,0,0,191,573,50,1756,16,528,22,16
"1071","2020-04-13",91,13,232,324,2069,0.492508458192363,0,0,191,573,55,1811,14,542,24,14
"1072","2020-04-14",95,13,226,327,2069,0.492508458192363,0,0,191,573,50,1861,16,558,18,16
"1073","2020-04-15",102,13,208,312,2069,0.492508458192363,0,0,191,573,59,1920,19,577,29,19
"1074","2020-04-16",102,13,201,308,2069,0.492508458192363,0,0,191,573,54,1974,14,591,24,14
"1075","2020-04-17",103,13,217,316,2069,0.492508458192363,0,0,191,573,51,2025,12,603,22,12
"1076","2020-04-18",94,13,221,312,2069,0.492508458192363,0,0,191,573,65,2090,18,621,28,18
"1077","2020-04-19",94,13,218,299,2069,0.492508458192363,0,0,191,573,62,2152,29,650,29,29
"1078","2020-04-20",90,13,226,276,2069,0.492508458192363,0,0,191,573,36,2188,39,689,12,39
"1079","2020-04-21",90,13,230,280,2069,0.492508458192363,0,0,191,573,47,2235,36,725,20,36
"1080","2020-04-22",88,13,246,286,2069,0.492508458192363,0,0,191,573,43,2278,24,749,20,24
"1081","2020-04-23",83,13,260,275,2069,0.492508458192363,0,0,191,573,43,2321,46,795,20,46
"1082","2020-04-24",81,13,236,268,2069,0.492508458192363,0,0,191,573,57,2378,20,815,24,20
"1083","2020-04-25",80,13,243,261,2069,0.492508458192363,0,0,191,573,42,2420,11,826,19,11
"1084","2020-04-26",86,13,272,249,2069,0.492508458192363,0,0,191,573,41,2461,10,836,15,10
"1085","2020-04-27",86,13,279,248,2069,0.492508458192363,0,0,191,573,44,2505,15,851,14,15
"1086","2020-04-28",87,13,273,241,2069,0.492508458192363,0,0,191,573,68,2573,10,861,31,10
"1087","2020-04-29",85,13,277,240,2069,0.492508458192363,0,0,191,573,52,2625,11,872,23,11
"1088","2020-04-30",83,13,266,228,2069,0.492508458192363,0,0,191,573,51,2676,21,893,23,21
"1089","2020-05-01",82,13,238,233,2069,0.492508458192363,0,0,191,573,59,2735,22,915,28,22
"1090","2020-05-02",83,13,240,228,2069,0.492508458192363,0,0,191,573,40,2775,24,939,13,24
"1091","2020-05-03",72,13,219,233,2069,0.492508458192363,0,0,191,573,49,2824,19,958,20,19
"1092","2020-05-04",71,13,225,230,2069,0.492508458192363,0,0,191,573,50,2874,28,986,20,28
"1093","2020-05-05",64,13,225,230,2069,0.492508458192363,0,0,191,573,50,2924,31,1017,24,31
"1094","2020-05-06",61,13,218,236,2069,0.492508458192363,0,0,191,573,45,2969,10,1027,16,10
"1095","2020-05-07",60,13,213,240,2069,0.492508458192363,0,0,191,573,52,3021,15,1042,24,15
"1096","2020-05-08",59,13,211,248,2069,0.492508458192363,0,0,191,573,51,3072,17,1059,19,17
"1097","2020-05-09",58,13,211,251,2069,0.492508458192363,0,0,191,573,45,3117,17,1076,14,17
"1098","2020-05-10",56,13,209,264,2069,0.492508458192363,0,0,191,573,40,3157,13,1089,15,13
"1099","2020-05-11",54,13,201,256,2069,0.492508458192363,0,0,191,573,34,3191,8,1097,20,8
"1100","2020-05-12",60,13,210,267,2069,0.492508458192363,0,0,191,573,40,3231,30,1127,20,30
"1101","2020-05-13",59,13,219,258,2069,0.492508458192363,0,0,191,573,43,3274,26,1153,18,26
"1102","2020-05-14",58,13,225,268,2069,0.492508458192363,0,0,191,573,50,3324,24,1177,22,24
"1103","2020-05-15",58,13,213,271,2069,0.492508458192363,0,0,191,573,39,3363,11,1188,16,11
"1104","2020-05-16",58,13,207,270,2069,0.492508458192363,0,0,191,573,33,3396,12,1200,15,12
"1105","2020-05-17",70,13,229,268,2069,0.492508458192363,0,0,191,573,32,3428,16,1216,18,16
"1106","2020-05-18",73,13,231,267,2069,0.492508458192363,0,0,191,573,38,3466,17,1233,15,17
"1107","2020-05-19",70,13,223,267,2069,0.492508458192363,0,0,191,573,27,3493,8,1241,11,8
"1108","2020-05-20",76,13,208,257,2069,0.492508458192363,0,0,191,573,37,3530,12,1253,22,12
"1109","2020-05-21",79,13,226,243,2069,0.492508458192363,0,0,191,573,27,3557,10,1263,13,10
"1110","2020-05-22",85,13,225,231,2069,0.492508458192363,0,0,191,573,24,3581,8,1271,9,8
"1111","2020-05-23",86,13,245,234,2069,0.492508458192363,0,0,191,573,32,3613,13,1284,16,13
"1112","2020-05-24",81,13,237,228,2069,0.492508458192363,0,0,191,573,26,3639,20,1304,14,20
"1113","2020-05-25",78,13,238,222,2069,0.492508458192363,0,0,191,573,31,3670,13,1317,19,13
"1114","2020-05-26",82,13,227,214,2069,0.492508458192363,0,0,191,573,19,3689,14,1331,9,14
"1115","2020-05-27",76,13,217,206,2069,0.492508458192363,0,0,191,573,28,3717,12,1343,11,12
"1116","2020-05-28",74,13,216,210,2069,0.492508458192363,0,0,191,573,28,3745,7,1350,10,7
"1117","2020-05-29",73,13,209,211,2069,0.492508458192363,0,0,191,573,25,3770,10,1360,11,10
"1118","2020-05-30",72,13,196,201,2069,0.492508458192363,0,0,191,573,19,3789,14,1374,6,14
"1119","2020-05-31",63,13,188,196,2069,0.492508458192363,0,0,191,573,22,3811,22,1396,9,22
"1120","2020-06-01",69,13,184,200,2069,0.492508458192363,0,0,191,573,16,3827,24,1420,10,24
"1121","2020-06-02",66,13,201,197,2069,0.492508458192363,0,0,191,573,21,3848,18,1438,11,18
"1122","2020-06-03",64,13,195,199,2069,0.492508458192363,0,0,191,573,10,3858,14,1452,5,14
"1123","2020-06-04",66,13,193,187,2069,0.492508458192363,0,0,191,573,15,3873,21,1473,4,21
"1124","2020-06-05",60,13,196,173,2069,0.492508458192363,0,0,191,573,16,3889,14,1487,8,14
"1125","2020-06-06",57,13,194,177,2069,0.492508458192363,0,0,191,573,12,3901,11,1498,9,11
"1126","2020-06-07",58,13,204,175,2069,0.492508458192363,0,0,191,573,18,3919,14,1512,10,14
"1127","2020-03-13",1,14,65,57,6388,0.871477770820288,0,0,588,809,48,94,14,40,17,14
"1128","2020-03-14",2,14,79,79,6388,0.871477770820288,0,0,588,809,47,141,21,61,26,21
"1129","2020-03-15",6,14,83,116,6388,0.871477770820288,0,0,588,809,57,198,20,81,37,20
"1130","2020-03-16",10,14,89,149,6388,0.871477770820288,0,0,588,809,87,285,33,114,65,33
"1131","2020-03-17",16,14,93,188,6388,0.871477770820288,0,0,588,809,89,374,25,139,73,25
"1132","2020-03-18",25,14,106,233,6388,0.871477770820288,0,0,588,809,143,517,15,154,128,15
"1133","2020-03-19",35,14,129,277,6388,0.871477770820288,0,0,588,809,171,688,9,163,148,9
"1134","2020-03-20",46,14,149,304,6388,0.871477770820288,0,0,588,809,191,879,10,173,173,10
"1135","2020-03-21",58,14,158,357,6388,0.871477770820288,0,0,588,809,254,1133,28,201,238,28
"1136","2020-03-22",67,14,151,425,6388,0.871477770820288,0,0,588,809,306,1439,17,218,290,17
"1137","2020-03-23",79,14,137,500,6388,0.871477770820288,0,0,588,809,245,1684,45,263,230,45
"1138","2020-03-24",84,14,153,555,6388,0.871477770820288,0,0,588,809,374,2058,60,323,355,60
"1139","2020-03-25",95,14,164,630,6388,0.871477770820288,0,0,588,809,447,2505,32,355,427,32
"1140","2020-03-26",115,14,184,683,6388,0.871477770820288,0,0,588,809,512,3017,15,370,497,15
"1141","2020-03-27",127,14,199,784,6388,0.871477770820288,0,0,588,809,459,3476,20,390,450,20
"1142","2020-03-28",139,14,205,862,6388,0.871477770820288,0,0,588,809,551,4027,12,402,544,12
"1143","2020-03-29",156,14,194,925,6388,0.871477770820288,0,0,588,809,454,4481,7,409,446,7
"1144","2020-03-30",176,14,188,1042,6388,0.871477770820288,0,0,588,809,422,4903,9,418,406,9
"1145","2020-03-31",203,14,187,1133,6388,0.871477770820288,0,0,588,809,402,5305,14,432,394,14
"1146","2020-04-01",224,14,192,1230,6388,0.871477770820288,0,0,588,809,374,5679,8,440,370,8
"1147","2020-04-02",237,14,223,1314,6388,0.871477770820288,0,0,588,809,278,5957,49,489,270,49
"1148","2020-04-03",266,14,247,1382,6388,0.871477770820288,0,0,588,809,289,6246,30,519,283,30
"1149","2020-04-04",297,14,220,1506,6388,0.871477770820288,0,0,588,809,228,6474,50,569,223,50
"1150","2020-04-05",322,14,220,1579,6388,0.871477770820288,0,0,588,809,221,6695,27,596,213,27
"1151","2020-04-06",348,14,199,1605,6388,0.871477770820288,0,0,588,809,171,6866,48,644,169,48
"1152","2020-04-07",365,14,187,1688,6388,0.871477770820288,0,0,588,809,125,6991,62,706,121,62
"1153","2020-04-08",403,14,172,1738,6388,0.871477770820288,0,0,588,809,97,7088,55,761,94,55
"1154","2020-04-09",439,14,172,1776,6388,0.871477770820288,0,0,588,809,88,7176,26,787,85,26
"1155","2020-04-10",458,14,155,1828,6388,0.871477770820288,0,0,588,809,72,7248,45,832,66,45
"1156","2020-04-11",475,14,152,1825,6388,0.871477770820288,0,0,588,809,54,7302,20,852,52,20
"1157","2020-04-12",485,14,142,1831,6388,0.871477770820288,0,0,588,809,41,7343,7,859,39,7
"1158","2020-04-13",490,14,148,1818,6388,0.871477770820288,0,0,588,809,25,7368,11,870,25,11
"1159","2020-04-14",519,14,147,1835,6388,0.871477770820288,0,0,588,809,24,7392,29,899,23,29
"1160","2020-04-15",516,14,155,1843,6388,0.871477770820288,0,0,588,809,30,7422,31,930,28,31
"1161","2020-04-16",516,14,179,1827,6388,0.871477770820288,0,0,588,809,18,7440,10,940,18,10
"1162","2020-04-17",516,14,196,1794,6388,0.871477770820288,0,0,588,809,24,7464,6,946,24,6
"1163","2020-04-18",532,14,193,1715,6388,0.871477770820288,0,0,588,809,13,7477,8,954,13,8
"1164","2020-04-19",542,14,185,1670,6388,0.871477770820288,0,0,588,809,9,7486,8,962,6,8
"1165","2020-04-20",543,14,185,1604,6388,0.871477770820288,0,0,588,809,8,7494,45,1007,7,45
"1166","2020-04-21",534,14,181,1498,6388,0.871477770820288,0,0,588,809,8,7502,21,1028,5,21
"1167","2020-04-22",521,14,158,1427,6388,0.871477770820288,0,0,588,809,6,7508,7,1035,5,7
"1168","2020-04-23",504,14,166,1354,6388,0.871477770820288,0,0,588,809,5,7513,12,1047,2,12
"1169","2020-04-24",478,14,142,1256,6388,0.871477770820288,0,0,588,809,7,7520,9,1056,5,9
"1170","2020-04-25",438,14,152,1191,6388,0.871477770820288,0,0,588,809,3,7523,5,1061,2,5
"1171","2020-04-26",405,14,168,1127,6388,0.871477770820288,0,0,588,809,2,7525,5,1066,1,5
"1172","2020-04-27",382,14,197,1034,6388,0.871477770820288,0,0,588,809,3,7528,6,1072,2,6
"1173","2020-04-28",346,14,211,968,6388,0.871477770820288,0,0,588,809,5,7533,7,1079,3,7
"1174","2020-04-29",327,14,201,896,6388,0.871477770820288,0,0,588,809,4,7537,3,1082,2,3
"1175","2020-04-30",289,14,192,840,6388,0.871477770820288,0,0,588,809,3,7540,4,1086,2,4
"1176","2020-05-01",274,14,181,795,6388,0.871477770820288,0,0,588,809,3,7543,3,1089,NA,3
"1177","2020-05-02",256,14,176,742,6388,0.871477770820288,0,0,588,809,2,7545,3,1092,NA,3
"1178","2020-05-03",238,14,158,699,6388,0.871477770820288,0,0,588,809,2,7547,5,1097,2,5
"1179","2020-05-04",214,14,163,657,6388,0.871477770820288,0,0,588,809,3,7550,2,1099,NA,2
"1180","2020-05-05",195,14,162,623,6388,0.871477770820288,0,0,588,809,2,7552,12,1111,2,12
"1181","2020-05-06",176,14,153,582,6388,0.871477770820288,0,0,588,809,NA,NA,40,1151,NA,40
"1182","2020-05-07",179,14,143,540,6388,0.871477770820288,0,0,588,809,3,7555,20,1171,2,20
"1183","2020-05-08",168,14,163,504,6388,0.871477770820288,0,0,588,809,2,7557,10,1181,2,10
"1184","2020-05-09",159,14,200,468,6388,0.871477770820288,0,0,588,809,1,7558,12,1193,1,12
"1185","2020-05-10",156,14,199,447,6388,0.871477770820288,0,0,588,809,4,7562,36,1229,NA,36
"1186","2020-05-11",162,14,190,433,6388,0.871477770820288,0,0,588,809,5,7567,73,1302,2,73
"1187","2020-05-12",158,14,172,418,6388,0.871477770820288,0,0,588,809,1,7568,23,1325,NA,23
"1188","2020-05-13",149,14,164,392,6388,0.871477770820288,0,0,588,809,1,7569,10,1335,1,10
"1189","2020-05-14",140,14,158,373,6388,0.871477770820288,0,0,588,809,5,7574,9,1344,2,9
"1190","2020-05-15",131,14,153,351,6388,0.871477770820288,0,0,588,809,2,7576,8,1352,1,8
"1191","2020-05-16",124,14,159,328,6388,0.871477770820288,0,0,588,809,NA,NA,8,1360,NA,8
"1192","2020-05-17",115,14,177,314,6388,0.871477770820288,0,0,588,809,5,7581,14,1374,2,14
"1193","2020-05-18",92,14,216,303,6388,0.871477770820288,0,0,588,809,2,7583,37,1411,NA,37
"1194","2020-05-19",89,14,222,287,6388,0.871477770820288,0,0,588,809,2,7585,26,1437,1,26
"1195","2020-05-20",90,14,257,277,6388,0.871477770820288,0,0,588,809,3,7588,42,1479,1,42
"1196","2020-05-21",81,14,272,254,6388,0.871477770820288,0,0,588,809,1,7589,53,1532,1,53
"1197","2020-05-22",80,14,243,230,6388,0.871477770820288,0,0,588,809,NA,NA,42,1574,NA,42
"1198","2020-05-23",72,14,208,213,6388,0.871477770820288,0,0,588,809,3,7592,32,1606,1,32
"1199","2020-05-24",68,14,196,203,6388,0.871477770820288,0,0,588,809,2,7594,19,1625,2,19
"1200","2020-05-25",73,14,204,188,6388,0.871477770820288,0,0,588,809,3,7597,15,1640,1,15
"1201","2020-05-26",68,14,188,181,6388,0.871477770820288,0,0,588,809,4,7601,15,1655,2,15
"1202","2020-05-27",56,14,180,169,6388,0.871477770820288,0,0,588,809,2,7603,10,1665,1,10
"1203","2020-05-28",55,14,179,165,6388,0.871477770820288,0,0,588,809,3,7606,15,1680,1,15
"1204","2020-05-29",54,14,160,156,6388,0.871477770820288,0,0,588,809,NA,NA,29,1709,NA,29
"1205","2020-05-30",50,14,152,157,6388,0.871477770820288,0,0,588,809,1,7607,23,1732,NA,23
"1206","2020-05-31",47,14,152,160,6388,0.871477770820288,0,0,588,809,1,7608,49,1781,NA,49
"1207","2020-06-01",46,14,148,146,6388,0.871477770820288,0,0,588,809,2,7610,15,1796,1,15
"1208","2020-06-02",43,14,173,132,6388,0.871477770820288,0,0,588,809,1,7611,35,1831,1,35
"1209","2020-06-03",45,14,172,136,6388,0.871477770820288,0,0,588,809,1,7612,21,1852,NA,21
"1210","2020-06-04",40,14,179,123,6388,0.871477770820288,0,0,588,809,NA,NA,19,1871,NA,19
"1211","2020-06-05",37,14,181,122,6388,0.871477770820288,0,0,588,809,NA,NA,41,1912,NA,41
"1212","2020-06-06",41,14,164,121,6388,0.871477770820288,0,0,588,809,1,7613,39,1951,1,39
"1213","2020-06-07",37,14,180,109,6388,0.871477770820288,0,0,588,809,2,7615,32,1983,1,32
"1214","2020-03-12",2,15,119,117,8642,0.837653320990511,0,0,711,1217,46,82,22,37,NA,22
"1215","2020-03-13",4,15,121,189,8642,0.837653320990511,0,0,711,1217,66,148,8,45,7,8
"1216","2020-03-14",10,15,123,281,8642,0.837653320990511,0,0,711,1217,46,194,6,51,8,6
"1217","2020-03-15",21,15,109,399,8642,0.837653320990511,0,0,711,1217,53,247,7,58,10,7
"1218","2020-03-16",32,15,105,535,8642,0.837653320990511,0,0,711,1217,56,303,8,66,15,8
"1219","2020-03-17",51,15,108,707,8642,0.837653320990511,0,0,711,1217,77,380,7,73,26,7
"1220","2020-03-18",78,15,186,938,8642,0.837653320990511,0,0,711,1217,62,442,12,85,12,12
"1221","2020-03-19",105,15,240,1222,8642,0.837653320990511,0,0,711,1217,59,501,11,96,23,11
"1222","2020-03-20",141,15,233,1540,8642,0.837653320990511,0,0,711,1217,71,572,16,112,16,16
"1223","2020-03-21",193,15,198,1973,8642,0.837653320990511,0,0,711,1217,55,627,18,130,20,18
"1224","2020-03-22",254,15,173,2337,8642,0.837653320990511,0,0,711,1217,57,684,12,142,23,12
"1225","2020-03-23",332,15,208,2808,8642,0.837653320990511,0,0,711,1217,64,748,14,156,25,14
"1226","2020-03-24",407,15,226,3313,8642,0.837653320990511,0,0,711,1217,72,820,12,168,29,12
"1227","2020-03-25",471,15,255,3650,8642,0.837653320990511,0,0,711,1217,65,885,26,194,22,26
"1228","2020-03-26",576,15,265,4129,8642,0.837653320990511,0,0,711,1217,61,946,11,205,23,11
"1229","2020-03-27",710,15,232,4453,8642,0.837653320990511,0,0,711,1217,72,1018,16,221,26,16
"1230","2020-03-28",832,15,201,4775,8642,0.837653320990511,0,0,711,1217,81,1099,15,236,30,15
"1231","2020-03-29",958,15,184,4960,8642,0.837653320990511,0,0,711,1217,86,1185,11,247,24,11
"1232","2020-03-30",1117,15,194,4990,8642,0.837653320990511,0,0,711,1217,74,1259,21,268,31,21
"1233","2020-03-31",1243,15,211,4879,8642,0.837653320990511,0,0,711,1217,81,1340,18,286,31,18
"1234","2020-04-01",1352,15,225,4699,8642,0.837653320990511,0,0,711,1217,61,1401,16,302,22,16
"1235","2020-04-02",1438,15,215,4481,8642,0.837653320990511,0,0,711,1217,70,1471,12,314,23,12
"1236","2020-04-03",1462,15,260,4176,8642,0.837653320990511,0,0,711,1217,83,1554,7,321,36,7
"1237","2020-04-04",1455,15,260,3800,8642,0.837653320990511,0,0,711,1217,82,1636,24,345,23,24
"1238","2020-04-05",1426,15,266,3418,8642,0.837653320990511,0,0,711,1217,68,1704,40,385,28,40
"1239","2020-04-06",1307,15,243,3035,8642,0.837653320990511,0,0,711,1217,79,1783,33,418,27,33
"1240","2020-04-07",1203,15,221,2657,8642,0.837653320990511,0,0,711,1217,75,1858,19,437,28,19
"1241","2020-04-08",1103,15,203,2239,8642,0.837653320990511,0,0,711,1217,73,1931,8,445,20,8
"1242","2020-04-09",960,15,200,1912,8642,0.837653320990511,0,0,711,1217,79,2010,25,470,30,25
"1243","2020-04-10",823,15,221,1579,8642,0.837653320990511,0,0,711,1217,92,2102,31,501,38,31
"1244","2020-04-11",707,15,263,1319,8642,0.837653320990511,0,0,711,1217,65,2167,31,532,16,31
"1245","2020-04-12",594,15,246,1070,8642,0.837653320990511,0,0,711,1217,86,2253,35,567,34,35
"1246","2020-04-13",499,15,223,863,8642,0.837653320990511,0,0,711,1217,74,2327,24,591,26,24
"1247","2020-04-14",409,15,200,704,8642,0.837653320990511,0,0,711,1217,70,2397,28,619,24,28
"1248","2020-04-15",334,15,197,562,8642,0.837653320990511,0,0,711,1217,76,2473,20,639,21,20
"1249","2020-04-16",277,15,238,466,8642,0.837653320990511,0,0,711,1217,88,2561,10,649,31,10
"1250","2020-04-17",230,15,233,381,8642,0.837653320990511,0,0,711,1217,59,2620,17,666,17,17
"1251","2020-04-18",187,15,213,310,8642,0.837653320990511,0,0,711,1217,64,2684,34,700,21,34
"1252","2020-04-19",143,15,187,251,8642,0.837653320990511,0,0,711,1217,73,2757,31,731,31,31
"1253","2020-04-20",122,15,176,220,8642,0.837653320990511,0,0,711,1217,68,2825,26,757,20,26
"1254","2020-04-21",100,15,166,172,8642,0.837653320990511,0,0,711,1217,63,2888,32,789,24,32
"1255","2020-04-22",82,15,160,154,8642,0.837653320990511,0,0,711,1217,59,2947,24,813,21,24
"1256","2020-04-23",69,15,150,136,8642,0.837653320990511,0,0,711,1217,58,3005,31,844,16,31
"1257","2020-04-24",60,15,157,123,8642,0.837653320990511,0,0,711,1217,66,3071,30,874,22,30
"1258","2020-04-25",53,15,233,107,8642,0.837653320990511,0,0,711,1217,53,3124,31,905,13,31
"1259","2020-04-26",45,15,246,88,8642,0.837653320990511,0,0,711,1217,77,3201,23,928,24,23
"1260","2020-04-27",33,15,245,77,8642,0.837653320990511,0,0,711,1217,48,3249,32,960,13,32
"1261","2020-04-28",30,15,238,72,8642,0.837653320990511,0,0,711,1217,63,3312,27,987,13,27
"1262","2020-04-29",23,15,210,59,8642,0.837653320990511,0,0,711,1217,56,3368,19,1006,10,19
"1263","2020-04-30",22,15,220,53,8642,0.837653320990511,0,0,711,1217,62,3430,15,1021,20,15
"1264","2020-05-01",19,15,218,52,8642,0.837653320990511,0,0,711,1217,63,3493,26,1047,22,26
"1265","2020-05-02",13,15,244,50,8642,0.837653320990511,0,0,711,1217,50,3543,10,1057,12,10
"1266","2020-05-03",11,15,249,49,8642,0.837653320990511,0,0,711,1217,67,3610,22,1079,20,22
"1267","2020-05-04",13,15,217,47,8642,0.837653320990511,0,0,711,1217,49,3659,10,1089,11,10
"1268","2020-05-05",13,15,228,48,8642,0.837653320990511,0,0,711,1217,47,3706,16,1105,16,16
"1269","2020-05-06",14,15,278,46,8642,0.837653320990511,0,0,711,1217,60,3766,13,1118,21,13
"1270","2020-05-07",11,15,269,42,8642,0.837653320990511,0,0,711,1217,51,3817,13,1131,23,13
"1271","2020-05-08",11,15,271,42,8642,0.837653320990511,0,0,711,1217,52,3869,9,1140,13,9
"1272","2020-05-09",12,15,252,37,8642,0.837653320990511,0,0,711,1217,53,3922,13,1153,12,13
"1273","2020-05-10",11,15,221,39,8642,0.837653320990511,0,0,711,1217,51,3973,9,1162,10,9
"1274","2020-05-11",11,15,270,38,8642,0.837653320990511,0,0,711,1217,57,4030,20,1182,17,20
"1275","2020-05-12",11,15,296,37,8642,0.837653320990511,0,0,711,1217,36,4066,34,1216,13,34
"1276","2020-05-13",11,15,268,34,8642,0.837653320990511,0,0,711,1217,44,4110,25,1241,10,25
"1277","2020-05-14",9,15,262,35,8642,0.837653320990511,0,0,711,1217,42,4152,41,1282,9,41
"1278","2020-05-15",9,15,227,35,8642,0.837653320990511,0,0,711,1217,33,4185,41,1323,8,41
"1279","2020-05-16",10,15,211,30,8642,0.837653320990511,0,0,711,1217,26,4211,21,1344,5,21
"1280","2020-05-17",11,15,196,27,8642,0.837653320990511,0,0,711,1217,53,4264,25,1369,18,25
"1281","2020-05-18",9,15,182,28,8642,0.837653320990511,0,0,711,1217,35,4299,22,1391,5,22
"1282","2020-05-19",13,15,231,28,8642,0.837653320990511,0,0,711,1217,25,4324,27,1418,5,27
"1283","2020-05-20",12,15,294,30,8642,0.837653320990511,0,0,711,1217,35,4359,16,1434,12,16
"1284","2020-05-21",12,15,308,28,8642,0.837653320990511,0,0,711,1217,24,4383,16,1450,6,16
"1285","2020-05-22",13,15,284,26,8642,0.837653320990511,0,0,711,1217,26,4409,3,1453,7,3
"1286","2020-05-23",11,15,272,22,8642,0.837653320990511,0,0,711,1217,32,4441,13,1466,11,13
"1287","2020-05-24",12,15,246,23,8642,0.837653320990511,0,0,711,1217,29,4470,12,1478,7,12
"1288","2020-05-25",12,15,233,23,8642,0.837653320990511,0,0,711,1217,26,4496,24,1502,9,24
"1289","2020-05-26",10,15,244,24,8642,0.837653320990511,0,0,711,1217,29,4525,15,1517,4,15
"1290","2020-05-27",10,15,239,23,8642,0.837653320990511,0,0,711,1217,25,4550,20,1537,6,20
"1291","2020-05-28",10,15,264,25,8642,0.837653320990511,0,0,711,1217,23,4573,7,1544,4,7
"1292","2020-05-29",10,15,244,26,8642,0.837653320990511,0,0,711,1217,25,4598,18,1562,8,18
"1293","2020-05-30",10,15,217,25,8642,0.837653320990511,0,0,711,1217,23,4621,26,1588,8,26
"1294","2020-05-31",8,15,228,24,8642,0.837653320990511,0,0,711,1217,16,4637,13,1601,6,13
"1295","2020-06-01",7,15,205,22,8642,0.837653320990511,0,0,711,1217,17,4654,27,1628,5,27
"1296","2020-06-02",4,15,226,22,8642,0.837653320990511,0,0,711,1217,18,4672,12,1640,5,12
"1297","2020-06-03",4,15,255,21,8642,0.837653320990511,0,0,711,1217,18,4690,10,1650,4,10
"1298","2020-06-04",3,15,222,19,8642,0.837653320990511,0,0,711,1217,15,4705,19,1669,6,19
"1299","2020-06-05",2,15,193,19,8642,0.837653320990511,0,0,711,1217,11,4716,21,1690,3,21
"1300","2020-06-06",2,15,173,14,8642,0.837653320990511,0,0,711,1217,16,4732,8,1698,4,8
"1301","2020-06-07",1,15,166,13,8642,0.837653320990511,0,0,711,1217,15,4747,12,1710,3,12
"1302","2020-03-13",1,16,60,35,2826,0.562632696390658,0,0,220,901,37,78,31,75,4,31
"1303","2020-03-14",1,16,66,52,2826,0.562632696390658,0,0,220,901,33,111,56,131,4,56
"1304","2020-03-15",1,16,84,66,2826,0.562632696390658,0,0,220,901,42,153,35,166,16,35
"1305","2020-03-16",2,16,88,90,2826,0.562632696390658,0,0,220,901,39,192,34,200,14,34
"1306","2020-03-17",3,16,98,114,2826,0.562632696390658,0,0,220,901,33,225,44,244,12,44
"1307","2020-03-18",9,16,103,147,2826,0.562632696390658,0,0,220,901,51,276,70,314,16,70
"1308","2020-03-19",16,16,120,181,2826,0.562632696390658,0,0,220,901,52,328,41,355,21,41
"1309","2020-03-20",17,16,112,216,2826,0.562632696390658,0,0,220,901,50,378,28,383,23,28
"1310","2020-03-21",28,16,120,243,2826,0.562632696390658,0,0,220,901,48,426,43,426,17,43
"1311","2020-03-22",36,16,131,273,2826,0.562632696390658,0,0,220,901,67,493,46,472,34,46
"1312","2020-03-23",46,16,129,296,2826,0.562632696390658,0,0,220,901,57,550,54,526,34,54
"1313","2020-03-24",60,16,145,316,2826,0.562632696390658,0,0,220,901,64,614,32,558,30,32
"1314","2020-03-25",71,16,144,342,2826,0.562632696390658,0,0,220,901,57,671,38,596,28,38
"1315","2020-03-26",77,16,166,361,2826,0.562632696390658,0,0,220,901,70,741,30,626,36,30
"1316","2020-03-27",86,16,206,378,2826,0.562632696390658,0,0,220,901,63,804,25,651,30,25
"1317","2020-03-28",92,16,203,379,2826,0.562632696390658,0,0,220,901,65,869,28,679,28,28
"1318","2020-03-29",95,16,193,389,2826,0.562632696390658,0,0,220,901,58,927,53,732,25,53
"1319","2020-03-30",97,16,181,394,2826,0.562632696390658,0,0,220,901,52,979,45,777,29,45
"1320","2020-03-31",96,16,196,387,2826,0.562632696390658,0,0,220,901,61,1040,32,809,24,32
"1321","2020-04-01",91,16,183,384,2826,0.562632696390658,0,0,220,901,67,1107,36,845,43,36
"1322","2020-04-02",102,16,162,387,2826,0.562632696390658,0,0,220,901,54,1161,40,885,25,40
"1323","2020-04-03",108,16,171,401,2826,0.562632696390658,0,0,220,901,59,1220,46,931,19,46
"1324","2020-04-04",111,16,212,429,2826,0.562632696390658,0,0,220,901,58,1278,65,996,24,65
"1325","2020-04-05",117,16,244,436,2826,0.562632696390658,0,0,220,901,70,1348,43,1039,34,43
"1326","2020-04-06",121,16,228,430,2826,0.562632696390658,0,0,220,901,61,1409,69,1108,32,69
"1327","2020-04-07",136,16,213,433,2826,0.562632696390658,0,0,220,901,63,1472,44,1152,29,44
"1328","2020-04-08",136,16,208,448,2826,0.562632696390658,0,0,220,901,85,1557,47,1199,38,47
"1329","2020-04-09",135,16,216,463,2826,0.562632696390658,0,0,220,901,66,1623,45,1244,30,45
"1330","2020-04-10",131,16,204,464,2826,0.562632696390658,0,0,220,901,73,1696,50,1294,34,50
"1331","2020-04-11",139,16,193,463,2826,0.562632696390658,0,0,220,901,68,1764,61,1355,26,61
"1332","2020-04-12",139,16,212,465,2826,0.562632696390658,0,0,220,901,81,1845,43,1398,46,43
"1333","2020-04-13",143,16,236,464,2826,0.562632696390658,0,0,220,901,74,1919,33,1431,30,33
"1334","2020-04-14",137,16,224,458,2826,0.562632696390658,0,0,220,901,66,1985,29,1460,28,29
"1335","2020-04-15",141,16,211,446,2826,0.562632696390658,0,0,220,901,59,2044,27,1487,26,27
"1336","2020-04-16",134,16,211,441,2826,0.562632696390658,0,0,220,901,73,2117,34,1521,34,34
"1337","2020-04-17",137,16,207,428,2826,0.562632696390658,0,0,220,901,68,2185,22,1543,35,22
"1338","2020-04-18",131,16,193,431,2826,0.562632696390658,0,0,220,901,68,2253,21,1564,33,21
"1339","2020-04-19",131,16,221,415,2826,0.562632696390658,0,0,220,901,77,2330,67,1631,35,67
"1340","2020-04-20",130,16,242,409,2826,0.562632696390658,0,0,220,901,61,2391,53,1684,23,53
"1341","2020-04-21",116,16,235,413,2826,0.562632696390658,0,0,220,901,60,2451,36,1720,31,36
"1342","2020-04-22",114,16,225,411,2826,0.562632696390658,0,0,220,901,73,2524,40,1760,36,40
"1343","2020-04-23",114,16,228,419,2826,0.562632696390658,0,0,220,901,61,2585,31,1791,22,31
"1344","2020-04-24",113,16,247,416,2826,0.562632696390658,0,0,220,901,70,2655,35,1826,38,35
"1345","2020-04-25",105,16,257,412,2826,0.562632696390658,0,0,220,901,64,2719,61,1887,32,61
"1346","2020-04-26",108,16,262,397,2826,0.562632696390658,0,0,220,901,72,2791,66,1953,34,66
"1347","2020-04-27",105,16,273,393,2826,0.562632696390658,0,0,220,901,46,2837,61,2014,18,61
"1348","2020-04-28",114,16,270,397,2826,0.562632696390658,0,0,220,901,49,2886,53,2067,17,53
"1349","2020-04-29",112,16,262,392,2826,0.562632696390658,0,0,220,901,50,2936,47,2114,18,47
"1350","2020-04-30",112,16,249,382,2826,0.562632696390658,0,0,220,901,61,2997,40,2154,28,40
"1351","2020-05-01",111,16,254,374,2826,0.562632696390658,0,0,220,901,52,3049,58,2212,20,58
"1352","2020-05-02",115,16,259,377,2826,0.562632696390658,0,0,220,901,48,3097,33,2245,21,33
"1353","2020-05-03",107,16,262,392,2826,0.562632696390658,0,0,220,901,53,3150,51,2296,29,51
"1354","2020-05-04",100,16,257,397,2826,0.562632696390658,0,0,220,901,51,3201,35,2331,18,35
"1355","2020-05-05",101,16,269,409,2826,0.562632696390658,0,0,220,901,51,3252,33,2364,27,33
"1356","2020-05-06",106,16,261,410,2826,0.562632696390658,0,0,220,901,39,3291,54,2418,15,54
"1357","2020-05-07",102,16,236,429,2826,0.562632696390658,0,0,220,901,40,3331,56,2474,11,56
"1358","2020-05-08",107,16,250,425,2826,0.562632696390658,0,0,220,901,43,3374,34,2508,18,34
"1359","2020-05-09",103,16,267,428,2826,0.562632696390658,0,0,220,901,42,3416,48,2556,15,48
"1360","2020-05-10",115,16,255,426,2826,0.562632696390658,0,0,220,901,41,3457,51,2607,14,51
"1361","2020-05-11",130,16,253,418,2826,0.562632696390658,0,0,220,901,47,3504,46,2653,18,46
"1362","2020-05-12",128,16,252,421,2826,0.562632696390658,0,0,220,901,32,3536,58,2711,11,58
"1363","2020-05-13",130,16,231,409,2826,0.562632696390658,0,0,220,901,31,3567,55,2766,13,55
"1364","2020-05-14",137,16,229,391,2826,0.562632696390658,0,0,220,901,36,3603,47,2813,10,47
"1365","2020-05-15",135,16,234,385,2826,0.562632696390658,0,0,220,901,30,3633,32,2845,10,32
"1366","2020-05-16",133,16,215,360,2826,0.562632696390658,0,0,220,901,44,3677,36,2881,12,36
"1367","2020-05-17",124,16,209,344,2826,0.562632696390658,0,0,220,901,31,3708,32,2913,13,32
"1368","2020-05-18",110,16,201,333,2826,0.562632696390658,0,0,220,901,28,3736,50,2963,9,50
"1369","2020-05-19",110,16,175,317,2826,0.562632696390658,0,0,220,901,46,3782,30,2993,20,30
"1370","2020-05-20",112,16,175,298,2826,0.562632696390658,0,0,220,901,36,3818,35,3028,19,35
"1371","2020-05-21",106,16,208,294,2826,0.562632696390658,0,0,220,901,37,3855,52,3080,16,52
"1372","2020-05-22",99,16,208,285,2826,0.562632696390658,0,0,220,901,43,3898,60,3140,17,60
"1373","2020-05-23",98,16,193,278,2826,0.562632696390658,0,0,220,901,30,3928,36,3176,13,36
"1374","2020-05-24",96,16,182,278,2826,0.562632696390658,0,0,220,901,30,3958,39,3215,8,39
"1375","2020-05-25",96,16,167,269,2826,0.562632696390658,0,0,220,901,37,3995,17,3232,15,17
"1376","2020-05-26",91,16,174,253,2826,0.562632696390658,0,0,220,901,21,4016,30,3262,6,30
"1377","2020-05-27",84,16,179,246,2826,0.562632696390658,0,0,220,901,25,4041,35,3297,13,35
"1378","2020-05-28",83,16,182,241,2826,0.562632696390658,0,0,220,901,27,4068,29,3326,12,29
"1379","2020-05-29",80,16,182,239,2826,0.562632696390658,0,0,220,901,21,4089,37,3363,9,37
"1380","2020-05-30",80,16,186,223,2826,0.562632696390658,0,0,220,901,19,4108,29,3392,8,29
"1381","2020-05-31",76,16,199,216,2826,0.562632696390658,0,0,220,901,21,4129,43,3435,9,43
"1382","2020-06-01",81,16,191,208,2826,0.562632696390658,0,0,220,901,23,4152,20,3455,12,20
"1383","2020-06-02",75,16,188,194,2826,0.562632696390658,0,0,220,901,15,4167,30,3485,3,30
"1384","2020-06-03",66,16,191,196,2826,0.562632696390658,0,0,220,901,23,4190,17,3502,10,17
"1385","2020-06-04",60,16,199,190,2826,0.562632696390658,0,0,220,901,15,4205,47,3549,3,47
"1386","2020-06-05",58,16,190,183,2826,0.562632696390658,0,0,220,901,14,4219,32,3581,2,32
"1387","2020-06-06",52,16,176,171,2826,0.562632696390658,0,0,220,901,20,4239,37,3618,9,37
"1388","2020-06-07",50,16,175,162,2826,0.562632696390658,0,0,220,901,13,4252,53,3671,4,53
"1389","2020-03-13",1,17,79,68,3519,0.306337027564649,0,0,316,946,15,35,5,42,7,5
"1390","2020-03-14",4,17,96,105,3519,0.306337027564649,0,0,316,946,12,47,8,50,7,8
"1391","2020-03-15",7,17,129,140,3519,0.306337027564649,0,0,316,946,22,69,7,57,17,7
"1392","2020-03-16",13,17,148,179,3519,0.306337027564649,0,0,316,946,29,98,1,58,22,1
"1393","2020-03-17",23,17,138,218,3519,0.306337027564649,0,0,316,946,35,133,6,64,28,6
"1394","2020-03-18",31,17,168,244,3519,0.306337027564649,0,0,316,946,37,170,14,78,30,14
"1395","2020-03-19",43,17,178,282,3519,0.306337027564649,0,0,316,946,47,217,25,103,45,25
"1396","2020-03-20",57,17,174,312,3519,0.306337027564649,0,0,316,946,60,277,11,114,52,11
"1397","2020-03-21",72,17,154,340,3519,0.306337027564649,0,0,316,946,69,346,19,133,58,19
"1398","2020-03-22",82,17,149,364,3519,0.306337027564649,0,0,316,946,80,426,32,165,72,32
"1399","2020-03-23",90,17,162,400,3519,0.306337027564649,0,0,316,946,113,539,29,194,109,29
"1400","2020-03-24",96,17,173,412,3519,0.306337027564649,0,0,316,946,104,643,21,215,95,21
"1401","2020-03-25",110,17,164,425,3519,0.306337027564649,0,0,316,946,124,767,13,228,122,13
"1402","2020-03-26",113,17,153,441,3519,0.306337027564649,0,0,316,946,178,945,37,265,170,37
"1403","2020-03-27",111,17,141,446,3519,0.306337027564649,0,0,316,946,203,1148,39,304,199,39
"1404","2020-03-28",109,17,127,463,3519,0.306337027564649,0,0,316,946,192,1340,33,337,187,33
"1405","2020-03-29",121,17,149,492,3519,0.306337027564649,0,0,316,946,230,1570,43,380,223,43
"1406","2020-03-30",121,17,158,510,3519,0.306337027564649,0,0,316,946,261,1831,33,413,257,33
"1407","2020-03-31",133,17,184,525,3519,0.306337027564649,0,0,316,946,310,2141,29,442,305,29
"1408","2020-04-01",135,17,208,532,3519,0.306337027564649,0,0,316,946,301,2442,23,465,294,23
"1409","2020-04-02",143,17,229,539,3519,0.306337027564649,0,0,316,946,398,2840,15,480,394,15
"1410","2020-04-03",144,17,241,545,3519,0.306337027564649,0,0,316,946,370,3210,42,522,365,42
"1411","2020-04-04",145,17,222,531,3519,0.306337027564649,0,0,316,946,381,3591,41,563,374,41
"1412","2020-04-05",130,17,251,549,3519,0.306337027564649,0,0,316,946,448,4039,45,608,445,45
"1413","2020-04-06",137,17,235,535,3519,0.306337027564649,0,0,316,946,385,4424,31,639,382,31
"1414","2020-04-07",135,17,205,518,3519,0.306337027564649,0,0,316,946,429,4853,35,674,428,35
"1415","2020-04-08",129,17,220,498,3519,0.306337027564649,0,0,316,946,334,5187,51,725,328,51
"1416","2020-04-09",127,17,212,482,3519,0.306337027564649,0,0,316,946,309,5496,29,754,306,29
"1417","2020-04-10",132,17,177,469,3519,0.306337027564649,0,0,316,946,300,5796,18,772,295,18
"1418","2020-04-11",132,17,176,454,3519,0.306337027564649,0,0,316,946,276,6072,21,793,274,21
"1419","2020-04-12",138,17,190,468,3519,0.306337027564649,0,0,316,946,204,6276,24,817,203,24
"1420","2020-04-13",131,17,185,471,3519,0.306337027564649,0,0,316,946,163,6439,44,861,162,44
"1421","2020-04-14",120,17,164,470,3519,0.306337027564649,0,0,316,946,152,6591,54,915,151,54
"1422","2020-04-15",124,17,145,467,3519,0.306337027564649,0,0,316,946,142,6733,53,968,141,53
"1423","2020-04-16",126,17,117,478,3519,0.306337027564649,0,0,316,946,93,6826,62,1030,93,62
"1424","2020-04-17",129,17,108,481,3519,0.306337027564649,0,0,316,946,82,6908,55,1085,79,55
"1425","2020-04-18",128,17,114,491,3519,0.306337027564649,0,0,316,946,68,6976,58,1143,67,58
"1426","2020-04-19",132,17,155,491,3519,0.306337027564649,0,0,316,946,72,7048,43,1186,71,43
"1427","2020-04-20",137,17,199,500,3519,0.306337027564649,0,0,316,946,48,7096,42,1228,46,42
"1428","2020-04-21",143,17,212,506,3519,0.306337027564649,0,0,316,946,31,7127,31,1259,29,31
"1429","2020-04-22",137,17,230,508,3519,0.306337027564649,0,0,316,946,30,7157,12,1271,30,12
"1430","2020-04-23",137,17,212,524,3519,0.306337027564649,0,0,316,946,18,7175,18,1289,18,18
"1431","2020-04-24",139,17,201,528,3519,0.306337027564649,0,0,316,946,31,7206,40,1329,29,40
"1432","2020-04-25",147,17,185,533,3519,0.306337027564649,0,0,316,946,24,7230,20,1349,21,20
"1433","2020-04-26",147,17,194,530,3519,0.306337027564649,0,0,316,946,18,7248,15,1364,18,15
"1434","2020-04-27",155,17,189,539,3519,0.306337027564649,0,0,316,946,16,7264,8,1372,14,8
"1435","2020-04-28",150,17,176,522,3519,0.306337027564649,0,0,316,946,6,7270,50,1422,6,50
"1436","2020-04-29",156,17,177,520,3519,0.306337027564649,0,0,316,946,10,7280,30,1452,10,30
"1437","2020-04-30",153,17,193,503,3519,0.306337027564649,0,0,316,946,12,7292,21,1473,11,21
"1438","2020-05-01",148,17,200,498,3519,0.306337027564649,0,0,316,946,6,7298,22,1495,5,22
"1439","2020-05-02",138,17,201,476,3519,0.306337027564649,0,0,316,946,6,7304,45,1540,5,45
"1440","2020-05-03",132,17,198,468,3519,0.306337027564649,0,0,316,946,5,7309,32,1572,3,32
"1441","2020-05-04",126,17,186,459,3519,0.306337027564649,0,0,316,946,4,7313,9,1581,4,9
"1442","2020-05-05",122,17,157,464,3519,0.306337027564649,0,0,316,946,4,7317,15,1596,4,15
"1443","2020-05-06",121,17,137,470,3519,0.306337027564649,0,0,316,946,5,7322,11,1607,4,11
"1444","2020-05-07",119,17,134,467,3519,0.306337027564649,0,0,316,946,1,7323,10,1617,NA,10
"1445","2020-05-08",119,17,132,454,3519,0.306337027564649,0,0,316,946,4,7327,13,1630,4,13
"1446","2020-05-09",125,17,134,451,3519,0.306337027564649,0,0,316,946,4,7331,21,1651,3,21
"1447","2020-05-10",126,17,136,465,3519,0.306337027564649,0,0,316,946,3,7334,52,1703,3,52
"1448","2020-05-11",113,17,171,473,3519,0.306337027564649,0,0,316,946,1,7335,43,1746,NA,43
"1449","2020-05-12",122,17,191,474,3519,0.306337027564649,0,0,316,946,4,7339,48,1794,4,48
"1450","2020-05-13",122,17,175,440,3519,0.306337027564649,0,0,316,946,5,7344,18,1812,4,18
"1451","2020-05-14",124,17,190,436,3519,0.306337027564649,0,0,316,946,3,7347,20,1832,2,20
"1452","2020-05-15",116,17,189,434,3519,0.306337027564649,0,0,316,946,2,7349,47,1879,2,47
"1453","2020-05-16",117,17,198,451,3519,0.306337027564649,0,0,316,946,2,7351,27,1906,2,27
"1454","2020-05-17",117,17,191,445,3519,0.306337027564649,0,0,316,946,3,7354,49,1955,3,49
"1455","2020-05-18",128,17,185,427,3519,0.306337027564649,0,0,316,946,3,7357,19,1974,3,19
"1456","2020-05-19",126,17,211,414,3519,0.306337027564649,0,0,316,946,4,7361,16,1990,4,16
"1457","2020-05-20",120,17,202,400,3519,0.306337027564649,0,0,316,946,1,7362,36,2026,NA,36
"1458","2020-05-21",116,17,170,394,3519,0.306337027564649,0,0,316,946,NA,NA,35,2061,NA,35
"1459","2020-05-22",120,17,162,379,3519,0.306337027564649,0,0,316,946,3,7365,25,2086,2,25
"1460","2020-05-23",114,17,174,381,3519,0.306337027564649,0,0,316,946,4,7369,35,2121,4,35
"1461","2020-05-24",117,17,164,350,3519,0.306337027564649,0,0,316,946,2,7371,24,2145,1,24
"1462","2020-05-25",114,17,199,326,3519,0.306337027564649,0,0,316,946,2,7373,27,2172,NA,27
"1463","2020-05-26",107,17,251,320,3519,0.306337027564649,0,0,316,946,1,7374,34,2206,1,34
"1464","2020-05-27",106,17,246,314,3519,0.306337027564649,0,0,316,946,2,7376,42,2248,1,42
"1465","2020-05-28",101,17,234,301,3519,0.306337027564649,0,0,316,946,2,7378,36,2284,2,36
"1466","2020-05-29",103,17,228,297,3519,0.306337027564649,0,0,316,946,NA,NA,39,2323,NA,39
"1467","2020-05-30",98,17,214,286,3519,0.306337027564649,0,0,316,946,2,7380,47,2370,2,47
"1468","2020-05-31",91,17,196,272,3519,0.306337027564649,0,0,316,946,1,7381,35,2405,1,35
"1469","2020-06-01",86,17,209,264,3519,0.306337027564649,0,0,316,946,1,7382,16,2421,1,16
"1470","2020-06-02",88,17,214,255,3519,0.306337027564649,0,0,316,946,2,7384,19,2440,1,19
"1471","2020-06-03",80,17,208,239,3519,0.306337027564649,0,0,316,946,NA,NA,15,2455,NA,15
"1472","2020-06-04",77,17,203,228,3519,0.306337027564649,0,0,316,946,3,7387,31,2486,1,31
"1473","2020-06-05",68,17,225,224,3519,0.306337027564649,0,0,316,946,NA,NA,16,2502,NA,16
"1474","2020-06-06",68,17,208,212,3519,0.306337027564649,0,0,316,946,2,7389,32,2534,2,32
"1475","2020-06-07",70,17,207,201,3519,0.306337027564649,0,0,316,946,2,7391,16,2550,2,16
"1476","2020-03-14",1,18,62,60,3280,0.619207317073171,0,0,319,794,13,39,1,19,4,1
"1477","2020-03-15",5,18,65,85,3280,0.619207317073171,0,0,319,794,12,51,14,33,7,14
"1478","2020-03-16",7,18,69,109,3280,0.619207317073171,0,0,319,794,16,67,10,43,9,10
"1479","2020-03-17",11,18,66,134,3280,0.619207317073171,0,0,319,794,25,92,27,70,15,27
"1480","2020-03-18",20,18,81,160,3280,0.619207317073171,0,0,319,794,16,108,18,88,12,18
"1481","2020-03-19",27,18,124,186,3280,0.619207317073171,0,0,319,794,21,129,23,111,14,23
"1482","2020-03-20",32,18,153,211,3280,0.619207317073171,0,0,319,794,19,148,24,135,12,24
"1483","2020-03-21",38,18,172,244,3280,0.619207317073171,0,0,319,794,16,164,21,156,6,21
"1484","2020-03-22",46,18,168,273,3280,0.619207317073171,0,0,319,794,22,186,22,178,17,22
"1485","2020-03-23",56,18,186,298,3280,0.619207317073171,0,0,319,794,17,203,25,203,8,25
"1486","2020-03-24",67,18,187,322,3280,0.619207317073171,0,0,319,794,18,221,33,236,11,33
"1487","2020-03-25",65,18,192,354,3280,0.619207317073171,0,0,319,794,14,235,38,274,7,38
"1488","2020-03-26",68,18,206,375,3280,0.619207317073171,0,0,319,794,25,260,41,315,19,41
"1489","2020-03-27",74,18,211,394,3280,0.619207317073171,0,0,319,794,19,279,41,356,11,41
"1490","2020-03-28",81,18,194,404,3280,0.619207317073171,0,0,319,794,21,300,47,403,11,47
"1491","2020-03-29",93,18,161,422,3280,0.619207317073171,0,0,319,794,17,317,21,424,9,21
"1492","2020-03-30",97,18,154,426,3280,0.619207317073171,0,0,319,794,13,330,21,445,8,21
"1493","2020-03-31",104,18,189,461,3280,0.619207317073171,0,0,319,794,17,347,44,489,8,44
"1494","2020-04-01",116,18,199,459,3280,0.619207317073171,0,0,319,794,18,365,19,508,10,19
"1495","2020-04-02",125,18,218,457,3280,0.619207317073171,0,0,319,794,26,391,21,529,16,21
"1496","2020-04-03",126,18,203,458,3280,0.619207317073171,0,0,319,794,15,406,27,556,9,27
"1497","2020-04-04",127,18,190,468,3280,0.619207317073171,0,0,319,794,20,426,24,580,10,24
"1498","2020-04-05",120,18,196,482,3280,0.619207317073171,0,0,319,794,18,444,44,624,11,44
"1499","2020-04-06",116,18,201,485,3280,0.619207317073171,0,0,319,794,14,458,27,651,5,27
"1500","2020-04-07",120,18,189,483,3280,0.619207317073171,0,0,319,794,15,473,36,687,10,36
"1501","2020-04-08",115,18,227,491,3280,0.619207317073171,0,0,319,794,19,492,27,714,5,27
"1502","2020-04-09",124,18,213,514,3280,0.619207317073171,0,0,319,794,18,510,22,736,6,22
"1503","2020-04-10",129,18,191,523,3280,0.619207317073171,0,0,319,794,24,534,46,782,15,46
"1504","2020-04-11",134,18,196,529,3280,0.619207317073171,0,0,319,794,22,556,47,829,14,47
"1505","2020-04-12",138,18,180,547,3280,0.619207317073171,0,0,319,794,21,577,50,879,12,50
"1506","2020-04-13",155,18,205,572,3280,0.619207317073171,0,0,319,794,21,598,22,901,11,22
"1507","2020-04-14",156,18,208,561,3280,0.619207317073171,0,0,319,794,22,620,28,929,16,28
"1508","2020-04-15",155,18,199,567,3280,0.619207317073171,0,0,319,794,20,640,16,945,9,16
"1509","2020-04-16",157,18,178,582,3280,0.619207317073171,0,0,319,794,22,662,46,991,12,46
"1510","2020-04-17",158,18,206,569,3280,0.619207317073171,0,0,319,794,20,682,40,1031,12,40
"1511","2020-04-18",154,18,203,589,3280,0.619207317073171,0,0,319,794,20,702,30,1061,8,30
"1512","2020-04-19",163,18,208,585,3280,0.619207317073171,0,0,319,794,28,730,60,1121,17,60
"1513","2020-04-20",148,18,192,557,3280,0.619207317073171,0,0,319,794,27,757,59,1180,16,59
"1514","2020-04-21",148,18,178,542,3280,0.619207317073171,0,0,319,794,30,787,52,1232,19,52
"1515","2020-04-22",158,18,172,542,3280,0.619207317073171,0,0,319,794,31,818,33,1265,22,33
"1516","2020-04-23",148,18,191,552,3280,0.619207317073171,0,0,319,794,31,849,27,1292,20,27
"1517","2020-04-24",150,18,199,550,3280,0.619207317073171,0,0,319,794,28,877,39,1331,14,39
"1518","2020-04-25",154,18,197,537,3280,0.619207317073171,0,0,319,794,30,907,50,1381,22,50
"1519","2020-04-26",146,18,210,542,3280,0.619207317073171,0,0,319,794,30,937,46,1427,17,46
"1520","2020-04-27",154,18,235,549,3280,0.619207317073171,0,0,319,794,37,974,37,1464,20,37
"1521","2020-04-28",154,18,239,549,3280,0.619207317073171,0,0,319,794,25,999,45,1509,13,45
"1522","2020-04-29",149,18,243,556,3280,0.619207317073171,0,0,319,794,25,1024,23,1532,12,23
"1523","2020-04-30",161,18,227,551,3280,0.619207317073171,0,0,319,794,21,1045,26,1558,8,26
"1524","2020-05-01",166,18,216,525,3280,0.619207317073171,0,0,319,794,25,1070,21,1579,15,21
"1525","2020-05-02",163,18,205,512,3280,0.619207317073171,0,0,319,794,24,1094,16,1595,9,16
"1526","2020-05-03",157,18,202,507,3280,0.619207317073171,0,0,319,794,17,1111,30,1625,11,30
"1527","2020-05-04",159,18,191,521,3280,0.619207317073171,0,0,319,794,31,1142,12,1637,21,12
"1528","2020-05-05",148,18,182,503,3280,0.619207317073171,0,0,319,794,41,1183,12,1649,29,12
"1529","2020-05-06",153,18,174,478,3280,0.619207317073171,0,0,319,794,30,1213,10,1659,19,10
"1530","2020-05-07",139,18,206,457,3280,0.619207317073171,0,0,319,794,34,1247,14,1673,25,14
"1531","2020-05-08",132,18,250,449,3280,0.619207317073171,0,0,319,794,32,1279,36,1709,24,36
"1532","2020-05-09",132,18,245,440,3280,0.619207317073171,0,0,319,794,26,1305,34,1743,18,34
"1533","2020-05-10",134,18,237,425,3280,0.619207317073171,0,0,319,794,25,1330,32,1775,15,32
"1534","2020-05-11",126,18,257,412,3280,0.619207317073171,0,0,319,794,28,1358,14,1789,18,14
"1535","2020-05-12",125,18,225,405,3280,0.619207317073171,0,0,319,794,23,1381,12,1801,14,12
"1536","2020-05-13",120,18,201,389,3280,0.619207317073171,0,0,319,794,24,1405,31,1832,20,31
"1537","2020-05-14",124,18,216,389,3280,0.619207317073171,0,0,319,794,19,1424,22,1854,10,22
"1538","2020-05-15",126,18,234,367,3280,0.619207317073171,0,0,319,794,24,1448,20,1874,19,20
"1539","2020-05-16",121,18,237,361,3280,0.619207317073171,0,0,319,794,30,1478,11,1885,19,11
"1540","2020-05-17",119,18,237,339,3280,0.619207317073171,0,0,319,794,31,1509,6,1891,19,6
"1541","2020-05-18",112,18,219,322,3280,0.619207317073171,0,0,319,794,18,1527,40,1931,12,40
"1542","2020-05-19",115,18,225,320,3280,0.619207317073171,0,0,319,794,22,1549,41,1972,17,41
"1543","2020-05-20",114,18,227,317,3280,0.619207317073171,0,0,319,794,20,1569,27,1999,9,27
"1544","2020-05-21",105,18,259,306,3280,0.619207317073171,0,0,319,794,18,1587,26,2025,11,26
"1545","2020-05-22",98,18,236,288,3280,0.619207317073171,0,0,319,794,26,1613,23,2048,15,23
"1546","2020-05-23",100,18,199,290,3280,0.619207317073171,0,0,319,794,17,1630,27,2075,10,27
"1547","2020-05-24",94,18,165,291,3280,0.619207317073171,0,0,319,794,20,1650,23,2098,12,23
"1548","2020-05-25",96,18,147,283,3280,0.619207317073171,0,0,319,794,12,1662,17,2115,5,17
"1549","2020-05-26",84,18,141,279,3280,0.619207317073171,0,0,319,794,20,1682,11,2126,9,11
"1550","2020-05-27",76,18,129,272,3280,0.619207317073171,0,0,319,794,23,1705,14,2140,16,14
"1551","2020-05-28",76,18,125,259,3280,0.619207317073171,0,0,319,794,13,1718,39,2179,11,39
"1552","2020-05-29",74,18,116,242,3280,0.619207317073171,0,0,319,794,19,1737,18,2197,11,18
"1553","2020-05-30",74,18,123,229,3280,0.619207317073171,0,0,319,794,22,1759,16,2213,15,16
"1554","2020-05-31",75,18,136,224,3280,0.619207317073171,0,0,319,794,19,1778,11,2224,14,11
"1555","2020-06-01",72,18,157,220,3280,0.619207317073171,0,0,319,794,16,1794,14,2238,9,14
"1556","2020-06-02",73,18,180,213,3280,0.619207317073171,0,0,319,794,13,1807,18,2256,10,18
"1557","2020-06-03",74,18,200,203,3280,0.619207317073171,0,0,319,794,17,1824,28,2284,10,28
"1558","2020-06-04",75,18,191,193,3280,0.619207317073171,0,0,319,794,16,1840,17,2301,11,17
"1559","2020-06-05",67,18,175,187,3280,0.619207317073171,0,0,319,794,13,1853,21,2322,10,21
"1560","2020-06-06",60,18,178,175,3280,0.619207317073171,0,0,319,794,18,1871,20,2342,9,20
"1561","2020-06-07",56,18,159,178,3280,0.619207317073171,0,0,319,794,15,1886,19,2361,10,19
"1562","2020-03-13",1,19,34,94,3345,0.271150971599402,0,0,302,535,34,103,39,90,4,39
"1563","2020-03-14",4,19,41,122,3345,0.271150971599402,0,0,302,535,39,142,32,122,14,32
"1564","2020-03-15",9,19,44,154,3345,0.271150971599402,0,0,302,535,39,181,17,139,14,17
"1565","2020-03-16",13,19,60,192,3345,0.271150971599402,0,0,302,535,47,228,13,152,19,13
"1566","2020-03-17",18,19,71,222,3345,0.271150971599402,0,0,302,535,45,273,8,160,17,8
"1567","2020-03-18",23,19,79,257,3345,0.271150971599402,0,0,302,535,43,316,14,174,19,14
"1568","2020-03-19",33,19,84,293,3345,0.271150971599402,0,0,302,535,65,381,35,209,31,35
"1569","2020-03-20",47,19,80,312,3345,0.271150971599402,0,0,302,535,44,425,29,238,22,29
"1570","2020-03-21",56,19,69,351,3345,0.271150971599402,0,0,302,535,55,480,26,264,22,26
"1571","2020-03-22",64,19,77,375,3345,0.271150971599402,0,0,302,535,60,540,44,308,33,44
"1572","2020-03-23",79,19,83,387,3345,0.271150971599402,0,0,302,535,66,606,41,349,36,41
"1573","2020-03-24",93,19,92,413,3345,0.271150971599402,0,0,302,535,63,669,42,391,29,42
"1574","2020-03-25",102,19,109,431,3345,0.271150971599402,0,0,302,535,66,735,46,437,37,46
"1575","2020-03-26",108,19,99,454,3345,0.271150971599402,0,0,302,535,63,798,38,475,22,38
"1576","2020-03-27",107,19,99,468,3345,0.271150971599402,0,0,302,535,43,841,64,539,16,64
"1577","2020-03-28",115,19,118,482,3345,0.271150971599402,0,0,302,535,46,887,46,585,17,46
"1578","2020-03-29",119,19,126,485,3345,0.271150971599402,0,0,302,535,58,945,55,640,29,55
"1579","2020-03-30",118,19,141,484,3345,0.271150971599402,0,0,302,535,59,1004,56,696,33,56
"1580","2020-03-31",121,19,148,462,3345,0.271150971599402,0,0,302,535,51,1055,57,753,18,57
"1581","2020-04-01",124,19,130,463,3345,0.271150971599402,0,0,302,535,55,1110,25,778,29,25
"1582","2020-04-02",127,19,137,473,3345,0.271150971599402,0,0,302,535,49,1159,17,795,21,17
"1583","2020-04-03",135,19,140,475,3345,0.271150971599402,0,0,302,535,51,1210,13,808,26,13
"1584","2020-04-04",133,19,123,479,3345,0.271150971599402,0,0,302,535,65,1275,11,819,33,11
"1585","2020-04-05",140,19,103,482,3345,0.271150971599402,0,0,302,535,61,1336,23,842,27,23
"1586","2020-04-06",137,19,89,472,3345,0.271150971599402,0,0,302,535,60,1396,4,846,27,4
"1587","2020-04-07",134,19,79,485,3345,0.271150971599402,0,0,302,535,50,1446,15,861,23,15
"1588","2020-04-08",128,19,80,486,3345,0.271150971599402,0,0,302,535,46,1492,5,866,23,5
"1589","2020-04-09",124,19,97,489,3345,0.271150971599402,0,0,302,535,68,1560,NA,NA,28,NA
"1590","2020-04-10",120,19,112,488,3345,0.271150971599402,0,0,302,535,74,1634,3,869,40,3
"1591","2020-04-11",125,19,94,494,3345,0.271150971599402,0,0,302,535,73,1707,16,885,38,16
"1592","2020-04-12",123,19,128,500,3345,0.271150971599402,0,0,302,535,77,1784,61,946,42,61
"1593","2020-04-13",125,19,128,512,3345,0.271150971599402,0,0,302,535,62,1846,58,1004,27,58
"1594","2020-04-14",125,19,123,519,3345,0.271150971599402,0,0,302,535,55,1901,29,1033,26,29
"1595","2020-04-15",135,19,128,523,3345,0.271150971599402,0,0,302,535,65,1966,64,1097,35,64
"1596","2020-04-16",134,19,136,524,3345,0.271150971599402,0,0,302,535,69,2035,37,1134,31,37
"1597","2020-04-17",134,19,140,530,3345,0.271150971599402,0,0,302,535,82,2117,43,1177,45,43
"1598","2020-04-18",131,19,163,534,3345,0.271150971599402,0,0,302,535,49,2166,59,1236,16,59
"1599","2020-04-19",124,19,180,520,3345,0.271150971599402,0,0,302,535,52,2218,49,1285,18,49
"1600","2020-04-20",141,19,179,506,3345,0.271150971599402,0,0,302,535,68,2286,28,1313,33,28
"1601","2020-04-21",140,19,183,503,3345,0.271150971599402,0,0,302,535,52,2338,24,1337,18,24
"1602","2020-04-22",144,19,171,499,3345,0.271150971599402,0,0,302,535,64,2402,35,1372,31,35
"1603","2020-04-23",151,19,157,488,3345,0.271150971599402,0,0,302,535,47,2449,25,1397,15,25
"1604","2020-04-24",154,19,175,501,3345,0.271150971599402,0,0,302,535,52,2501,18,1415,14,18
"1605","2020-04-25",154,19,187,495,3345,0.271150971599402,0,0,302,535,48,2549,38,1453,16,38
"1606","2020-04-26",162,19,171,487,3345,0.271150971599402,0,0,302,535,62,2611,19,1472,16,19
"1607","2020-04-27",139,19,176,483,3345,0.271150971599402,0,0,302,535,64,2675,45,1517,24,45
"1608","2020-04-28",141,19,164,483,3345,0.271150971599402,0,0,302,535,51,2726,40,1557,18,40
"1609","2020-04-29",138,19,181,460,3345,0.271150971599402,0,0,302,535,40,2766,30,1587,12,30
"1610","2020-04-30",145,19,192,456,3345,0.271150971599402,0,0,302,535,49,2815,21,1608,22,21
"1611","2020-05-01",146,19,204,458,3345,0.271150971599402,0,0,302,535,47,2862,55,1663,15,55
"1612","2020-05-02",145,19,213,444,3345,0.271150971599402,0,0,302,535,49,2911,32,1695,21,32
"1613","2020-05-03",136,19,202,441,3345,0.271150971599402,0,0,302,535,50,2961,20,1715,16,20
"1614","2020-05-04",144,19,206,449,3345,0.271150971599402,0,0,302,535,56,3017,33,1748,19,33
"1615","2020-05-05",145,19,220,443,3345,0.271150971599402,0,0,302,535,46,3063,21,1769,15,21
"1616","2020-05-06",140,19,229,448,3345,0.271150971599402,0,0,302,535,47,3110,16,1785,20,16
"1617","2020-05-07",128,19,247,458,3345,0.271150971599402,0,0,302,535,39,3149,15,1800,17,15
"1618","2020-05-08",120,19,229,442,3345,0.271150971599402,0,0,302,535,44,3193,10,1810,14,10
"1619","2020-05-09",114,19,217,443,3345,0.271150971599402,0,0,302,535,42,3235,23,1833,21,23
"1620","2020-05-10",112,19,215,450,3345,0.271150971599402,0,0,302,535,37,3272,71,1904,14,71
"1621","2020-05-11",115,19,225,449,3345,0.271150971599402,0,0,302,535,42,3314,70,1974,18,70
"1622","2020-05-12",107,19,214,431,3345,0.271150971599402,0,0,302,535,41,3355,62,2036,16,62
"1623","2020-05-13",110,19,192,420,3345,0.271150971599402,0,0,302,535,35,3390,61,2097,10,61
"1624","2020-05-14",113,19,196,426,3345,0.271150971599402,0,0,302,535,25,3415,44,2141,6,44
"1625","2020-05-15",116,19,217,413,3345,0.271150971599402,0,0,302,535,34,3449,41,2182,5,41
"1626","2020-05-16",124,19,196,406,3345,0.271150971599402,0,0,302,535,22,3471,60,2242,7,60
"1627","2020-05-17",134,19,180,389,3345,0.271150971599402,0,0,302,535,36,3507,34,2276,9,34
"1628","2020-05-18",119,19,177,368,3345,0.271150971599402,0,0,302,535,31,3538,36,2312,7,36
"1629","2020-05-19",124,19,172,372,3345,0.271150971599402,0,0,302,535,25,3563,19,2331,6,19
"1630","2020-05-20",124,19,151,370,3345,0.271150971599402,0,0,302,535,22,3585,19,2350,6,19
"1631","2020-05-21",117,19,137,345,3345,0.271150971599402,0,0,302,535,22,3607,13,2363,5,13
"1632","2020-05-22",118,19,152,327,3345,0.271150971599402,0,0,302,535,28,3635,40,2403,14,40
"1633","2020-05-23",107,19,142,316,3345,0.271150971599402,0,0,302,535,25,3660,29,2432,9,29
"1634","2020-05-24",104,19,132,296,3345,0.271150971599402,0,0,302,535,25,3685,10,2442,11,10
"1635","2020-05-25",106,19,115,290,3345,0.271150971599402,0,0,302,535,19,3704,4,2446,10,4
"1636","2020-05-26",100,19,104,283,3345,0.271150971599402,0,0,302,535,26,3730,7,2453,13,7
"1637","2020-05-27",90,19,111,275,3345,0.271150971599402,0,0,302,535,33,3763,10,2463,16,10
"1638","2020-05-28",89,19,124,260,3345,0.271150971599402,0,0,302,535,20,3783,2,2465,9,2
"1639","2020-05-29",80,19,142,261,3345,0.271150971599402,0,0,302,535,33,3816,8,2473,16,8
"1640","2020-05-30",79,19,144,248,3345,0.271150971599402,0,0,302,535,20,3836,33,2506,12,33
"1641","2020-05-31",68,19,144,230,3345,0.271150971599402,0,0,302,535,23,3859,12,2518,8,12
"1642","2020-06-01",70,19,144,219,3345,0.271150971599402,0,0,302,535,28,3887,10,2528,18,10
"1643","2020-06-02",64,19,136,199,3345,0.271150971599402,0,0,302,535,24,3911,17,2545,8,17
"1644","2020-06-03",60,19,128,194,3345,0.271150971599402,0,0,302,535,25,3936,21,2566,9,21
"1645","2020-06-04",57,19,122,186,3345,0.271150971599402,0,0,302,535,21,3957,22,2588,10,22
"1646","2020-06-05",59,19,116,188,3345,0.271150971599402,0,0,302,535,16,3973,17,2605,7,17
"1647","2020-06-06",57,19,105,179,3345,0.271150971599402,0,0,302,535,23,3996,30,2635,11,30
"1648","2020-06-07",52,19,107,177,3345,0.271150971599402,0,0,302,535,14,4010,20,2655,9,20
"1649","2020-03-13",1,20,95,21,4528,0.884054770318021,0,0,445,840,17,45,17,33,7,17
"1650","2020-03-14",1,20,93,35,4528,0.884054770318021,0,0,445,840,16,61,20,53,5,20
"1651","2020-03-15",3,20,98,55,4528,0.884054770318021,0,0,445,840,23,84,24,77,11,24
"1652","2020-03-16",5,20,88,68,4528,0.884054770318021,0,0,445,840,21,105,19,96,14,19
"1653","2020-03-17",5,20,89,89,4528,0.884054770318021,0,0,445,840,20,125,17,113,11,17
"1654","2020-03-18",11,20,86,107,4528,0.884054770318021,0,0,445,840,20,145,18,131,8,18
"1655","2020-03-19",15,20,127,122,4528,0.884054770318021,0,0,445,840,27,172,18,149,13,18
"1656","2020-03-20",23,20,144,135,4528,0.884054770318021,0,0,445,840,22,194,19,168,14,19
"1657","2020-03-21",31,20,169,146,4528,0.884054770318021,0,0,445,840,25,219,36,204,12,36
"1658","2020-03-22",31,20,161,184,4528,0.884054770318021,0,0,445,840,34,253,55,259,18,55
"1659","2020-03-23",33,20,145,214,4528,0.884054770318021,0,0,445,840,29,282,36,295,21,36
"1660","2020-03-24",38,20,130,240,4528,0.884054770318021,0,0,445,840,24,306,34,329,11,34
"1661","2020-03-25",48,20,128,276,4528,0.884054770318021,0,0,445,840,26,332,40,369,15,40
"1662","2020-03-26",55,20,114,304,4528,0.884054770318021,0,0,445,840,36,368,38,407,21,38
"1663","2020-03-27",58,20,150,346,4528,0.884054770318021,0,0,445,840,20,388,38,445,11,38
"1664","2020-03-28",68,20,184,384,4528,0.884054770318021,0,0,445,840,23,411,46,491,15,46
"1665","2020-03-29",83,20,178,421,4528,0.884054770318021,0,0,445,840,37,448,36,527,19,36
"1666","2020-03-30",97,20,193,448,4528,0.884054770318021,0,0,445,840,21,469,25,552,10,25
"1667","2020-03-31",105,20,170,490,4528,0.884054770318021,0,0,445,840,26,495,44,596,15,44
"1668","2020-04-01",112,20,164,533,4528,0.884054770318021,0,0,445,840,25,520,31,627,15,31
"1669","2020-04-02",119,20,186,553,4528,0.884054770318021,0,0,445,840,31,551,25,652,22,25
"1670","2020-04-03",127,20,225,578,4528,0.884054770318021,0,0,445,840,27,578,35,687,17,35
"1671","2020-04-04",142,20,254,604,4528,0.884054770318021,0,0,445,840,33,611,36,723,18,36
"1672","2020-04-05",144,20,283,642,4528,0.884054770318021,0,0,445,840,39,650,46,769,28,46
"1673","2020-04-06",150,20,260,653,4528,0.884054770318021,0,0,445,840,29,679,50,819,11,50
"1674","2020-04-07",170,20,238,678,4528,0.884054770318021,0,0,445,840,37,716,52,871,19,52
"1675","2020-04-08",170,20,211,693,4528,0.884054770318021,0,0,445,840,27,743,65,936,7,65
"1676","2020-04-09",182,20,227,711,4528,0.884054770318021,0,0,445,840,20,763,36,972,9,36
"1677","2020-04-10",196,20,220,728,4528,0.884054770318021,0,0,445,840,31,794,39,1011,16,39
"1678","2020-04-11",190,20,216,757,4528,0.884054770318021,0,0,445,840,23,817,39,1050,10,39
"1679","2020-04-12",209,20,229,763,4528,0.884054770318021,0,0,445,840,25,842,37,1087,15,37
"1680","2020-04-13",225,20,225,783,4528,0.884054770318021,0,0,445,840,43,885,44,1131,21,44
"1681","2020-04-14",212,20,195,788,4528,0.884054770318021,0,0,445,840,29,914,39,1170,15,39
"1682","2020-04-15",209,20,206,804,4528,0.884054770318021,0,0,445,840,21,935,33,1203,8,33
"1683","2020-04-16",210,20,213,814,4528,0.884054770318021,0,0,445,840,30,965,40,1243,14,40
"1684","2020-04-17",203,20,203,822,4528,0.884054770318021,0,0,445,840,25,990,36,1279,11,36
"1685","2020-04-18",211,20,189,831,4528,0.884054770318021,0,0,445,840,24,1014,43,1322,12,43
"1686","2020-04-19",210,20,204,845,4528,0.884054770318021,0,0,445,840,21,1035,34,1356,9,34
"1687","2020-04-20",210,20,187,855,4528,0.884054770318021,0,0,445,840,17,1052,45,1401,6,45
"1688","2020-04-21",230,20,215,884,4528,0.884054770318021,0,0,445,840,28,1080,33,1434,9,33
"1689","2020-04-22",246,20,250,896,4528,0.884054770318021,0,0,445,840,27,1107,49,1483,15,49
"1690","2020-04-23",253,20,245,906,4528,0.884054770318021,0,0,445,840,15,1122,46,1529,3,46
"1691","2020-04-24",270,20,210,895,4528,0.884054770318021,0,0,445,840,25,1147,39,1568,9,39
"1692","2020-04-25",276,20,184,881,4528,0.884054770318021,0,0,445,840,18,1165,60,1628,7,60
"1693","2020-04-26",274,20,233,875,4528,0.884054770318021,0,0,445,840,16,1181,52,1680,6,52
"1694","2020-04-27",270,20,264,872,4528,0.884054770318021,0,0,445,840,19,1200,48,1728,6,48
"1695","2020-04-28",264,20,257,865,4528,0.884054770318021,0,0,445,840,22,1222,44,1772,4,44
"1696","2020-04-29",267,20,233,864,4528,0.884054770318021,0,0,445,840,19,1241,44,1816,6,44
"1697","2020-04-30",262,20,191,839,4528,0.884054770318021,0,0,445,840,18,1259,31,1847,6,31
"1698","2020-05-01",250,20,167,834,4528,0.884054770318021,0,0,445,840,27,1286,33,1880,6,33
"1699","2020-05-02",249,20,163,833,4528,0.884054770318021,0,0,445,840,22,1308,40,1920,9,40
"1700","2020-05-03",252,20,211,804,4528,0.884054770318021,0,0,445,840,27,1335,27,1947,10,27
"1701","2020-05-04",250,20,200,771,4528,0.884054770318021,0,0,445,840,18,1353,35,1982,8,35
"1702","2020-05-05",248,20,179,748,4528,0.884054770318021,0,0,445,840,18,1371,35,2017,11,35
"1703","2020-05-06",244,20,172,737,4528,0.884054770318021,0,0,445,840,28,1399,34,2051,14,34
"1704","2020-05-07",246,20,168,697,4528,0.884054770318021,0,0,445,840,25,1424,32,2083,15,32
"1705","2020-05-08",240,20,202,690,4528,0.884054770318021,0,0,445,840,27,1451,31,2114,17,31
"1706","2020-05-09",219,20,189,681,4528,0.884054770318021,0,0,445,840,25,1476,27,2141,11,27
"1707","2020-05-10",203,20,184,654,4528,0.884054770318021,0,0,445,840,35,1511,31,2172,14,31
"1708","2020-05-11",193,20,210,639,4528,0.884054770318021,0,0,445,840,19,1530,30,2202,8,30
"1709","2020-05-12",195,20,196,628,4528,0.884054770318021,0,0,445,840,29,1559,38,2240,13,38
"1710","2020-05-13",187,20,225,620,4528,0.884054770318021,0,0,445,840,20,1579,32,2272,8,32
"1711","2020-05-14",171,20,210,609,4528,0.884054770318021,0,0,445,840,32,1611,36,2308,18,36
"1712","2020-05-15",165,20,176,577,4528,0.884054770318021,0,0,445,840,21,1632,22,2330,14,22
"1713","2020-05-16",164,20,157,569,4528,0.884054770318021,0,0,445,840,23,1655,21,2351,14,21
"1714","2020-05-17",160,20,189,541,4528,0.884054770318021,0,0,445,840,15,1670,45,2396,8,45
"1715","2020-05-18",163,20,203,522,4528,0.884054770318021,0,0,445,840,21,1691,35,2431,10,35
"1716","2020-05-19",151,20,199,504,4528,0.884054770318021,0,0,445,840,22,1713,25,2456,13,25
"1717","2020-05-20",143,20,233,500,4528,0.884054770318021,0,0,445,840,16,1729,24,2480,9,24
"1718","2020-05-21",155,20,240,485,4528,0.884054770318021,0,0,445,840,13,1742,37,2517,6,37
"1719","2020-05-22",161,20,230,470,4528,0.884054770318021,0,0,445,840,21,1763,37,2554,13,37
"1720","2020-05-23",163,20,242,474,4528,0.884054770318021,0,0,445,840,30,1793,50,2604,18,50
"1721","2020-05-24",167,20,227,465,4528,0.884054770318021,0,0,445,840,19,1812,32,2636,7,32
"1722","2020-05-25",161,20,207,445,4528,0.884054770318021,0,0,445,840,14,1826,46,2682,10,46
"1723","2020-05-26",154,20,203,436,4528,0.884054770318021,0,0,445,840,16,1842,29,2711,13,29
"1724","2020-05-27",154,20,199,416,4528,0.884054770318021,0,0,445,840,13,1855,29,2740,9,29
"1725","2020-05-28",140,20,199,405,4528,0.884054770318021,0,0,445,840,20,1875,35,2775,13,35
"1726","2020-05-29",135,20,204,377,4528,0.884054770318021,0,0,445,840,21,1896,26,2801,10,26
"1727","2020-05-30",127,20,190,358,4528,0.884054770318021,0,0,445,840,14,1910,23,2824,7,23
"1728","2020-05-31",119,20,167,336,4528,0.884054770318021,0,0,445,840,18,1928,20,2844,11,20
"1729","2020-06-01",113,20,195,321,4528,0.884054770318021,0,0,445,840,21,1949,28,2872,13,28
"1730","2020-06-02",111,20,173,306,4528,0.884054770318021,0,0,445,840,20,1969,42,2914,10,42
"1731","2020-06-03",102,20,161,289,4528,0.884054770318021,0,0,445,840,17,1986,26,2940,11,26
"1732","2020-06-04",97,20,189,278,4528,0.884054770318021,0,0,445,840,8,1994,31,2971,7,31
"1733","2020-06-05",83,20,198,264,4528,0.884054770318021,0,0,445,840,8,2002,34,3005,4,34
"1734","2020-06-06",83,20,177,247,4528,0.884054770318021,0,0,445,840,16,2018,23,3028,7,23
"1735","2020-06-07",78,20,146,240,4528,0.884054770318021,0,0,445,840,17,2035,39,3067,12,39
