"","Date","Absents","Paramset","Infections_or_Exposed_per_day_Patient","Infections_or_Exposed_per_day_HCW","total_infections","nosocomial_proportion","PCR_pooled","LFD_pooled","HCW_symp_test","patient_symp_test","new_hcw_infs","cumulative_hcw_infs","new_pat_infs","cumulative_pats_infs","new_nosocomial_hcw_infs","new_nosocomial_pat_infs"
"1","2020-03-13",1,1,39,132,7712,0.672199170124481,0,0,718,673,48,132,16,26,4,16
"2","2020-03-14",1,1,64,188,7712,0.672199170124481,0,0,718,673,56,188,20,46,15,20
"3","2020-03-15",6,1,84,248,7712,0.672199170124481,0,0,718,673,60,248,22,68,20,22
"4","2020-03-16",11,1,92,334,7712,0.672199170124481,0,0,718,673,86,334,21,89,36,21
"5","2020-03-17",32,1,112,422,7712,0.672199170124481,0,0,718,673,91,425,30,119,43,30
"6","2020-03-18",44,1,130,521,7712,0.672199170124481,0,0,718,673,107,532,29,148,63,29
"7","2020-03-19",69,1,142,621,7712,0.672199170124481,0,0,718,673,117,649,32,180,68,32
"8","2020-03-20",94,1,153,741,7712,0.672199170124481,0,0,718,673,142,791,42,222,106,42
"9","2020-03-21",116,1,178,862,7712,0.672199170124481,0,0,718,673,139,930,41,263,98,41
"10","2020-03-22",148,1,191,1005,7712,0.672199170124481,0,0,718,673,170,1100,41,304,125,41
"11","2020-03-23",183,1,196,1162,7712,0.672199170124481,0,0,718,673,189,1289,50,354,148,50
"12","2020-03-24",210,1,208,1293,7712,0.672199170124481,0,0,718,673,171,1460,43,397,134,43
"13","2020-03-25",246,1,210,1455,7712,0.672199170124481,0,0,718,673,216,1676,41,438,173,41
"14","2020-03-26",281,1,182,1598,7712,0.672199170124481,0,0,718,673,225,1901,24,462,182,24
"15","2020-03-27",305,1,187,1719,7712,0.672199170124481,0,0,718,673,216,2117,25,487,183,25
"16","2020-03-28",355,1,168,1834,7712,0.672199170124481,0,0,718,673,206,2323,23,510,165,23
"17","2020-03-29",389,1,174,1954,7712,0.672199170124481,0,0,718,673,214,2537,32,542,175,32
"18","2020-03-30",430,1,192,2080,7712,0.672199170124481,0,0,718,673,227,2764,44,586,178,44
"19","2020-03-31",476,1,192,2201,7712,0.672199170124481,0,0,718,673,246,3010,34,620,205,34
"20","2020-04-01",517,1,204,2309,7712,0.672199170124481,0,0,718,673,264,3274,45,665,229,45
"21","2020-04-02",550,1,206,2379,7712,0.672199170124481,0,0,718,673,244,3518,35,700,210,35
"22","2020-04-03",575,1,197,2426,7712,0.672199170124481,0,0,718,673,231,3749,45,745,192,45
"23","2020-04-04",589,1,198,2491,7712,0.672199170124481,0,0,718,673,245,3994,32,777,213,32
"24","2020-04-05",609,1,196,2525,7712,0.672199170124481,0,0,718,673,215,4209,39,816,183,39
"25","2020-04-06",624,1,188,2509,7712,0.672199170124481,0,0,718,673,178,4387,20,836,154,20
"26","2020-04-07",621,1,173,2484,7712,0.672199170124481,0,0,718,673,182,4569,25,861,150,25
"27","2020-04-08",637,1,156,2456,7712,0.672199170124481,0,0,718,673,184,4753,23,884,153,23
"28","2020-04-09",644,1,150,2373,7712,0.672199170124481,0,0,718,673,161,4914,16,900,137,16
"29","2020-04-10",642,1,140,2307,7712,0.672199170124481,0,0,718,673,170,5084,12,912,141,12
"30","2020-04-11",658,1,178,2221,7712,0.672199170124481,0,0,718,673,136,5220,53,965,106,53
"31","2020-04-12",650,1,156,2143,7712,0.672199170124481,0,0,718,673,132,5352,22,987,107,22
"32","2020-04-13",631,1,164,2062,7712,0.672199170124481,0,0,718,673,142,5494,24,1011,123,24
"33","2020-04-14",615,1,164,1957,7712,0.672199170124481,0,0,718,673,127,5621,28,1039,99,28
"34","2020-04-15",576,1,156,1827,7712,0.672199170124481,0,0,718,673,84,5705,24,1063,67,24
"35","2020-04-16",563,1,138,1698,7712,0.672199170124481,0,0,718,673,81,5786,25,1088,58,25
"36","2020-04-17",556,1,151,1574,7712,0.672199170124481,0,0,718,673,71,5857,25,1113,59,25
"37","2020-04-18",517,1,168,1459,7712,0.672199170124481,0,0,718,673,58,5915,38,1151,40,38
"38","2020-04-19",494,1,163,1356,7712,0.672199170124481,0,0,718,673,82,5997,26,1177,66,26
"39","2020-04-20",468,1,190,1259,7712,0.672199170124481,0,0,718,673,68,6065,50,1227,50,50
"40","2020-04-21",437,1,181,1153,7712,0.672199170124481,0,0,718,673,49,6114,32,1259,32,32
"41","2020-04-22",432,1,174,1043,7712,0.672199170124481,0,0,718,673,53,6167,14,1273,35,14
"42","2020-04-23",382,1,169,955,7712,0.672199170124481,0,0,718,673,34,6201,24,1297,17,24
"43","2020-04-24",348,1,162,866,7712,0.672199170124481,0,0,718,673,42,6243,27,1324,24,27
"44","2020-04-25",321,1,149,791,7712,0.672199170124481,0,0,718,673,35,6278,18,1342,26,18
"45","2020-04-26",289,1,143,720,7712,0.672199170124481,0,0,718,673,37,6315,16,1358,19,16
"46","2020-04-27",263,1,151,676,7712,0.672199170124481,0,0,718,673,35,6350,19,1377,17,19
"47","2020-04-28",248,1,167,632,7712,0.672199170124481,0,0,718,673,37,6387,40,1417,22,40
"48","2020-04-29",220,1,172,593,7712,0.672199170124481,0,0,718,673,38,6425,27,1444,25,27
"49","2020-04-30",199,1,164,534,7712,0.672199170124481,0,0,718,673,32,6457,10,1454,21,10
"50","2020-05-01",183,1,160,516,7712,0.672199170124481,0,0,718,673,31,6488,19,1473,15,19
"51","2020-05-02",170,1,160,468,7712,0.672199170124481,0,0,718,673,23,6511,36,1509,12,36
"52","2020-05-03",164,1,150,441,7712,0.672199170124481,0,0,718,673,23,6534,19,1528,15,19
"53","2020-05-04",155,1,172,404,7712,0.672199170124481,0,0,718,673,19,6553,45,1573,11,45
"54","2020-05-05",140,1,171,368,7712,0.672199170124481,0,0,718,673,19,6572,26,1599,5,26
"55","2020-05-06",117,1,175,355,7712,0.672199170124481,0,0,718,673,22,6594,32,1631,10,32
"56","2020-05-07",114,1,192,318,7712,0.672199170124481,0,0,718,673,13,6607,36,1667,4,36
"57","2020-05-08",109,1,184,293,7712,0.672199170124481,0,0,718,673,18,6625,20,1687,9,20
"58","2020-05-09",97,1,172,269,7712,0.672199170124481,0,0,718,673,12,6637,19,1706,3,19
"59","2020-05-10",82,1,177,274,7712,0.672199170124481,0,0,718,673,28,6665,32,1738,15,32
"60","2020-05-11",72,1,180,250,7712,0.672199170124481,0,0,718,673,14,6679,23,1761,7,23
"61","2020-05-12",66,1,175,229,7712,0.672199170124481,0,0,718,673,18,6697,23,1784,7,23
"62","2020-05-13",58,1,179,215,7712,0.672199170124481,0,0,718,673,14,6711,35,1819,5,35
"63","2020-05-14",51,1,183,202,7712,0.672199170124481,0,0,718,673,15,6726,27,1846,2,27
"64","2020-05-15",44,1,177,205,7712,0.672199170124481,0,0,718,673,22,6748,24,1870,8,24
"65","2020-05-16",42,1,160,202,7712,0.672199170124481,0,0,718,673,13,6761,15,1885,6,15
"66","2020-05-17",44,1,196,202,7712,0.672199170124481,0,0,718,673,17,6778,45,1930,5,45
"67","2020-05-18",50,1,216,192,7712,0.672199170124481,0,0,718,673,18,6796,48,1978,9,48
"68","2020-05-19",47,1,223,182,7712,0.672199170124481,0,0,718,673,12,6808,46,2024,7,46
"69","2020-05-20",51,1,238,173,7712,0.672199170124481,0,0,718,673,11,6819,49,2073,2,49
"70","2020-05-21",53,1,232,169,7712,0.672199170124481,0,0,718,673,11,6830,33,2106,4,33
"71","2020-05-22",60,1,217,170,7712,0.672199170124481,0,0,718,673,16,6846,28,2134,6,28
"72","2020-05-23",60,1,215,166,7712,0.672199170124481,0,0,718,673,15,6861,31,2165,5,31
"73","2020-05-24",58,1,194,171,7712,0.672199170124481,0,0,718,673,17,6878,22,2187,9,22
"74","2020-05-25",53,1,201,171,7712,0.672199170124481,0,0,718,673,11,6889,34,2221,3,34
"75","2020-05-26",56,1,175,160,7712,0.672199170124481,0,0,718,673,10,6899,22,2243,1,22
"76","2020-05-27",52,1,161,155,7712,0.672199170124481,0,0,718,673,7,6906,12,2255,3,12
"77","2020-05-28",49,1,155,148,7712,0.672199170124481,0,0,718,673,8,6914,21,2276,4,21
"78","2020-05-29",42,1,178,140,7712,0.672199170124481,0,0,718,673,12,6926,40,2316,6,40
"79","2020-05-30",40,1,183,127,7712,0.672199170124481,0,0,718,673,7,6933,31,2347,2,31
"80","2020-05-31",38,1,155,124,7712,0.672199170124481,0,0,718,673,9,6942,19,2366,5,19
"81","2020-06-01",38,1,142,118,7712,0.672199170124481,0,0,718,673,5,6947,15,2381,1,15
"82","2020-06-02",34,1,145,115,7712,0.672199170124481,0,0,718,673,9,6956,27,2408,4,27
"83","2020-06-03",34,1,157,110,7712,0.672199170124481,0,0,718,673,6,6962,33,2441,3,33
"84","2020-06-04",35,1,165,96,7712,0.672199170124481,0,0,718,673,1,6963,38,2479,NA,38
"85","2020-06-05",36,1,155,90,7712,0.672199170124481,0,0,718,673,5,6968,22,2501,1,22
"86","2020-06-06",33,1,158,81,7712,0.672199170124481,0,0,718,673,7,6975,31,2532,4,31
"87","2020-06-07",30,1,161,80,7712,0.672199170124481,0,0,718,673,7,6982,20,2552,3,20
"88","2020-03-14",1,2,38,110,4774,0.624842899036447,0,0,393,360,52,159,9,47,9,9
"89","2020-03-15",5,2,39,144,4774,0.624842899036447,0,0,393,360,40,199,25,72,10,25
"90","2020-03-16",11,2,44,191,4774,0.624842899036447,0,0,393,360,47,246,22,94,12,22
"91","2020-03-17",17,2,49,226,4774,0.624842899036447,0,0,393,360,44,290,33,127,17,33
"92","2020-03-18",27,2,56,270,4774,0.624842899036447,0,0,393,360,60,350,21,148,20,21
"93","2020-03-19",37,2,63,312,4774,0.624842899036447,0,0,393,360,74,424,27,175,20,27
"94","2020-03-20",50,2,54,357,4774,0.624842899036447,0,0,393,360,47,471,24,199,15,24
"95","2020-03-21",63,2,50,398,4774,0.624842899036447,0,0,393,360,50,521,16,215,15,16
"96","2020-03-22",77,2,35,435,4774,0.624842899036447,0,0,393,360,58,579,30,245,22,30
"97","2020-03-23",90,2,35,489,4774,0.624842899036447,0,0,393,360,58,637,32,277,24,32
"98","2020-03-24",103,2,39,521,4774,0.624842899036447,0,0,393,360,52,689,23,300,20,23
"99","2020-03-25",119,2,50,553,4774,0.624842899036447,0,0,393,360,46,735,52,352,23,52
"100","2020-03-26",135,2,52,584,4774,0.624842899036447,0,0,393,360,54,789,40,392,23,40
"101","2020-03-27",141,2,65,606,4774,0.624842899036447,0,0,393,360,48,837,43,435,18,43
"102","2020-03-28",149,2,61,634,4774,0.624842899036447,0,0,393,360,58,895,34,469,26,34
"103","2020-03-29",159,2,68,677,4774,0.624842899036447,0,0,393,360,47,942,37,506,20,37
"104","2020-03-30",164,2,77,699,4774,0.624842899036447,0,0,393,360,55,997,32,538,17,32
"105","2020-03-31",172,2,78,745,4774,0.624842899036447,0,0,393,360,50,1047,28,566,8,28
"106","2020-04-01",173,2,98,778,4774,0.624842899036447,0,0,393,360,51,1098,20,586,20,20
"107","2020-04-02",174,2,118,805,4774,0.624842899036447,0,0,393,360,59,1157,23,609,21,23
"108","2020-04-03",198,2,116,824,4774,0.624842899036447,0,0,393,360,59,1216,21,630,18,21
"109","2020-04-04",216,2,112,834,4774,0.624842899036447,0,0,393,360,49,1265,23,653,16,23
"110","2020-04-05",229,2,113,852,4774,0.624842899036447,0,0,393,360,66,1331,22,675,21,22
"111","2020-04-06",241,2,113,881,4774,0.624842899036447,0,0,393,360,77,1408,44,719,30,44
"112","2020-04-07",242,2,125,877,4774,0.624842899036447,0,0,393,360,68,1476,42,761,18,42
"113","2020-04-08",248,2,127,895,4774,0.624842899036447,0,0,393,360,71,1547,30,791,28,30
"114","2020-04-09",257,2,121,900,4774,0.624842899036447,0,0,393,360,57,1604,33,824,22,33
"115","2020-04-10",246,2,135,907,4774,0.624842899036447,0,0,393,360,51,1655,29,853,16,29
"116","2020-04-11",240,2,125,931,4774,0.624842899036447,0,0,393,360,70,1725,27,880,20,27
"117","2020-04-12",235,2,135,923,4774,0.624842899036447,0,0,393,360,64,1789,30,910,20,30
"118","2020-04-13",242,2,143,903,4774,0.624842899036447,0,0,393,360,44,1833,36,946,14,36
"119","2020-04-14",251,2,157,881,4774,0.624842899036447,0,0,393,360,72,1905,41,987,21,41
"120","2020-04-15",263,2,164,877,4774,0.624842899036447,0,0,393,360,66,1971,26,1013,17,26
"121","2020-04-16",255,2,163,884,4774,0.624842899036447,0,0,393,360,62,2033,25,1038,21,25
"122","2020-04-17",254,2,166,869,4774,0.624842899036447,0,0,393,360,52,2085,39,1077,19,39
"123","2020-04-18",258,2,151,886,4774,0.624842899036447,0,0,393,360,69,2154,35,1112,24,35
"124","2020-04-19",251,2,133,885,4774,0.624842899036447,0,0,393,360,47,2201,32,1144,17,32
"125","2020-04-20",251,2,117,880,4774,0.624842899036447,0,0,393,360,51,2252,32,1176,14,32
"126","2020-04-21",249,2,110,871,4774,0.624842899036447,0,0,393,360,60,2312,41,1217,16,41
"127","2020-04-22",239,2,109,840,4774,0.624842899036447,0,0,393,360,58,2370,26,1243,23,26
"128","2020-04-23",249,2,126,836,4774,0.624842899036447,0,0,393,360,51,2421,36,1279,16,36
"129","2020-04-24",260,2,145,809,4774,0.624842899036447,0,0,393,360,50,2471,26,1305,13,26
"130","2020-04-25",256,2,165,791,4774,0.624842899036447,0,0,393,360,65,2536,28,1333,19,28
"131","2020-04-26",256,2,149,773,4774,0.624842899036447,0,0,393,360,62,2598,25,1358,18,25
"132","2020-04-27",248,2,134,761,4774,0.624842899036447,0,0,393,360,52,2650,20,1378,21,20
"133","2020-04-28",239,2,125,730,4774,0.624842899036447,0,0,393,360,58,2708,16,1394,14,16
"134","2020-04-29",231,2,139,704,4774,0.624842899036447,0,0,393,360,59,2767,21,1415,22,21
"135","2020-04-30",223,2,166,674,4774,0.624842899036447,0,0,393,360,45,2812,27,1442,11,27
"136","2020-05-01",211,2,196,684,4774,0.624842899036447,0,0,393,360,67,2879,34,1476,26,34
"137","2020-05-02",211,2,198,660,4774,0.624842899036447,0,0,393,360,67,2946,20,1496,25,20
"138","2020-05-03",216,2,197,642,4774,0.624842899036447,0,0,393,360,60,3006,20,1516,22,20
"139","2020-05-04",202,2,179,626,4774,0.624842899036447,0,0,393,360,47,3053,27,1543,14,27
"140","2020-05-05",204,2,179,600,4774,0.624842899036447,0,0,393,360,49,3102,47,1590,12,47
"141","2020-05-06",195,2,191,598,4774,0.624842899036447,0,0,393,360,57,3159,30,1620,19,30
"142","2020-05-07",193,2,187,597,4774,0.624842899036447,0,0,393,360,62,3221,24,1644,26,24
"143","2020-05-08",183,2,188,580,4774,0.624842899036447,0,0,393,360,49,3270,48,1692,15,48
"144","2020-05-09",176,2,187,557,4774,0.624842899036447,0,0,393,360,43,3313,34,1726,17,34
"145","2020-05-10",165,2,209,553,4774,0.624842899036447,0,0,393,360,49,3362,28,1754,16,28
"146","2020-05-11",164,2,177,539,4774,0.624842899036447,0,0,393,360,44,3406,28,1782,16,28
"147","2020-05-12",155,2,162,545,4774,0.624842899036447,0,0,393,360,39,3445,24,1806,13,24
"148","2020-05-13",163,2,159,513,4774,0.624842899036447,0,0,393,360,35,3480,37,1843,14,37
"149","2020-05-14",160,2,138,503,4774,0.624842899036447,0,0,393,360,31,3511,17,1860,8,17
"150","2020-05-15",157,2,143,487,4774,0.624842899036447,0,0,393,360,35,3546,25,1885,10,25
"151","2020-05-16",146,2,165,482,4774,0.624842899036447,0,0,393,360,44,3590,17,1902,9,17
"152","2020-05-17",134,2,182,469,4774,0.624842899036447,0,0,393,360,31,3621,24,1926,13,24
"153","2020-05-18",130,2,192,459,4774,0.624842899036447,0,0,393,360,39,3660,20,1946,12,20
"154","2020-05-19",128,2,205,442,4774,0.624842899036447,0,0,393,360,39,3699,22,1968,8,22
"155","2020-05-20",125,2,203,417,4774,0.624842899036447,0,0,393,360,36,3735,19,1987,13,19
"156","2020-05-21",118,2,196,420,4774,0.624842899036447,0,0,393,360,37,3772,26,2013,15,26
"157","2020-05-22",117,2,168,403,4774,0.624842899036447,0,0,393,360,47,3819,16,2029,18,16
"158","2020-05-23",114,2,156,384,4774,0.624842899036447,0,0,393,360,32,3851,27,2056,17,27
"159","2020-05-24",118,2,150,367,4774,0.624842899036447,0,0,393,360,32,3883,23,2079,9,23
"160","2020-05-25",119,2,145,362,4774,0.624842899036447,0,0,393,360,36,3919,19,2098,16,19
"161","2020-05-26",120,2,124,341,4774,0.624842899036447,0,0,393,360,28,3947,12,2110,5,12
"162","2020-05-27",112,2,113,326,4774,0.624842899036447,0,0,393,360,26,3973,36,2146,7,36
"163","2020-05-28",109,2,124,311,4774,0.624842899036447,0,0,393,360,33,4006,32,2178,15,32
"164","2020-05-29",105,2,114,304,4774,0.624842899036447,0,0,393,360,22,4028,28,2206,5,28
"165","2020-05-30",108,2,97,288,4774,0.624842899036447,0,0,393,360,30,4058,41,2247,11,41
"166","2020-05-31",104,2,97,276,4774,0.624842899036447,0,0,393,360,23,4081,26,2273,10,26
"167","2020-06-01",100,2,81,272,4774,0.624842899036447,0,0,393,360,22,4103,30,2303,11,30
"168","2020-06-02",89,2,83,259,4774,0.624842899036447,0,0,393,360,24,4127,17,2320,8,17
"169","2020-06-03",82,2,82,245,4774,0.624842899036447,0,0,393,360,15,4142,23,2343,3,23
"170","2020-06-04",75,2,86,227,4774,0.624842899036447,0,0,393,360,14,4156,34,2377,4,34
"171","2020-06-05",73,2,82,208,4774,0.624842899036447,0,0,393,360,12,4168,22,2399,6,22
"172","2020-06-06",68,2,80,194,4774,0.624842899036447,0,0,393,360,19,4187,24,2423,6,24
"173","2020-06-07",62,2,81,185,4774,0.624842899036447,0,0,393,360,19,4206,26,2449,5,26
"174","2020-03-13",4,3,99,139,5363,0.393436509416371,0,0,459,1042,26,46,31,71,13,31
"175","2020-03-14",6,3,131,185,5363,0.393436509416371,0,0,459,1042,26,72,31,102,20,31
"176","2020-03-15",14,3,174,231,5363,0.393436509416371,0,0,459,1042,25,97,23,125,13,23
"177","2020-03-16",26,3,197,298,5363,0.393436509416371,0,0,459,1042,36,133,33,158,28,33
"178","2020-03-17",37,3,238,355,5363,0.393436509416371,0,0,459,1042,39,172,23,181,32,23
"179","2020-03-18",52,3,242,417,5363,0.393436509416371,0,0,459,1042,48,220,33,214,37,33
"180","2020-03-19",75,3,262,464,5363,0.393436509416371,0,0,459,1042,60,280,19,233,49,19
"181","2020-03-20",91,3,247,514,5363,0.393436509416371,0,0,459,1042,83,363,24,257,75,24
"182","2020-03-21",110,3,243,568,5363,0.393436509416371,0,0,459,1042,85,448,27,284,79,27
"183","2020-03-22",123,3,241,624,5363,0.393436509416371,0,0,459,1042,102,550,13,297,85,13
"184","2020-03-23",135,3,246,655,5363,0.393436509416371,0,0,459,1042,83,633,33,330,70,33
"185","2020-03-24",148,3,235,687,5363,0.393436509416371,0,0,459,1042,99,732,34,364,88,34
"186","2020-03-25",159,3,236,713,5363,0.393436509416371,0,0,459,1042,157,889,49,413,146,49
"187","2020-03-26",166,3,243,741,5363,0.393436509416371,0,0,459,1042,142,1031,29,442,130,29
"188","2020-03-27",186,3,258,772,5363,0.393436509416371,0,0,459,1042,163,1194,41,483,148,41
"189","2020-03-28",195,3,273,800,5363,0.393436509416371,0,0,459,1042,148,1342,49,532,140,49
"190","2020-03-29",204,3,260,807,5363,0.393436509416371,0,0,459,1042,158,1500,38,570,146,38
"191","2020-03-30",218,3,240,832,5363,0.393436509416371,0,0,459,1042,201,1701,41,611,192,41
"192","2020-03-31",220,3,272,838,5363,0.393436509416371,0,0,459,1042,185,1886,31,642,175,31
"193","2020-04-01",230,3,301,853,5363,0.393436509416371,0,0,459,1042,179,2065,32,674,171,32
"194","2020-04-02",240,3,299,866,5363,0.393436509416371,0,0,459,1042,133,2198,15,689,127,15
"195","2020-04-03",236,3,294,866,5363,0.393436509416371,0,0,459,1042,200,2398,21,710,187,21
"196","2020-04-04",236,3,267,849,5363,0.393436509416371,0,0,459,1042,201,2599,39,749,189,39
"197","2020-04-05",237,3,271,878,5363,0.393436509416371,0,0,459,1042,211,2810,17,766,205,17
"198","2020-04-06",239,3,293,877,5363,0.393436509416371,0,0,459,1042,205,3015,29,795,202,29
"199","2020-04-07",250,3,296,872,5363,0.393436509416371,0,0,459,1042,176,3191,41,836,160,41
"200","2020-04-08",244,3,305,874,5363,0.393436509416371,0,0,459,1042,184,3375,32,868,174,32
"201","2020-04-09",220,3,321,873,5363,0.393436509416371,0,0,459,1042,155,3530,24,892,148,24
"202","2020-04-10",225,3,321,884,5363,0.393436509416371,0,0,459,1042,200,3730,21,913,189,21
"203","2020-04-11",230,3,303,883,5363,0.393436509416371,0,0,459,1042,158,3888,14,927,150,14
"204","2020-04-12",240,3,293,880,5363,0.393436509416371,0,0,459,1042,139,4027,17,944,131,17
"205","2020-04-13",234,3,289,907,5363,0.393436509416371,0,0,459,1042,147,4174,15,959,142,15
"206","2020-04-14",227,3,299,889,5363,0.393436509416371,0,0,459,1042,126,4300,41,1000,120,41
"207","2020-04-15",231,3,288,869,5363,0.393436509416371,0,0,459,1042,120,4420,50,1050,114,50
"208","2020-04-16",246,3,271,864,5363,0.393436509416371,0,0,459,1042,135,4555,31,1081,131,31
"209","2020-04-17",240,3,266,844,5363,0.393436509416371,0,0,459,1042,107,4662,37,1118,91,37
"210","2020-04-18",232,3,255,833,5363,0.393436509416371,0,0,459,1042,89,4751,44,1162,83,44
"211","2020-04-19",227,3,259,809,5363,0.393436509416371,0,0,459,1042,106,4857,27,1189,101,27
"212","2020-04-20",226,3,250,806,5363,0.393436509416371,0,0,459,1042,87,4944,26,1215,84,26
"213","2020-04-21",234,3,249,806,5363,0.393436509416371,0,0,459,1042,81,5025,21,1236,77,21
"214","2020-04-22",234,3,264,794,5363,0.393436509416371,0,0,459,1042,62,5087,18,1254,58,18
"215","2020-04-23",237,3,264,808,5363,0.393436509416371,0,0,459,1042,61,5148,26,1280,57,26
"216","2020-04-24",233,3,263,814,5363,0.393436509416371,0,0,459,1042,75,5223,16,1296,64,16
"217","2020-04-25",241,3,265,815,5363,0.393436509416371,0,0,459,1042,59,5282,21,1317,50,21
"218","2020-04-26",238,3,265,807,5363,0.393436509416371,0,0,459,1042,66,5348,14,1331,58,14
"219","2020-04-27",241,3,297,800,5363,0.393436509416371,0,0,459,1042,79,5427,28,1359,69,28
"220","2020-04-28",235,3,279,790,5363,0.393436509416371,0,0,459,1042,54,5481,24,1383,50,24
"221","2020-04-29",243,3,270,767,5363,0.393436509416371,0,0,459,1042,38,5519,27,1410,34,27
"222","2020-04-30",235,3,276,751,5363,0.393436509416371,0,0,459,1042,46,5565,22,1432,43,22
"223","2020-05-01",237,3,263,738,5363,0.393436509416371,0,0,459,1042,42,5607,41,1473,39,41
"224","2020-05-02",235,3,266,738,5363,0.393436509416371,0,0,459,1042,32,5639,32,1505,24,32
"225","2020-05-03",230,3,277,722,5363,0.393436509416371,0,0,459,1042,44,5683,21,1526,36,21
"226","2020-05-04",222,3,285,708,5363,0.393436509416371,0,0,459,1042,37,5720,23,1549,32,23
"227","2020-05-05",216,3,295,709,5363,0.393436509416371,0,0,459,1042,30,5750,17,1566,28,17
"228","2020-05-06",204,3,296,681,5363,0.393436509416371,0,0,459,1042,26,5776,13,1579,24,13
"229","2020-05-07",195,3,292,667,5363,0.393436509416371,0,0,459,1042,27,5803,22,1601,22,22
"230","2020-05-08",201,3,300,637,5363,0.393436509416371,0,0,459,1042,19,5822,19,1620,18,19
"231","2020-05-09",202,3,292,628,5363,0.393436509416371,0,0,459,1042,17,5839,37,1657,13,37
"232","2020-05-10",203,3,286,619,5363,0.393436509416371,0,0,459,1042,24,5863,44,1701,21,44
"233","2020-05-11",187,3,277,619,5363,0.393436509416371,0,0,459,1042,16,5879,31,1732,13,31
"234","2020-05-12",187,3,272,595,5363,0.393436509416371,0,0,459,1042,27,5906,30,1762,22,30
"235","2020-05-13",187,3,268,591,5363,0.393436509416371,0,0,459,1042,16,5922,28,1790,12,28
"236","2020-05-14",194,3,259,577,5363,0.393436509416371,0,0,459,1042,14,5936,16,1806,10,16
"237","2020-05-15",177,3,279,566,5363,0.393436509416371,0,0,459,1042,7,5943,25,1831,5,25
"238","2020-05-16",161,3,300,544,5363,0.393436509416371,0,0,459,1042,16,5959,23,1854,11,23
"239","2020-05-17",159,3,306,516,5363,0.393436509416371,0,0,459,1042,16,5975,34,1888,11,34
"240","2020-05-18",166,3,306,506,5363,0.393436509416371,0,0,459,1042,11,5986,35,1923,7,35
"241","2020-05-19",160,3,308,501,5363,0.393436509416371,0,0,459,1042,12,5998,27,1950,10,27
"242","2020-05-20",142,3,315,479,5363,0.393436509416371,0,0,459,1042,16,6014,28,1978,11,28
"243","2020-05-21",137,3,310,444,5363,0.393436509416371,0,0,459,1042,13,6027,42,2020,10,42
"244","2020-05-22",137,3,291,422,5363,0.393436509416371,0,0,459,1042,10,6037,31,2051,8,31
"245","2020-05-23",129,3,283,417,5363,0.393436509416371,0,0,459,1042,8,6045,28,2079,4,28
"246","2020-05-24",122,3,274,402,5363,0.393436509416371,0,0,459,1042,11,6056,21,2100,8,21
"247","2020-05-25",119,3,256,380,5363,0.393436509416371,0,0,459,1042,12,6068,14,2114,7,14
"248","2020-05-26",117,3,294,378,5363,0.393436509416371,0,0,459,1042,15,6083,22,2136,11,22
"249","2020-05-27",119,3,308,374,5363,0.393436509416371,0,0,459,1042,12,6095,15,2151,9,15
"250","2020-05-28",115,3,317,345,5363,0.393436509416371,0,0,459,1042,7,6102,31,2182,3,31
"251","2020-05-29",107,3,320,337,5363,0.393436509416371,0,0,459,1042,8,6110,31,2213,7,31
"252","2020-05-30",108,3,321,329,5363,0.393436509416371,0,0,459,1042,7,6117,19,2232,5,19
"253","2020-05-31",104,3,305,306,5363,0.393436509416371,0,0,459,1042,16,6133,40,2272,13,40
"254","2020-06-01",107,3,304,289,5363,0.393436509416371,0,0,459,1042,12,6145,19,2291,8,19
"255","2020-06-02",101,3,305,274,5363,0.393436509416371,0,0,459,1042,14,6159,41,2332,11,41
"256","2020-06-03",100,3,286,269,5363,0.393436509416371,0,0,459,1042,8,6167,32,2364,4,32
"257","2020-06-04",104,3,270,260,5363,0.393436509416371,0,0,459,1042,8,6175,22,2386,7,22
"258","2020-06-05",101,3,264,250,5363,0.393436509416371,0,0,459,1042,5,6180,29,2415,5,29
"259","2020-06-06",95,3,302,246,5363,0.393436509416371,0,0,459,1042,6,6186,29,2444,6,29
"260","2020-06-07",90,3,322,247,5363,0.393436509416371,0,0,459,1042,6,6192,28,2472,3,28
"261","2020-03-13",2,4,49,54,4559,0.664400087738539,0,0,374,574,64,164,10,92,26,10
"262","2020-03-14",4,4,61,84,4559,0.664400087738539,0,0,374,574,98,262,12,104,55,12
"263","2020-03-15",8,4,80,116,4559,0.664400087738539,0,0,374,574,89,351,10,114,59,10
"264","2020-03-16",13,4,71,149,4559,0.664400087738539,0,0,374,574,81,432,38,152,50,38
"265","2020-03-17",19,4,66,183,4559,0.664400087738539,0,0,374,574,146,578,28,180,104,28
"266","2020-03-18",27,4,91,213,4559,0.664400087738539,0,0,374,574,211,789,40,220,171,40
"267","2020-03-19",37,4,97,252,4559,0.664400087738539,0,0,374,574,206,995,48,268,168,48
"268","2020-03-20",39,4,77,288,4559,0.664400087738539,0,0,374,574,242,1237,30,298,205,30
"269","2020-03-21",52,4,74,322,4559,0.664400087738539,0,0,374,574,357,1594,25,323,327,25
"270","2020-03-22",65,4,67,358,4559,0.664400087738539,0,0,374,574,398,1992,49,372,361,49
"271","2020-03-23",69,4,70,371,4559,0.664400087738539,0,0,374,574,473,2465,26,398,448,26
"272","2020-03-24",75,4,77,419,4559,0.664400087738539,0,0,374,574,478,2943,23,421,458,23
"273","2020-03-25",78,4,85,449,4559,0.664400087738539,0,0,374,574,474,3417,12,433,448,12
"274","2020-03-26",84,4,115,473,4559,0.664400087738539,0,0,374,574,530,3947,25,458,511,25
"275","2020-03-27",98,4,135,503,4559,0.664400087738539,0,0,374,574,459,4406,41,499,443,41
"276","2020-03-28",101,4,156,538,4559,0.664400087738539,0,0,374,574,376,4782,60,559,354,60
"277","2020-03-29",106,4,185,561,4559,0.664400087738539,0,0,374,574,470,5252,78,637,456,78
"278","2020-03-30",113,4,206,596,4559,0.664400087738539,0,0,374,574,413,5665,68,705,394,68
"279","2020-03-31",133,4,233,620,4559,0.664400087738539,0,0,374,574,439,6104,29,734,428,29
"280","2020-04-01",143,4,220,655,4559,0.664400087738539,0,0,374,574,323,6427,21,755,312,21
"281","2020-04-02",156,4,216,659,4559,0.664400087738539,0,0,374,574,298,6725,12,767,288,12
"282","2020-04-03",166,4,209,670,4559,0.664400087738539,0,0,374,574,185,6910,22,789,175,22
"283","2020-04-04",171,4,217,712,4559,0.664400087738539,0,0,374,574,152,7062,52,841,142,52
"284","2020-04-05",187,4,218,740,4559,0.664400087738539,0,0,374,574,148,7210,24,865,144,24
"285","2020-04-06",197,4,216,745,4559,0.664400087738539,0,0,374,574,126,7336,14,879,121,14
"286","2020-04-07",196,4,198,756,4559,0.664400087738539,0,0,374,574,93,7429,13,892,89,13
"287","2020-04-08",203,4,204,795,4559,0.664400087738539,0,0,374,574,63,7492,12,904,58,12
"288","2020-04-09",201,4,182,814,4559,0.664400087738539,0,0,374,574,37,7529,57,961,31,57
"289","2020-04-10",208,4,205,819,4559,0.664400087738539,0,0,374,574,34,7563,39,1000,32,39
"290","2020-04-11",213,4,202,847,4559,0.664400087738539,0,0,374,574,24,7587,68,1068,23,68
"291","2020-04-12",201,4,199,849,4559,0.664400087738539,0,0,374,574,17,7604,42,1110,16,42
"292","2020-04-13",206,4,215,841,4559,0.664400087738539,0,0,374,574,25,7629,36,1146,19,36
"293","2020-04-14",209,4,239,853,4559,0.664400087738539,0,0,374,574,11,7640,61,1207,9,61
"294","2020-04-15",210,4,271,853,4559,0.664400087738539,0,0,374,574,11,7651,46,1253,7,46
"295","2020-04-16",220,4,254,831,4559,0.664400087738539,0,0,374,574,17,7668,79,1332,12,79
"296","2020-04-17",216,4,220,830,4559,0.664400087738539,0,0,374,574,11,7679,32,1364,6,32
"297","2020-04-18",229,4,225,824,4559,0.664400087738539,0,0,374,574,7,7686,20,1384,5,20
"298","2020-04-19",235,4,200,817,4559,0.664400087738539,0,0,374,574,11,7697,21,1405,7,21
"299","2020-04-20",244,4,186,820,4559,0.664400087738539,0,0,374,574,12,7709,30,1435,6,30
"300","2020-04-21",236,4,200,830,4559,0.664400087738539,0,0,374,574,6,7715,22,1457,4,22
"301","2020-04-22",247,4,213,834,4559,0.664400087738539,0,0,374,574,8,7723,14,1471,6,14
"302","2020-04-23",257,4,174,838,4559,0.664400087738539,0,0,374,574,3,7726,11,1482,NA,11
"303","2020-04-24",255,4,187,848,4559,0.664400087738539,0,0,374,574,4,7730,5,1487,3,5
"304","2020-04-25",248,4,200,821,4559,0.664400087738539,0,0,374,574,2,7732,26,1513,1,26
"305","2020-04-26",253,4,219,825,4559,0.664400087738539,0,0,374,574,4,7736,11,1524,4,11
"306","2020-04-27",247,4,197,800,4559,0.664400087738539,0,0,374,574,6,7742,26,1550,1,26
"307","2020-04-28",267,4,194,787,4559,0.664400087738539,0,0,374,574,3,7745,77,1627,1,77
"308","2020-04-29",257,4,200,773,4559,0.664400087738539,0,0,374,574,8,7753,32,1659,5,32
"309","2020-04-30",240,4,195,757,4559,0.664400087738539,0,0,374,574,3,7756,50,1709,1,50
"310","2020-05-01",242,4,216,721,4559,0.664400087738539,0,0,374,574,4,7760,31,1740,2,31
"311","2020-05-02",243,4,199,703,4559,0.664400087738539,0,0,374,574,3,7763,19,1759,2,19
"312","2020-05-03",231,4,169,670,4559,0.664400087738539,0,0,374,574,3,7766,61,1820,1,61
"313","2020-05-04",221,4,167,645,4559,0.664400087738539,0,0,374,574,5,7771,84,1904,2,84
"314","2020-05-05",191,4,141,635,4559,0.664400087738539,0,0,374,574,5,7776,37,1941,1,37
"315","2020-05-06",188,4,136,642,4559,0.664400087738539,0,0,374,574,3,7779,28,1969,2,28
"316","2020-05-07",185,4,114,606,4559,0.664400087738539,0,0,374,574,5,7784,26,1995,2,26
"317","2020-05-08",179,4,100,581,4559,0.664400087738539,0,0,374,574,1,7785,21,2016,NA,21
"318","2020-05-09",167,4,108,572,4559,0.664400087738539,0,0,374,574,6,7791,55,2071,5,55
"319","2020-05-10",165,4,104,545,4559,0.664400087738539,0,0,374,574,3,7794,35,2106,1,35
"320","2020-05-11",157,4,100,537,4559,0.664400087738539,0,0,374,574,4,7798,18,2124,1,18
"321","2020-05-12",153,4,142,527,4559,0.664400087738539,0,0,374,574,NA,NA,66,2190,NA,66
"322","2020-05-13",148,4,188,514,4559,0.664400087738539,0,0,374,574,4,7802,66,2256,1,66
"323","2020-05-14",148,4,209,504,4559,0.664400087738539,0,0,374,574,2,7804,26,2282,NA,26
"324","2020-05-15",149,4,204,496,4559,0.664400087738539,0,0,374,574,NA,NA,28,2310,NA,28
"325","2020-05-16",149,4,183,482,4559,0.664400087738539,0,0,374,574,1,7805,33,2343,NA,33
"326","2020-05-17",146,4,175,464,4559,0.664400087738539,0,0,374,574,1,7806,21,2364,NA,21
"327","2020-05-18",155,4,180,447,4559,0.664400087738539,0,0,374,574,2,7808,18,2382,NA,18
"328","2020-05-19",161,4,156,440,4559,0.664400087738539,0,0,374,574,3,7811,15,2397,1,15
"329","2020-05-20",153,4,149,415,4559,0.664400087738539,0,0,374,574,3,7814,18,2415,1,18
"330","2020-05-21",140,4,132,395,4559,0.664400087738539,0,0,374,574,2,7816,27,2442,1,27
"331","2020-05-22",133,4,141,379,4559,0.664400087738539,0,0,374,574,2,7818,17,2459,1,17
"332","2020-05-23",126,4,138,371,4559,0.664400087738539,0,0,374,574,5,7823,7,2466,2,7
"333","2020-05-24",120,4,154,340,4559,0.664400087738539,0,0,374,574,NA,NA,16,2482,NA,16
"334","2020-05-25",108,4,166,330,4559,0.664400087738539,0,0,374,574,2,7825,20,2502,1,20
"335","2020-05-26",107,4,171,324,4559,0.664400087738539,0,0,374,574,3,7828,27,2529,1,27
"336","2020-05-27",103,4,176,311,4559,0.664400087738539,0,0,374,574,2,7830,20,2549,1,20
"337","2020-05-28",104,4,183,304,4559,0.664400087738539,0,0,374,574,NA,NA,10,2559,NA,10
"338","2020-05-29",96,4,211,302,4559,0.664400087738539,0,0,374,574,3,7833,17,2576,1,17
"339","2020-05-30",95,4,213,293,4559,0.664400087738539,0,0,374,574,2,7835,44,2620,1,44
"340","2020-05-31",92,4,213,286,4559,0.664400087738539,0,0,374,574,1,7836,23,2643,1,23
"341","2020-06-01",93,4,212,275,4559,0.664400087738539,0,0,374,574,1,7837,15,2658,NA,15
"342","2020-06-02",95,4,208,277,4559,0.664400087738539,0,0,374,574,NA,NA,13,2671,NA,13
"343","2020-06-03",96,4,191,268,4559,0.664400087738539,0,0,374,574,4,7841,50,2721,1,50
"344","2020-06-04",94,4,165,266,4559,0.664400087738539,0,0,374,574,2,7843,17,2738,1,17
"345","2020-06-05",95,4,153,250,4559,0.664400087738539,0,0,374,574,1,7844,29,2767,NA,29
"346","2020-06-06",96,4,154,240,4559,0.664400087738539,0,0,374,574,3,7847,41,2808,1,41
"347","2020-06-07",87,4,145,237,4559,0.664400087738539,0,0,374,574,NA,NA,24,2832,NA,24
"348","2020-03-12",3,5,17,52,3954,0.437025796661609,0,0,371,387,18,34,24,33,1,24
"349","2020-03-13",3,5,19,77,3954,0.437025796661609,0,0,371,387,15,49,39,72,5,39
"350","2020-03-14",6,5,26,106,3954,0.437025796661609,0,0,371,387,21,70,23,95,7,23
"351","2020-03-15",8,5,35,134,3954,0.437025796661609,0,0,371,387,24,94,18,113,9,18
"352","2020-03-16",12,5,37,169,3954,0.437025796661609,0,0,371,387,30,124,33,146,12,33
"353","2020-03-17",21,5,38,202,3954,0.437025796661609,0,0,371,387,32,156,29,175,15,29
"354","2020-03-18",28,5,49,244,3954,0.437025796661609,0,0,371,387,25,181,36,211,14,36
"355","2020-03-19",38,5,57,284,3954,0.437025796661609,0,0,371,387,29,210,40,251,19,40
"356","2020-03-20",53,5,69,315,3954,0.437025796661609,0,0,371,387,28,238,36,287,15,36
"357","2020-03-21",68,5,94,363,3954,0.437025796661609,0,0,371,387,37,275,27,314,20,27
"358","2020-03-22",77,5,116,390,3954,0.437025796661609,0,0,371,387,33,308,35,349,21,35
"359","2020-03-23",92,5,109,423,3954,0.437025796661609,0,0,371,387,39,347,30,379,28,30
"360","2020-03-24",101,5,114,440,3954,0.437025796661609,0,0,371,387,25,372,21,400,10,21
"361","2020-03-25",110,5,105,462,3954,0.437025796661609,0,0,371,387,42,414,48,448,29,48
"362","2020-03-26",112,5,106,493,3954,0.437025796661609,0,0,371,387,36,450,27,475,15,27
"363","2020-03-27",116,5,105,514,3954,0.437025796661609,0,0,371,387,40,490,44,519,25,44
"364","2020-03-28",126,5,105,523,3954,0.437025796661609,0,0,371,387,37,527,31,550,23,31
"365","2020-03-29",135,5,89,536,3954,0.437025796661609,0,0,371,387,31,558,34,584,24,34
"366","2020-03-30",141,5,93,570,3954,0.437025796661609,0,0,371,387,48,606,47,631,33,47
"367","2020-03-31",146,5,96,574,3954,0.437025796661609,0,0,371,387,44,650,32,663,28,32
"368","2020-04-01",161,5,86,570,3954,0.437025796661609,0,0,371,387,49,699,38,701,29,38
"369","2020-04-02",174,5,84,580,3954,0.437025796661609,0,0,371,387,48,747,44,745,33,44
"370","2020-04-03",174,5,80,586,3954,0.437025796661609,0,0,371,387,43,790,35,780,33,35
"371","2020-04-04",166,5,70,608,3954,0.437025796661609,0,0,371,387,47,837,19,799,31,19
"372","2020-04-05",174,5,66,622,3954,0.437025796661609,0,0,371,387,46,883,41,840,35,41
"373","2020-04-06",170,5,56,631,3954,0.437025796661609,0,0,371,387,37,920,63,903,24,63
"374","2020-04-07",168,5,63,647,3954,0.437025796661609,0,0,371,387,47,967,35,938,30,35
"375","2020-04-08",157,5,77,661,3954,0.437025796661609,0,0,371,387,49,1016,30,968,35,30
"376","2020-04-09",147,5,64,671,3954,0.437025796661609,0,0,371,387,58,1074,45,1013,41,45
"377","2020-04-10",146,5,70,685,3954,0.437025796661609,0,0,371,387,38,1112,36,1049,23,36
"378","2020-04-11",149,5,64,696,3954,0.437025796661609,0,0,371,387,42,1154,27,1076,29,27
"379","2020-04-12",161,5,59,719,3954,0.437025796661609,0,0,371,387,46,1200,28,1104,27,28
"380","2020-04-13",164,5,77,747,3954,0.437025796661609,0,0,371,387,41,1241,61,1165,22,61
"381","2020-04-14",177,5,116,745,3954,0.437025796661609,0,0,371,387,41,1282,57,1222,25,57
"382","2020-04-15",184,5,128,746,3954,0.437025796661609,0,0,371,387,34,1316,39,1261,25,39
"383","2020-04-16",204,5,147,739,3954,0.437025796661609,0,0,371,387,50,1366,32,1293,36,32
"384","2020-04-17",222,5,144,733,3954,0.437025796661609,0,0,371,387,42,1408,20,1313,28,20
"385","2020-04-18",227,5,150,719,3954,0.437025796661609,0,0,371,387,40,1448,43,1356,28,43
"386","2020-04-19",211,5,143,709,3954,0.437025796661609,0,0,371,387,42,1490,38,1394,27,38
"387","2020-04-20",232,5,150,700,3954,0.437025796661609,0,0,371,387,41,1531,41,1435,26,41
"388","2020-04-21",229,5,166,696,3954,0.437025796661609,0,0,371,387,52,1583,45,1480,33,45
"389","2020-04-22",233,5,180,678,3954,0.437025796661609,0,0,371,387,46,1629,28,1508,30,28
"390","2020-04-23",214,5,167,668,3954,0.437025796661609,0,0,371,387,38,1667,16,1524,25,16
"391","2020-04-24",203,5,167,640,3954,0.437025796661609,0,0,371,387,41,1708,20,1544,20,20
"392","2020-04-25",210,5,144,617,3954,0.437025796661609,0,0,371,387,36,1744,20,1564,24,20
"393","2020-04-26",204,5,140,598,3954,0.437025796661609,0,0,371,387,46,1790,31,1595,28,31
"394","2020-04-27",184,5,146,588,3954,0.437025796661609,0,0,371,387,40,1830,28,1623,26,28
"395","2020-04-28",174,5,138,574,3954,0.437025796661609,0,0,371,387,50,1880,24,1647,33,24
"396","2020-04-29",167,5,130,577,3954,0.437025796661609,0,0,371,387,47,1927,33,1680,17,33
"397","2020-04-30",170,5,149,568,3954,0.437025796661609,0,0,371,387,34,1961,28,1708,18,28
"398","2020-05-01",167,5,162,563,3954,0.437025796661609,0,0,371,387,37,1998,21,1729,28,21
"399","2020-05-02",155,5,181,559,3954,0.437025796661609,0,0,371,387,40,2038,21,1750,22,21
"400","2020-05-03",148,5,178,541,3954,0.437025796661609,0,0,371,387,44,2082,22,1772,18,22
"401","2020-05-04",143,5,180,512,3954,0.437025796661609,0,0,371,387,33,2115,15,1787,22,15
"402","2020-05-05",137,5,164,511,3954,0.437025796661609,0,0,371,387,29,2144,38,1825,18,38
"403","2020-05-06",136,5,181,499,3954,0.437025796661609,0,0,371,387,32,2176,29,1854,24,29
"404","2020-05-07",136,5,192,483,3954,0.437025796661609,0,0,371,387,30,2206,32,1886,20,32
"405","2020-05-08",138,5,186,473,3954,0.437025796661609,0,0,371,387,35,2241,27,1913,19,27
"406","2020-05-09",130,5,159,461,3954,0.437025796661609,0,0,371,387,37,2278,23,1936,24,23
"407","2020-05-10",131,5,154,449,3954,0.437025796661609,0,0,371,387,30,2308,32,1968,20,32
"408","2020-05-11",130,5,151,433,3954,0.437025796661609,0,0,371,387,37,2345,22,1990,20,22
"409","2020-05-12",133,5,166,419,3954,0.437025796661609,0,0,371,387,32,2377,59,2049,23,59
"410","2020-05-13",124,5,172,422,3954,0.437025796661609,0,0,371,387,33,2410,33,2082,23,33
"411","2020-05-14",120,5,155,408,3954,0.437025796661609,0,0,371,387,26,2436,56,2138,14,56
"412","2020-05-15",113,5,138,390,3954,0.437025796661609,0,0,371,387,22,2458,22,2160,15,22
"413","2020-05-16",118,5,122,372,3954,0.437025796661609,0,0,371,387,25,2483,47,2207,14,47
"414","2020-05-17",118,5,108,376,3954,0.437025796661609,0,0,371,387,34,2517,26,2233,18,26
"415","2020-05-18",111,5,125,371,3954,0.437025796661609,0,0,371,387,23,2540,30,2263,13,30
"416","2020-05-19",112,5,138,361,3954,0.437025796661609,0,0,371,387,19,2559,29,2292,10,29
"417","2020-05-20",109,5,143,352,3954,0.437025796661609,0,0,371,387,26,2585,40,2332,21,40
"418","2020-05-21",105,5,145,342,3954,0.437025796661609,0,0,371,387,20,2605,36,2368,9,36
"419","2020-05-22",105,5,125,338,3954,0.437025796661609,0,0,371,387,19,2624,34,2402,7,34
"420","2020-05-23",93,5,114,329,3954,0.437025796661609,0,0,371,387,22,2646,20,2422,15,20
"421","2020-05-24",94,5,115,315,3954,0.437025796661609,0,0,371,387,17,2663,35,2457,9,35
"422","2020-05-25",91,5,122,294,3954,0.437025796661609,0,0,371,387,15,2678,31,2488,7,31
"423","2020-05-26",83,5,118,292,3954,0.437025796661609,0,0,371,387,16,2694,27,2515,8,27
"424","2020-05-27",85,5,102,296,3954,0.437025796661609,0,0,371,387,19,2713,23,2538,11,23
"425","2020-05-28",85,5,95,286,3954,0.437025796661609,0,0,371,387,16,2729,21,2559,7,21
"426","2020-05-29",80,5,86,290,3954,0.437025796661609,0,0,371,387,22,2751,16,2575,15,16
"427","2020-05-30",81,5,71,283,3954,0.437025796661609,0,0,371,387,10,2761,38,2613,6,38
"428","2020-05-31",82,5,71,287,3954,0.437025796661609,0,0,371,387,18,2779,29,2642,10,29
"429","2020-06-01",81,5,87,273,3954,0.437025796661609,0,0,371,387,22,2801,21,2663,10,21
"430","2020-06-02",83,5,84,272,3954,0.437025796661609,0,0,371,387,14,2815,18,2681,8,18
"431","2020-06-03",79,5,87,261,3954,0.437025796661609,0,0,371,387,23,2838,37,2718,16,37
"432","2020-06-04",73,5,87,260,3954,0.437025796661609,0,0,371,387,9,2847,29,2747,5,29
"433","2020-06-05",71,5,97,251,3954,0.437025796661609,0,0,371,387,15,2862,22,2769,7,22
"434","2020-06-06",74,5,101,235,3954,0.437025796661609,0,0,371,387,12,2874,22,2791,8,22
"435","2020-06-07",70,5,103,220,3954,0.437025796661609,0,0,371,387,19,2893,16,2807,11,16
"436","2020-03-15",4,6,104,189,8134,0.910253257929678,0,0,698,519,39,169,11,63,13,11
"437","2020-03-16",7,6,110,253,8134,0.910253257929678,0,0,698,519,38,207,8,71,16,8
"438","2020-03-17",17,6,135,356,8134,0.910253257929678,0,0,698,519,34,241,4,75,7,4
"439","2020-03-18",26,6,138,478,8134,0.910253257929678,0,0,698,519,27,268,7,82,16,7
"440","2020-03-19",44,6,149,639,8134,0.910253257929678,0,0,698,519,64,332,7,89,31,7
"441","2020-03-20",62,6,151,837,8134,0.910253257929678,0,0,698,519,43,375,6,95,18,6
"442","2020-03-21",91,6,183,1039,8134,0.910253257929678,0,0,698,519,43,418,19,114,17,19
"443","2020-03-22",127,6,204,1328,8134,0.910253257929678,0,0,698,519,61,479,9,123,32,9
"444","2020-03-23",164,6,182,1683,8134,0.910253257929678,0,0,698,519,41,520,24,147,22,24
"445","2020-03-24",221,6,165,2019,8134,0.910253257929678,0,0,698,519,41,561,25,172,20,25
"446","2020-03-25",269,6,160,2454,8134,0.910253257929678,0,0,698,519,53,614,44,216,25,44
"447","2020-03-26",342,6,167,2788,8134,0.910253257929678,0,0,698,519,35,649,26,242,14,26
"448","2020-03-27",435,6,155,3144,8134,0.910253257929678,0,0,698,519,50,699,12,254,22,12
"449","2020-03-28",510,6,172,3585,8134,0.910253257929678,0,0,698,519,43,742,8,262,15,8
"450","2020-03-29",617,6,207,3866,8134,0.910253257929678,0,0,698,519,53,795,11,273,19,11
"451","2020-03-30",727,6,196,4230,8134,0.910253257929678,0,0,698,519,55,850,8,281,25,8
"452","2020-03-31",848,6,202,4418,8134,0.910253257929678,0,0,698,519,30,880,15,296,10,15
"453","2020-04-01",980,6,207,4578,8134,0.910253257929678,0,0,698,519,43,923,9,305,21,9
"454","2020-04-02",1090,6,203,4590,8134,0.910253257929678,0,0,698,519,58,981,13,318,29,13
"455","2020-04-03",1169,6,217,4524,8134,0.910253257929678,0,0,698,519,51,1032,12,330,19,12
"456","2020-04-04",1254,6,219,4377,8134,0.910253257929678,0,0,698,519,51,1083,26,356,24,26
"457","2020-04-05",1281,6,203,4174,8134,0.910253257929678,0,0,698,519,60,1143,44,400,23,44
"458","2020-04-06",1304,6,179,3875,8134,0.910253257929678,0,0,698,519,51,1194,50,450,20,50
"459","2020-04-07",1292,6,180,3554,8134,0.910253257929678,0,0,698,519,54,1248,43,493,22,43
"460","2020-04-08",1266,6,173,3237,8134,0.910253257929678,0,0,698,519,48,1296,59,552,18,59
"461","2020-04-09",1209,6,202,2865,8134,0.910253257929678,0,0,698,519,42,1338,48,600,13,48
"462","2020-04-10",1141,6,201,2525,8134,0.910253257929678,0,0,698,519,46,1384,32,632,10,32
"463","2020-04-11",1069,6,177,2170,8134,0.910253257929678,0,0,698,519,39,1423,23,655,4,23
"464","2020-04-12",963,6,161,1816,8134,0.910253257929678,0,0,698,519,44,1467,21,676,22,21
"465","2020-04-13",856,6,174,1501,8134,0.910253257929678,0,0,698,519,41,1508,12,688,10,12
"466","2020-04-14",746,6,189,1246,8134,0.910253257929678,0,0,698,519,45,1553,24,712,13,24
"467","2020-04-15",618,6,237,1025,8134,0.910253257929678,0,0,698,519,38,1591,37,749,6,37
"468","2020-04-16",526,6,228,829,8134,0.910253257929678,0,0,698,519,54,1645,32,781,13,32
"469","2020-04-17",433,6,220,669,8134,0.910253257929678,0,0,698,519,37,1682,58,839,11,58
"470","2020-04-18",348,6,237,558,8134,0.910253257929678,0,0,698,519,37,1719,60,899,7,60
"471","2020-04-19",302,6,216,441,8134,0.910253257929678,0,0,698,519,44,1763,60,959,16,60
"472","2020-04-20",252,6,217,353,8134,0.910253257929678,0,0,698,519,41,1804,53,1012,13,53
"473","2020-04-21",195,6,205,293,8134,0.910253257929678,0,0,698,519,36,1840,28,1040,9,28
"474","2020-04-22",168,6,176,235,8134,0.910253257929678,0,0,698,519,35,1875,45,1085,6,45
"475","2020-04-23",128,6,167,183,8134,0.910253257929678,0,0,698,519,41,1916,45,1130,11,45
"476","2020-04-24",108,6,150,157,8134,0.910253257929678,0,0,698,519,45,1961,23,1153,9,23
"477","2020-04-25",80,6,182,131,8134,0.910253257929678,0,0,698,519,47,2008,18,1171,11,18
"478","2020-04-26",64,6,172,108,8134,0.910253257929678,0,0,698,519,37,2045,12,1183,7,12
"479","2020-04-27",50,6,162,84,8134,0.910253257929678,0,0,698,519,41,2086,7,1190,7,7
"480","2020-04-28",41,6,149,72,8134,0.910253257929678,0,0,698,519,38,2124,11,1201,7,11
"481","2020-04-29",35,6,181,55,8134,0.910253257929678,0,0,698,519,38,2162,11,1212,6,11
"482","2020-04-30",23,6,216,46,8134,0.910253257929678,0,0,698,519,46,2208,43,1255,12,43
"483","2020-05-01",16,6,194,42,8134,0.910253257929678,0,0,698,519,38,2246,33,1288,11,33
"484","2020-05-02",14,6,183,41,8134,0.910253257929678,0,0,698,519,34,2280,41,1329,5,41
"485","2020-05-03",10,6,213,35,8134,0.910253257929678,0,0,698,519,47,2327,32,1361,12,32
"486","2020-05-04",9,6,231,30,8134,0.910253257929678,0,0,698,519,40,2367,22,1383,11,22
"487","2020-05-05",14,6,239,27,8134,0.910253257929678,0,0,698,519,41,2408,56,1439,7,56
"488","2020-05-06",13,6,248,25,8134,0.910253257929678,0,0,698,519,37,2445,37,1476,10,37
"489","2020-05-07",13,6,229,29,8134,0.910253257929678,0,0,698,519,48,2493,21,1497,8,21
"490","2020-05-08",11,6,224,34,8134,0.910253257929678,0,0,698,519,43,2536,23,1520,17,23
"491","2020-05-09",11,6,238,31,8134,0.910253257929678,0,0,698,519,40,2576,38,1558,14,38
"492","2020-05-10",10,6,223,30,8134,0.910253257929678,0,0,698,519,31,2607,31,1589,4,31
"493","2020-05-11",10,6,213,31,8134,0.910253257929678,0,0,698,519,45,2652,43,1632,18,43
"494","2020-05-12",6,6,210,31,8134,0.910253257929678,0,0,698,519,37,2689,26,1658,7,26
"495","2020-05-13",6,6,233,34,8134,0.910253257929678,0,0,698,519,41,2730,32,1690,17,32
"496","2020-05-14",9,6,224,34,8134,0.910253257929678,0,0,698,519,33,2763,34,1724,12,34
"497","2020-05-15",13,6,217,32,8134,0.910253257929678,0,0,698,519,21,2784,35,1759,8,35
"498","2020-05-16",12,6,211,30,8134,0.910253257929678,0,0,698,519,31,2815,15,1774,7,15
"499","2020-05-17",12,6,200,31,8134,0.910253257929678,0,0,698,519,31,2846,57,1831,11,57
"500","2020-05-18",13,6,209,29,8134,0.910253257929678,0,0,698,519,27,2873,58,1889,8,58
"501","2020-05-19",13,6,197,29,8134,0.910253257929678,0,0,698,519,28,2901,36,1925,6,36
"502","2020-05-20",13,6,199,31,8134,0.910253257929678,0,0,698,519,18,2919,26,1951,9,26
"503","2020-05-21",10,6,169,27,8134,0.910253257929678,0,0,698,519,28,2947,44,1995,1,44
"504","2020-05-22",9,6,162,26,8134,0.910253257929678,0,0,698,519,28,2975,29,2024,11,29
"505","2020-05-23",8,6,191,25,8134,0.910253257929678,0,0,698,519,15,2990,36,2060,5,36
"506","2020-05-24",9,6,190,25,8134,0.910253257929678,0,0,698,519,22,3012,32,2092,3,32
"507","2020-05-25",10,6,177,23,8134,0.910253257929678,0,0,698,519,26,3038,44,2136,6,44
"508","2020-05-26",9,6,184,23,8134,0.910253257929678,0,0,698,519,19,3057,24,2160,7,24
"509","2020-05-27",8,6,172,23,8134,0.910253257929678,0,0,698,519,13,3070,11,2171,5,11
"510","2020-05-28",8,6,193,21,8134,0.910253257929678,0,0,698,519,18,3088,42,2213,4,42
"511","2020-05-29",6,6,204,22,8134,0.910253257929678,0,0,698,519,12,3100,47,2260,1,47
"512","2020-05-30",8,6,191,25,8134,0.910253257929678,0,0,698,519,22,3122,28,2288,7,28
"513","2020-05-31",8,6,208,20,8134,0.910253257929678,0,0,698,519,19,3141,15,2303,5,15
"514","2020-06-01",6,6,176,22,8134,0.910253257929678,0,0,698,519,24,3165,9,2312,4,9
"515","2020-06-02",7,6,178,20,8134,0.910253257929678,0,0,698,519,19,3184,13,2325,9,13
"516","2020-06-03",8,6,187,22,8134,0.910253257929678,0,0,698,519,15,3199,23,2348,10,23
"517","2020-06-04",9,6,172,19,8134,0.910253257929678,0,0,698,519,19,3218,28,2376,4,28
"518","2020-06-05",9,6,155,22,8134,0.910253257929678,0,0,698,519,12,3230,27,2403,5,27
"519","2020-06-06",7,6,184,22,8134,0.910253257929678,0,0,698,519,21,3251,20,2423,5,20
"520","2020-06-07",5,6,172,20,8134,0.910253257929678,0,0,698,519,18,3269,20,2443,6,20
"521","2020-03-14",4,7,49,156,5193,0.296938186019642,0,0,483,362,18,69,40,143,8,40
"522","2020-03-15",7,7,51,215,5193,0.296938186019642,0,0,483,362,20,89,20,163,7,20
"523","2020-03-16",16,7,68,264,5193,0.296938186019642,0,0,483,362,25,114,12,175,12,12
"524","2020-03-17",32,7,74,312,5193,0.296938186019642,0,0,483,362,26,140,3,178,11,3
"525","2020-03-18",43,7,65,388,5193,0.296938186019642,0,0,483,362,27,167,3,181,13,3
"526","2020-03-19",58,7,64,444,5193,0.296938186019642,0,0,483,362,31,198,7,188,13,7
"527","2020-03-20",82,7,74,491,5193,0.296938186019642,0,0,483,362,45,243,30,218,31,30
"528","2020-03-21",101,7,78,541,5193,0.296938186019642,0,0,483,362,27,270,22,240,18,22
"529","2020-03-22",118,7,94,589,5193,0.296938186019642,0,0,483,362,33,303,11,251,19,11
"530","2020-03-23",129,7,96,620,5193,0.296938186019642,0,0,483,362,49,352,27,278,34,27
"531","2020-03-24",128,7,92,668,5193,0.296938186019642,0,0,483,362,37,389,17,295,24,17
"532","2020-03-25",144,7,104,713,5193,0.296938186019642,0,0,483,362,37,426,17,312,32,17
"533","2020-03-26",157,7,115,728,5193,0.296938186019642,0,0,483,362,61,487,40,352,48,40
"534","2020-03-27",160,7,103,739,5193,0.296938186019642,0,0,483,362,43,530,45,397,28,45
"535","2020-03-28",159,7,109,739,5193,0.296938186019642,0,0,483,362,37,567,40,437,24,40
"536","2020-03-29",177,7,88,732,5193,0.296938186019642,0,0,483,362,50,617,56,493,28,56
"537","2020-03-30",193,7,73,763,5193,0.296938186019642,0,0,483,362,40,657,62,555,28,62
"538","2020-03-31",210,7,64,784,5193,0.296938186019642,0,0,483,362,49,706,53,608,39,53
"539","2020-04-01",218,7,67,794,5193,0.296938186019642,0,0,483,362,47,753,58,666,34,58
"540","2020-04-02",221,7,74,793,5193,0.296938186019642,0,0,483,362,40,793,53,719,23,53
"541","2020-04-03",227,7,84,815,5193,0.296938186019642,0,0,483,362,64,857,56,775,44,56
"542","2020-04-04",235,7,85,819,5193,0.296938186019642,0,0,483,362,44,901,39,814,26,39
"543","2020-04-05",218,7,91,849,5193,0.296938186019642,0,0,483,362,59,960,27,841,39,27
"544","2020-04-06",221,7,110,855,5193,0.296938186019642,0,0,483,362,51,1011,46,887,36,46
"545","2020-04-07",222,7,121,877,5193,0.296938186019642,0,0,483,362,58,1069,23,910,38,23
"546","2020-04-08",223,7,103,887,5193,0.296938186019642,0,0,483,362,51,1120,14,924,34,14
"547","2020-04-09",223,7,107,889,5193,0.296938186019642,0,0,483,362,36,1156,32,956,25,32
"548","2020-04-10",220,7,119,900,5193,0.296938186019642,0,0,483,362,49,1205,11,967,33,11
"549","2020-04-11",218,7,111,890,5193,0.296938186019642,0,0,483,362,35,1240,14,981,27,14
"550","2020-04-12",232,7,121,882,5193,0.296938186019642,0,0,483,362,40,1280,8,989,23,8
"551","2020-04-13",232,7,122,907,5193,0.296938186019642,0,0,483,362,39,1319,7,996,20,7
"552","2020-04-14",234,7,123,896,5193,0.296938186019642,0,0,483,362,35,1354,17,1013,17,17
"553","2020-04-15",231,7,108,899,5193,0.296938186019642,0,0,483,362,48,1402,5,1018,38,5
"554","2020-04-16",232,7,106,919,5193,0.296938186019642,0,0,483,362,44,1446,8,1026,27,8
"555","2020-04-17",242,7,99,919,5193,0.296938186019642,0,0,483,362,34,1480,31,1057,22,31
"556","2020-04-18",244,7,90,896,5193,0.296938186019642,0,0,483,362,39,1519,27,1084,25,27
"557","2020-04-19",252,7,95,870,5193,0.296938186019642,0,0,483,362,51,1570,41,1125,32,41
"558","2020-04-20",253,7,95,842,5193,0.296938186019642,0,0,483,362,53,1623,30,1155,32,30
"559","2020-04-21",251,7,93,832,5193,0.296938186019642,0,0,483,362,55,1678,17,1172,36,17
"560","2020-04-22",251,7,127,829,5193,0.296938186019642,0,0,483,362,43,1721,9,1181,23,9
"561","2020-04-23",255,7,133,821,5193,0.296938186019642,0,0,483,362,41,1762,13,1194,31,13
"562","2020-04-24",255,7,147,808,5193,0.296938186019642,0,0,483,362,55,1817,9,1203,30,9
"563","2020-04-25",253,7,167,782,5193,0.296938186019642,0,0,483,362,42,1859,13,1216,23,13
"564","2020-04-26",243,7,183,819,5193,0.296938186019642,0,0,483,362,42,1901,11,1227,29,11
"565","2020-04-27",236,7,170,788,5193,0.296938186019642,0,0,483,362,46,1947,6,1233,30,6
"566","2020-04-28",229,7,145,783,5193,0.296938186019642,0,0,483,362,51,1998,6,1239,32,6
"567","2020-04-29",217,7,156,772,5193,0.296938186019642,0,0,483,362,63,2061,28,1267,34,28
"568","2020-04-30",212,7,171,762,5193,0.296938186019642,0,0,483,362,41,2102,13,1280,29,13
"569","2020-05-01",204,7,183,740,5193,0.296938186019642,0,0,483,362,48,2150,5,1285,34,5
"570","2020-05-02",205,7,203,719,5193,0.296938186019642,0,0,483,362,46,2196,11,1296,30,11
"571","2020-05-03",198,7,220,690,5193,0.296938186019642,0,0,483,362,52,2248,39,1335,30,39
"572","2020-05-04",194,7,230,675,5193,0.296938186019642,0,0,483,362,47,2295,24,1359,33,24
"573","2020-05-05",193,7,203,653,5193,0.296938186019642,0,0,483,362,56,2351,55,1414,40,55
"574","2020-05-06",205,7,185,639,5193,0.296938186019642,0,0,483,362,44,2395,49,1463,33,49
"575","2020-05-07",196,7,187,634,5193,0.296938186019642,0,0,483,362,31,2426,23,1486,17,23
"576","2020-05-08",188,7,217,595,5193,0.296938186019642,0,0,483,362,33,2459,13,1499,20,13
"577","2020-05-09",190,7,212,577,5193,0.296938186019642,0,0,483,362,44,2503,42,1541,29,42
"578","2020-05-10",177,7,201,538,5193,0.296938186019642,0,0,483,362,24,2527,37,1578,15,37
"579","2020-05-11",166,7,178,535,5193,0.296938186019642,0,0,483,362,41,2568,21,1599,30,21
"580","2020-05-12",171,7,198,539,5193,0.296938186019642,0,0,483,362,29,2597,15,1614,18,15
"581","2020-05-13",169,7,193,525,5193,0.296938186019642,0,0,483,362,25,2622,12,1626,12,12
"582","2020-05-14",167,7,201,502,5193,0.296938186019642,0,0,483,362,26,2648,39,1665,18,39
"583","2020-05-15",164,7,203,492,5193,0.296938186019642,0,0,483,362,32,2680,14,1679,22,14
"584","2020-05-16",151,7,201,483,5193,0.296938186019642,0,0,483,362,26,2706,34,1713,16,34
"585","2020-05-17",155,7,179,473,5193,0.296938186019642,0,0,483,362,23,2729,17,1730,8,17
"586","2020-05-18",157,7,170,457,5193,0.296938186019642,0,0,483,362,37,2766,6,1736,26,6
"587","2020-05-19",147,7,175,443,5193,0.296938186019642,0,0,483,362,25,2791,8,1744,10,8
"588","2020-05-20",131,7,169,437,5193,0.296938186019642,0,0,483,362,22,2813,4,1748,19,4
"589","2020-05-21",131,7,162,425,5193,0.296938186019642,0,0,483,362,30,2843,24,1772,19,24
"590","2020-05-22",125,7,153,401,5193,0.296938186019642,0,0,483,362,21,2864,31,1803,16,31
"591","2020-05-23",125,7,161,403,5193,0.296938186019642,0,0,483,362,28,2892,58,1861,16,58
"592","2020-05-24",126,7,161,386,5193,0.296938186019642,0,0,483,362,19,2911,64,1925,15,64
"593","2020-05-25",124,7,171,365,5193,0.296938186019642,0,0,483,362,26,2937,30,1955,17,30
"594","2020-05-26",119,7,163,343,5193,0.296938186019642,0,0,483,362,17,2954,24,1979,9,24
"595","2020-05-27",114,7,152,338,5193,0.296938186019642,0,0,483,362,24,2978,31,2010,18,31
"596","2020-05-28",102,7,129,331,5193,0.296938186019642,0,0,483,362,12,2990,22,2032,9,22
"597","2020-05-29",93,7,113,327,5193,0.296938186019642,0,0,483,362,19,3009,18,2050,10,18
"598","2020-05-30",85,7,104,304,5193,0.296938186019642,0,0,483,362,25,3034,8,2058,21,8
"599","2020-05-31",80,7,121,283,5193,0.296938186019642,0,0,483,362,17,3051,9,2067,11,9
"600","2020-06-01",75,7,126,284,5193,0.296938186019642,0,0,483,362,12,3063,5,2072,5,5
"601","2020-06-02",71,7,121,275,5193,0.296938186019642,0,0,483,362,16,3079,6,2078,9,6
"602","2020-06-03",70,7,123,260,5193,0.296938186019642,0,0,483,362,7,3086,2,2080,5,2
"603","2020-06-04",72,7,120,248,5193,0.296938186019642,0,0,483,362,12,3098,23,2103,10,23
"604","2020-06-05",81,7,116,228,5193,0.296938186019642,0,0,483,362,17,3115,25,2128,12,25
"605","2020-06-06",81,7,109,222,5193,0.296938186019642,0,0,483,362,17,3132,11,2139,11,11
"606","2020-06-07",75,7,102,214,5193,0.296938186019642,0,0,483,362,15,3147,9,2148,13,9
"607","2020-03-13",1,8,83,100,4572,0.402887139107612,0,0,436,1176,27,77,18,44,1,18
"608","2020-03-14",4,8,115,141,4572,0.402887139107612,0,0,436,1176,32,109,10,54,6,10
"609","2020-03-15",8,8,125,186,4572,0.402887139107612,0,0,436,1176,36,145,5,59,8,5
"610","2020-03-16",12,8,125,233,4572,0.402887139107612,0,0,436,1176,35,180,10,69,6,10
"611","2020-03-17",24,8,132,286,4572,0.402887139107612,0,0,436,1176,44,224,4,73,18,4
"612","2020-03-18",36,8,133,329,4572,0.402887139107612,0,0,436,1176,49,273,6,79,21,6
"613","2020-03-19",46,8,147,377,4572,0.402887139107612,0,0,436,1176,27,300,16,95,11,16
"614","2020-03-20",56,8,181,407,4572,0.402887139107612,0,0,436,1176,37,337,13,108,15,13
"615","2020-03-21",67,8,188,458,4572,0.402887139107612,0,0,436,1176,48,385,27,135,23,27
"616","2020-03-22",79,8,216,512,4572,0.402887139107612,0,0,436,1176,38,423,31,166,12,31
"617","2020-03-23",99,8,245,543,4572,0.402887139107612,0,0,436,1176,52,475,17,183,22,17
"618","2020-03-24",111,8,269,586,4572,0.402887139107612,0,0,436,1176,44,519,5,188,14,5
"619","2020-03-25",123,8,262,621,4572,0.402887139107612,0,0,436,1176,59,578,32,220,24,32
"620","2020-03-26",141,8,286,617,4572,0.402887139107612,0,0,436,1176,39,617,24,244,18,24
"621","2020-03-27",158,8,292,615,4572,0.402887139107612,0,0,436,1176,50,667,15,259,16,15
"622","2020-03-28",171,8,297,619,4572,0.402887139107612,0,0,436,1176,32,699,7,266,20,7
"623","2020-03-29",185,8,261,616,4572,0.402887139107612,0,0,436,1176,58,757,12,278,25,12
"624","2020-03-30",184,8,285,622,4572,0.402887139107612,0,0,436,1176,43,800,12,290,19,12
"625","2020-03-31",181,8,292,641,4572,0.402887139107612,0,0,436,1176,40,840,7,297,15,7
"626","2020-04-01",179,8,272,648,4572,0.402887139107612,0,0,436,1176,42,882,19,316,15,19
"627","2020-04-02",176,8,268,664,4572,0.402887139107612,0,0,436,1176,53,935,31,347,19,31
"628","2020-04-03",172,8,255,673,4572,0.402887139107612,0,0,436,1176,44,979,41,388,21,41
"629","2020-04-04",170,8,268,685,4572,0.402887139107612,0,0,436,1176,42,1021,23,411,15,23
"630","2020-04-05",165,8,286,682,4572,0.402887139107612,0,0,436,1176,49,1070,17,428,12,17
"631","2020-04-06",157,8,282,706,4572,0.402887139107612,0,0,436,1176,38,1108,14,442,19,14
"632","2020-04-07",165,8,266,716,4572,0.402887139107612,0,0,436,1176,53,1161,34,476,17,34
"633","2020-04-08",164,8,277,715,4572,0.402887139107612,0,0,436,1176,42,1203,21,497,11,21
"634","2020-04-09",174,8,274,720,4572,0.402887139107612,0,0,436,1176,40,1243,15,512,16,15
"635","2020-04-10",183,8,278,750,4572,0.402887139107612,0,0,436,1176,47,1290,16,528,16,16
"636","2020-04-11",183,8,278,743,4572,0.402887139107612,0,0,436,1176,50,1340,45,573,10,45
"637","2020-04-12",192,8,268,755,4572,0.402887139107612,0,0,436,1176,37,1377,37,610,11,37
"638","2020-04-13",205,8,272,763,4572,0.402887139107612,0,0,436,1176,49,1426,37,647,13,37
"639","2020-04-14",212,8,294,774,4572,0.402887139107612,0,0,436,1176,56,1482,38,685,21,38
"640","2020-04-15",223,8,290,781,4572,0.402887139107612,0,0,436,1176,51,1533,50,735,12,50
"641","2020-04-16",216,8,268,765,4572,0.402887139107612,0,0,436,1176,37,1570,51,786,12,51
"642","2020-04-17",216,8,245,752,4572,0.402887139107612,0,0,436,1176,43,1613,33,819,7,33
"643","2020-04-18",222,8,240,743,4572,0.402887139107612,0,0,436,1176,46,1659,17,836,14,17
"644","2020-04-19",219,8,277,724,4572,0.402887139107612,0,0,436,1176,37,1696,33,869,9,33
"645","2020-04-20",214,8,252,704,4572,0.402887139107612,0,0,436,1176,42,1738,18,887,6,18
"646","2020-04-21",201,8,276,686,4572,0.402887139107612,0,0,436,1176,45,1783,17,904,6,17
"647","2020-04-22",190,8,279,657,4572,0.402887139107612,0,0,436,1176,43,1826,39,943,12,39
"648","2020-04-23",181,8,275,660,4572,0.402887139107612,0,0,436,1176,40,1866,27,970,12,27
"649","2020-04-24",173,8,254,645,4572,0.402887139107612,0,0,436,1176,40,1906,18,988,15,18
"650","2020-04-25",175,8,244,647,4572,0.402887139107612,0,0,436,1176,39,1945,33,1021,13,33
"651","2020-04-26",165,8,234,639,4572,0.402887139107612,0,0,436,1176,48,1993,31,1052,13,31
"652","2020-04-27",161,8,245,636,4572,0.402887139107612,0,0,436,1176,44,2037,16,1068,8,16
"653","2020-04-28",170,8,259,639,4572,0.402887139107612,0,0,436,1176,29,2066,42,1110,3,42
"654","2020-04-29",169,8,269,649,4572,0.402887139107612,0,0,436,1176,40,2106,51,1161,9,51
"655","2020-04-30",176,8,285,653,4572,0.402887139107612,0,0,436,1176,47,2153,39,1200,9,39
"656","2020-05-01",179,8,306,623,4572,0.402887139107612,0,0,436,1176,50,2203,42,1242,8,42
"657","2020-05-02",165,8,304,644,4572,0.402887139107612,0,0,436,1176,30,2233,23,1265,4,23
"658","2020-05-03",164,8,280,661,4572,0.402887139107612,0,0,436,1176,33,2266,19,1284,5,19
"659","2020-05-04",177,8,272,650,4572,0.402887139107612,0,0,436,1176,40,2306,11,1295,5,11
"660","2020-05-05",168,8,270,636,4572,0.402887139107612,0,0,436,1176,39,2345,10,1305,11,10
"661","2020-05-06",170,8,249,621,4572,0.402887139107612,0,0,436,1176,35,2380,40,1345,9,40
"662","2020-05-07",174,8,246,619,4572,0.402887139107612,0,0,436,1176,34,2414,31,1376,9,31
"663","2020-05-08",170,8,233,617,4572,0.402887139107612,0,0,436,1176,40,2454,27,1403,7,27
"664","2020-05-09",178,8,229,600,4572,0.402887139107612,0,0,436,1176,38,2492,16,1419,8,16
"665","2020-05-10",180,8,226,596,4572,0.402887139107612,0,0,436,1176,45,2537,17,1436,14,17
"666","2020-05-11",175,8,219,595,4572,0.402887139107612,0,0,436,1176,25,2562,42,1478,10,42
"667","2020-05-12",175,8,247,570,4572,0.402887139107612,0,0,436,1176,25,2587,37,1515,9,37
"668","2020-05-13",182,8,251,556,4572,0.402887139107612,0,0,436,1176,35,2622,37,1552,6,37
"669","2020-05-14",178,8,277,544,4572,0.402887139107612,0,0,436,1176,23,2645,50,1602,7,50
"670","2020-05-15",181,8,298,526,4572,0.402887139107612,0,0,436,1176,32,2677,29,1631,13,29
"671","2020-05-16",175,8,329,512,4572,0.402887139107612,0,0,436,1176,27,2704,21,1652,6,21
"672","2020-05-17",172,8,325,483,4572,0.402887139107612,0,0,436,1176,24,2728,38,1690,9,38
"673","2020-05-18",163,8,318,467,4572,0.402887139107612,0,0,436,1176,40,2768,27,1717,11,27
"674","2020-05-19",161,8,313,445,4572,0.402887139107612,0,0,436,1176,23,2791,27,1744,6,27
"675","2020-05-20",143,8,296,440,4572,0.402887139107612,0,0,436,1176,21,2812,42,1786,7,42
"676","2020-05-21",133,8,278,437,4572,0.402887139107612,0,0,436,1176,27,2839,26,1812,4,26
"677","2020-05-22",127,8,265,409,4572,0.402887139107612,0,0,436,1176,26,2865,29,1841,4,29
"678","2020-05-23",121,8,244,400,4572,0.402887139107612,0,0,436,1176,21,2886,42,1883,6,42
"679","2020-05-24",123,8,257,381,4572,0.402887139107612,0,0,436,1176,33,2919,35,1918,6,35
"680","2020-05-25",119,8,264,361,4572,0.402887139107612,0,0,436,1176,18,2937,36,1954,5,36
"681","2020-05-26",113,8,325,354,4572,0.402887139107612,0,0,436,1176,24,2961,37,1991,4,37
"682","2020-05-27",118,8,326,339,4572,0.402887139107612,0,0,436,1176,26,2987,28,2019,8,28
"683","2020-05-28",113,8,320,323,4572,0.402887139107612,0,0,436,1176,17,3004,14,2033,4,14
"684","2020-05-29",101,8,317,326,4572,0.402887139107612,0,0,436,1176,17,3021,19,2052,6,19
"685","2020-05-30",98,8,323,313,4572,0.402887139107612,0,0,436,1176,15,3036,7,2059,6,7
"686","2020-05-31",91,8,319,302,4572,0.402887139107612,0,0,436,1176,26,3062,9,2068,9,9
"687","2020-06-01",87,8,317,293,4572,0.402887139107612,0,0,436,1176,15,3077,3,2071,6,3
"688","2020-06-02",86,8,328,271,4572,0.402887139107612,0,0,436,1176,24,3101,10,2081,11,10
"689","2020-06-03",82,8,327,261,4572,0.402887139107612,0,0,436,1176,23,3124,6,2087,3,6
"690","2020-06-04",81,8,305,244,4572,0.402887139107612,0,0,436,1176,21,3145,4,2091,9,4
"691","2020-06-05",86,8,295,231,4572,0.402887139107612,0,0,436,1176,30,3175,7,2098,17,7
"692","2020-06-06",83,8,295,218,4572,0.402887139107612,0,0,436,1176,18,3193,20,2118,7,20
"693","2020-06-07",77,8,304,207,4572,0.402887139107612,0,0,436,1176,17,3210,10,2128,6,10
"694","2020-03-13",1,9,69,40,7432,0.96299784714747,0,0,626,750,10,27,14,62,5,14
"695","2020-03-14",3,9,66,67,7432,0.96299784714747,0,0,626,750,13,40,28,90,5,28
"696","2020-03-15",4,9,81,82,7432,0.96299784714747,0,0,626,750,15,55,37,127,10,37
"697","2020-03-16",8,9,95,115,7432,0.96299784714747,0,0,626,750,10,65,17,144,5,17
"698","2020-03-17",11,9,90,160,7432,0.96299784714747,0,0,626,750,27,92,16,160,20,16
"699","2020-03-18",18,9,105,215,7432,0.96299784714747,0,0,626,750,18,110,7,167,15,7
"700","2020-03-19",26,9,99,253,7432,0.96299784714747,0,0,626,750,21,131,19,186,17,19
"701","2020-03-20",35,9,112,312,7432,0.96299784714747,0,0,626,750,27,158,38,224,20,38
"702","2020-03-21",43,9,104,382,7432,0.96299784714747,0,0,626,750,19,177,20,244,17,20
"703","2020-03-22",54,9,89,466,7432,0.96299784714747,0,0,626,750,35,212,21,265,28,21
"704","2020-03-23",64,9,80,577,7432,0.96299784714747,0,0,626,750,36,248,14,279,32,14
"705","2020-03-24",72,9,78,704,7432,0.96299784714747,0,0,626,750,41,289,18,297,36,18
"706","2020-03-25",100,9,106,829,7432,0.96299784714747,0,0,626,750,29,318,22,319,23,22
"707","2020-03-26",122,9,152,980,7432,0.96299784714747,0,0,626,750,42,360,11,330,33,11
"708","2020-03-27",145,9,144,1148,7432,0.96299784714747,0,0,626,750,58,418,7,337,54,7
"709","2020-03-28",174,9,134,1364,7432,0.96299784714747,0,0,626,750,54,472,13,350,51,13
"710","2020-03-29",223,9,145,1554,7432,0.96299784714747,0,0,626,750,64,536,45,395,59,45
"711","2020-03-30",274,9,142,1776,7432,0.96299784714747,0,0,626,750,61,597,25,420,51,25
"712","2020-03-31",333,9,133,2008,7432,0.96299784714747,0,0,626,750,64,661,45,465,57,45
"713","2020-04-01",355,9,134,2266,7432,0.96299784714747,0,0,626,750,78,739,34,499,68,34
"714","2020-04-02",419,9,158,2516,7432,0.96299784714747,0,0,626,750,75,814,42,541,70,42
"715","2020-04-03",481,9,178,2786,7432,0.96299784714747,0,0,626,750,76,890,31,572,69,31
"716","2020-04-04",545,9,193,3025,7432,0.96299784714747,0,0,626,750,73,963,77,649,71,77
"717","2020-04-05",602,9,188,3172,7432,0.96299784714747,0,0,626,750,78,1041,60,709,74,60
"718","2020-04-06",667,9,174,3330,7432,0.96299784714747,0,0,626,750,89,1130,58,767,83,58
"719","2020-04-07",715,9,169,3512,7432,0.96299784714747,0,0,626,750,110,1240,50,817,106,50
"720","2020-04-08",822,9,156,3545,7432,0.96299784714747,0,0,626,750,80,1320,22,839,75,22
"721","2020-04-09",854,9,153,3553,7432,0.96299784714747,0,0,626,750,110,1430,11,850,98,11
"722","2020-04-10",918,9,148,3512,7432,0.96299784714747,0,0,626,750,73,1503,9,859,70,9
"723","2020-04-11",968,9,145,3424,7432,0.96299784714747,0,0,626,750,88,1591,18,877,83,18
"724","2020-04-12",993,9,157,3200,7432,0.96299784714747,0,0,626,750,90,1681,13,890,79,13
"725","2020-04-13",982,9,146,3070,7432,0.96299784714747,0,0,626,750,109,1790,13,903,104,13
"726","2020-04-14",1026,9,134,2886,7432,0.96299784714747,0,0,626,750,84,1874,31,934,77,31
"727","2020-04-15",987,9,153,2656,7432,0.96299784714747,0,0,626,750,123,1997,57,991,116,57
"728","2020-04-16",987,9,165,2434,7432,0.96299784714747,0,0,626,750,92,2089,41,1032,85,41
"729","2020-04-17",923,9,144,2172,7432,0.96299784714747,0,0,626,750,78,2167,28,1060,77,28
"730","2020-04-18",866,9,147,1952,7432,0.96299784714747,0,0,626,750,77,2244,51,1111,74,51
"731","2020-04-19",809,9,195,1711,7432,0.96299784714747,0,0,626,750,74,2318,34,1145,71,34
"732","2020-04-20",764,9,235,1464,7432,0.96299784714747,0,0,626,750,77,2395,50,1195,64,50
"733","2020-04-21",669,9,254,1265,7432,0.96299784714747,0,0,626,750,73,2468,31,1226,68,31
"734","2020-04-22",593,9,246,1106,7432,0.96299784714747,0,0,626,750,64,2532,35,1261,58,35
"735","2020-04-23",519,9,212,959,7432,0.96299784714747,0,0,626,750,78,2610,24,1285,72,24
"736","2020-04-24",465,9,195,837,7432,0.96299784714747,0,0,626,750,67,2677,27,1312,61,27
"737","2020-04-25",400,9,172,710,7432,0.96299784714747,0,0,626,750,85,2762,55,1367,80,55
"738","2020-04-26",338,9,205,609,7432,0.96299784714747,0,0,626,750,66,2828,42,1409,58,42
"739","2020-04-27",287,9,250,520,7432,0.96299784714747,0,0,626,750,81,2909,15,1424,75,15
"740","2020-04-28",242,9,234,434,7432,0.96299784714747,0,0,626,750,67,2976,45,1469,61,45
"741","2020-04-29",210,9,224,360,7432,0.96299784714747,0,0,626,750,76,3052,32,1501,70,32
"742","2020-04-30",167,9,204,303,7432,0.96299784714747,0,0,626,750,66,3118,44,1545,58,44
"743","2020-05-01",133,9,189,251,7432,0.96299784714747,0,0,626,750,62,3180,51,1596,58,51
"744","2020-05-02",113,9,177,222,7432,0.96299784714747,0,0,626,750,53,3233,62,1658,45,62
"745","2020-05-03",100,9,162,179,7432,0.96299784714747,0,0,626,750,67,3300,44,1702,64,44
"746","2020-05-04",84,9,147,155,7432,0.96299784714747,0,0,626,750,43,3343,35,1737,36,35
"747","2020-05-05",68,9,154,141,7432,0.96299784714747,0,0,626,750,62,3405,29,1766,60,29
"748","2020-05-06",56,9,175,119,7432,0.96299784714747,0,0,626,750,64,3469,79,1845,56,79
"749","2020-05-07",52,9,187,104,7432,0.96299784714747,0,0,626,750,70,3539,59,1904,63,59
"750","2020-05-08",50,9,189,87,7432,0.96299784714747,0,0,626,750,67,3606,45,1949,62,45
"751","2020-05-09",41,9,220,80,7432,0.96299784714747,0,0,626,750,45,3651,16,1965,37,16
"752","2020-05-10",34,9,252,75,7432,0.96299784714747,0,0,626,750,50,3701,24,1989,43,24
"753","2020-05-11",32,9,272,63,7432,0.96299784714747,0,0,626,750,27,3728,15,2004,24,15
"754","2020-05-12",28,9,286,57,7432,0.96299784714747,0,0,626,750,42,3770,30,2034,41,30
"755","2020-05-13",24,9,256,54,7432,0.96299784714747,0,0,626,750,44,3814,54,2088,40,54
"756","2020-05-14",21,9,236,53,7432,0.96299784714747,0,0,626,750,34,3848,27,2115,32,27
"757","2020-05-15",19,9,231,52,7432,0.96299784714747,0,0,626,750,34,3882,24,2139,34,24
"758","2020-05-16",19,9,246,48,7432,0.96299784714747,0,0,626,750,32,3914,45,2184,30,45
"759","2020-05-17",16,9,226,48,7432,0.96299784714747,0,0,626,750,29,3943,16,2200,26,16
"760","2020-05-18",12,9,211,43,7432,0.96299784714747,0,0,626,750,46,3989,17,2217,44,17
"761","2020-05-19",15,9,229,40,7432,0.96299784714747,0,0,626,750,27,4016,16,2233,25,16
"762","2020-05-20",16,9,246,35,7432,0.96299784714747,0,0,626,750,32,4048,35,2268,32,35
"763","2020-05-21",14,9,235,35,7432,0.96299784714747,0,0,626,750,28,4076,30,2298,25,30
"764","2020-05-22",11,9,250,33,7432,0.96299784714747,0,0,626,750,33,4109,37,2335,27,37
"765","2020-05-23",11,9,256,31,7432,0.96299784714747,0,0,626,750,19,4128,39,2374,18,39
"766","2020-05-24",11,9,238,31,7432,0.96299784714747,0,0,626,750,22,4150,37,2411,19,37
"767","2020-05-25",11,9,219,29,7432,0.96299784714747,0,0,626,750,25,4175,57,2468,24,57
"768","2020-05-26",7,9,190,31,7432,0.96299784714747,0,0,626,750,16,4191,56,2524,13,56
"769","2020-05-27",6,9,183,32,7432,0.96299784714747,0,0,626,750,21,4212,64,2588,15,64
"770","2020-05-28",9,9,187,31,7432,0.96299784714747,0,0,626,750,20,4232,43,2631,18,43
"771","2020-05-29",10,9,208,33,7432,0.96299784714747,0,0,626,750,13,4245,24,2655,13,24
"772","2020-05-30",10,9,193,31,7432,0.96299784714747,0,0,626,750,19,4264,40,2695,18,40
"773","2020-05-31",12,9,202,35,7432,0.96299784714747,0,0,626,750,19,4283,23,2718,16,23
"774","2020-06-01",11,9,209,32,7432,0.96299784714747,0,0,626,750,16,4299,20,2738,12,20
"775","2020-06-02",10,9,226,32,7432,0.96299784714747,0,0,626,750,11,4310,15,2753,9,15
"776","2020-06-03",11,9,216,31,7432,0.96299784714747,0,0,626,750,11,4321,22,2775,10,22
"777","2020-06-04",8,9,235,32,7432,0.96299784714747,0,0,626,750,13,4334,23,2798,12,23
"778","2020-06-05",11,9,235,30,7432,0.96299784714747,0,0,626,750,17,4351,13,2811,16,13
"779","2020-06-06",10,9,210,27,7432,0.96299784714747,0,0,626,750,13,4364,31,2842,12,31
"780","2020-06-07",8,9,185,27,7432,0.96299784714747,0,0,626,750,6,4370,19,2861,6,19
"781","2020-03-13",1,10,68,28,2083,0.625060009601536,0,0,165,756,26,79,10,27,5,10
"782","2020-03-14",1,10,86,40,2083,0.625060009601536,0,0,165,756,31,110,4,31,13,4
"783","2020-03-15",3,10,88,46,2083,0.625060009601536,0,0,165,756,34,144,5,36,12,5
"784","2020-03-16",7,10,77,62,2083,0.625060009601536,0,0,165,756,47,191,7,43,24,7
"785","2020-03-17",8,10,76,75,2083,0.625060009601536,0,0,165,756,35,226,9,52,13,9
"786","2020-03-18",10,10,88,86,2083,0.625060009601536,0,0,165,756,46,272,12,64,17,12
"787","2020-03-19",11,10,112,92,2083,0.625060009601536,0,0,165,756,49,321,13,77,29,13
"788","2020-03-20",14,10,101,106,2083,0.625060009601536,0,0,165,756,57,378,6,83,34,6
"789","2020-03-21",19,10,99,117,2083,0.625060009601536,0,0,165,756,55,433,4,87,36,4
"790","2020-03-22",23,10,81,128,2083,0.625060009601536,0,0,165,756,49,482,5,92,33,5
"791","2020-03-23",23,10,69,138,2083,0.625060009601536,0,0,165,756,73,555,7,99,56,7
"792","2020-03-24",25,10,68,150,2083,0.625060009601536,0,0,165,756,63,618,5,104,41,5
"793","2020-03-25",29,10,100,172,2083,0.625060009601536,0,0,165,756,55,673,11,115,43,11
"794","2020-03-26",36,10,113,181,2083,0.625060009601536,0,0,165,756,72,745,9,124,57,9
"795","2020-03-27",40,10,105,214,2083,0.625060009601536,0,0,165,756,69,814,12,136,50,12
"796","2020-03-28",41,10,104,219,2083,0.625060009601536,0,0,165,756,62,876,5,141,41,5
"797","2020-03-29",47,10,97,247,2083,0.625060009601536,0,0,165,756,98,974,15,156,73,15
"798","2020-03-30",51,10,119,274,2083,0.625060009601536,0,0,165,756,66,1040,18,174,48,18
"799","2020-03-31",54,10,147,294,2083,0.625060009601536,0,0,165,756,93,1133,11,185,67,11
"800","2020-04-01",60,10,149,317,2083,0.625060009601536,0,0,165,756,99,1232,31,216,66,31
"801","2020-04-02",70,10,180,332,2083,0.625060009601536,0,0,165,756,76,1308,35,251,64,35
"802","2020-04-03",72,10,199,348,2083,0.625060009601536,0,0,165,756,76,1384,15,266,59,15
"803","2020-04-04",77,10,207,352,2083,0.625060009601536,0,0,165,756,68,1452,19,285,49,19
"804","2020-04-05",76,10,190,352,2083,0.625060009601536,0,0,165,756,95,1547,19,304,74,19
"805","2020-04-06",81,10,198,348,2083,0.625060009601536,0,0,165,756,89,1636,22,326,67,22
"806","2020-04-07",90,10,182,347,2083,0.625060009601536,0,0,165,756,74,1710,29,355,51,29
"807","2020-04-08",96,10,199,346,2083,0.625060009601536,0,0,165,756,86,1796,22,377,62,22
"808","2020-04-09",100,10,211,340,2083,0.625060009601536,0,0,165,756,89,1885,14,391,63,14
"809","2020-04-10",103,10,182,333,2083,0.625060009601536,0,0,165,756,85,1970,32,423,57,32
"810","2020-04-11",105,10,187,316,2083,0.625060009601536,0,0,165,756,90,2060,22,445,64,22
"811","2020-04-12",114,10,179,311,2083,0.625060009601536,0,0,165,756,70,2130,25,470,45,25
"812","2020-04-13",112,10,200,317,2083,0.625060009601536,0,0,165,756,76,2206,31,501,56,31
"813","2020-04-14",108,10,176,324,2083,0.625060009601536,0,0,165,756,69,2275,35,536,46,35
"814","2020-04-15",101,10,159,313,2083,0.625060009601536,0,0,165,756,82,2357,37,573,62,37
"815","2020-04-16",88,10,143,290,2083,0.625060009601536,0,0,165,756,86,2443,32,605,54,32
"816","2020-04-17",88,10,134,292,2083,0.625060009601536,0,0,165,756,72,2515,34,639,40,34
"817","2020-04-18",83,10,131,300,2083,0.625060009601536,0,0,165,756,86,2601,18,657,64,18
"818","2020-04-19",72,10,160,315,2083,0.625060009601536,0,0,165,756,72,2673,15,672,53,15
"819","2020-04-20",75,10,167,316,2083,0.625060009601536,0,0,165,756,74,2747,9,681,51,9
"820","2020-04-21",80,10,190,311,2083,0.625060009601536,0,0,165,756,76,2823,9,690,45,9
"821","2020-04-22",79,10,204,322,2083,0.625060009601536,0,0,165,756,63,2886,16,706,40,16
"822","2020-04-23",82,10,184,323,2083,0.625060009601536,0,0,165,756,66,2952,30,736,45,30
"823","2020-04-24",82,10,167,328,2083,0.625060009601536,0,0,165,756,67,3019,30,766,35,30
"824","2020-04-25",87,10,156,333,2083,0.625060009601536,0,0,165,756,58,3077,40,806,37,40
"825","2020-04-26",90,10,167,347,2083,0.625060009601536,0,0,165,756,59,3136,17,823,37,17
"826","2020-04-27",91,10,173,346,2083,0.625060009601536,0,0,165,756,59,3195,15,838,39,15
"827","2020-04-28",85,10,191,347,2083,0.625060009601536,0,0,165,756,54,3249,15,853,37,15
"828","2020-04-29",88,10,169,350,2083,0.625060009601536,0,0,165,756,56,3305,31,884,40,31
"829","2020-04-30",96,10,169,353,2083,0.625060009601536,0,0,165,756,52,3357,39,923,39,39
"830","2020-05-01",96,10,169,340,2083,0.625060009601536,0,0,165,756,62,3419,56,979,37,56
"831","2020-05-02",97,10,142,332,2083,0.625060009601536,0,0,165,756,39,3458,33,1012,27,33
"832","2020-05-03",106,10,146,316,2083,0.625060009601536,0,0,165,756,57,3515,38,1050,33,38
"833","2020-05-04",98,10,128,311,2083,0.625060009601536,0,0,165,756,44,3559,23,1073,22,23
"834","2020-05-05",98,10,161,329,2083,0.625060009601536,0,0,165,756,39,3598,35,1108,18,35
"835","2020-05-06",102,10,193,308,2083,0.625060009601536,0,0,165,756,54,3652,25,1133,33,25
"836","2020-05-07",91,10,191,291,2083,0.625060009601536,0,0,165,756,49,3701,34,1167,35,34
"837","2020-05-08",85,10,179,283,2083,0.625060009601536,0,0,165,756,37,3738,30,1197,20,30
"838","2020-05-09",84,10,185,282,2083,0.625060009601536,0,0,165,756,48,3786,25,1222,29,25
"839","2020-05-10",75,10,205,273,2083,0.625060009601536,0,0,165,756,43,3829,49,1271,25,49
"840","2020-05-11",80,10,176,262,2083,0.625060009601536,0,0,165,756,40,3869,19,1290,28,19
"841","2020-05-12",83,10,162,252,2083,0.625060009601536,0,0,165,756,56,3925,14,1304,35,14
"842","2020-05-13",83,10,145,244,2083,0.625060009601536,0,0,165,756,33,3958,23,1327,18,23
"843","2020-05-14",86,10,142,236,2083,0.625060009601536,0,0,165,756,35,3993,15,1342,20,15
"844","2020-05-15",89,10,159,239,2083,0.625060009601536,0,0,165,756,48,4041,22,1364,33,22
"845","2020-05-16",83,10,164,235,2083,0.625060009601536,0,0,165,756,42,4083,40,1404,26,40
"846","2020-05-17",76,10,184,228,2083,0.625060009601536,0,0,165,756,32,4115,40,1444,20,40
"847","2020-05-18",77,10,178,218,2083,0.625060009601536,0,0,165,756,41,4156,47,1491,29,47
"848","2020-05-19",73,10,164,200,2083,0.625060009601536,0,0,165,756,30,4186,45,1536,15,45
"849","2020-05-20",66,10,176,197,2083,0.625060009601536,0,0,165,756,23,4209,43,1579,10,43
"850","2020-05-21",60,10,161,193,2083,0.625060009601536,0,0,165,756,36,4245,22,1601,20,22
"851","2020-05-22",56,10,173,192,2083,0.625060009601536,0,0,165,756,20,4265,24,1625,12,24
"852","2020-05-23",53,10,152,193,2083,0.625060009601536,0,0,165,756,24,4289,21,1646,9,21
"853","2020-05-24",55,10,138,199,2083,0.625060009601536,0,0,165,756,33,4322,21,1667,19,21
"854","2020-05-25",54,10,129,196,2083,0.625060009601536,0,0,165,756,29,4351,14,1681,16,14
"855","2020-05-26",50,10,122,193,2083,0.625060009601536,0,0,165,756,20,4371,14,1695,12,14
"856","2020-05-27",49,10,104,195,2083,0.625060009601536,0,0,165,756,30,4401,12,1707,18,12
"857","2020-05-28",48,10,102,196,2083,0.625060009601536,0,0,165,756,23,4424,29,1736,17,29
"858","2020-05-29",49,10,99,184,2083,0.625060009601536,0,0,165,756,20,4444,11,1747,11,11
"859","2020-05-30",52,10,85,190,2083,0.625060009601536,0,0,165,756,15,4459,1,1748,10,1
"860","2020-05-31",52,10,94,188,2083,0.625060009601536,0,0,165,756,18,4477,8,1756,11,8
"861","2020-06-01",50,10,101,195,2083,0.625060009601536,0,0,165,756,22,4499,3,1759,14,3
"862","2020-06-02",54,10,98,191,2083,0.625060009601536,0,0,165,756,25,4524,10,1769,16,10
"863","2020-06-03",55,10,112,194,2083,0.625060009601536,0,0,165,756,15,4539,6,1775,7,6
"864","2020-06-04",59,10,112,181,2083,0.625060009601536,0,0,165,756,16,4555,12,1787,8,12
"865","2020-06-05",57,10,110,182,2083,0.625060009601536,0,0,165,756,5,4560,13,1800,3,13
"866","2020-06-06",59,10,103,183,2083,0.625060009601536,0,0,165,756,12,4572,15,1815,5,15
"867","2020-06-07",58,10,95,178,2083,0.625060009601536,0,0,165,756,14,4586,16,1831,11,16
"868","2020-03-13",1,11,98,99,4213,0.3935437930216,0,0,363,626,50,140,36,79,8,36
"869","2020-03-14",4,11,86,141,4213,0.3935437930216,0,0,363,626,48,188,41,120,10,41
"870","2020-03-15",6,11,78,177,4213,0.3935437930216,0,0,363,626,46,234,47,167,16,47
"871","2020-03-16",20,11,88,244,4213,0.3935437930216,0,0,363,626,67,301,48,215,18,48
"872","2020-03-17",28,11,109,295,4213,0.3935437930216,0,0,363,626,58,359,67,282,29,67
"873","2020-03-18",43,11,115,341,4213,0.3935437930216,0,0,363,626,67,426,53,335,25,53
"874","2020-03-19",49,11,131,382,4213,0.3935437930216,0,0,363,626,58,484,65,400,24,65
"875","2020-03-20",69,11,158,453,4213,0.3935437930216,0,0,363,626,67,551,34,434,32,34
"876","2020-03-21",81,11,175,509,4213,0.3935437930216,0,0,363,626,72,623,40,474,39,40
"877","2020-03-22",99,11,196,559,4213,0.3935437930216,0,0,363,626,72,695,53,527,30,53
"878","2020-03-23",110,11,211,610,4213,0.3935437930216,0,0,363,626,63,758,46,573,27,46
"879","2020-03-24",134,11,239,641,4213,0.3935437930216,0,0,363,626,71,829,37,610,34,37
"880","2020-03-25",133,11,258,664,4213,0.3935437930216,0,0,363,626,86,915,33,643,45,33
"881","2020-03-26",144,11,252,669,4213,0.3935437930216,0,0,363,626,88,1003,34,677,41,34
"882","2020-03-27",139,11,221,673,4213,0.3935437930216,0,0,363,626,89,1092,40,717,49,40
"883","2020-03-28",146,11,222,655,4213,0.3935437930216,0,0,363,626,76,1168,58,775,36,58
"884","2020-03-29",152,11,233,653,4213,0.3935437930216,0,0,363,626,75,1243,36,811,36,36
"885","2020-03-30",151,11,207,620,4213,0.3935437930216,0,0,363,626,74,1317,39,850,44,39
"886","2020-03-31",145,11,193,633,4213,0.3935437930216,0,0,363,626,67,1384,71,921,32,71
"887","2020-04-01",161,11,182,636,4213,0.3935437930216,0,0,363,626,76,1460,63,984,39,63
"888","2020-04-02",173,11,172,633,4213,0.3935437930216,0,0,363,626,86,1546,49,1033,39,49
"889","2020-04-03",184,11,158,623,4213,0.3935437930216,0,0,363,626,80,1626,44,1077,41,44
"890","2020-04-04",187,11,139,625,4213,0.3935437930216,0,0,363,626,58,1684,35,1112,33,35
"891","2020-04-05",193,11,125,651,4213,0.3935437930216,0,0,363,626,96,1780,55,1167,39,55
"892","2020-04-06",195,11,158,660,4213,0.3935437930216,0,0,363,626,76,1856,62,1229,31,62
"893","2020-04-07",183,11,155,649,4213,0.3935437930216,0,0,363,626,76,1932,49,1278,40,49
"894","2020-04-08",177,11,156,651,4213,0.3935437930216,0,0,363,626,81,2013,60,1338,41,60
"895","2020-04-09",174,11,141,647,4213,0.3935437930216,0,0,363,626,85,2098,57,1395,46,57
"896","2020-04-10",182,11,168,668,4213,0.3935437930216,0,0,363,626,79,2177,50,1445,38,50
"897","2020-04-11",175,11,181,663,4213,0.3935437930216,0,0,363,626,69,2246,42,1487,34,42
"898","2020-04-12",169,11,177,655,4213,0.3935437930216,0,0,363,626,73,2319,52,1539,35,52
"899","2020-04-13",179,11,173,660,4213,0.3935437930216,0,0,363,626,94,2413,51,1590,49,51
"900","2020-04-14",195,11,188,679,4213,0.3935437930216,0,0,363,626,64,2477,49,1639,26,49
"901","2020-04-15",196,11,210,673,4213,0.3935437930216,0,0,363,626,66,2543,44,1683,28,44
"902","2020-04-16",190,11,241,676,4213,0.3935437930216,0,0,363,626,73,2616,29,1712,26,29
"903","2020-04-17",176,11,244,668,4213,0.3935437930216,0,0,363,626,77,2693,40,1752,35,40
"904","2020-04-18",181,11,209,667,4213,0.3935437930216,0,0,363,626,65,2758,33,1785,21,33
"905","2020-04-19",190,11,179,646,4213,0.3935437930216,0,0,363,626,60,2818,38,1823,18,38
"906","2020-04-20",181,11,209,640,4213,0.3935437930216,0,0,363,626,78,2896,24,1847,29,24
"907","2020-04-21",177,11,211,623,4213,0.3935437930216,0,0,363,626,76,2972,39,1886,29,39
"908","2020-04-22",185,11,198,601,4213,0.3935437930216,0,0,363,626,65,3037,40,1926,30,40
"909","2020-04-23",191,11,224,595,4213,0.3935437930216,0,0,363,626,81,3118,39,1965,36,39
"910","2020-04-24",191,11,204,598,4213,0.3935437930216,0,0,363,626,63,3181,35,2000,25,35
"911","2020-04-25",186,11,185,582,4213,0.3935437930216,0,0,363,626,73,3254,50,2050,36,50
"912","2020-04-26",173,11,182,560,4213,0.3935437930216,0,0,363,626,67,3321,26,2076,30,26
"913","2020-04-27",174,11,154,551,4213,0.3935437930216,0,0,363,626,66,3387,57,2133,34,57
"914","2020-04-28",169,11,159,555,4213,0.3935437930216,0,0,363,626,60,3447,37,2170,26,37
"915","2020-04-29",151,11,188,546,4213,0.3935437930216,0,0,363,626,59,3506,32,2202,22,32
"916","2020-04-30",147,11,185,565,4213,0.3935437930216,0,0,363,626,55,3561,49,2251,23,49
"917","2020-05-01",150,11,177,549,4213,0.3935437930216,0,0,363,626,55,3616,37,2288,24,37
"918","2020-05-02",151,11,211,533,4213,0.3935437930216,0,0,363,626,63,3679,32,2320,20,32
"919","2020-05-03",157,11,221,537,4213,0.3935437930216,0,0,363,626,49,3728,52,2372,22,52
"920","2020-05-04",144,11,191,535,4213,0.3935437930216,0,0,363,626,55,3783,43,2415,25,43
"921","2020-05-05",141,11,165,518,4213,0.3935437930216,0,0,363,626,66,3849,37,2452,21,37
"922","2020-05-06",145,11,150,507,4213,0.3935437930216,0,0,363,626,47,3896,45,2497,10,45
"923","2020-05-07",142,11,138,513,4213,0.3935437930216,0,0,363,626,48,3944,51,2548,15,51
"924","2020-05-08",139,11,176,512,4213,0.3935437930216,0,0,363,626,55,3999,36,2584,14,36
"925","2020-05-09",148,11,220,505,4213,0.3935437930216,0,0,363,626,53,4052,41,2625,24,41
"926","2020-05-10",144,11,246,500,4213,0.3935437930216,0,0,363,626,42,4094,30,2655,15,30
"927","2020-05-11",148,11,242,496,4213,0.3935437930216,0,0,363,626,55,4149,26,2681,18,26
"928","2020-05-12",148,11,269,488,4213,0.3935437930216,0,0,363,626,33,4182,34,2715,18,34
"929","2020-05-13",145,11,300,493,4213,0.3935437930216,0,0,363,626,42,4224,38,2753,19,38
"930","2020-05-14",143,11,290,487,4213,0.3935437930216,0,0,363,626,38,4262,29,2782,18,29
"931","2020-05-15",142,11,238,466,4213,0.3935437930216,0,0,363,626,37,4299,50,2832,18,50
"932","2020-05-16",131,11,210,454,4213,0.3935437930216,0,0,363,626,33,4332,48,2880,15,48
"933","2020-05-17",129,11,206,447,4213,0.3935437930216,0,0,363,626,38,4370,50,2930,12,50
"934","2020-05-18",129,11,183,435,4213,0.3935437930216,0,0,363,626,46,4416,46,2976,16,46
"935","2020-05-19",130,11,155,414,4213,0.3935437930216,0,0,363,626,42,4458,34,3010,14,34
"936","2020-05-20",129,11,135,396,4213,0.3935437930216,0,0,363,626,35,4493,48,3058,18,48
"937","2020-05-21",127,11,122,383,4213,0.3935437930216,0,0,363,626,25,4518,41,3099,11,41
"938","2020-05-22",128,11,131,364,4213,0.3935437930216,0,0,363,626,31,4549,41,3140,12,41
"939","2020-05-23",124,11,163,358,4213,0.3935437930216,0,0,363,626,34,4583,39,3179,13,39
"940","2020-05-24",120,11,187,346,4213,0.3935437930216,0,0,363,626,30,4613,29,3208,10,29
"941","2020-05-25",115,11,209,330,4213,0.3935437930216,0,0,363,626,29,4642,33,3241,8,33
"942","2020-05-26",109,11,223,335,4213,0.3935437930216,0,0,363,626,29,4671,64,3305,10,64
"943","2020-05-27",104,11,199,316,4213,0.3935437930216,0,0,363,626,30,4701,59,3364,14,59
"944","2020-05-28",105,11,178,310,4213,0.3935437930216,0,0,363,626,15,4716,55,3419,7,55
"945","2020-05-29",99,11,189,295,4213,0.3935437930216,0,0,363,626,27,4743,42,3461,7,42
"946","2020-05-30",98,11,173,286,4213,0.3935437930216,0,0,363,626,23,4766,42,3503,6,42
"947","2020-05-31",93,11,145,276,4213,0.3935437930216,0,0,363,626,18,4784,32,3535,10,32
"948","2020-06-01",93,11,142,271,4213,0.3935437930216,0,0,363,626,22,4806,50,3585,7,50
"949","2020-06-02",93,11,123,266,4213,0.3935437930216,0,0,363,626,19,4825,51,3636,9,51
"950","2020-06-03",91,11,126,248,4213,0.3935437930216,0,0,363,626,23,4848,36,3672,9,36
"951","2020-06-04",86,11,125,240,4213,0.3935437930216,0,0,363,626,17,4865,26,3698,9,26
"952","2020-06-05",78,11,123,225,4213,0.3935437930216,0,0,363,626,17,4882,33,3731,5,33
"953","2020-06-06",74,11,151,211,4213,0.3935437930216,0,0,363,626,23,4905,65,3796,6,65
"954","2020-06-07",71,11,154,199,4213,0.3935437930216,0,0,363,626,24,4929,55,3851,9,55
"955","2020-03-13",2,12,50,107,4501,0.306598533659187,0,0,382,595,18,54,12,43,5,12
"956","2020-03-14",4,12,54,159,4501,0.306598533659187,0,0,382,595,30,84,14,57,10,14
"957","2020-03-15",15,12,81,199,4501,0.306598533659187,0,0,382,595,32,116,24,81,15,24
"958","2020-03-16",20,12,92,246,4501,0.306598533659187,0,0,382,595,33,149,7,88,17,7
"959","2020-03-17",34,12,106,289,4501,0.306598533659187,0,0,382,595,35,184,5,93,24,5
"960","2020-03-18",43,12,107,343,4501,0.306598533659187,0,0,382,595,35,219,28,121,20,28
"961","2020-03-19",53,12,112,406,4501,0.306598533659187,0,0,382,595,41,260,21,142,27,21
"962","2020-03-20",70,12,117,438,4501,0.306598533659187,0,0,382,595,40,300,4,146,23,4
"963","2020-03-21",93,12,104,474,4501,0.306598533659187,0,0,382,595,41,341,8,154,22,8
"964","2020-03-22",96,12,127,517,4501,0.306598533659187,0,0,382,595,53,394,6,160,36,6
"965","2020-03-23",114,12,143,549,4501,0.306598533659187,0,0,382,595,39,433,13,173,23,13
"966","2020-03-24",121,12,146,563,4501,0.306598533659187,0,0,382,595,70,503,9,182,52,9
"967","2020-03-25",140,12,166,575,4501,0.306598533659187,0,0,382,595,54,557,16,198,36,16
"968","2020-03-26",151,12,181,591,4501,0.306598533659187,0,0,382,595,48,605,31,229,34,31
"969","2020-03-27",160,12,192,592,4501,0.306598533659187,0,0,382,595,58,663,38,267,43,38
"970","2020-03-28",160,12,185,605,4501,0.306598533659187,0,0,382,595,66,729,52,319,55,52
"971","2020-03-29",170,12,191,595,4501,0.306598533659187,0,0,382,595,54,783,51,370,38,51
"972","2020-03-30",159,12,200,587,4501,0.306598533659187,0,0,382,595,78,861,40,410,53,40
"973","2020-03-31",170,12,189,584,4501,0.306598533659187,0,0,382,595,67,928,54,464,49,54
"974","2020-04-01",172,12,174,587,4501,0.306598533659187,0,0,382,595,79,1007,33,497,60,33
"975","2020-04-02",176,12,170,597,4501,0.306598533659187,0,0,382,595,61,1068,26,523,43,26
"976","2020-04-03",168,12,160,612,4501,0.306598533659187,0,0,382,595,63,1131,46,569,44,46
"977","2020-04-04",169,12,148,596,4501,0.306598533659187,0,0,382,595,87,1218,42,611,63,42
"978","2020-04-05",170,12,144,608,4501,0.306598533659187,0,0,382,595,84,1302,35,646,61,35
"979","2020-04-06",173,12,173,628,4501,0.306598533659187,0,0,382,595,65,1367,43,689,46,43
"980","2020-04-07",160,12,189,637,4501,0.306598533659187,0,0,382,595,75,1442,19,708,56,19
"981","2020-04-08",159,12,193,644,4501,0.306598533659187,0,0,382,595,94,1536,42,750,73,42
"982","2020-04-09",157,12,195,655,4501,0.306598533659187,0,0,382,595,72,1608,20,770,52,20
"983","2020-04-10",164,12,188,645,4501,0.306598533659187,0,0,382,595,73,1681,50,820,50,50
"984","2020-04-11",169,12,172,658,4501,0.306598533659187,0,0,382,595,90,1771,40,860,64,40
"985","2020-04-12",170,12,177,677,4501,0.306598533659187,0,0,382,595,85,1856,33,893,57,33
"986","2020-04-13",177,12,195,670,4501,0.306598533659187,0,0,382,595,68,1924,50,943,53,50
"987","2020-04-14",184,12,195,676,4501,0.306598533659187,0,0,382,595,83,2007,59,1002,61,59
"988","2020-04-15",180,12,190,687,4501,0.306598533659187,0,0,382,595,69,2076,61,1063,50,61
"989","2020-04-16",181,12,188,683,4501,0.306598533659187,0,0,382,595,63,2139,37,1100,46,37
"990","2020-04-17",175,12,196,665,4501,0.306598533659187,0,0,382,595,74,2213,18,1118,57,18
"991","2020-04-18",162,12,193,668,4501,0.306598533659187,0,0,382,595,61,2274,44,1162,40,44
"992","2020-04-19",165,12,195,656,4501,0.306598533659187,0,0,382,595,80,2354,26,1188,58,26
"993","2020-04-20",158,12,194,643,4501,0.306598533659187,0,0,382,595,67,2421,21,1209,52,21
"994","2020-04-21",157,12,209,651,4501,0.306598533659187,0,0,382,595,89,2510,51,1260,66,51
"995","2020-04-22",163,12,198,653,4501,0.306598533659187,0,0,382,595,77,2587,44,1304,59,44
"996","2020-04-23",170,12,204,645,4501,0.306598533659187,0,0,382,595,78,2665,17,1321,53,17
"997","2020-04-24",173,12,197,639,4501,0.306598533659187,0,0,382,595,75,2740,36,1357,56,36
"998","2020-04-25",181,12,186,647,4501,0.306598533659187,0,0,382,595,58,2798,48,1405,46,48
"999","2020-04-26",172,12,170,655,4501,0.306598533659187,0,0,382,595,81,2879,49,1454,57,49
"1000","2020-04-27",186,12,157,632,4501,0.306598533659187,0,0,382,595,47,2926,30,1484,31,30
"1001","2020-04-28",189,12,148,637,4501,0.306598533659187,0,0,382,595,64,2990,21,1505,52,21
"1002","2020-04-29",189,12,157,635,4501,0.306598533659187,0,0,382,595,58,3048,46,1551,33,46
"1003","2020-04-30",187,12,161,637,4501,0.306598533659187,0,0,382,595,59,3107,24,1575,37,24
"1004","2020-05-01",189,12,168,649,4501,0.306598533659187,0,0,382,595,52,3159,50,1625,37,50
"1005","2020-05-02",183,12,155,661,4501,0.306598533659187,0,0,382,595,51,3210,27,1652,35,27
"1006","2020-05-03",183,12,150,664,4501,0.306598533659187,0,0,382,595,54,3264,12,1664,34,12
"1007","2020-05-04",180,12,164,653,4501,0.306598533659187,0,0,382,595,46,3310,24,1688,32,24
"1008","2020-05-05",177,12,195,650,4501,0.306598533659187,0,0,382,595,50,3360,7,1695,36,7
"1009","2020-05-06",176,12,180,654,4501,0.306598533659187,0,0,382,595,57,3417,17,1712,37,17
"1010","2020-05-07",162,12,175,656,4501,0.306598533659187,0,0,382,595,42,3459,6,1718,29,6
"1011","2020-05-08",159,12,199,640,4501,0.306598533659187,0,0,382,595,46,3505,6,1724,28,6
"1012","2020-05-09",160,12,200,617,4501,0.306598533659187,0,0,382,595,39,3544,20,1744,22,20
"1013","2020-05-10",165,12,190,606,4501,0.306598533659187,0,0,382,595,43,3587,7,1751,28,7
"1014","2020-05-11",158,12,191,590,4501,0.306598533659187,0,0,382,595,43,3630,15,1766,26,15
"1015","2020-05-12",160,12,183,561,4501,0.306598533659187,0,0,382,595,40,3670,35,1801,29,35
"1016","2020-05-13",155,12,188,539,4501,0.306598533659187,0,0,382,595,45,3715,64,1865,30,64
"1017","2020-05-14",158,12,166,511,4501,0.306598533659187,0,0,382,595,42,3757,56,1921,27,56
"1018","2020-05-15",157,12,158,484,4501,0.306598533659187,0,0,382,595,36,3793,30,1951,18,30
"1019","2020-05-16",154,12,155,485,4501,0.306598533659187,0,0,382,595,37,3830,19,1970,25,19
"1020","2020-05-17",144,12,153,471,4501,0.306598533659187,0,0,382,595,40,3870,21,1991,28,21
"1021","2020-05-18",144,12,144,459,4501,0.306598533659187,0,0,382,595,25,3895,25,2016,15,25
"1022","2020-05-19",139,12,144,447,4501,0.306598533659187,0,0,382,595,39,3934,7,2023,23,7
"1023","2020-05-20",129,12,143,436,4501,0.306598533659187,0,0,382,595,29,3963,9,2032,17,9
"1024","2020-05-21",133,12,147,423,4501,0.306598533659187,0,0,382,595,28,3991,7,2039,20,7
"1025","2020-05-22",122,12,138,423,4501,0.306598533659187,0,0,382,595,21,4012,36,2075,14,36
"1026","2020-05-23",124,12,155,424,4501,0.306598533659187,0,0,382,595,26,4038,19,2094,15,19
"1027","2020-05-24",129,12,151,420,4501,0.306598533659187,0,0,382,595,17,4055,45,2139,10,45
"1028","2020-05-25",122,12,144,417,4501,0.306598533659187,0,0,382,595,26,4081,30,2169,16,30
"1029","2020-05-26",115,12,140,415,4501,0.306598533659187,0,0,382,595,26,4107,30,2199,17,30
"1030","2020-05-27",116,12,158,401,4501,0.306598533659187,0,0,382,595,24,4131,29,2228,19,29
"1031","2020-05-28",113,12,162,394,4501,0.306598533659187,0,0,382,595,28,4159,34,2262,18,34
"1032","2020-05-29",120,12,169,373,4501,0.306598533659187,0,0,382,595,28,4187,59,2321,22,59
"1033","2020-05-30",114,12,186,356,4501,0.306598533659187,0,0,382,595,22,4209,36,2357,15,36
"1034","2020-05-31",103,12,184,344,4501,0.306598533659187,0,0,382,595,24,4233,40,2397,18,40
"1035","2020-06-01",107,12,178,323,4501,0.306598533659187,0,0,382,595,15,4248,45,2442,12,45
"1036","2020-06-02",105,12,169,311,4501,0.306598533659187,0,0,382,595,22,4270,37,2479,18,37
"1037","2020-06-03",105,12,171,307,4501,0.306598533659187,0,0,382,595,23,4293,35,2514,13,35
"1038","2020-06-04",102,12,178,276,4501,0.306598533659187,0,0,382,595,23,4316,7,2521,17,7
"1039","2020-06-05",98,12,166,259,4501,0.306598533659187,0,0,382,595,13,4329,27,2548,7,27
"1040","2020-06-06",96,12,160,247,4501,0.306598533659187,0,0,382,595,18,4347,29,2577,15,29
"1041","2020-06-07",95,12,160,230,4501,0.306598533659187,0,0,382,595,17,4364,22,2599,12,22
"1042","2020-03-13",2,13,81,40,2168,0.482472324723247,0,0,194,585,25,77,NA,NA,5,NA
"1043","2020-03-14",4,13,92,51,2168,0.482472324723247,0,0,194,585,29,106,3,12,4,3
"1044","2020-03-15",5,13,106,60,2168,0.482472324723247,0,0,194,585,28,134,13,25,6,13
"1045","2020-03-16",6,13,108,71,2168,0.482472324723247,0,0,194,585,35,169,4,29,5,4
"1046","2020-03-17",9,13,117,91,2168,0.482472324723247,0,0,194,585,33,202,8,37,14,8
"1047","2020-03-18",15,13,105,113,2168,0.482472324723247,0,0,194,585,45,247,10,47,22,10
"1048","2020-03-19",17,13,108,127,2168,0.482472324723247,0,0,194,585,46,293,14,61,14,14
"1049","2020-03-20",16,13,108,145,2168,0.482472324723247,0,0,194,585,39,332,17,78,15,17
"1050","2020-03-21",18,13,110,156,2168,0.482472324723247,0,0,194,585,59,391,26,104,23,26
"1051","2020-03-22",21,13,113,170,2168,0.482472324723247,0,0,194,585,41,432,33,137,22,33
"1052","2020-03-23",25,13,111,196,2168,0.482472324723247,0,0,194,585,50,482,14,151,24,14
"1053","2020-03-24",30,13,101,212,2168,0.482472324723247,0,0,194,585,51,533,19,170,20,19
"1054","2020-03-25",28,13,131,221,2168,0.482472324723247,0,0,194,585,48,581,19,189,27,19
"1055","2020-03-26",37,13,165,243,2168,0.482472324723247,0,0,194,585,59,640,16,205,27,16
"1056","2020-03-27",44,13,167,255,2168,0.482472324723247,0,0,194,585,54,694,13,218,28,13
"1057","2020-03-28",47,13,143,263,2168,0.482472324723247,0,0,194,585,44,738,13,231,25,13
"1058","2020-03-29",53,13,127,278,2168,0.482472324723247,0,0,194,585,57,795,14,245,35,14
"1059","2020-03-30",61,13,122,289,2168,0.482472324723247,0,0,194,585,62,857,27,272,37,27
"1060","2020-03-31",66,13,108,302,2168,0.482472324723247,0,0,194,585,53,910,14,286,29,14
"1061","2020-04-01",72,13,117,312,2168,0.482472324723247,0,0,194,585,47,957,10,296,25,10
"1062","2020-04-02",76,13,137,314,2168,0.482472324723247,0,0,194,585,63,1020,10,306,30,10
"1063","2020-04-03",85,13,151,321,2168,0.482472324723247,0,0,194,585,57,1077,17,323,24,17
"1064","2020-04-04",91,13,152,317,2168,0.482472324723247,0,0,194,585,71,1148,6,329,36,6
"1065","2020-04-05",94,13,159,344,2168,0.482472324723247,0,0,194,585,59,1207,7,336,27,7
"1066","2020-04-06",95,13,157,349,2168,0.482472324723247,0,0,194,585,62,1269,6,342,40,6
"1067","2020-04-07",89,13,154,345,2168,0.482472324723247,0,0,194,585,82,1351,17,359,51,17
"1068","2020-04-08",95,13,175,348,2168,0.482472324723247,0,0,194,585,62,1413,7,366,34,7
"1069","2020-04-09",93,13,181,357,2168,0.482472324723247,0,0,194,585,62,1475,8,374,36,8
"1070","2020-04-10",85,13,172,359,2168,0.482472324723247,0,0,194,585,69,1544,12,386,42,12
"1071","2020-04-11",87,13,165,359,2168,0.482472324723247,0,0,194,585,71,1615,7,393,45,7
"1072","2020-04-12",89,13,193,368,2168,0.482472324723247,0,0,194,585,86,1701,5,398,42,5
"1073","2020-04-13",89,13,216,357,2168,0.482472324723247,0,0,194,585,84,1785,24,422,57,24
"1074","2020-04-14",99,13,226,362,2168,0.482472324723247,0,0,194,585,59,1844,33,455,32,33
"1075","2020-04-15",95,13,232,369,2168,0.482472324723247,0,0,194,585,54,1898,31,486,31,31
"1076","2020-04-16",104,13,241,357,2168,0.482472324723247,0,0,194,585,52,1950,29,515,27,29
"1077","2020-04-17",113,13,233,348,2168,0.482472324723247,0,0,194,585,61,2011,18,533,33,18
"1078","2020-04-18",116,13,236,343,2168,0.482472324723247,0,0,194,585,46,2057,34,567,25,34
"1079","2020-04-19",112,13,245,344,2168,0.482472324723247,0,0,194,585,56,2113,17,584,29,17
"1080","2020-04-20",113,13,228,342,2168,0.482472324723247,0,0,194,585,55,2168,28,612,23,28
"1081","2020-04-21",109,13,230,343,2168,0.482472324723247,0,0,194,585,62,2230,36,648,34,36
"1082","2020-04-22",110,13,228,324,2168,0.482472324723247,0,0,194,585,49,2279,41,689,23,41
"1083","2020-04-23",101,13,211,323,2168,0.482472324723247,0,0,194,585,55,2334,21,710,23,21
"1084","2020-04-24",95,13,195,309,2168,0.482472324723247,0,0,194,585,58,2392,33,743,25,33
"1085","2020-04-25",88,13,179,308,2168,0.482472324723247,0,0,194,585,44,2436,19,762,15,19
"1086","2020-04-26",87,13,182,306,2168,0.482472324723247,0,0,194,585,56,2492,14,776,26,14
"1087","2020-04-27",85,13,182,312,2168,0.482472324723247,0,0,194,585,42,2534,25,801,15,25
"1088","2020-04-28",82,13,173,298,2168,0.482472324723247,0,0,194,585,39,2573,25,826,14,25
"1089","2020-04-29",80,13,172,294,2168,0.482472324723247,0,0,194,585,42,2615,18,844,18,18
"1090","2020-04-30",81,13,162,296,2168,0.482472324723247,0,0,194,585,42,2657,32,876,18,32
"1091","2020-05-01",85,13,177,286,2168,0.482472324723247,0,0,194,585,50,2707,33,909,23,33
"1092","2020-05-02",84,13,213,289,2168,0.482472324723247,0,0,194,585,46,2753,40,949,21,40
"1093","2020-05-03",83,13,212,286,2168,0.482472324723247,0,0,194,585,48,2801,30,979,21,30
"1094","2020-05-04",80,13,214,284,2168,0.482472324723247,0,0,194,585,36,2837,29,1008,12,29
"1095","2020-05-05",78,13,207,302,2168,0.482472324723247,0,0,194,585,43,2880,21,1029,21,21
"1096","2020-05-06",79,13,193,304,2168,0.482472324723247,0,0,194,585,40,2920,46,1075,16,46
"1097","2020-05-07",78,13,183,307,2168,0.482472324723247,0,0,194,585,35,2955,28,1103,13,28
"1098","2020-05-08",70,13,193,298,2168,0.482472324723247,0,0,194,585,36,2991,26,1129,14,26
"1099","2020-05-09",84,13,187,277,2168,0.482472324723247,0,0,194,585,34,3025,21,1150,14,21
"1100","2020-05-10",84,13,177,265,2168,0.482472324723247,0,0,194,585,36,3061,16,1166,10,16
"1101","2020-05-11",83,13,192,267,2168,0.482472324723247,0,0,194,585,30,3091,19,1185,5,19
"1102","2020-05-12",83,13,192,268,2168,0.482472324723247,0,0,194,585,36,3127,31,1216,9,31
"1103","2020-05-13",82,13,214,270,2168,0.482472324723247,0,0,194,585,39,3166,26,1242,17,26
"1104","2020-05-14",80,13,207,262,2168,0.482472324723247,0,0,194,585,28,3194,26,1268,7,26
"1105","2020-05-15",82,13,210,276,2168,0.482472324723247,0,0,194,585,38,3232,9,1277,13,9
"1106","2020-05-16",65,13,217,267,2168,0.482472324723247,0,0,194,585,27,3259,13,1290,8,13
"1107","2020-05-17",70,13,215,267,2168,0.482472324723247,0,0,194,585,30,3289,9,1299,12,9
"1108","2020-05-18",72,13,231,254,2168,0.482472324723247,0,0,194,585,25,3314,26,1325,12,26
"1109","2020-05-19",76,13,239,246,2168,0.482472324723247,0,0,194,585,33,3347,30,1355,10,30
"1110","2020-05-20",78,13,232,241,2168,0.482472324723247,0,0,194,585,22,3369,25,1380,9,25
"1111","2020-05-21",79,13,227,229,2168,0.482472324723247,0,0,194,585,19,3388,23,1403,6,23
"1112","2020-05-22",75,13,218,220,2168,0.482472324723247,0,0,194,585,25,3413,17,1420,11,17
"1113","2020-05-23",77,13,213,211,2168,0.482472324723247,0,0,194,585,24,3437,18,1438,13,18
"1114","2020-05-24",72,13,218,204,2168,0.482472324723247,0,0,194,585,25,3462,18,1456,9,18
"1115","2020-05-25",70,13,196,199,2168,0.482472324723247,0,0,194,585,20,3482,18,1474,7,18
"1116","2020-05-26",72,13,210,189,2168,0.482472324723247,0,0,194,585,24,3506,16,1490,9,16
"1117","2020-05-27",68,13,211,191,2168,0.482472324723247,0,0,194,585,32,3538,14,1504,11,14
"1118","2020-05-28",66,13,212,181,2168,0.482472324723247,0,0,194,585,19,3557,10,1514,11,10
"1119","2020-05-29",67,13,209,180,2168,0.482472324723247,0,0,194,585,32,3589,11,1525,20,11
"1120","2020-05-30",68,13,194,185,2168,0.482472324723247,0,0,194,585,22,3611,8,1533,12,8
"1121","2020-05-31",61,13,188,178,2168,0.482472324723247,0,0,194,585,23,3634,9,1542,11,9
"1122","2020-06-01",59,13,183,174,2168,0.482472324723247,0,0,194,585,23,3657,20,1562,8,20
"1123","2020-06-02",52,13,181,181,2168,0.482472324723247,0,0,194,585,29,3686,10,1572,13,10
"1124","2020-06-03",51,13,176,178,2168,0.482472324723247,0,0,194,585,16,3702,20,1592,5,20
"1125","2020-06-04",55,13,181,166,2168,0.482472324723247,0,0,194,585,19,3721,11,1603,9,11
"1126","2020-06-05",59,13,179,159,2168,0.482472324723247,0,0,194,585,15,3736,26,1629,11,26
"1127","2020-06-06",53,13,161,160,2168,0.482472324723247,0,0,194,585,15,3751,16,1645,7,16
"1128","2020-06-07",57,13,166,149,2168,0.482472324723247,0,0,194,585,8,3759,20,1665,4,20
"1129","2020-03-11",1,14,27,9,6420,0.888785046728972,0,0,535,742,25,25,27,30,6,27
"1130","2020-03-12",1,14,65,20,6420,0.888785046728972,0,0,535,742,21,46,21,51,3,21
"1131","2020-03-13",1,14,97,46,6420,0.888785046728972,0,0,535,742,33,79,19,70,17,19
"1132","2020-03-14",1,14,117,72,6420,0.888785046728972,0,0,535,742,55,134,28,98,34,28
"1133","2020-03-15",4,14,115,97,6420,0.888785046728972,0,0,535,742,55,189,18,116,38,18
"1134","2020-03-16",7,14,126,132,6420,0.888785046728972,0,0,535,742,64,253,18,134,49,18
"1135","2020-03-17",14,14,124,171,6420,0.888785046728972,0,0,535,742,103,356,30,164,90,30
"1136","2020-03-18",18,14,140,219,6420,0.888785046728972,0,0,535,742,126,482,21,185,108,21
"1137","2020-03-19",26,14,125,276,6420,0.888785046728972,0,0,535,742,169,651,31,216,151,31
"1138","2020-03-20",34,14,138,355,6420,0.888785046728972,0,0,535,742,208,859,26,242,193,26
"1139","2020-03-21",46,14,128,429,6420,0.888785046728972,0,0,535,742,222,1081,52,294,206,52
"1140","2020-03-22",52,14,121,520,6420,0.888785046728972,0,0,535,742,312,1393,52,346,287,52
"1141","2020-03-23",66,14,145,583,6420,0.888785046728972,0,0,535,742,394,1787,16,362,380,16
"1142","2020-03-24",74,14,169,659,6420,0.888785046728972,0,0,535,742,384,2171,24,386,372,24
"1143","2020-03-25",94,14,188,792,6420,0.888785046728972,0,0,535,742,490,2661,18,404,476,18
"1144","2020-03-26",120,14,178,901,6420,0.888785046728972,0,0,535,742,417,3078,39,443,402,39
"1145","2020-03-27",152,14,186,1037,6420,0.888785046728972,0,0,535,742,441,3519,15,458,428,15
"1146","2020-03-28",180,14,207,1119,6420,0.888785046728972,0,0,535,742,568,4087,46,504,553,46
"1147","2020-03-29",205,14,201,1219,6420,0.888785046728972,0,0,535,742,429,4516,53,557,421,53
"1148","2020-03-30",236,14,210,1374,6420,0.888785046728972,0,0,535,742,553,5069,29,586,544,29
"1149","2020-03-31",290,14,200,1477,6420,0.888785046728972,0,0,535,742,422,5491,37,623,417,37
"1150","2020-04-01",316,14,192,1578,6420,0.888785046728972,0,0,535,742,418,5909,35,658,407,35
"1151","2020-04-02",340,14,170,1612,6420,0.888785046728972,0,0,535,742,295,6204,36,694,288,36
"1152","2020-04-03",374,14,159,1698,6420,0.888785046728972,0,0,535,742,271,6475,38,732,265,38
"1153","2020-04-04",399,14,177,1782,6420,0.888785046728972,0,0,535,742,239,6714,35,767,238,35
"1154","2020-04-05",438,14,161,1871,6420,0.888785046728972,0,0,535,742,196,6910,35,802,192,35
"1155","2020-04-06",469,14,189,1933,6420,0.888785046728972,0,0,535,742,140,7050,13,815,136,13
"1156","2020-04-07",477,14,203,1944,6420,0.888785046728972,0,0,535,742,122,7172,39,854,119,39
"1157","2020-04-08",495,14,201,1965,6420,0.888785046728972,0,0,535,742,100,7272,23,877,95,23
"1158","2020-04-09",518,14,180,1955,6420,0.888785046728972,0,0,535,742,70,7342,45,922,70,45
"1159","2020-04-10",525,14,156,2006,6420,0.888785046728972,0,0,535,742,47,7389,29,951,44,29
"1160","2020-04-11",547,14,156,1971,6420,0.888785046728972,0,0,535,742,37,7426,23,974,34,23
"1161","2020-04-12",553,14,144,1946,6420,0.888785046728972,0,0,535,742,32,7458,16,990,30,16
"1162","2020-04-13",552,14,142,1909,6420,0.888785046728972,0,0,535,742,29,7487,37,1027,27,37
"1163","2020-04-14",559,14,176,1842,6420,0.888785046728972,0,0,535,742,22,7509,29,1056,19,29
"1164","2020-04-15",565,14,188,1804,6420,0.888785046728972,0,0,535,742,20,7529,60,1116,19,60
"1165","2020-04-16",561,14,201,1764,6420,0.888785046728972,0,0,535,742,9,7538,27,1143,5,27
"1166","2020-04-17",545,14,190,1687,6420,0.888785046728972,0,0,535,742,10,7548,15,1158,8,15
"1167","2020-04-18",527,14,213,1569,6420,0.888785046728972,0,0,535,742,9,7557,42,1200,8,42
"1168","2020-04-19",509,14,212,1505,6420,0.888785046728972,0,0,535,742,7,7564,28,1228,6,28
"1169","2020-04-20",490,14,209,1412,6420,0.888785046728972,0,0,535,742,2,7566,36,1264,2,36
"1170","2020-04-21",460,14,201,1317,6420,0.888785046728972,0,0,535,742,5,7571,25,1289,4,25
"1171","2020-04-22",434,14,178,1248,6420,0.888785046728972,0,0,535,742,5,7576,11,1300,4,11
"1172","2020-04-23",412,14,175,1150,6420,0.888785046728972,0,0,535,742,3,7579,13,1313,2,13
"1173","2020-04-24",393,14,180,1094,6420,0.888785046728972,0,0,535,742,8,7587,12,1325,5,12
"1174","2020-04-25",364,14,167,1025,6420,0.888785046728972,0,0,535,742,1,7588,39,1364,1,39
"1175","2020-04-26",341,14,164,975,6420,0.888785046728972,0,0,535,742,2,7590,20,1384,2,20
"1176","2020-04-27",333,14,176,937,6420,0.888785046728972,0,0,535,742,3,7593,8,1392,2,8
"1177","2020-04-28",312,14,183,875,6420,0.888785046728972,0,0,535,742,4,7597,16,1408,2,16
"1178","2020-04-29",303,14,181,788,6420,0.888785046728972,0,0,535,742,1,7598,38,1446,1,38
"1179","2020-04-30",278,14,191,751,6420,0.888785046728972,0,0,535,742,3,7601,45,1491,3,45
"1180","2020-05-01",265,14,209,707,6420,0.888785046728972,0,0,535,742,3,7604,23,1514,1,23
"1181","2020-05-02",256,14,212,654,6420,0.888785046728972,0,0,535,742,4,7608,17,1531,2,17
"1182","2020-05-03",249,14,187,626,6420,0.888785046728972,0,0,535,742,2,7610,53,1584,1,53
"1183","2020-05-04",219,14,182,576,6420,0.888785046728972,0,0,535,742,NA,NA,40,1624,NA,40
"1184","2020-05-05",206,14,164,541,6420,0.888785046728972,0,0,535,742,1,7611,23,1647,NA,23
"1185","2020-05-06",185,14,163,492,6420,0.888785046728972,0,0,535,742,NA,NA,41,1688,NA,41
"1186","2020-05-07",178,14,165,460,6420,0.888785046728972,0,0,535,742,7,7618,21,1709,3,21
"1187","2020-05-08",163,14,147,425,6420,0.888785046728972,0,0,535,742,5,7623,28,1737,3,28
"1188","2020-05-09",140,14,176,392,6420,0.888785046728972,0,0,535,742,2,7625,37,1774,1,37
"1189","2020-05-10",133,14,207,361,6420,0.888785046728972,0,0,535,742,2,7627,22,1796,NA,22
"1190","2020-05-11",129,14,211,336,6420,0.888785046728972,0,0,535,742,2,7629,17,1813,1,17
"1191","2020-05-12",120,14,197,321,6420,0.888785046728972,0,0,535,742,3,7632,33,1846,1,33
"1192","2020-05-13",116,14,195,295,6420,0.888785046728972,0,0,535,742,3,7635,53,1899,3,53
"1193","2020-05-14",104,14,187,269,6420,0.888785046728972,0,0,535,742,4,7639,43,1942,2,43
"1194","2020-05-15",98,14,184,241,6420,0.888785046728972,0,0,535,742,NA,NA,34,1976,NA,34
"1195","2020-05-16",99,14,191,231,6420,0.888785046728972,0,0,535,742,2,7641,34,2010,1,34
"1196","2020-05-17",85,14,196,219,6420,0.888785046728972,0,0,535,742,4,7645,18,2028,3,18
"1197","2020-05-18",74,14,199,200,6420,0.888785046728972,0,0,535,742,NA,NA,15,2043,NA,15
"1198","2020-05-19",71,14,197,186,6420,0.888785046728972,0,0,535,742,3,7648,40,2083,2,40
"1199","2020-05-20",67,14,184,183,6420,0.888785046728972,0,0,535,742,3,7651,21,2104,3,21
"1200","2020-05-21",67,14,189,176,6420,0.888785046728972,0,0,535,742,NA,NA,13,2117,NA,13
"1201","2020-05-22",64,14,192,160,6420,0.888785046728972,0,0,535,742,3,7654,12,2129,2,12
"1202","2020-05-23",62,14,190,149,6420,0.888785046728972,0,0,535,742,NA,NA,50,2179,NA,50
"1203","2020-05-24",55,14,184,143,6420,0.888785046728972,0,0,535,742,2,7656,30,2209,1,30
"1204","2020-05-25",56,14,160,136,6420,0.888785046728972,0,0,535,742,2,7658,27,2236,2,27
"1205","2020-05-26",51,14,170,138,6420,0.888785046728972,0,0,535,742,2,7660,28,2264,2,28
"1206","2020-05-27",43,14,154,132,6420,0.888785046728972,0,0,535,742,1,7661,31,2295,NA,31
"1207","2020-05-28",35,14,169,126,6420,0.888785046728972,0,0,535,742,1,7662,42,2337,NA,42
"1208","2020-05-29",35,14,173,119,6420,0.888785046728972,0,0,535,742,3,7665,43,2380,3,43
"1209","2020-05-30",31,14,150,116,6420,0.888785046728972,0,0,535,742,4,7669,24,2404,1,24
"1210","2020-05-31",31,14,177,121,6420,0.888785046728972,0,0,535,742,NA,NA,46,2450,NA,46
"1211","2020-06-01",31,14,164,121,6420,0.888785046728972,0,0,535,742,2,7671,21,2471,1,21
"1212","2020-06-02",35,14,181,119,6420,0.888785046728972,0,0,535,742,NA,NA,18,2489,NA,18
"1213","2020-06-03",36,14,182,111,6420,0.888785046728972,0,0,535,742,2,7673,32,2521,2,32
"1214","2020-06-04",38,14,175,112,6420,0.888785046728972,0,0,535,742,NA,NA,19,2540,NA,19
"1215","2020-06-05",32,14,179,109,6420,0.888785046728972,0,0,535,742,3,7676,14,2554,1,14
"1216","2020-06-06",33,14,181,110,6420,0.888785046728972,0,0,535,742,2,7678,39,2593,2,39
"1217","2020-06-07",43,14,164,103,6420,0.888785046728972,0,0,535,742,NA,NA,33,2626,NA,33
"1218","2020-03-12",3,15,110,100,8704,0.830537683823529,0,0,799,1304,36,69,18,26,2,18
"1219","2020-03-13",4,15,100,164,8704,0.830537683823529,0,0,799,1304,36,105,10,36,3,10
"1220","2020-03-14",8,15,103,262,8704,0.830537683823529,0,0,799,1304,51,156,10,46,8,10
"1221","2020-03-15",13,15,94,351,8704,0.830537683823529,0,0,799,1304,59,215,7,53,15,7
"1222","2020-03-16",27,15,116,432,8704,0.830537683823529,0,0,799,1304,49,264,21,74,10,21
"1223","2020-03-17",47,15,135,574,8704,0.830537683823529,0,0,799,1304,49,313,20,94,20,20
"1224","2020-03-18",74,15,160,780,8704,0.830537683823529,0,0,799,1304,80,393,6,100,31,6
"1225","2020-03-19",92,15,197,973,8704,0.830537683823529,0,0,799,1304,68,461,6,106,25,6
"1226","2020-03-20",120,15,184,1190,8704,0.830537683823529,0,0,799,1304,61,522,23,129,24,23
"1227","2020-03-21",159,15,183,1514,8704,0.830537683823529,0,0,799,1304,67,589,13,142,23,13
"1228","2020-03-22",209,15,206,1875,8704,0.830537683823529,0,0,799,1304,69,658,27,169,28,27
"1229","2020-03-23",247,15,196,2292,8704,0.830537683823529,0,0,799,1304,61,719,16,185,23,16
"1230","2020-03-24",316,15,182,2706,8704,0.830537683823529,0,0,799,1304,93,812,10,195,44,10
"1231","2020-03-25",384,15,145,3108,8704,0.830537683823529,0,0,799,1304,77,889,29,224,37,29
"1232","2020-03-26",479,15,159,3517,8704,0.830537683823529,0,0,799,1304,70,959,25,249,26,25
"1233","2020-03-27",589,15,168,3833,8704,0.830537683823529,0,0,799,1304,77,1036,16,265,37,16
"1234","2020-03-28",710,15,217,4048,8704,0.830537683823529,0,0,799,1304,56,1092,15,280,21,15
"1235","2020-03-29",823,15,272,4324,8704,0.830537683823529,0,0,799,1304,57,1149,4,284,31,4
"1236","2020-03-30",945,15,298,4495,8704,0.830537683823529,0,0,799,1304,83,1232,9,293,34,9
"1237","2020-03-31",1033,15,266,4665,8704,0.830537683823529,0,0,799,1304,73,1305,6,299,29,6
"1238","2020-04-01",1127,15,228,4647,8704,0.830537683823529,0,0,799,1304,91,1396,18,317,44,18
"1239","2020-04-02",1220,15,213,4606,8704,0.830537683823529,0,0,799,1304,66,1462,13,330,22,13
"1240","2020-04-03",1293,15,211,4386,8704,0.830537683823529,0,0,799,1304,80,1542,19,349,32,19
"1241","2020-04-04",1290,15,241,4158,8704,0.830537683823529,0,0,799,1304,68,1610,9,358,29,9
"1242","2020-04-05",1301,15,215,3880,8704,0.830537683823529,0,0,799,1304,90,1700,24,382,23,24
"1243","2020-04-06",1292,15,185,3557,8704,0.830537683823529,0,0,799,1304,86,1786,23,405,40,23
"1244","2020-04-07",1247,15,161,3216,8704,0.830537683823529,0,0,799,1304,107,1893,30,435,34,30
"1245","2020-04-08",1208,15,154,2841,8704,0.830537683823529,0,0,799,1304,75,1968,11,446,29,11
"1246","2020-04-09",1126,15,196,2487,8704,0.830537683823529,0,0,799,1304,84,2052,23,469,38,23
"1247","2020-04-10",1026,15,208,2152,8704,0.830537683823529,0,0,799,1304,83,2135,27,496,28,27
"1248","2020-04-11",943,15,260,1862,8704,0.830537683823529,0,0,799,1304,73,2208,8,504,21,8
"1249","2020-04-12",839,15,266,1546,8704,0.830537683823529,0,0,799,1304,67,2275,18,522,25,18
"1250","2020-04-13",728,15,255,1276,8704,0.830537683823529,0,0,799,1304,99,2374,32,554,33,32
"1251","2020-04-14",639,15,272,1041,8704,0.830537683823529,0,0,799,1304,75,2449,27,581,26,27
"1252","2020-04-15",520,15,277,849,8704,0.830537683823529,0,0,799,1304,74,2523,12,593,26,12
"1253","2020-04-16",423,15,316,702,8704,0.830537683823529,0,0,799,1304,85,2608,9,602,29,9
"1254","2020-04-17",328,15,279,599,8704,0.830537683823529,0,0,799,1304,74,2682,10,612,27,10
"1255","2020-04-18",275,15,250,492,8704,0.830537683823529,0,0,799,1304,60,2742,13,625,23,13
"1256","2020-04-19",207,15,239,414,8704,0.830537683823529,0,0,799,1304,71,2813,11,636,18,11
"1257","2020-04-20",168,15,232,335,8704,0.830537683823529,0,0,799,1304,63,2876,12,648,23,12
"1258","2020-04-21",134,15,217,290,8704,0.830537683823529,0,0,799,1304,69,2945,12,660,19,12
"1259","2020-04-22",114,15,189,253,8704,0.830537683823529,0,0,799,1304,64,3009,42,702,21,42
"1260","2020-04-23",91,15,181,212,8704,0.830537683823529,0,0,799,1304,69,3078,23,725,18,23
"1261","2020-04-24",81,15,169,174,8704,0.830537683823529,0,0,799,1304,69,3147,29,754,23,29
"1262","2020-04-25",65,15,160,145,8704,0.830537683823529,0,0,799,1304,52,3199,53,807,17,53
"1263","2020-04-26",61,15,167,125,8704,0.830537683823529,0,0,799,1304,93,3292,39,846,30,39
"1264","2020-04-27",52,15,172,108,8704,0.830537683823529,0,0,799,1304,54,3346,22,868,26,22
"1265","2020-04-28",44,15,248,98,8704,0.830537683823529,0,0,799,1304,66,3412,15,883,19,15
"1266","2020-04-29",37,15,253,90,8704,0.830537683823529,0,0,799,1304,58,3470,29,912,16,29
"1267","2020-04-30",33,15,266,75,8704,0.830537683823529,0,0,799,1304,59,3529,27,939,17,27
"1268","2020-05-01",29,15,252,74,8704,0.830537683823529,0,0,799,1304,51,3580,32,971,12,32
"1269","2020-05-02",22,15,234,66,8704,0.830537683823529,0,0,799,1304,49,3629,47,1018,15,47
"1270","2020-05-03",20,15,273,66,8704,0.830537683823529,0,0,799,1304,55,3684,48,1066,20,48
"1271","2020-05-04",15,15,310,56,8704,0.830537683823529,0,0,799,1304,48,3732,41,1107,8,41
"1272","2020-05-05",16,15,294,55,8704,0.830537683823529,0,0,799,1304,52,3784,28,1135,12,28
"1273","2020-05-06",15,15,275,49,8704,0.830537683823529,0,0,799,1304,49,3833,29,1164,18,29
"1274","2020-05-07",14,15,258,48,8704,0.830537683823529,0,0,799,1304,60,3893,26,1190,19,26
"1275","2020-05-08",14,15,244,46,8704,0.830537683823529,0,0,799,1304,29,3922,55,1245,6,55
"1276","2020-05-09",14,15,273,48,8704,0.830537683823529,0,0,799,1304,34,3956,31,1276,4,31
"1277","2020-05-10",14,15,249,45,8704,0.830537683823529,0,0,799,1304,35,3991,24,1300,7,24
"1278","2020-05-11",14,15,223,44,8704,0.830537683823529,0,0,799,1304,56,4047,25,1325,10,25
"1279","2020-05-12",14,15,264,38,8704,0.830537683823529,0,0,799,1304,42,4089,47,1372,6,47
"1280","2020-05-13",13,15,297,39,8704,0.830537683823529,0,0,799,1304,35,4124,20,1392,7,20
"1281","2020-05-14",13,15,284,38,8704,0.830537683823529,0,0,799,1304,31,4155,49,1441,6,49
"1282","2020-05-15",11,15,257,35,8704,0.830537683823529,0,0,799,1304,40,4195,33,1474,10,33
"1283","2020-05-16",10,15,231,34,8704,0.830537683823529,0,0,799,1304,36,4231,31,1505,7,31
"1284","2020-05-17",12,15,213,29,8704,0.830537683823529,0,0,799,1304,38,4269,25,1530,9,25
"1285","2020-05-18",13,15,203,30,8704,0.830537683823529,0,0,799,1304,33,4302,25,1555,7,25
"1286","2020-05-19",12,15,193,31,8704,0.830537683823529,0,0,799,1304,37,4339,33,1588,11,33
"1287","2020-05-20",12,15,176,29,8704,0.830537683823529,0,0,799,1304,28,4367,24,1612,9,24
"1288","2020-05-21",10,15,183,27,8704,0.830537683823529,0,0,799,1304,35,4402,25,1637,8,25
"1289","2020-05-22",9,15,168,25,8704,0.830537683823529,0,0,799,1304,15,4417,17,1654,5,17
"1290","2020-05-23",8,15,152,26,8704,0.830537683823529,0,0,799,1304,36,4453,33,1687,3,33
"1291","2020-05-24",6,15,147,22,8704,0.830537683823529,0,0,799,1304,33,4486,26,1713,5,26
"1292","2020-05-25",5,15,158,22,8704,0.830537683823529,0,0,799,1304,20,4506,32,1745,5,32
"1293","2020-05-26",5,15,161,24,8704,0.830537683823529,0,0,799,1304,17,4523,22,1767,3,22
"1294","2020-05-27",4,15,160,25,8704,0.830537683823529,0,0,799,1304,29,4552,19,1786,8,19
"1295","2020-05-28",5,15,148,23,8704,0.830537683823529,0,0,799,1304,23,4575,9,1795,4,9
"1296","2020-05-29",6,15,146,22,8704,0.830537683823529,0,0,799,1304,27,4602,6,1801,5,6
"1297","2020-05-30",8,15,168,23,8704,0.830537683823529,0,0,799,1304,14,4616,8,1809,3,8
"1298","2020-05-31",8,15,164,23,8704,0.830537683823529,0,0,799,1304,12,4628,25,1834,4,25
"1299","2020-06-01",8,15,143,22,8704,0.830537683823529,0,0,799,1304,22,4650,28,1862,5,28
"1300","2020-06-02",9,15,145,17,8704,0.830537683823529,0,0,799,1304,21,4671,12,1874,8,12
"1301","2020-06-03",9,15,178,20,8704,0.830537683823529,0,0,799,1304,17,4688,23,1897,3,23
"1302","2020-06-04",8,15,164,21,8704,0.830537683823529,0,0,799,1304,22,4710,17,1914,6,17
"1303","2020-06-05",8,15,168,19,8704,0.830537683823529,0,0,799,1304,16,4726,15,1929,3,15
"1304","2020-06-06",7,15,183,22,8704,0.830537683823529,0,0,799,1304,21,4747,10,1939,6,10
"1305","2020-06-07",7,15,175,22,8704,0.830537683823529,0,0,799,1304,15,4762,9,1948,6,9
"1306","2020-03-14",2,16,108,70,2978,0.589993284083277,0,0,291,976,41,141,34,89,8,34
"1307","2020-03-15",3,16,113,94,2978,0.589993284083277,0,0,291,976,45,186,23,112,21,23
"1308","2020-03-16",8,16,130,124,2978,0.589993284083277,0,0,291,976,48,234,22,134,19,22
"1309","2020-03-17",17,16,128,156,2978,0.589993284083277,0,0,291,976,53,287,24,158,27,24
"1310","2020-03-18",22,16,148,180,2978,0.589993284083277,0,0,291,976,48,335,22,180,21,22
"1311","2020-03-19",24,16,177,204,2978,0.589993284083277,0,0,291,976,60,395,25,205,31,25
"1312","2020-03-20",29,16,186,227,2978,0.589993284083277,0,0,291,976,48,443,56,261,23,56
"1313","2020-03-21",37,16,182,257,2978,0.589993284083277,0,0,291,976,64,507,40,301,29,40
"1314","2020-03-22",44,16,189,282,2978,0.589993284083277,0,0,291,976,72,579,47,348,38,47
"1315","2020-03-23",50,16,182,309,2978,0.589993284083277,0,0,291,976,52,631,67,415,23,67
"1316","2020-03-24",56,16,177,314,2978,0.589993284083277,0,0,291,976,68,699,65,480,33,65
"1317","2020-03-25",65,16,199,330,2978,0.589993284083277,0,0,291,976,63,762,56,536,24,56
"1318","2020-03-26",79,16,182,341,2978,0.589993284083277,0,0,291,976,49,811,64,600,24,64
"1319","2020-03-27",88,16,197,363,2978,0.589993284083277,0,0,291,976,48,859,57,657,26,57
"1320","2020-03-28",96,16,188,374,2978,0.589993284083277,0,0,291,976,59,918,50,707,26,50
"1321","2020-03-29",99,16,186,367,2978,0.589993284083277,0,0,291,976,52,970,32,739,25,32
"1322","2020-03-30",103,16,202,382,2978,0.589993284083277,0,0,291,976,68,1038,65,804,31,65
"1323","2020-03-31",103,16,193,398,2978,0.589993284083277,0,0,291,976,66,1104,41,845,22,41
"1324","2020-04-01",107,16,199,419,2978,0.589993284083277,0,0,291,976,57,1161,42,887,25,42
"1325","2020-04-02",105,16,212,439,2978,0.589993284083277,0,0,291,976,67,1228,44,931,34,44
"1326","2020-04-03",104,16,208,449,2978,0.589993284083277,0,0,291,976,73,1301,43,974,30,43
"1327","2020-04-04",108,16,198,457,2978,0.589993284083277,0,0,291,976,68,1369,46,1020,34,46
"1328","2020-04-05",116,16,205,468,2978,0.589993284083277,0,0,291,976,60,1429,51,1071,37,51
"1329","2020-04-06",120,16,243,475,2978,0.589993284083277,0,0,291,976,79,1508,46,1117,34,46
"1330","2020-04-07",128,16,229,468,2978,0.589993284083277,0,0,291,976,70,1578,41,1158,27,41
"1331","2020-04-08",128,16,211,480,2978,0.589993284083277,0,0,291,976,58,1636,47,1205,27,47
"1332","2020-04-09",129,16,234,503,2978,0.589993284083277,0,0,291,976,69,1705,49,1254,34,49
"1333","2020-04-10",136,16,231,492,2978,0.589993284083277,0,0,291,976,80,1785,52,1306,45,52
"1334","2020-04-11",131,16,215,495,2978,0.589993284083277,0,0,291,976,73,1858,58,1364,39,58
"1335","2020-04-12",136,16,216,498,2978,0.589993284083277,0,0,291,976,67,1925,37,1401,27,37
"1336","2020-04-13",140,16,241,503,2978,0.589993284083277,0,0,291,976,70,1995,48,1449,31,48
"1337","2020-04-14",133,16,264,499,2978,0.589993284083277,0,0,291,976,69,2064,63,1512,35,63
"1338","2020-04-15",134,16,253,483,2978,0.589993284083277,0,0,291,976,75,2139,48,1560,38,48
"1339","2020-04-16",136,16,224,491,2978,0.589993284083277,0,0,291,976,56,2195,30,1590,29,30
"1340","2020-04-17",140,16,208,480,2978,0.589993284083277,0,0,291,976,52,2247,34,1624,21,34
"1341","2020-04-18",138,16,240,475,2978,0.589993284083277,0,0,291,976,62,2309,38,1662,26,38
"1342","2020-04-19",128,16,242,473,2978,0.589993284083277,0,0,291,976,50,2359,57,1719,21,57
"1343","2020-04-20",126,16,247,471,2978,0.589993284083277,0,0,291,976,54,2413,31,1750,21,31
"1344","2020-04-21",125,16,264,482,2978,0.589993284083277,0,0,291,976,51,2464,53,1803,23,53
"1345","2020-04-22",120,16,227,483,2978,0.589993284083277,0,0,291,976,57,2521,50,1853,23,50
"1346","2020-04-23",123,16,214,473,2978,0.589993284083277,0,0,291,976,59,2580,35,1888,15,35
"1347","2020-04-24",115,16,201,479,2978,0.589993284083277,0,0,291,976,47,2627,40,1928,20,40
"1348","2020-04-25",131,16,187,466,2978,0.589993284083277,0,0,291,976,64,2691,32,1960,24,32
"1349","2020-04-26",136,16,198,462,2978,0.589993284083277,0,0,291,976,55,2746,27,1987,19,27
"1350","2020-04-27",132,16,188,462,2978,0.589993284083277,0,0,291,976,67,2813,37,2024,22,37
"1351","2020-04-28",140,16,186,469,2978,0.589993284083277,0,0,291,976,59,2872,45,2069,26,45
"1352","2020-04-29",140,16,190,470,2978,0.589993284083277,0,0,291,976,63,2935,42,2111,23,42
"1353","2020-04-30",134,16,192,468,2978,0.589993284083277,0,0,291,976,52,2987,55,2166,21,55
"1354","2020-05-01",140,16,179,466,2978,0.589993284083277,0,0,291,976,40,3027,50,2216,14,50
"1355","2020-05-02",130,16,172,466,2978,0.589993284083277,0,0,291,976,62,3089,38,2254,31,38
"1356","2020-05-03",129,16,170,464,2978,0.589993284083277,0,0,291,976,53,3142,30,2284,23,30
"1357","2020-05-04",134,16,158,450,2978,0.589993284083277,0,0,291,976,50,3192,34,2318,15,34
"1358","2020-05-05",132,16,173,431,2978,0.589993284083277,0,0,291,976,54,3246,32,2350,21,32
"1359","2020-05-06",136,16,189,418,2978,0.589993284083277,0,0,291,976,42,3288,30,2380,17,30
"1360","2020-05-07",138,16,194,406,2978,0.589993284083277,0,0,291,976,55,3343,26,2406,23,26
"1361","2020-05-08",135,16,186,404,2978,0.589993284083277,0,0,291,976,56,3399,28,2434,25,28
"1362","2020-05-09",126,16,187,397,2978,0.589993284083277,0,0,291,976,48,3447,33,2467,22,33
"1363","2020-05-10",123,16,193,393,2978,0.589993284083277,0,0,291,976,53,3500,32,2499,26,32
"1364","2020-05-11",119,16,197,383,2978,0.589993284083277,0,0,291,976,53,3553,15,2514,14,15
"1365","2020-05-12",108,16,225,379,2978,0.589993284083277,0,0,291,976,38,3591,53,2567,24,53
"1366","2020-05-13",107,16,219,380,2978,0.589993284083277,0,0,291,976,36,3627,47,2614,22,47
"1367","2020-05-14",110,16,232,371,2978,0.589993284083277,0,0,291,976,36,3663,58,2672,17,58
"1368","2020-05-15",108,16,213,352,2978,0.589993284083277,0,0,291,976,35,3698,61,2733,17,61
"1369","2020-05-16",120,16,216,341,2978,0.589993284083277,0,0,291,976,37,3735,52,2785,17,52
"1370","2020-05-17",117,16,218,337,2978,0.589993284083277,0,0,291,976,25,3760,55,2840,9,55
"1371","2020-05-18",112,16,201,330,2978,0.589993284083277,0,0,291,976,30,3790,51,2891,13,51
"1372","2020-05-19",112,16,199,321,2978,0.589993284083277,0,0,291,976,33,3823,36,2927,13,36
"1373","2020-05-20",108,16,204,306,2978,0.589993284083277,0,0,291,976,40,3863,39,2966,16,39
"1374","2020-05-21",98,16,217,295,2978,0.589993284083277,0,0,291,976,40,3903,38,3004,16,38
"1375","2020-05-22",91,16,214,279,2978,0.589993284083277,0,0,291,976,28,3931,35,3039,11,35
"1376","2020-05-23",82,16,201,266,2978,0.589993284083277,0,0,291,976,31,3962,37,3076,13,37
"1377","2020-05-24",84,16,210,253,2978,0.589993284083277,0,0,291,976,23,3985,49,3125,8,49
"1378","2020-05-25",83,16,211,235,2978,0.589993284083277,0,0,291,976,24,4009,47,3172,10,47
"1379","2020-05-26",85,16,192,219,2978,0.589993284083277,0,0,291,976,30,4039,66,3238,13,66
"1380","2020-05-27",82,16,186,210,2978,0.589993284083277,0,0,291,976,19,4058,58,3296,6,58
"1381","2020-05-28",81,16,170,205,2978,0.589993284083277,0,0,291,976,22,4080,48,3344,8,48
"1382","2020-05-29",76,16,149,206,2978,0.589993284083277,0,0,291,976,25,4105,55,3399,9,55
"1383","2020-05-30",72,16,174,197,2978,0.589993284083277,0,0,291,976,29,4134,44,3443,14,44
"1384","2020-05-31",70,16,177,196,2978,0.589993284083277,0,0,291,976,27,4161,47,3490,10,47
"1385","2020-06-01",64,16,169,200,2978,0.589993284083277,0,0,291,976,16,4177,41,3531,8,41
"1386","2020-06-02",57,16,156,191,2978,0.589993284083277,0,0,291,976,12,4189,49,3580,6,49
"1387","2020-06-03",55,16,174,198,2978,0.589993284083277,0,0,291,976,19,4208,49,3629,9,49
"1388","2020-06-04",58,16,180,185,2978,0.589993284083277,0,0,291,976,17,4225,46,3675,7,46
"1389","2020-06-05",58,16,170,180,2978,0.589993284083277,0,0,291,976,12,4237,34,3709,4,34
"1390","2020-06-06",56,16,157,178,2978,0.589993284083277,0,0,291,976,16,4253,43,3752,7,43
"1391","2020-06-07",49,16,145,175,2978,0.589993284083277,0,0,291,976,15,4268,46,3798,7,46
"1392","2020-03-12",1,17,40,59,3436,0.30267753201397,0,0,311,923,17,28,15,39,11,15
"1393","2020-03-13",3,17,61,95,3436,0.30267753201397,0,0,311,923,12,40,19,58,8,19
"1394","2020-03-14",5,17,78,130,3436,0.30267753201397,0,0,311,923,27,67,6,64,24,6
"1395","2020-03-15",8,17,76,169,3436,0.30267753201397,0,0,311,923,15,82,17,81,13,17
"1396","2020-03-16",12,17,61,206,3436,0.30267753201397,0,0,311,923,33,115,23,104,27,23
"1397","2020-03-17",18,17,57,239,3436,0.30267753201397,0,0,311,923,45,160,14,118,36,14
"1398","2020-03-18",31,17,56,261,3436,0.30267753201397,0,0,311,923,56,216,27,145,49,27
"1399","2020-03-19",37,17,62,316,3436,0.30267753201397,0,0,311,923,42,258,17,162,38,17
"1400","2020-03-20",46,17,66,348,3436,0.30267753201397,0,0,311,923,68,326,19,181,63,19
"1401","2020-03-21",58,17,65,379,3436,0.30267753201397,0,0,311,923,79,405,16,197,71,16
"1402","2020-03-22",71,17,63,422,3436,0.30267753201397,0,0,311,923,94,499,4,201,91,4
"1403","2020-03-23",89,17,92,434,3436,0.30267753201397,0,0,311,923,121,620,7,208,115,7
"1404","2020-03-24",97,17,106,441,3436,0.30267753201397,0,0,311,923,151,771,6,214,145,6
"1405","2020-03-25",101,17,144,474,3436,0.30267753201397,0,0,311,923,159,930,35,249,152,35
"1406","2020-03-26",116,17,147,466,3436,0.30267753201397,0,0,311,923,180,1110,60,309,177,60
"1407","2020-03-27",125,17,142,476,3436,0.30267753201397,0,0,311,923,201,1311,26,335,194,26
"1408","2020-03-28",139,17,109,475,3436,0.30267753201397,0,0,311,923,261,1572,12,347,260,12
"1409","2020-03-29",140,17,103,497,3436,0.30267753201397,0,0,311,923,241,1813,32,379,235,32
"1410","2020-03-30",135,17,97,508,3436,0.30267753201397,0,0,311,923,289,2102,20,399,282,20
"1411","2020-03-31",146,17,98,496,3436,0.30267753201397,0,0,311,923,307,2409,16,415,303,16
"1412","2020-04-01",146,17,98,496,3436,0.30267753201397,0,0,311,923,357,2766,18,433,350,18
"1413","2020-04-02",144,17,100,519,3436,0.30267753201397,0,0,311,923,366,3132,34,467,359,34
"1414","2020-04-03",142,17,107,524,3436,0.30267753201397,0,0,311,923,399,3531,41,508,396,41
"1415","2020-04-04",134,17,116,526,3436,0.30267753201397,0,0,311,923,392,3923,45,553,387,45
"1416","2020-04-05",141,17,157,543,3436,0.30267753201397,0,0,311,923,313,4236,38,591,310,38
"1417","2020-04-06",146,17,189,546,3436,0.30267753201397,0,0,311,923,350,4586,25,616,349,25
"1418","2020-04-07",140,17,204,564,3436,0.30267753201397,0,0,311,923,387,4973,17,633,385,17
"1419","2020-04-08",150,17,244,554,3436,0.30267753201397,0,0,311,923,280,5253,16,649,276,16
"1420","2020-04-09",153,17,252,562,3436,0.30267753201397,0,0,311,923,270,5523,27,676,270,27
"1421","2020-04-10",148,17,235,542,3436,0.30267753201397,0,0,311,923,252,5775,15,691,252,15
"1422","2020-04-11",155,17,211,523,3436,0.30267753201397,0,0,311,923,203,5978,16,707,202,16
"1423","2020-04-12",152,17,194,525,3436,0.30267753201397,0,0,311,923,150,6128,42,749,148,42
"1424","2020-04-13",151,17,177,522,3436,0.30267753201397,0,0,311,923,168,6296,16,765,165,16
"1425","2020-04-14",154,17,195,527,3436,0.30267753201397,0,0,311,923,135,6431,18,783,134,18
"1426","2020-04-15",154,17,200,524,3436,0.30267753201397,0,0,311,923,103,6534,48,831,103,48
"1427","2020-04-16",152,17,190,533,3436,0.30267753201397,0,0,311,923,106,6640,32,863,105,32
"1428","2020-04-17",162,17,231,511,3436,0.30267753201397,0,0,311,923,93,6733,16,879,92,16
"1429","2020-04-18",153,17,257,507,3436,0.30267753201397,0,0,311,923,73,6806,15,894,73,15
"1430","2020-04-19",156,17,278,492,3436,0.30267753201397,0,0,311,923,47,6853,57,951,46,57
"1431","2020-04-20",162,17,281,482,3436,0.30267753201397,0,0,311,923,44,6897,59,1010,43,59
"1432","2020-04-21",151,17,258,465,3436,0.30267753201397,0,0,311,923,36,6933,42,1052,36,42
"1433","2020-04-22",140,17,255,449,3436,0.30267753201397,0,0,311,923,32,6965,31,1083,30,31
"1434","2020-04-23",139,17,258,452,3436,0.30267753201397,0,0,311,923,35,7000,20,1103,35,20
"1435","2020-04-24",140,17,241,453,3436,0.30267753201397,0,0,311,923,29,7029,27,1130,26,27
"1436","2020-04-25",138,17,229,457,3436,0.30267753201397,0,0,311,923,20,7049,23,1153,18,23
"1437","2020-04-26",129,17,180,459,3436,0.30267753201397,0,0,311,923,27,7076,47,1200,25,47
"1438","2020-04-27",117,17,156,466,3436,0.30267753201397,0,0,311,923,7,7083,63,1263,5,63
"1439","2020-04-28",125,17,143,464,3436,0.30267753201397,0,0,311,923,14,7097,28,1291,13,28
"1440","2020-04-29",131,17,135,466,3436,0.30267753201397,0,0,311,923,11,7108,36,1327,10,36
"1441","2020-04-30",126,17,166,474,3436,0.30267753201397,0,0,311,923,10,7118,23,1350,8,23
"1442","2020-05-01",123,17,172,466,3436,0.30267753201397,0,0,311,923,10,7128,19,1369,9,19
"1443","2020-05-02",126,17,196,445,3436,0.30267753201397,0,0,311,923,9,7137,12,1381,7,12
"1444","2020-05-03",133,17,183,455,3436,0.30267753201397,0,0,311,923,1,7138,15,1396,1,15
"1445","2020-05-04",135,17,184,453,3436,0.30267753201397,0,0,311,923,8,7146,15,1411,7,15
"1446","2020-05-05",135,17,228,454,3436,0.30267753201397,0,0,311,923,8,7154,13,1424,7,13
"1447","2020-05-06",129,17,240,454,3436,0.30267753201397,0,0,311,923,5,7159,47,1471,5,47
"1448","2020-05-07",134,17,215,462,3436,0.30267753201397,0,0,311,923,6,7165,35,1506,5,35
"1449","2020-05-08",134,17,190,470,3436,0.30267753201397,0,0,311,923,4,7169,28,1534,4,28
"1450","2020-05-09",129,17,212,474,3436,0.30267753201397,0,0,311,923,4,7173,52,1586,3,52
"1451","2020-05-10",124,17,197,463,3436,0.30267753201397,0,0,311,923,7,7180,66,1652,6,66
"1452","2020-05-11",123,17,208,468,3436,0.30267753201397,0,0,311,923,3,7183,54,1706,1,54
"1453","2020-05-12",125,17,207,452,3436,0.30267753201397,0,0,311,923,3,7186,51,1757,2,51
"1454","2020-05-13",122,17,202,449,3436,0.30267753201397,0,0,311,923,5,7191,21,1778,4,21
"1455","2020-05-14",122,17,207,436,3436,0.30267753201397,0,0,311,923,5,7196,25,1803,4,25
"1456","2020-05-15",123,17,202,422,3436,0.30267753201397,0,0,311,923,2,7198,39,1842,2,39
"1457","2020-05-16",118,17,194,413,3436,0.30267753201397,0,0,311,923,2,7200,45,1887,2,45
"1458","2020-05-17",112,17,229,399,3436,0.30267753201397,0,0,311,923,6,7206,39,1926,4,39
"1459","2020-05-18",113,17,251,385,3436,0.30267753201397,0,0,311,923,2,7208,29,1955,2,29
"1460","2020-05-19",107,17,255,367,3436,0.30267753201397,0,0,311,923,1,7209,49,2004,NA,49
"1461","2020-05-20",109,17,246,344,3436,0.30267753201397,0,0,311,923,3,7212,52,2056,2,52
"1462","2020-05-21",106,17,240,329,3436,0.30267753201397,0,0,311,923,3,7215,46,2102,2,46
"1463","2020-05-22",96,17,232,320,3436,0.30267753201397,0,0,311,923,3,7218,45,2147,3,45
"1464","2020-05-23",106,17,229,309,3436,0.30267753201397,0,0,311,923,3,7221,51,2198,2,51
"1465","2020-05-24",109,17,215,301,3436,0.30267753201397,0,0,311,923,4,7225,30,2228,3,30
"1466","2020-05-25",102,17,223,288,3436,0.30267753201397,0,0,311,923,3,7228,25,2253,3,25
"1467","2020-05-26",105,17,205,282,3436,0.30267753201397,0,0,311,923,4,7232,25,2278,2,25
"1468","2020-05-27",94,17,192,263,3436,0.30267753201397,0,0,311,923,2,7234,18,2296,2,18
"1469","2020-05-28",86,17,203,256,3436,0.30267753201397,0,0,311,923,2,7236,49,2345,2,49
"1470","2020-05-29",85,17,220,237,3436,0.30267753201397,0,0,311,923,4,7240,43,2388,4,43
"1471","2020-05-30",73,17,209,230,3436,0.30267753201397,0,0,311,923,2,7242,24,2412,2,24
"1472","2020-05-31",67,17,189,225,3436,0.30267753201397,0,0,311,923,6,7248,42,2454,5,42
"1473","2020-06-01",65,17,163,219,3436,0.30267753201397,0,0,311,923,NA,NA,44,2498,NA,44
"1474","2020-06-02",52,17,147,209,3436,0.30267753201397,0,0,311,923,2,7250,41,2539,1,41
"1475","2020-06-03",56,17,155,194,3436,0.30267753201397,0,0,311,923,1,7251,27,2566,NA,27
"1476","2020-06-04",53,17,155,201,3436,0.30267753201397,0,0,311,923,4,7255,36,2602,3,36
"1477","2020-06-05",49,17,155,193,3436,0.30267753201397,0,0,311,923,2,7257,39,2641,2,39
"1478","2020-06-06",54,17,141,194,3436,0.30267753201397,0,0,311,923,2,7259,22,2663,2,22
"1479","2020-06-07",53,17,143,188,3436,0.30267753201397,0,0,311,923,3,7262,16,2679,2,16
"1480","2020-03-13",1,18,134,51,3232,0.622215346534653,0,0,296,1078,8,28,21,35,3,21
"1481","2020-03-14",3,18,163,69,3232,0.622215346534653,0,0,296,1078,12,40,28,63,2,28
"1482","2020-03-15",9,18,156,89,3232,0.622215346534653,0,0,296,1078,6,46,17,80,3,17
"1483","2020-03-16",14,18,142,114,3232,0.622215346534653,0,0,296,1078,16,62,8,88,12,8
"1484","2020-03-17",20,18,118,139,3232,0.622215346534653,0,0,296,1078,13,75,8,96,7,8
"1485","2020-03-18",23,18,96,166,3232,0.622215346534653,0,0,296,1078,12,87,22,118,8,22
"1486","2020-03-19",29,18,99,193,3232,0.622215346534653,0,0,296,1078,11,98,36,154,7,36
"1487","2020-03-20",34,18,126,234,3232,0.622215346534653,0,0,296,1078,16,114,11,165,12,11
"1488","2020-03-21",46,18,121,256,3232,0.622215346534653,0,0,296,1078,16,130,11,176,9,11
"1489","2020-03-22",46,18,120,281,3232,0.622215346534653,0,0,296,1078,20,150,5,181,10,5
"1490","2020-03-23",48,18,123,323,3232,0.622215346534653,0,0,296,1078,17,167,2,183,11,2
"1491","2020-03-24",58,18,121,336,3232,0.622215346534653,0,0,296,1078,19,186,8,191,13,8
"1492","2020-03-25",65,18,126,348,3232,0.622215346534653,0,0,296,1078,31,217,34,225,19,34
"1493","2020-03-26",75,18,158,386,3232,0.622215346534653,0,0,296,1078,21,238,29,254,13,29
"1494","2020-03-27",79,18,183,402,3232,0.622215346534653,0,0,296,1078,43,281,17,271,24,17
"1495","2020-03-28",84,18,198,405,3232,0.622215346534653,0,0,296,1078,24,305,14,285,16,14
"1496","2020-03-29",97,18,229,428,3232,0.622215346534653,0,0,296,1078,40,345,7,292,31,7
"1497","2020-03-30",103,18,251,432,3232,0.622215346534653,0,0,296,1078,42,387,30,322,33,30
"1498","2020-03-31",112,18,275,450,3232,0.622215346534653,0,0,296,1078,37,424,33,355,31,33
"1499","2020-04-01",118,18,280,468,3232,0.622215346534653,0,0,296,1078,32,456,20,375,25,20
"1500","2020-04-02",116,18,290,467,3232,0.622215346534653,0,0,296,1078,33,489,42,417,25,42
"1501","2020-04-03",121,18,313,497,3232,0.622215346534653,0,0,296,1078,41,530,39,456,34,39
"1502","2020-04-04",124,18,290,486,3232,0.622215346534653,0,0,296,1078,32,562,43,499,24,43
"1503","2020-04-05",129,18,258,510,3232,0.622215346534653,0,0,296,1078,22,584,18,517,14,18
"1504","2020-04-06",138,18,266,522,3232,0.622215346534653,0,0,296,1078,32,616,41,558,24,41
"1505","2020-04-07",132,18,240,537,3232,0.622215346534653,0,0,296,1078,33,649,26,584,16,26
"1506","2020-04-08",145,18,206,549,3232,0.622215346534653,0,0,296,1078,26,675,47,631,17,47
"1507","2020-04-09",154,18,211,535,3232,0.622215346534653,0,0,296,1078,29,704,43,674,21,43
"1508","2020-04-10",166,18,178,534,3232,0.622215346534653,0,0,296,1078,24,728,15,689,15,15
"1509","2020-04-11",164,18,155,523,3232,0.622215346534653,0,0,296,1078,24,752,34,723,18,34
"1510","2020-04-12",163,18,143,526,3232,0.622215346534653,0,0,296,1078,28,780,19,742,17,19
"1511","2020-04-13",156,18,128,510,3232,0.622215346534653,0,0,296,1078,33,813,54,796,17,54
"1512","2020-04-14",166,18,132,482,3232,0.622215346534653,0,0,296,1078,32,845,14,810,23,14
"1513","2020-04-15",161,18,127,479,3232,0.622215346534653,0,0,296,1078,23,868,8,818,17,8
"1514","2020-04-16",153,18,123,478,3232,0.622215346534653,0,0,296,1078,16,884,16,834,10,16
"1515","2020-04-17",139,18,147,459,3232,0.622215346534653,0,0,296,1078,29,913,4,838,16,4
"1516","2020-04-18",141,18,164,454,3232,0.622215346534653,0,0,296,1078,37,950,13,851,21,13
"1517","2020-04-19",137,18,188,456,3232,0.622215346534653,0,0,296,1078,43,993,36,887,30,36
"1518","2020-04-20",136,18,187,462,3232,0.622215346534653,0,0,296,1078,26,1019,27,914,18,27
"1519","2020-04-21",124,18,169,479,3232,0.622215346534653,0,0,296,1078,28,1047,43,957,17,43
"1520","2020-04-22",116,18,148,479,3232,0.622215346534653,0,0,296,1078,36,1083,33,990,23,33
"1521","2020-04-23",118,18,134,480,3232,0.622215346534653,0,0,296,1078,27,1110,17,1007,17,17
"1522","2020-04-24",132,18,116,485,3232,0.622215346534653,0,0,296,1078,38,1148,17,1024,23,17
"1523","2020-04-25",133,18,130,492,3232,0.622215346534653,0,0,296,1078,26,1174,13,1037,22,13
"1524","2020-04-26",136,18,123,500,3232,0.622215346534653,0,0,296,1078,38,1212,24,1061,29,24
"1525","2020-04-27",139,18,122,506,3232,0.622215346534653,0,0,296,1078,28,1240,26,1087,17,26
"1526","2020-04-28",143,18,117,510,3232,0.622215346534653,0,0,296,1078,35,1275,44,1131,21,44
"1527","2020-04-29",145,18,152,537,3232,0.622215346534653,0,0,296,1078,32,1307,20,1151,14,20
"1528","2020-04-30",141,18,150,525,3232,0.622215346534653,0,0,296,1078,26,1333,18,1169,15,18
"1529","2020-05-01",144,18,124,528,3232,0.622215346534653,0,0,296,1078,26,1359,16,1185,14,16
"1530","2020-05-02",147,18,124,517,3232,0.622215346534653,0,0,296,1078,24,1383,15,1200,15,15
"1531","2020-05-03",139,18,154,524,3232,0.622215346534653,0,0,296,1078,27,1410,10,1210,10,10
"1532","2020-05-04",144,18,162,519,3232,0.622215346534653,0,0,296,1078,24,1434,13,1223,12,13
"1533","2020-05-05",151,18,216,525,3232,0.622215346534653,0,0,296,1078,42,1476,38,1261,30,38
"1534","2020-05-06",145,18,245,522,3232,0.622215346534653,0,0,296,1078,17,1493,42,1303,11,42
"1535","2020-05-07",154,18,225,507,3232,0.622215346534653,0,0,296,1078,17,1510,30,1333,12,30
"1536","2020-05-08",141,18,199,495,3232,0.622215346534653,0,0,296,1078,21,1531,31,1364,10,31
"1537","2020-05-09",137,18,222,494,3232,0.622215346534653,0,0,296,1078,19,1550,36,1400,10,36
"1538","2020-05-10",145,18,223,473,3232,0.622215346534653,0,0,296,1078,29,1579,33,1433,18,33
"1539","2020-05-11",145,18,214,469,3232,0.622215346534653,0,0,296,1078,19,1598,16,1449,10,16
"1540","2020-05-12",137,18,190,446,3232,0.622215346534653,0,0,296,1078,21,1619,20,1469,12,20
"1541","2020-05-13",138,18,166,432,3232,0.622215346534653,0,0,296,1078,13,1632,13,1482,5,13
"1542","2020-05-14",134,18,191,412,3232,0.622215346534653,0,0,296,1078,19,1651,17,1499,9,17
"1543","2020-05-15",134,18,171,389,3232,0.622215346534653,0,0,296,1078,15,1666,40,1539,9,40
"1544","2020-05-16",130,18,190,356,3232,0.622215346534653,0,0,296,1078,14,1680,28,1567,4,28
"1545","2020-05-17",124,18,188,345,3232,0.622215346534653,0,0,296,1078,18,1698,38,1605,13,38
"1546","2020-05-18",112,18,152,347,3232,0.622215346534653,0,0,296,1078,17,1715,25,1630,10,25
"1547","2020-05-19",106,18,145,326,3232,0.622215346534653,0,0,296,1078,15,1730,20,1650,9,20
"1548","2020-05-20",103,18,142,305,3232,0.622215346534653,0,0,296,1078,21,1751,26,1676,13,26
"1549","2020-05-21",101,18,153,306,3232,0.622215346534653,0,0,296,1078,14,1765,24,1700,7,24
"1550","2020-05-22",94,18,163,300,3232,0.622215346534653,0,0,296,1078,17,1782,35,1735,10,35
"1551","2020-05-23",82,18,203,290,3232,0.622215346534653,0,0,296,1078,18,1800,21,1756,12,21
"1552","2020-05-24",81,18,241,271,3232,0.622215346534653,0,0,296,1078,25,1825,11,1767,14,11
"1553","2020-05-25",81,18,220,265,3232,0.622215346534653,0,0,296,1078,17,1842,10,1777,9,10
"1554","2020-05-26",81,18,209,261,3232,0.622215346534653,0,0,296,1078,16,1858,19,1796,11,19
"1555","2020-05-27",84,18,209,260,3232,0.622215346534653,0,0,296,1078,19,1877,6,1802,13,6
"1556","2020-05-28",77,18,194,241,3232,0.622215346534653,0,0,296,1078,15,1892,13,1815,8,13
"1557","2020-05-29",73,18,175,240,3232,0.622215346534653,0,0,296,1078,12,1904,8,1823,8,8
"1558","2020-05-30",76,18,158,239,3232,0.622215346534653,0,0,296,1078,20,1924,9,1832,15,9
"1559","2020-05-31",67,18,142,232,3232,0.622215346534653,0,0,296,1078,21,1945,18,1850,12,18
"1560","2020-06-01",68,18,130,219,3232,0.622215346534653,0,0,296,1078,17,1962,20,1870,9,20
"1561","2020-06-02",62,18,117,210,3232,0.622215346534653,0,0,296,1078,11,1973,14,1884,9,14
"1562","2020-06-03",63,18,106,190,3232,0.622215346534653,0,0,296,1078,21,1994,26,1910,15,26
"1563","2020-06-04",63,18,111,179,3232,0.622215346534653,0,0,296,1078,11,2005,25,1935,7,25
"1564","2020-06-05",71,18,115,180,3232,0.622215346534653,0,0,296,1078,18,2023,21,1956,17,21
"1565","2020-06-06",70,18,111,182,3232,0.622215346534653,0,0,296,1078,14,2037,16,1972,9,16
"1566","2020-06-07",72,18,106,177,3232,0.622215346534653,0,0,296,1078,17,2054,9,1981,14,9
"1567","2020-03-13",1,19,57,77,3388,0.282172373081464,0,0,267,497,44,99,34,69,11,34
"1568","2020-03-14",2,19,62,109,3388,0.282172373081464,0,0,267,497,42,141,8,77,10,8
"1569","2020-03-15",4,19,55,145,3388,0.282172373081464,0,0,267,497,36,177,7,84,8,7
"1570","2020-03-16",8,19,61,178,3388,0.282172373081464,0,0,267,497,67,244,19,103,31,19
"1571","2020-03-17",16,19,56,220,3388,0.282172373081464,0,0,267,497,52,296,26,129,24,26
"1572","2020-03-18",21,19,51,266,3388,0.282172373081464,0,0,267,497,51,347,26,155,23,26
"1573","2020-03-19",34,19,58,288,3388,0.282172373081464,0,0,267,497,52,399,23,178,25,23
"1574","2020-03-20",42,19,63,308,3388,0.282172373081464,0,0,267,497,77,476,53,231,53,53
"1575","2020-03-21",58,19,80,336,3388,0.282172373081464,0,0,267,497,76,552,34,265,48,34
"1576","2020-03-22",63,19,107,357,3388,0.282172373081464,0,0,267,497,65,617,54,319,33,54
"1577","2020-03-23",72,19,102,391,3388,0.282172373081464,0,0,267,497,76,693,51,370,38,51
"1578","2020-03-24",81,19,86,416,3388,0.282172373081464,0,0,267,497,55,748,56,426,26,56
"1579","2020-03-25",91,19,103,450,3388,0.282172373081464,0,0,267,497,59,807,52,478,35,52
"1580","2020-03-26",103,19,114,457,3388,0.282172373081464,0,0,267,497,62,869,46,524,39,46
"1581","2020-03-27",111,19,104,480,3388,0.282172373081464,0,0,267,497,61,930,31,555,32,31
"1582","2020-03-28",119,19,96,480,3388,0.282172373081464,0,0,267,497,45,975,35,590,21,35
"1583","2020-03-29",138,19,100,489,3388,0.282172373081464,0,0,267,497,54,1029,61,651,25,61
"1584","2020-03-30",140,19,90,486,3388,0.282172373081464,0,0,267,497,49,1078,17,668,19,17
"1585","2020-03-31",145,19,89,484,3388,0.282172373081464,0,0,267,497,72,1150,18,686,27,18
"1586","2020-04-01",154,19,103,492,3388,0.282172373081464,0,0,267,497,54,1204,20,706,24,20
"1587","2020-04-02",144,19,134,507,3388,0.282172373081464,0,0,267,497,57,1261,18,724,21,18
"1588","2020-04-03",145,19,150,505,3388,0.282172373081464,0,0,267,497,50,1311,16,740,21,16
"1589","2020-04-04",136,19,147,503,3388,0.282172373081464,0,0,267,497,58,1369,14,754,30,14
"1590","2020-04-05",123,19,136,501,3388,0.282172373081464,0,0,267,497,75,1444,14,768,42,14
"1591","2020-04-06",127,19,135,491,3388,0.282172373081464,0,0,267,497,63,1507,47,815,31,47
"1592","2020-04-07",124,19,143,496,3388,0.282172373081464,0,0,267,497,54,1561,21,836,28,21
"1593","2020-04-08",118,19,142,498,3388,0.282172373081464,0,0,267,497,62,1623,19,855,29,19
"1594","2020-04-09",127,19,135,479,3388,0.282172373081464,0,0,267,497,55,1678,14,869,24,14
"1595","2020-04-10",127,19,136,485,3388,0.282172373081464,0,0,267,497,73,1751,46,915,38,46
"1596","2020-04-11",136,19,167,496,3388,0.282172373081464,0,0,267,497,57,1808,31,946,19,31
"1597","2020-04-12",148,19,174,477,3388,0.282172373081464,0,0,267,497,49,1857,27,973,18,27
"1598","2020-04-13",140,19,181,487,3388,0.282172373081464,0,0,267,497,61,1918,16,989,21,16
"1599","2020-04-14",144,19,193,510,3388,0.282172373081464,0,0,267,497,58,1976,45,1034,26,45
"1600","2020-04-15",150,19,210,517,3388,0.282172373081464,0,0,267,497,55,2031,53,1087,24,53
"1601","2020-04-16",150,19,223,504,3388,0.282172373081464,0,0,267,497,62,2093,55,1142,23,55
"1602","2020-04-17",154,19,210,499,3388,0.282172373081464,0,0,267,497,54,2147,33,1175,27,33
"1603","2020-04-18",153,19,181,490,3388,0.282172373081464,0,0,267,497,53,2200,20,1195,26,20
"1604","2020-04-19",143,19,181,481,3388,0.282172373081464,0,0,267,497,52,2252,18,1213,24,18
"1605","2020-04-20",152,19,177,483,3388,0.282172373081464,0,0,267,497,64,2316,57,1270,27,57
"1606","2020-04-21",144,19,167,489,3388,0.282172373081464,0,0,267,497,43,2359,26,1296,15,26
"1607","2020-04-22",136,19,172,481,3388,0.282172373081464,0,0,267,497,38,2397,25,1321,14,25
"1608","2020-04-23",127,19,161,476,3388,0.282172373081464,0,0,267,497,52,2449,53,1374,23,53
"1609","2020-04-24",126,19,156,474,3388,0.282172373081464,0,0,267,497,58,2507,35,1409,19,35
"1610","2020-04-25",117,19,161,463,3388,0.282172373081464,0,0,267,497,39,2546,16,1425,9,16
"1611","2020-04-26",118,19,163,466,3388,0.282172373081464,0,0,267,497,43,2589,16,1441,17,16
"1612","2020-04-27",122,19,147,467,3388,0.282172373081464,0,0,267,497,45,2634,19,1460,21,19
"1613","2020-04-28",125,19,175,456,3388,0.282172373081464,0,0,267,497,57,2691,20,1480,20,20
"1614","2020-04-29",127,19,210,461,3388,0.282172373081464,0,0,267,497,47,2738,51,1531,16,51
"1615","2020-04-30",130,19,207,462,3388,0.282172373081464,0,0,267,497,60,2798,26,1557,23,26
"1616","2020-05-01",128,19,207,468,3388,0.282172373081464,0,0,267,497,31,2829,28,1585,9,28
"1617","2020-05-02",139,19,199,445,3388,0.282172373081464,0,0,267,497,42,2871,52,1637,14,52
"1618","2020-05-03",132,19,177,440,3388,0.282172373081464,0,0,267,497,38,2909,33,1670,8,33
"1619","2020-05-04",126,19,153,432,3388,0.282172373081464,0,0,267,497,55,2964,17,1687,19,17
"1620","2020-05-05",129,19,142,427,3388,0.282172373081464,0,0,267,497,40,3004,12,1699,14,12
"1621","2020-05-06",126,19,172,421,3388,0.282172373081464,0,0,267,497,40,3044,7,1706,8,7
"1622","2020-05-07",123,19,173,412,3388,0.282172373081464,0,0,267,497,57,3101,14,1720,18,14
"1623","2020-05-08",115,19,171,412,3388,0.282172373081464,0,0,267,497,48,3149,47,1767,16,47
"1624","2020-05-09",105,19,152,413,3388,0.282172373081464,0,0,267,497,42,3191,70,1837,10,70
"1625","2020-05-10",111,19,153,420,3388,0.282172373081464,0,0,267,497,39,3230,60,1897,16,60
"1626","2020-05-11",108,19,165,408,3388,0.282172373081464,0,0,267,497,38,3268,51,1948,13,51
"1627","2020-05-12",103,19,188,390,3388,0.282172373081464,0,0,267,497,43,3311,69,2017,18,69
"1628","2020-05-13",100,19,202,386,3388,0.282172373081464,0,0,267,497,42,3353,66,2083,16,66
"1629","2020-05-14",105,19,211,376,3388,0.282172373081464,0,0,267,497,45,3398,31,2114,10,31
"1630","2020-05-15",109,19,201,368,3388,0.282172373081464,0,0,267,497,31,3429,15,2129,13,15
"1631","2020-05-16",108,19,187,352,3388,0.282172373081464,0,0,267,497,28,3457,16,2145,8,16
"1632","2020-05-17",106,19,195,340,3388,0.282172373081464,0,0,267,497,31,3488,38,2183,12,38
"1633","2020-05-18",102,19,189,343,3388,0.282172373081464,0,0,267,497,29,3517,19,2202,11,19
"1634","2020-05-19",101,19,187,335,3388,0.282172373081464,0,0,267,497,22,3539,14,2216,10,14
"1635","2020-05-20",104,19,203,317,3388,0.282172373081464,0,0,267,497,28,3567,13,2229,12,13
"1636","2020-05-21",104,19,203,317,3388,0.282172373081464,0,0,267,497,34,3601,8,2237,15,8
"1637","2020-05-22",101,19,186,314,3388,0.282172373081464,0,0,267,497,28,3629,20,2257,14,20
"1638","2020-05-23",102,19,190,301,3388,0.282172373081464,0,0,267,497,32,3661,53,2310,15,53
"1639","2020-05-24",100,19,193,302,3388,0.282172373081464,0,0,267,497,31,3692,56,2366,11,56
"1640","2020-05-25",101,19,206,298,3388,0.282172373081464,0,0,267,497,28,3720,48,2414,12,48
"1641","2020-05-26",98,19,202,286,3388,0.282172373081464,0,0,267,497,34,3754,46,2460,15,46
"1642","2020-05-27",93,19,180,290,3388,0.282172373081464,0,0,267,497,23,3777,21,2481,8,21
"1643","2020-05-28",83,19,167,281,3388,0.282172373081464,0,0,267,497,24,3801,22,2503,7,22
"1644","2020-05-29",77,19,158,278,3388,0.282172373081464,0,0,267,497,21,3822,38,2541,8,38
"1645","2020-05-30",74,19,124,266,3388,0.282172373081464,0,0,267,497,19,3841,24,2565,12,24
"1646","2020-05-31",79,19,106,266,3388,0.282172373081464,0,0,267,497,21,3862,11,2576,8,11
"1647","2020-06-01",78,19,96,239,3388,0.282172373081464,0,0,267,497,21,3883,12,2588,8,12
"1648","2020-06-02",77,19,93,246,3388,0.282172373081464,0,0,267,497,17,3900,14,2602,12,14
"1649","2020-06-03",76,19,83,242,3388,0.282172373081464,0,0,267,497,12,3912,20,2622,2,20
"1650","2020-06-04",75,19,78,238,3388,0.282172373081464,0,0,267,497,15,3927,27,2649,7,27
"1651","2020-06-05",77,19,74,244,3388,0.282172373081464,0,0,267,497,14,3941,23,2672,4,23
"1652","2020-06-06",69,19,86,242,3388,0.282172373081464,0,0,267,497,13,3954,41,2713,4,41
"1653","2020-06-07",67,19,84,234,3388,0.282172373081464,0,0,267,497,17,3971,26,2739,9,26
"1654","2020-03-13",1,20,70,27,4457,0.89634283150101,0,0,371,694,13,40,28,71,2,28
"1655","2020-03-14",2,20,94,40,4457,0.89634283150101,0,0,371,694,11,51,24,95,5,24
"1656","2020-03-15",2,20,120,55,4457,0.89634283150101,0,0,371,694,9,60,27,122,1,27
"1657","2020-03-16",4,20,125,65,4457,0.89634283150101,0,0,371,694,11,71,20,142,3,20
"1658","2020-03-17",10,20,118,92,4457,0.89634283150101,0,0,371,694,20,91,23,165,6,23
"1659","2020-03-18",12,20,92,109,4457,0.89634283150101,0,0,371,694,23,114,16,181,10,16
"1660","2020-03-19",14,20,103,125,4457,0.89634283150101,0,0,371,694,17,131,22,203,5,22
"1661","2020-03-20",21,20,133,151,4457,0.89634283150101,0,0,371,694,24,155,14,217,9,14
"1662","2020-03-21",27,20,137,167,4457,0.89634283150101,0,0,371,694,18,173,24,241,6,24
"1663","2020-03-22",31,20,132,197,4457,0.89634283150101,0,0,371,694,22,195,23,264,9,23
"1664","2020-03-23",33,20,127,229,4457,0.89634283150101,0,0,371,694,32,227,12,276,23,12
"1665","2020-03-24",42,20,128,257,4457,0.89634283150101,0,0,371,694,31,258,18,294,13,18
"1666","2020-03-25",50,20,124,275,4457,0.89634283150101,0,0,371,694,25,283,35,329,13,35
"1667","2020-03-26",59,20,115,298,4457,0.89634283150101,0,0,371,694,31,314,52,381,17,52
"1668","2020-03-27",66,20,98,338,4457,0.89634283150101,0,0,371,694,27,341,31,412,17,31
"1669","2020-03-28",73,20,103,381,4457,0.89634283150101,0,0,371,694,25,366,17,429,12,17
"1670","2020-03-29",86,20,129,417,4457,0.89634283150101,0,0,371,694,32,398,28,457,27,28
"1671","2020-03-30",100,20,135,462,4457,0.89634283150101,0,0,371,694,31,429,18,475,14,18
"1672","2020-03-31",105,20,164,496,4457,0.89634283150101,0,0,371,694,38,467,12,487,23,12
"1673","2020-04-01",115,20,173,541,4457,0.89634283150101,0,0,371,694,40,507,20,507,28,20
"1674","2020-04-02",119,20,197,585,4457,0.89634283150101,0,0,371,694,22,529,36,543,10,36
"1675","2020-04-03",125,20,204,625,4457,0.89634283150101,0,0,371,694,40,569,39,582,26,39
"1676","2020-04-04",128,20,253,648,4457,0.89634283150101,0,0,371,694,26,595,29,611,16,29
"1677","2020-04-05",139,20,283,692,4457,0.89634283150101,0,0,371,694,41,636,34,645,27,34
"1678","2020-04-06",153,20,298,725,4457,0.89634283150101,0,0,371,694,25,661,26,671,17,26
"1679","2020-04-07",154,20,287,787,4457,0.89634283150101,0,0,371,694,33,694,39,710,21,39
"1680","2020-04-08",164,20,243,809,4457,0.89634283150101,0,0,371,694,32,726,40,750,16,40
"1681","2020-04-09",187,20,208,864,4457,0.89634283150101,0,0,371,694,42,768,27,777,21,27
"1682","2020-04-10",203,20,180,874,4457,0.89634283150101,0,0,371,694,31,799,35,812,17,35
"1683","2020-04-11",222,20,172,903,4457,0.89634283150101,0,0,371,694,33,832,29,841,22,29
"1684","2020-04-12",235,20,157,921,4457,0.89634283150101,0,0,371,694,42,874,50,891,32,50
"1685","2020-04-13",238,20,143,964,4457,0.89634283150101,0,0,371,694,24,898,49,940,11,49
"1686","2020-04-14",255,20,146,982,4457,0.89634283150101,0,0,371,694,38,936,47,987,16,47
"1687","2020-04-15",268,20,192,1014,4457,0.89634283150101,0,0,371,694,34,970,47,1034,17,47
"1688","2020-04-16",281,20,203,1036,4457,0.89634283150101,0,0,371,694,20,990,37,1071,8,37
"1689","2020-04-17",278,20,197,1036,4457,0.89634283150101,0,0,371,694,26,1016,41,1112,12,41
"1690","2020-04-18",291,20,220,1011,4457,0.89634283150101,0,0,371,694,35,1051,42,1154,18,42
"1691","2020-04-19",286,20,223,982,4457,0.89634283150101,0,0,371,694,31,1082,48,1202,18,48
"1692","2020-04-20",288,20,236,973,4457,0.89634283150101,0,0,371,694,25,1107,33,1235,11,33
"1693","2020-04-21",287,20,227,958,4457,0.89634283150101,0,0,371,694,31,1138,38,1273,12,38
"1694","2020-04-22",278,20,226,918,4457,0.89634283150101,0,0,371,694,23,1161,39,1312,12,39
"1695","2020-04-23",267,20,212,899,4457,0.89634283150101,0,0,371,694,34,1195,26,1338,11,26
"1696","2020-04-24",266,20,210,877,4457,0.89634283150101,0,0,371,694,16,1211,20,1358,6,20
"1697","2020-04-25",254,20,226,872,4457,0.89634283150101,0,0,371,694,31,1242,27,1385,9,27
"1698","2020-04-26",249,20,223,854,4457,0.89634283150101,0,0,371,694,28,1270,22,1407,13,22
"1699","2020-04-27",247,20,201,851,4457,0.89634283150101,0,0,371,694,32,1302,41,1448,11,41
"1700","2020-04-28",243,20,219,814,4457,0.89634283150101,0,0,371,694,24,1326,31,1479,8,31
"1701","2020-04-29",245,20,217,805,4457,0.89634283150101,0,0,371,694,30,1356,25,1504,12,25
"1702","2020-04-30",244,20,220,795,4457,0.89634283150101,0,0,371,694,29,1385,24,1528,14,24
"1703","2020-05-01",244,20,257,797,4457,0.89634283150101,0,0,371,694,25,1410,38,1566,9,38
"1704","2020-05-02",234,20,283,763,4457,0.89634283150101,0,0,371,694,23,1433,62,1628,12,62
"1705","2020-05-03",248,20,280,763,4457,0.89634283150101,0,0,371,694,19,1452,32,1660,12,32
"1706","2020-05-04",239,20,262,720,4457,0.89634283150101,0,0,371,694,25,1477,35,1695,9,35
"1707","2020-05-05",229,20,248,707,4457,0.89634283150101,0,0,371,694,38,1515,36,1731,18,36
"1708","2020-05-06",223,20,281,699,4457,0.89634283150101,0,0,371,694,23,1538,24,1755,8,24
"1709","2020-05-07",224,20,290,695,4457,0.89634283150101,0,0,371,694,30,1568,26,1781,10,26
"1710","2020-05-08",218,20,275,693,4457,0.89634283150101,0,0,371,694,27,1595,41,1822,17,41
"1711","2020-05-09",217,20,240,672,4457,0.89634283150101,0,0,371,694,21,1616,30,1852,6,30
"1712","2020-05-10",195,20,219,661,4457,0.89634283150101,0,0,371,694,19,1635,28,1880,9,28
"1713","2020-05-11",197,20,199,611,4457,0.89634283150101,0,0,371,694,20,1655,42,1922,11,42
"1714","2020-05-12",195,20,210,597,4457,0.89634283150101,0,0,371,694,27,1682,31,1953,11,31
"1715","2020-05-13",197,20,219,580,4457,0.89634283150101,0,0,371,694,24,1706,48,2001,13,48
"1716","2020-05-14",176,20,202,552,4457,0.89634283150101,0,0,371,694,25,1731,35,2036,11,35
"1717","2020-05-15",167,20,198,518,4457,0.89634283150101,0,0,371,694,32,1763,34,2070,18,34
"1718","2020-05-16",168,20,219,487,4457,0.89634283150101,0,0,371,694,18,1781,39,2109,4,39
"1719","2020-05-17",168,20,196,469,4457,0.89634283150101,0,0,371,694,24,1805,42,2151,14,42
"1720","2020-05-18",164,20,170,459,4457,0.89634283150101,0,0,371,694,19,1824,46,2197,13,46
"1721","2020-05-19",163,20,155,431,4457,0.89634283150101,0,0,371,694,20,1844,50,2247,11,50
"1722","2020-05-20",148,20,167,408,4457,0.89634283150101,0,0,371,694,19,1863,32,2279,11,32
"1723","2020-05-21",144,20,176,385,4457,0.89634283150101,0,0,371,694,16,1879,37,2316,8,37
"1724","2020-05-22",137,20,181,366,4457,0.89634283150101,0,0,371,694,11,1890,31,2347,6,31
"1725","2020-05-23",128,20,180,340,4457,0.89634283150101,0,0,371,694,11,1901,34,2381,5,34
"1726","2020-05-24",112,20,186,334,4457,0.89634283150101,0,0,371,694,17,1918,37,2418,8,37
"1727","2020-05-25",104,20,209,327,4457,0.89634283150101,0,0,371,694,14,1932,25,2443,11,25
"1728","2020-05-26",101,20,242,298,4457,0.89634283150101,0,0,371,694,15,1947,41,2484,4,41
"1729","2020-05-27",95,20,269,290,4457,0.89634283150101,0,0,371,694,20,1967,36,2520,9,36
"1730","2020-05-28",89,20,266,287,4457,0.89634283150101,0,0,371,694,16,1983,24,2544,5,24
"1731","2020-05-29",89,20,231,267,4457,0.89634283150101,0,0,371,694,16,1999,27,2571,6,27
"1732","2020-05-30",83,20,234,257,4457,0.89634283150101,0,0,371,694,27,2026,37,2608,14,37
"1733","2020-05-31",88,20,219,241,4457,0.89634283150101,0,0,371,694,11,2037,27,2635,8,27
"1734","2020-06-01",85,20,190,229,4457,0.89634283150101,0,0,371,694,17,2054,29,2664,8,29
"1735","2020-06-02",77,20,163,211,4457,0.89634283150101,0,0,371,694,13,2067,24,2688,8,24
"1736","2020-06-03",78,20,149,198,4457,0.89634283150101,0,0,371,694,8,2075,26,2714,5,26
"1737","2020-06-04",83,20,145,184,4457,0.89634283150101,0,0,371,694,11,2086,37,2751,8,37
"1738","2020-06-05",79,20,136,173,4457,0.89634283150101,0,0,371,694,13,2099,27,2778,9,27
"1739","2020-06-06",75,20,157,167,4457,0.89634283150101,0,0,371,694,12,2111,21,2799,6,21
"1740","2020-06-07",68,20,142,157,4457,0.89634283150101,0,0,371,694,8,2119,31,2830,2,31
