"","Date","Absents","Paramset","Infections_or_Exposed_per_day_Patient","Infections_or_Exposed_per_day_HCW","total_infections","nosocomial_proportion","PCR_pooled","LFD_pooled","HCW_symp_test","patient_symp_test","new_hcw_infs","cumulative_hcw_infs","new_pat_infs","cumulative_pats_infs","new_nosocomial_hcw_infs","new_nosocomial_pat_infs"
"1","2020-03-13",1,1,10,29,2278,0.49297629499561,2115,4883,203,272,14,29,2,7,2,2
"2","2020-03-14",3,1,7,46,2278,0.49297629499561,2115,4883,203,272,17,46,1,8,3,1
"3","2020-03-15",9,1,17,63,2278,0.49297629499561,2115,4883,203,272,17,63,7,15,3,7
"4","2020-03-16",12,1,24,81,2278,0.49297629499561,2115,4883,203,272,18,81,7,22,4,7
"5","2020-03-17",18,1,28,102,2278,0.49297629499561,2115,4883,203,272,22,103,11,33,9,11
"6","2020-03-18",18,1,34,117,2278,0.49297629499561,2115,4883,203,272,16,119,8,41,3,8
"7","2020-03-19",19,1,35,134,2278,0.49297629499561,2115,4883,203,272,19,138,5,46,4,5
"8","2020-03-20",28,1,42,150,2278,0.49297629499561,2115,4883,203,272,20,158,10,56,9,10
"9","2020-03-21",38,1,46,164,2278,0.49297629499561,2115,4883,203,272,19,177,9,65,14,9
"10","2020-03-22",46,1,47,181,2278,0.49297629499561,2115,4883,203,272,22,199,5,70,10,5
"11","2020-03-23",45,1,46,194,2278,0.49297629499561,2115,4883,203,272,22,221,9,79,9,9
"12","2020-03-24",44,1,48,213,2278,0.49297629499561,2115,4883,203,272,28,249,12,91,10,12
"13","2020-03-25",51,1,41,228,2278,0.49297629499561,2115,4883,203,272,28,277,2,93,9,2
"14","2020-03-26",55,1,32,241,2278,0.49297629499561,2115,4883,203,272,31,308,3,96,18,3
"15","2020-03-27",69,1,26,250,2278,0.49297629499561,2115,4883,203,272,32,340,1,97,21,1
"16","2020-03-28",76,1,30,260,2278,0.49297629499561,2115,4883,203,272,30,370,8,105,16,8
"17","2020-03-29",76,1,32,268,2278,0.49297629499561,2115,4883,203,272,31,401,8,113,17,8
"18","2020-03-30",79,1,31,268,2278,0.49297629499561,2115,4883,203,272,19,420,5,118,11,5
"19","2020-03-31",76,1,23,289,2278,0.49297629499561,2115,4883,203,272,40,460,3,121,18,3
"20","2020-04-01",76,1,25,293,2278,0.49297629499561,2115,4883,203,272,24,484,4,125,10,4
"21","2020-04-02",86,1,28,306,2278,0.49297629499561,2115,4883,203,272,33,517,7,132,20,7
"22","2020-04-03",96,1,26,311,2278,0.49297629499561,2115,4883,203,272,28,545,6,138,14,6
"23","2020-04-04",89,1,40,316,2278,0.49297629499561,2115,4883,203,272,33,578,12,150,12,12
"24","2020-04-05",98,1,49,308,2278,0.49297629499561,2115,4883,203,272,27,605,12,162,18,12
"25","2020-04-06",107,1,46,319,2278,0.49297629499561,2115,4883,203,272,36,641,10,172,18,10
"26","2020-04-07",113,1,45,327,2278,0.49297629499561,2115,4883,203,272,31,672,3,175,13,3
"27","2020-04-08",120,1,46,324,2278,0.49297629499561,2115,4883,203,272,24,696,7,182,18,7
"28","2020-04-09",116,1,41,329,2278,0.49297629499561,2115,4883,203,272,36,732,3,185,18,3
"29","2020-04-10",127,1,33,339,2278,0.49297629499561,2115,4883,203,272,34,766,1,186,16,1
"30","2020-04-11",134,1,31,352,2278,0.49297629499561,2115,4883,203,272,40,806,2,188,20,2
"31","2020-04-12",123,1,31,359,2278,0.49297629499561,2115,4883,203,272,40,846,4,192,23,4
"32","2020-04-13",111,1,35,350,2278,0.49297629499561,2115,4883,203,272,33,879,7,199,17,7
"33","2020-04-14",103,1,36,359,2278,0.49297629499561,2115,4883,203,272,42,921,4,203,19,4
"34","2020-04-15",102,1,39,359,2278,0.49297629499561,2115,4883,203,272,24,945,11,214,15,11
"35","2020-04-16",106,1,51,361,2278,0.49297629499561,2115,4883,203,272,32,977,15,229,13,15
"36","2020-04-17",107,1,51,358,2278,0.49297629499561,2115,4883,203,272,31,1008,11,240,17,11
"37","2020-04-18",124,1,49,348,2278,0.49297629499561,2115,4883,203,272,22,1030,5,245,12,5
"38","2020-04-19",118,1,47,337,2278,0.49297629499561,2115,4883,203,272,31,1061,8,253,20,8
"39","2020-04-20",121,1,43,342,2278,0.49297629499561,2115,4883,203,272,31,1092,6,259,9,6
"40","2020-04-21",116,1,34,342,2278,0.49297629499561,2115,4883,203,272,30,1122,6,265,20,6
"41","2020-04-22",112,1,38,329,2278,0.49297629499561,2115,4883,203,272,20,1142,6,271,16,6
"42","2020-04-23",108,1,37,320,2278,0.49297629499561,2115,4883,203,272,26,1168,6,277,14,6
"43","2020-04-24",113,1,42,309,2278,0.49297629499561,2115,4883,203,272,22,1190,7,284,12,7
"44","2020-04-25",107,1,55,305,2278,0.49297629499561,2115,4883,203,272,26,1216,18,302,13,18
"45","2020-04-26",96,1,51,299,2278,0.49297629499561,2115,4883,203,272,23,1239,7,309,13,7
"46","2020-04-27",88,1,50,297,2278,0.49297629499561,2115,4883,203,272,31,1270,7,316,17,7
"47","2020-04-28",87,1,43,297,2278,0.49297629499561,2115,4883,203,272,35,1305,4,320,13,4
"48","2020-04-29",86,1,36,300,2278,0.49297629499561,2115,4883,203,272,35,1340,3,323,13,3
"49","2020-04-30",82,1,53,290,2278,0.49297629499561,2115,4883,203,272,25,1365,16,339,11,16
"50","2020-05-01",90,1,64,304,2278,0.49297629499561,2115,4883,203,272,29,1394,15,354,13,15
"51","2020-05-02",86,1,60,305,2278,0.49297629499561,2115,4883,203,272,27,1421,7,361,15,7
"52","2020-05-03",98,1,59,312,2278,0.49297629499561,2115,4883,203,272,32,1453,8,369,11,8
"53","2020-05-04",102,1,55,320,2278,0.49297629499561,2115,4883,203,272,28,1481,9,378,12,9
"54","2020-05-05",96,1,57,320,2278,0.49297629499561,2115,4883,203,272,25,1506,4,382,14,4
"55","2020-05-06",103,1,63,321,2278,0.49297629499561,2115,4883,203,272,25,1531,17,399,9,17
"56","2020-05-07",112,1,70,324,2278,0.49297629499561,2115,4883,203,272,33,1564,15,414,21,15
"57","2020-05-08",104,1,64,320,2278,0.49297629499561,2115,4883,203,272,25,1589,8,422,14,8
"58","2020-05-09",109,1,71,316,2278,0.49297629499561,2115,4883,203,272,24,1613,17,439,11,17
"59","2020-05-10",109,1,78,322,2278,0.49297629499561,2115,4883,203,272,35,1648,8,447,18,8
"60","2020-05-11",108,1,70,320,2278,0.49297629499561,2115,4883,203,272,34,1682,13,460,13,13
"61","2020-05-12",110,1,67,325,2278,0.49297629499561,2115,4883,203,272,30,1712,10,470,12,10
"62","2020-05-13",107,1,66,316,2278,0.49297629499561,2115,4883,203,272,26,1738,10,480,12,10
"63","2020-05-14",100,1,64,319,2278,0.49297629499561,2115,4883,203,272,30,1768,12,492,15,12
"64","2020-05-15",101,1,62,318,2278,0.49297629499561,2115,4883,203,272,28,1796,9,501,17,9
"65","2020-05-16",110,1,70,325,2278,0.49297629499561,2115,4883,203,272,30,1826,18,519,23,18
"66","2020-05-17",112,1,77,312,2278,0.49297629499561,2115,4883,203,272,19,1845,19,538,14,19
"67","2020-05-18",109,1,75,306,2278,0.49297629499561,2115,4883,203,272,20,1865,13,551,14,13
"68","2020-05-19",104,1,67,297,2278,0.49297629499561,2115,4883,203,272,26,1891,10,561,14,10
"69","2020-05-20",103,1,63,294,2278,0.49297629499561,2115,4883,203,272,21,1912,10,571,11,10
"70","2020-05-21",102,1,63,292,2278,0.49297629499561,2115,4883,203,272,24,1936,8,579,15,8
"71","2020-05-22",114,1,63,292,2278,0.49297629499561,2115,4883,203,272,26,1962,7,586,12,7
"72","2020-05-23",101,1,63,279,2278,0.49297629499561,2115,4883,203,272,20,1982,6,592,15,6
"73","2020-05-24",88,1,70,267,2278,0.49297629499561,2115,4883,203,272,15,1997,13,605,7,13
"74","2020-05-25",87,1,71,254,2278,0.49297629499561,2115,4883,203,272,17,2014,10,615,7,10
"75","2020-05-26",85,1,74,245,2278,0.49297629499561,2115,4883,203,272,18,2032,14,629,13,14
"76","2020-05-27",84,1,67,237,2278,0.49297629499561,2115,4883,203,272,19,2051,6,635,10,6
"77","2020-05-28",81,1,55,234,2278,0.49297629499561,2115,4883,203,272,21,2072,3,638,17,3
"78","2020-05-29",85,1,53,216,2278,0.49297629499561,2115,4883,203,272,13,2085,4,642,5,4
"79","2020-05-30",85,1,48,217,2278,0.49297629499561,2115,4883,203,272,20,2105,9,651,8,9
"80","2020-05-31",78,1,51,210,2278,0.49297629499561,2115,4883,203,272,15,2120,8,659,8,8
"81","2020-06-01",75,1,50,197,2278,0.49297629499561,2115,4883,203,272,15,2135,6,665,7,6
"82","2020-06-02",70,1,54,190,2278,0.49297629499561,2115,4883,203,272,12,2147,7,672,10,7
"83","2020-06-03",68,1,59,182,2278,0.49297629499561,2115,4883,203,272,12,2159,12,684,9,12
"84","2020-06-04",74,1,58,174,2278,0.49297629499561,2115,4883,203,272,13,2172,8,692,10,8
"85","2020-06-05",62,1,53,174,2278,0.49297629499561,2115,4883,203,272,13,2185,8,700,8,8
"86","2020-06-06",59,1,52,176,2278,0.49297629499561,2115,4883,203,272,18,2203,8,708,12,8
"87","2020-06-07",52,1,44,169,2278,0.49297629499561,2115,4883,203,272,12,2215,4,712,9,4
"88","2020-03-12",1,2,6,23,3989,0.861368764101278,2055,6700,411,164,13,21,5,6,2,5
"89","2020-03-13",3,2,11,28,3989,0.861368764101278,2055,6700,411,164,13,34,7,13,1,7
"90","2020-03-14",5,2,16,36,3989,0.861368764101278,2055,6700,411,164,7,41,5,18,NA,5
"91","2020-03-15",5,2,17,51,3989,0.861368764101278,2055,6700,411,164,13,54,3,21,3,3
"92","2020-03-16",7,2,17,56,3989,0.861368764101278,2055,6700,411,164,14,68,6,27,1,6
"93","2020-03-17",9,2,18,68,3989,0.861368764101278,2055,6700,411,164,7,75,7,34,2,7
"94","2020-03-18",11,2,16,84,3989,0.861368764101278,2055,6700,411,164,14,89,4,38,5,4
"95","2020-03-19",14,2,9,98,3989,0.861368764101278,2055,6700,411,164,13,102,11,49,4,11
"96","2020-03-20",15,2,17,102,3989,0.861368764101278,2055,6700,411,164,21,123,12,61,12,12
"97","2020-03-21",21,2,19,125,3989,0.861368764101278,2055,6700,411,164,13,136,6,67,7,6
"98","2020-03-22",30,2,22,148,3989,0.861368764101278,2055,6700,411,164,23,159,2,69,14,2
"99","2020-03-23",33,2,23,165,3989,0.861368764101278,2055,6700,411,164,18,177,2,71,7,2
"100","2020-03-24",36,2,23,183,3989,0.861368764101278,2055,6700,411,164,20,197,5,76,14,5
"101","2020-03-25",40,2,23,211,3989,0.861368764101278,2055,6700,411,164,25,222,11,87,12,11
"102","2020-03-26",45,2,25,235,3989,0.861368764101278,2055,6700,411,164,20,242,11,98,12,11
"103","2020-03-27",54,2,20,270,3989,0.861368764101278,2055,6700,411,164,35,277,4,102,25,4
"104","2020-03-28",74,2,19,290,3989,0.861368764101278,2055,6700,411,164,24,301,10,112,18,10
"105","2020-03-29",83,2,24,313,3989,0.861368764101278,2055,6700,411,164,23,324,6,118,12,6
"106","2020-03-30",88,2,22,339,3989,0.861368764101278,2055,6700,411,164,29,353,9,127,22,9
"107","2020-03-31",90,2,20,373,3989,0.861368764101278,2055,6700,411,164,27,380,8,135,16,8
"108","2020-04-01",102,2,20,396,3989,0.861368764101278,2055,6700,411,164,22,402,8,143,11,8
"109","2020-04-02",111,2,22,419,3989,0.861368764101278,2055,6700,411,164,30,432,5,148,19,5
"110","2020-04-03",142,2,20,442,3989,0.861368764101278,2055,6700,411,164,23,455,4,152,14,4
"111","2020-04-04",136,2,25,472,3989,0.861368764101278,2055,6700,411,164,43,498,5,157,24,5
"112","2020-04-05",144,2,32,475,3989,0.861368764101278,2055,6700,411,164,25,523,5,162,15,5
"113","2020-04-06",137,2,31,501,3989,0.861368764101278,2055,6700,411,164,24,547,4,166,17,4
"114","2020-04-07",148,2,33,524,3989,0.861368764101278,2055,6700,411,164,33,580,3,169,21,3
"115","2020-04-08",146,2,35,515,3989,0.861368764101278,2055,6700,411,164,37,617,5,174,24,5
"116","2020-04-09",142,2,40,545,3989,0.861368764101278,2055,6700,411,164,34,651,7,181,25,7
"117","2020-04-10",162,2,37,561,3989,0.861368764101278,2055,6700,411,164,39,690,6,187,26,6
"118","2020-04-11",195,2,36,549,3989,0.861368764101278,2055,6700,411,164,28,718,10,197,24,10
"119","2020-04-12",188,2,38,568,3989,0.861368764101278,2055,6700,411,164,27,745,11,208,18,11
"120","2020-04-13",195,2,39,592,3989,0.861368764101278,2055,6700,411,164,31,776,12,220,15,12
"121","2020-04-14",196,2,37,615,3989,0.861368764101278,2055,6700,411,164,27,803,5,225,16,5
"122","2020-04-15",201,2,36,638,3989,0.861368764101278,2055,6700,411,164,26,829,10,235,22,10
"123","2020-04-16",208,2,36,649,3989,0.861368764101278,2055,6700,411,164,30,859,9,244,20,9
"124","2020-04-17",222,2,41,674,3989,0.861368764101278,2055,6700,411,164,29,888,12,256,15,12
"125","2020-04-18",203,2,44,697,3989,0.861368764101278,2055,6700,411,164,20,908,14,270,12,14
"126","2020-04-19",209,2,48,705,3989,0.861368764101278,2055,6700,411,164,32,940,14,284,25,14
"127","2020-04-20",208,2,34,725,3989,0.861368764101278,2055,6700,411,164,45,985,11,295,24,11
"128","2020-04-21",195,2,33,722,3989,0.861368764101278,2055,6700,411,164,35,1020,13,308,22,13
"129","2020-04-22",200,2,31,751,3989,0.861368764101278,2055,6700,411,164,32,1052,14,322,19,14
"130","2020-04-23",208,2,27,771,3989,0.861368764101278,2055,6700,411,164,37,1089,8,330,27,8
"131","2020-04-24",220,2,34,783,3989,0.861368764101278,2055,6700,411,164,41,1130,10,340,29,10
"132","2020-04-25",239,2,39,796,3989,0.861368764101278,2055,6700,411,164,37,1167,10,350,26,10
"133","2020-04-26",250,2,43,786,3989,0.861368764101278,2055,6700,411,164,41,1208,18,368,30,18
"134","2020-04-27",250,2,49,782,3989,0.861368764101278,2055,6700,411,164,29,1237,16,384,16,16
"135","2020-04-28",255,2,47,797,3989,0.861368764101278,2055,6700,411,164,26,1263,8,392,21,8
"136","2020-04-29",263,2,37,798,3989,0.861368764101278,2055,6700,411,164,54,1317,7,399,38,7
"137","2020-04-30",264,2,40,773,3989,0.861368764101278,2055,6700,411,164,40,1357,8,407,28,8
"138","2020-05-01",298,2,39,780,3989,0.861368764101278,2055,6700,411,164,41,1398,13,420,28,13
"139","2020-05-02",299,2,41,759,3989,0.861368764101278,2055,6700,411,164,31,1429,14,434,15,14
"140","2020-05-03",274,2,37,766,3989,0.861368764101278,2055,6700,411,164,36,1465,9,443,23,9
"141","2020-05-04",279,2,35,776,3989,0.861368764101278,2055,6700,411,164,38,1503,16,459,27,16
"142","2020-05-05",268,2,29,752,3989,0.861368764101278,2055,6700,411,164,40,1543,13,472,28,13
"143","2020-05-06",261,2,29,750,3989,0.861368764101278,2055,6700,411,164,24,1567,16,488,17,16
"144","2020-05-07",265,2,44,754,3989,0.861368764101278,2055,6700,411,164,36,1603,4,492,27,4
"145","2020-05-08",272,2,40,720,3989,0.861368764101278,2055,6700,411,164,25,1628,6,498,20,6
"146","2020-05-09",273,2,45,712,3989,0.861368764101278,2055,6700,411,164,33,1661,13,511,19,13
"147","2020-05-10",251,2,49,694,3989,0.861368764101278,2055,6700,411,164,37,1698,9,520,23,9
"148","2020-05-11",236,2,49,678,3989,0.861368764101278,2055,6700,411,164,29,1727,10,530,16,10
"149","2020-05-12",228,2,52,671,3989,0.861368764101278,2055,6700,411,164,22,1749,12,542,15,12
"150","2020-05-13",214,2,57,638,3989,0.861368764101278,2055,6700,411,164,36,1785,10,552,22,10
"151","2020-05-14",205,2,58,618,3989,0.861368764101278,2055,6700,411,164,33,1818,8,560,19,8
"152","2020-05-15",196,2,58,607,3989,0.861368764101278,2055,6700,411,164,29,1847,7,567,19,7
"153","2020-05-16",206,2,52,585,3989,0.861368764101278,2055,6700,411,164,26,1873,7,574,10,7
"154","2020-05-17",206,2,50,564,3989,0.861368764101278,2055,6700,411,164,30,1903,5,579,17,5
"155","2020-05-18",201,2,41,553,3989,0.861368764101278,2055,6700,411,164,22,1925,15,594,19,15
"156","2020-05-19",195,2,44,552,3989,0.861368764101278,2055,6700,411,164,30,1955,13,607,22,13
"157","2020-05-20",200,2,50,540,3989,0.861368764101278,2055,6700,411,164,21,1976,10,617,13,10
"158","2020-05-21",199,2,53,528,3989,0.861368764101278,2055,6700,411,164,27,2003,24,641,23,24
"159","2020-05-22",196,2,51,504,3989,0.861368764101278,2055,6700,411,164,23,2026,6,647,15,6
"160","2020-05-23",183,2,53,481,3989,0.861368764101278,2055,6700,411,164,24,2050,11,658,14,11
"161","2020-05-24",156,2,58,447,3989,0.861368764101278,2055,6700,411,164,23,2073,10,668,20,10
"162","2020-05-25",153,2,49,406,3989,0.861368764101278,2055,6700,411,164,25,2098,12,680,16,12
"163","2020-05-26",152,2,46,383,3989,0.861368764101278,2055,6700,411,164,23,2121,15,695,17,15
"164","2020-05-27",149,2,48,369,3989,0.861368764101278,2055,6700,411,164,19,2140,19,714,16,19
"165","2020-05-28",139,2,51,362,3989,0.861368764101278,2055,6700,411,164,28,2168,19,733,23,19
"166","2020-05-29",139,2,45,335,3989,0.861368764101278,2055,6700,411,164,21,2189,15,748,18,15
"167","2020-05-30",125,2,40,309,3989,0.861368764101278,2055,6700,411,164,16,2205,20,768,12,20
"168","2020-05-31",123,2,28,288,3989,0.861368764101278,2055,6700,411,164,14,2219,13,781,10,13
"169","2020-06-01",120,2,25,265,3989,0.861368764101278,2055,6700,411,164,16,2235,10,791,12,10
"170","2020-06-02",108,2,23,246,3989,0.861368764101278,2055,6700,411,164,16,2251,10,801,10,10
"171","2020-06-03",103,2,17,229,3989,0.861368764101278,2055,6700,411,164,14,2265,7,808,11,7
"172","2020-06-04",96,2,20,205,3989,0.861368764101278,2055,6700,411,164,17,2282,13,821,13,13
"173","2020-06-05",89,2,19,197,3989,0.861368764101278,2055,6700,411,164,17,2299,19,840,13,19
"174","2020-06-06",88,2,18,181,3989,0.861368764101278,2055,6700,411,164,10,2309,9,849,8,9
"175","2020-06-07",79,2,16,171,3989,0.861368764101278,2055,6700,411,164,16,2325,12,861,8,12
"176","2020-03-13",4,3,48,40,3842,0.748568453930245,2055,6289,403,578,2,12,3,11,1,3
"177","2020-03-14",10,3,57,51,3842,0.748568453930245,2055,6289,403,578,7,19,4,15,5,4
"178","2020-03-15",15,3,60,69,3842,0.748568453930245,2055,6289,403,578,10,29,3,18,6,3
"179","2020-03-16",22,3,66,83,3842,0.748568453930245,2055,6289,403,578,12,41,1,19,9,1
"180","2020-03-17",20,3,68,103,3842,0.748568453930245,2055,6289,403,578,12,53,1,20,10,1
"181","2020-03-18",28,3,75,125,3842,0.748568453930245,2055,6289,403,578,13,66,4,24,13,4
"182","2020-03-19",30,3,81,152,3842,0.748568453930245,2055,6289,403,578,14,80,1,25,7,1
"183","2020-03-20",43,3,91,177,3842,0.748568453930245,2055,6289,403,578,29,109,2,27,21,2
"184","2020-03-21",45,3,103,197,3842,0.748568453930245,2055,6289,403,578,14,123,11,38,12,11
"185","2020-03-22",60,3,107,222,3842,0.748568453930245,2055,6289,403,578,16,139,6,44,14,6
"186","2020-03-23",62,3,100,243,3842,0.748568453930245,2055,6289,403,578,30,169,3,47,27,3
"187","2020-03-24",63,3,104,269,3842,0.748568453930245,2055,6289,403,578,32,201,3,50,25,3
"188","2020-03-25",66,3,100,291,3842,0.748568453930245,2055,6289,403,578,30,231,5,55,24,5
"189","2020-03-26",75,3,101,299,3842,0.748568453930245,2055,6289,403,578,33,264,5,60,30,5
"190","2020-03-27",93,3,113,321,3842,0.748568453930245,2055,6289,403,578,53,317,4,64,50,4
"191","2020-03-28",103,3,114,333,3842,0.748568453930245,2055,6289,403,578,49,366,3,67,46,3
"192","2020-03-29",96,3,120,356,3842,0.748568453930245,2055,6289,403,578,39,405,7,74,36,7
"193","2020-03-30",97,3,119,374,3842,0.748568453930245,2055,6289,403,578,44,449,9,83,41,9
"194","2020-03-31",106,3,123,397,3842,0.748568453930245,2055,6289,403,578,48,497,4,87,46,4
"195","2020-04-01",108,3,108,404,3842,0.748568453930245,2055,6289,403,578,44,541,3,90,40,3
"196","2020-04-02",116,3,111,411,3842,0.748568453930245,2055,6289,403,578,51,592,11,101,47,11
"197","2020-04-03",108,3,116,432,3842,0.748568453930245,2055,6289,403,578,79,671,12,113,77,12
"198","2020-04-04",138,3,137,451,3842,0.748568453930245,2055,6289,403,578,69,740,9,122,68,9
"199","2020-04-05",147,3,145,467,3842,0.748568453930245,2055,6289,403,578,80,820,9,131,76,9
"200","2020-04-06",136,3,144,489,3842,0.748568453930245,2055,6289,403,578,105,925,14,145,103,14
"201","2020-04-07",130,3,155,500,3842,0.748568453930245,2055,6289,403,578,87,1012,18,163,81,18
"202","2020-04-08",137,3,163,508,3842,0.748568453930245,2055,6289,403,578,107,1119,19,182,101,19
"203","2020-04-09",133,3,156,549,3842,0.748568453930245,2055,6289,403,578,97,1216,13,195,92,13
"204","2020-04-10",173,3,156,563,3842,0.748568453930245,2055,6289,403,578,90,1306,10,205,88,10
"205","2020-04-11",174,3,175,575,3842,0.748568453930245,2055,6289,403,578,99,1405,12,217,93,12
"206","2020-04-12",166,3,181,583,3842,0.748568453930245,2055,6289,403,578,132,1537,13,230,131,13
"207","2020-04-13",170,3,184,583,3842,0.748568453930245,2055,6289,403,578,93,1630,12,242,91,12
"208","2020-04-14",175,3,185,602,3842,0.748568453930245,2055,6289,403,578,122,1752,20,262,118,20
"209","2020-04-15",181,3,193,611,3842,0.748568453930245,2055,6289,403,578,121,1873,20,282,117,20
"210","2020-04-16",190,3,182,608,3842,0.748568453930245,2055,6289,403,578,128,2001,15,297,122,15
"211","2020-04-17",202,3,167,631,3842,0.748568453930245,2055,6289,403,578,98,2099,15,312,94,15
"212","2020-04-18",223,3,159,657,3842,0.748568453930245,2055,6289,403,578,107,2206,20,332,103,20
"213","2020-04-19",222,3,164,670,3842,0.748568453930245,2055,6289,403,578,104,2310,15,347,101,15
"214","2020-04-20",214,3,179,678,3842,0.748568453930245,2055,6289,403,578,119,2429,18,365,117,18
"215","2020-04-21",212,3,179,691,3842,0.748568453930245,2055,6289,403,578,139,2568,13,378,135,13
"216","2020-04-22",219,3,177,675,3842,0.748568453930245,2055,6289,403,578,98,2666,11,389,96,11
"217","2020-04-23",220,3,174,682,3842,0.748568453930245,2055,6289,403,578,99,2765,23,412,97,23
"218","2020-04-24",237,3,182,704,3842,0.748568453930245,2055,6289,403,578,130,2895,18,430,126,18
"219","2020-04-25",256,3,209,726,3842,0.748568453930245,2055,6289,403,578,89,2984,15,445,84,15
"220","2020-04-26",247,3,215,755,3842,0.748568453930245,2055,6289,403,578,102,3086,21,466,99,21
"221","2020-04-27",236,3,203,744,3842,0.748568453930245,2055,6289,403,578,95,3181,10,476,93,10
"222","2020-04-28",244,3,200,745,3842,0.748568453930245,2055,6289,403,578,96,3277,13,489,92,13
"223","2020-04-29",236,3,202,738,3842,0.748568453930245,2055,6289,403,578,97,3374,7,496,94,7
"224","2020-04-30",241,3,218,739,3842,0.748568453930245,2055,6289,403,578,86,3460,12,508,82,12
"225","2020-05-01",267,3,216,717,3842,0.748568453930245,2055,6289,403,578,98,3558,10,518,94,10
"226","2020-05-02",243,3,224,704,3842,0.748568453930245,2055,6289,403,578,65,3623,7,525,61,7
"227","2020-05-03",238,3,205,726,3842,0.748568453930245,2055,6289,403,578,52,3675,12,537,50,12
"228","2020-05-04",246,3,218,687,3842,0.748568453930245,2055,6289,403,578,64,3739,18,555,59,18
"229","2020-05-05",235,3,215,675,3842,0.748568453930245,2055,6289,403,578,64,3803,13,568,62,13
"230","2020-05-06",237,3,220,658,3842,0.748568453930245,2055,6289,403,578,54,3857,11,579,52,11
"231","2020-05-07",234,3,228,648,3842,0.748568453930245,2055,6289,403,578,62,3919,17,596,61,17
"232","2020-05-08",240,3,231,648,3842,0.748568453930245,2055,6289,403,578,71,3990,12,608,67,12
"233","2020-05-09",255,3,237,627,3842,0.748568453930245,2055,6289,403,578,49,4039,21,629,45,21
"234","2020-05-10",248,3,236,609,3842,0.748568453930245,2055,6289,403,578,50,4089,18,647,48,18
"235","2020-05-11",235,3,239,600,3842,0.748568453930245,2055,6289,403,578,53,4142,15,662,50,15
"236","2020-05-12",226,3,245,581,3842,0.748568453930245,2055,6289,403,578,38,4180,10,672,36,10
"237","2020-05-13",217,3,244,563,3842,0.748568453930245,2055,6289,403,578,41,4221,18,690,38,18
"238","2020-05-14",209,3,247,548,3842,0.748568453930245,2055,6289,403,578,47,4268,14,704,43,14
"239","2020-05-15",210,3,250,533,3842,0.748568453930245,2055,6289,403,578,32,4300,8,712,31,8
"240","2020-05-16",197,3,241,502,3842,0.748568453930245,2055,6289,403,578,36,4336,22,734,36,22
"241","2020-05-17",157,3,248,495,3842,0.748568453930245,2055,6289,403,578,42,4378,24,758,41,24
"242","2020-05-18",151,3,247,489,3842,0.748568453930245,2055,6289,403,578,31,4409,8,766,28,8
"243","2020-05-19",158,3,242,469,3842,0.748568453930245,2055,6289,403,578,30,4439,11,777,25,11
"244","2020-05-20",157,3,245,455,3842,0.748568453930245,2055,6289,403,578,33,4472,10,787,30,10
"245","2020-05-21",153,3,234,460,3842,0.748568453930245,2055,6289,403,578,25,4497,14,801,23,14
"246","2020-05-22",143,3,229,432,3842,0.748568453930245,2055,6289,403,578,27,4524,11,812,24,11
"247","2020-05-23",148,3,219,426,3842,0.748568453930245,2055,6289,403,578,22,4546,15,827,21,15
"248","2020-05-24",161,3,215,410,3842,0.748568453930245,2055,6289,403,578,21,4567,20,847,20,20
"249","2020-05-25",150,3,195,396,3842,0.748568453930245,2055,6289,403,578,17,4584,16,863,14,16
"250","2020-05-26",138,3,177,383,3842,0.748568453930245,2055,6289,403,578,21,4605,18,881,21,18
"251","2020-05-27",134,3,181,364,3842,0.748568453930245,2055,6289,403,578,24,4629,17,898,21,17
"252","2020-05-28",134,3,177,355,3842,0.748568453930245,2055,6289,403,578,18,4647,25,923,18,25
"253","2020-05-29",133,3,173,335,3842,0.748568453930245,2055,6289,403,578,23,4670,21,944,19,21
"254","2020-05-30",131,3,167,318,3842,0.748568453930245,2055,6289,403,578,12,4682,22,966,12,22
"255","2020-05-31",107,3,164,309,3842,0.748568453930245,2055,6289,403,578,30,4712,15,981,28,15
"256","2020-06-01",107,3,152,290,3842,0.748568453930245,2055,6289,403,578,18,4730,18,999,18,18
"257","2020-06-02",108,3,155,277,3842,0.748568453930245,2055,6289,403,578,19,4749,12,1011,15,12
"258","2020-06-03",102,3,154,262,3842,0.748568453930245,2055,6289,403,578,14,4763,8,1019,14,8
"259","2020-06-04",96,3,151,243,3842,0.748568453930245,2055,6289,403,578,20,4783,15,1034,18,15
"260","2020-06-05",92,3,153,230,3842,0.748568453930245,2055,6289,403,578,15,4798,12,1046,12,12
"261","2020-06-06",84,3,154,223,3842,0.748568453930245,2055,6289,403,578,17,4815,10,1056,15,10
"262","2020-06-07",76,3,151,217,3842,0.748568453930245,2055,6289,403,578,11,4826,10,1066,11,10
"263","2020-03-14",4,4,16,23,3261,0.8721251149954,2040,5564,359,264,14,44,9,36,6,9
"264","2020-03-15",4,4,16,30,3261,0.8721251149954,2040,5564,359,264,14,58,10,46,7,10
"265","2020-03-16",4,4,22,38,3261,0.8721251149954,2040,5564,359,264,13,71,14,60,7,14
"266","2020-03-17",6,4,21,48,3261,0.8721251149954,2040,5564,359,264,22,93,8,68,8,8
"267","2020-03-18",6,4,25,66,3261,0.8721251149954,2040,5564,359,264,29,122,6,74,13,6
"268","2020-03-19",6,4,29,75,3261,0.8721251149954,2040,5564,359,264,19,141,8,82,10,8
"269","2020-03-20",12,4,29,91,3261,0.8721251149954,2040,5564,359,264,33,174,15,97,16,15
"270","2020-03-21",14,4,26,101,3261,0.8721251149954,2040,5564,359,264,20,194,8,105,11,8
"271","2020-03-22",20,4,20,116,3261,0.8721251149954,2040,5564,359,264,26,220,3,108,19,3
"272","2020-03-23",24,4,20,141,3261,0.8721251149954,2040,5564,359,264,30,250,9,117,21,9
"273","2020-03-24",24,4,19,157,3261,0.8721251149954,2040,5564,359,264,35,285,5,122,20,5
"274","2020-03-25",29,4,15,178,3261,0.8721251149954,2040,5564,359,264,31,316,5,127,19,5
"275","2020-03-26",36,4,19,187,3261,0.8721251149954,2040,5564,359,264,28,344,4,131,19,4
"276","2020-03-27",47,4,21,209,3261,0.8721251149954,2040,5564,359,264,33,377,2,133,24,2
"277","2020-03-28",48,4,21,232,3261,0.8721251149954,2040,5564,359,264,30,407,2,135,18,2
"278","2020-03-29",62,4,19,260,3261,0.8721251149954,2040,5564,359,264,37,444,4,139,21,4
"279","2020-03-30",69,4,21,270,3261,0.8721251149954,2040,5564,359,264,26,470,2,141,18,2
"280","2020-03-31",75,4,23,283,3261,0.8721251149954,2040,5564,359,264,25,495,7,148,16,7
"281","2020-04-01",82,4,22,304,3261,0.8721251149954,2040,5564,359,264,40,535,11,159,28,11
"282","2020-04-02",89,4,22,315,3261,0.8721251149954,2040,5564,359,264,38,573,18,177,25,18
"283","2020-04-03",92,4,16,343,3261,0.8721251149954,2040,5564,359,264,33,606,4,181,20,4
"284","2020-04-04",97,4,19,352,3261,0.8721251149954,2040,5564,359,264,34,640,9,190,19,9
"285","2020-04-05",108,4,14,354,3261,0.8721251149954,2040,5564,359,264,24,664,17,207,13,17
"286","2020-04-06",110,4,17,370,3261,0.8721251149954,2040,5564,359,264,36,700,20,227,27,20
"287","2020-04-07",109,4,15,385,3261,0.8721251149954,2040,5564,359,264,42,742,25,252,23,25
"288","2020-04-08",108,4,14,404,3261,0.8721251149954,2040,5564,359,264,36,778,16,268,22,16
"289","2020-04-09",116,4,18,416,3261,0.8721251149954,2040,5564,359,264,39,817,27,295,26,27
"290","2020-04-10",143,4,20,426,3261,0.8721251149954,2040,5564,359,264,41,858,29,324,30,29
"291","2020-04-11",162,4,14,452,3261,0.8721251149954,2040,5564,359,264,49,907,24,348,36,24
"292","2020-04-12",154,4,17,475,3261,0.8721251149954,2040,5564,359,264,52,959,12,360,42,12
"293","2020-04-13",160,4,17,482,3261,0.8721251149954,2040,5564,359,264,42,1001,19,379,34,19
"294","2020-04-14",167,4,22,497,3261,0.8721251149954,2040,5564,359,264,52,1053,7,386,40,7
"295","2020-04-15",173,4,22,510,3261,0.8721251149954,2040,5564,359,264,41,1094,7,393,28,7
"296","2020-04-16",168,4,24,513,3261,0.8721251149954,2040,5564,359,264,46,1140,3,396,34,3
"297","2020-04-17",175,4,29,537,3261,0.8721251149954,2040,5564,359,264,50,1190,4,400,34,4
"298","2020-04-18",179,4,33,551,3261,0.8721251149954,2040,5564,359,264,44,1234,NA,NA,30,NA
"299","2020-04-19",166,4,35,561,3261,0.8721251149954,2040,5564,359,264,39,1273,1,401,28,1
"300","2020-04-20",160,4,35,564,3261,0.8721251149954,2040,5564,359,264,37,1310,8,409,26,8
"301","2020-04-21",152,4,30,577,3261,0.8721251149954,2040,5564,359,264,50,1360,16,425,35,16
"302","2020-04-22",167,4,29,573,3261,0.8721251149954,2040,5564,359,264,31,1391,15,440,19,15
"303","2020-04-23",169,4,41,586,3261,0.8721251149954,2040,5564,359,264,52,1443,20,460,37,20
"304","2020-04-24",190,4,48,588,3261,0.8721251149954,2040,5564,359,264,35,1478,13,473,26,13
"305","2020-04-25",208,4,58,594,3261,0.8721251149954,2040,5564,359,264,40,1518,30,503,25,30
"306","2020-04-26",212,4,60,600,3261,0.8721251149954,2040,5564,359,264,46,1564,32,535,31,32
"307","2020-04-27",210,4,53,587,3261,0.8721251149954,2040,5564,359,264,32,1596,22,557,20,22
"308","2020-04-28",217,4,47,611,3261,0.8721251149954,2040,5564,359,264,35,1631,10,567,23,10
"309","2020-04-29",203,4,44,612,3261,0.8721251149954,2040,5564,359,264,44,1675,30,597,30,30
"310","2020-04-30",204,4,44,601,3261,0.8721251149954,2040,5564,359,264,42,1717,20,617,29,20
"311","2020-05-01",227,4,40,601,3261,0.8721251149954,2040,5564,359,264,52,1769,12,629,32,12
"312","2020-05-02",215,4,39,607,3261,0.8721251149954,2040,5564,359,264,28,1797,20,649,19,20
"313","2020-05-03",211,4,57,605,3261,0.8721251149954,2040,5564,359,264,42,1839,19,668,25,19
"314","2020-05-04",202,4,54,590,3261,0.8721251149954,2040,5564,359,264,47,1886,29,697,29,29
"315","2020-05-05",194,4,61,573,3261,0.8721251149954,2040,5564,359,264,39,1925,11,708,24,11
"316","2020-05-06",196,4,53,587,3261,0.8721251149954,2040,5564,359,264,45,1970,26,734,27,26
"317","2020-05-07",202,4,52,565,3261,0.8721251149954,2040,5564,359,264,56,2026,33,767,40,33
"318","2020-05-08",204,4,55,534,3261,0.8721251149954,2040,5564,359,264,36,2062,15,782,23,15
"319","2020-05-09",207,4,58,517,3261,0.8721251149954,2040,5564,359,264,30,2092,12,794,23,12
"320","2020-05-10",191,4,64,518,3261,0.8721251149954,2040,5564,359,264,32,2124,9,803,22,9
"321","2020-05-11",183,4,59,512,3261,0.8721251149954,2040,5564,359,264,33,2157,8,811,22,8
"322","2020-05-12",170,4,57,516,3261,0.8721251149954,2040,5564,359,264,37,2194,17,828,20,17
"323","2020-05-13",169,4,54,518,3261,0.8721251149954,2040,5564,359,264,27,2221,12,840,15,12
"324","2020-05-14",162,4,55,493,3261,0.8721251149954,2040,5564,359,264,34,2255,35,875,20,35
"325","2020-05-15",154,4,65,496,3261,0.8721251149954,2040,5564,359,264,37,2292,42,917,26,42
"326","2020-05-16",160,4,51,477,3261,0.8721251149954,2040,5564,359,264,32,2324,18,935,21,18
"327","2020-05-17",143,4,54,468,3261,0.8721251149954,2040,5564,359,264,39,2363,20,955,30,20
"328","2020-05-18",143,4,54,438,3261,0.8721251149954,2040,5564,359,264,46,2409,29,984,30,29
"329","2020-05-19",144,4,47,433,3261,0.8721251149954,2040,5564,359,264,27,2436,24,1008,18,24
"330","2020-05-20",143,4,46,435,3261,0.8721251149954,2040,5564,359,264,25,2461,17,1025,21,17
"331","2020-05-21",135,4,51,419,3261,0.8721251149954,2040,5564,359,264,35,2496,12,1037,24,12
"332","2020-05-22",139,4,50,420,3261,0.8721251149954,2040,5564,359,264,24,2520,20,1057,20,20
"333","2020-05-23",133,4,46,417,3261,0.8721251149954,2040,5564,359,264,32,2552,9,1066,29,9
"334","2020-05-24",133,4,41,402,3261,0.8721251149954,2040,5564,359,264,26,2578,6,1072,17,6
"335","2020-05-25",131,4,31,394,3261,0.8721251149954,2040,5564,359,264,25,2603,12,1084,13,12
"336","2020-05-26",128,4,25,377,3261,0.8721251149954,2040,5564,359,264,15,2618,16,1100,7,16
"337","2020-05-27",127,4,22,359,3261,0.8721251149954,2040,5564,359,264,18,2636,18,1118,15,18
"338","2020-05-28",125,4,23,367,3261,0.8721251149954,2040,5564,359,264,28,2664,16,1134,21,16
"339","2020-05-29",133,4,27,351,3261,0.8721251149954,2040,5564,359,264,28,2692,15,1149,20,15
"340","2020-05-30",130,4,31,340,3261,0.8721251149954,2040,5564,359,264,24,2716,21,1170,14,21
"341","2020-05-31",111,4,27,324,3261,0.8721251149954,2040,5564,359,264,21,2737,9,1179,17,9
"342","2020-06-01",108,4,27,320,3261,0.8721251149954,2040,5564,359,264,12,2749,14,1193,7,14
"343","2020-06-02",101,4,27,310,3261,0.8721251149954,2040,5564,359,264,14,2763,16,1209,11,16
"344","2020-06-03",96,4,32,295,3261,0.8721251149954,2040,5564,359,264,25,2788,8,1217,23,8
"345","2020-06-04",101,4,25,271,3261,0.8721251149954,2040,5564,359,264,15,2803,3,1220,8,3
"346","2020-06-05",100,4,20,255,3261,0.8721251149954,2040,5564,359,264,14,2817,9,1229,8,9
"347","2020-06-06",96,4,18,245,3261,0.8721251149954,2040,5564,359,264,11,2828,21,1250,9,21
"348","2020-06-07",89,4,18,238,3261,0.8721251149954,2040,5564,359,264,22,2850,20,1270,17,20
"349","2020-03-07",1,5,0,0,3348,0.815710872162485,1995,5620,374,198,NA,NA,NA,NA,NA,NA
"350","2020-03-08",1,5,0,0,3348,0.815710872162485,1995,5620,374,198,NA,NA,NA,NA,NA,NA
"351","2020-03-09",0,5,0,0,3348,0.815710872162485,1995,5620,374,198,NA,NA,NA,NA,NA,NA
"352","2020-03-10",0,5,0,0,3348,0.815710872162485,1995,5620,374,198,NA,NA,NA,NA,NA,NA
"353","2020-03-11",0,5,0,0,3348,0.815710872162485,1995,5620,374,198,5,5,5,5,NA,5
"354","2020-03-12",0,5,0,0,3348,0.815710872162485,1995,5620,374,198,7,12,6,11,1,6
"355","2020-03-13",1,5,12,15,3348,0.815710872162485,1995,5620,374,198,1,13,3,14,1,3
"356","2020-03-14",2,5,11,18,3348,0.815710872162485,1995,5620,374,198,5,18,4,18,2,4
"357","2020-03-15",1,5,14,26,3348,0.815710872162485,1995,5620,374,198,4,22,4,22,2,4
"358","2020-03-16",2,5,16,33,3348,0.815710872162485,1995,5620,374,198,10,32,6,28,6,6
"359","2020-03-17",4,5,16,44,3348,0.815710872162485,1995,5620,374,198,10,42,2,30,8,2
"360","2020-03-18",7,5,18,51,3348,0.815710872162485,1995,5620,374,198,11,53,3,33,7,3
"361","2020-03-19",8,5,16,56,3348,0.815710872162485,1995,5620,374,198,16,69,7,40,11,7
"362","2020-03-20",11,5,12,60,3348,0.815710872162485,1995,5620,374,198,9,78,4,44,5,4
"363","2020-03-21",11,5,12,70,3348,0.815710872162485,1995,5620,374,198,13,91,5,49,10,5
"364","2020-03-22",21,5,17,82,3348,0.815710872162485,1995,5620,374,198,15,106,6,55,12,6
"365","2020-03-23",22,5,18,92,3348,0.815710872162485,1995,5620,374,198,22,128,9,64,15,9
"366","2020-03-24",22,5,17,104,3348,0.815710872162485,1995,5620,374,198,24,152,12,76,20,12
"367","2020-03-25",22,5,16,124,3348,0.815710872162485,1995,5620,374,198,25,177,10,86,19,10
"368","2020-03-26",26,5,16,136,3348,0.815710872162485,1995,5620,374,198,28,205,9,95,22,9
"369","2020-03-27",35,5,14,161,3348,0.815710872162485,1995,5620,374,198,28,233,9,104,22,9
"370","2020-03-28",47,5,16,184,3348,0.815710872162485,1995,5620,374,198,37,270,8,112,32,8
"371","2020-03-29",54,5,17,205,3348,0.815710872162485,1995,5620,374,198,24,294,14,126,23,14
"372","2020-03-30",52,5,17,225,3348,0.815710872162485,1995,5620,374,198,63,357,8,134,57,8
"373","2020-03-31",51,5,21,256,3348,0.815710872162485,1995,5620,374,198,44,401,16,150,41,16
"374","2020-04-01",55,5,19,283,3348,0.815710872162485,1995,5620,374,198,42,443,15,165,37,15
"375","2020-04-02",59,5,22,305,3348,0.815710872162485,1995,5620,374,198,63,506,12,177,59,12
"376","2020-04-03",74,5,31,321,3348,0.815710872162485,1995,5620,374,198,52,558,25,202,48,25
"377","2020-04-04",90,5,26,349,3348,0.815710872162485,1995,5620,374,198,59,617,21,223,58,21
"378","2020-04-05",94,5,28,387,3348,0.815710872162485,1995,5620,374,198,68,685,16,239,62,16
"379","2020-04-06",100,5,34,399,3348,0.815710872162485,1995,5620,374,198,68,753,6,245,62,6
"380","2020-04-07",108,5,38,421,3348,0.815710872162485,1995,5620,374,198,64,817,15,260,60,15
"381","2020-04-08",122,5,48,443,3348,0.815710872162485,1995,5620,374,198,93,910,3,263,89,3
"382","2020-04-09",132,5,53,460,3348,0.815710872162485,1995,5620,374,198,88,998,7,270,83,7
"383","2020-04-10",150,5,46,472,3348,0.815710872162485,1995,5620,374,198,63,1061,9,279,58,9
"384","2020-04-11",148,5,49,512,3348,0.815710872162485,1995,5620,374,198,88,1149,16,295,84,16
"385","2020-04-12",176,5,41,528,3348,0.815710872162485,1995,5620,374,198,98,1247,17,312,89,17
"386","2020-04-13",184,5,45,535,3348,0.815710872162485,1995,5620,374,198,79,1326,11,323,72,11
"387","2020-04-14",179,5,40,556,3348,0.815710872162485,1995,5620,374,198,101,1427,16,339,90,16
"388","2020-04-15",172,5,46,565,3348,0.815710872162485,1995,5620,374,198,110,1537,17,356,105,17
"389","2020-04-16",168,5,47,568,3348,0.815710872162485,1995,5620,374,198,97,1634,18,374,91,18
"390","2020-04-17",180,5,46,572,3348,0.815710872162485,1995,5620,374,198,126,1760,19,393,124,19
"391","2020-04-18",189,5,45,602,3348,0.815710872162485,1995,5620,374,198,128,1888,14,407,126,14
"392","2020-04-19",181,5,47,607,3348,0.815710872162485,1995,5620,374,198,118,2006,10,417,118,10
"393","2020-04-20",169,5,44,623,3348,0.815710872162485,1995,5620,374,198,126,2132,19,436,122,19
"394","2020-04-21",178,5,43,624,3348,0.815710872162485,1995,5620,374,198,101,2233,18,454,98,18
"395","2020-04-22",188,5,40,635,3348,0.815710872162485,1995,5620,374,198,123,2356,19,473,120,19
"396","2020-04-23",196,5,34,642,3348,0.815710872162485,1995,5620,374,198,114,2470,18,491,114,18
"397","2020-04-24",204,5,30,626,3348,0.815710872162485,1995,5620,374,198,163,2633,14,505,162,14
"398","2020-04-25",208,5,29,630,3348,0.815710872162485,1995,5620,374,198,124,2757,12,517,123,12
"399","2020-04-26",223,5,38,623,3348,0.815710872162485,1995,5620,374,198,132,2889,16,533,130,16
"400","2020-04-27",235,5,36,625,3348,0.815710872162485,1995,5620,374,198,142,3031,20,553,140,20
"401","2020-04-28",218,5,34,629,3348,0.815710872162485,1995,5620,374,198,116,3147,24,577,112,24
"402","2020-04-29",224,5,33,639,3348,0.815710872162485,1995,5620,374,198,141,3288,26,603,138,26
"403","2020-04-30",222,5,38,629,3348,0.815710872162485,1995,5620,374,198,121,3409,39,642,119,39
"404","2020-05-01",236,5,37,605,3348,0.815710872162485,1995,5620,374,198,103,3512,35,677,98,35
"405","2020-05-02",241,5,42,607,3348,0.815710872162485,1995,5620,374,198,121,3633,23,700,116,23
"406","2020-05-03",203,5,50,584,3348,0.815710872162485,1995,5620,374,198,126,3759,15,715,124,15
"407","2020-05-04",193,5,60,584,3348,0.815710872162485,1995,5620,374,198,110,3869,27,742,108,27
"408","2020-05-05",177,5,61,565,3348,0.815710872162485,1995,5620,374,198,87,3956,34,776,82,34
"409","2020-05-06",171,5,57,551,3348,0.815710872162485,1995,5620,374,198,104,4060,27,803,102,27
"410","2020-05-07",165,5,56,560,3348,0.815710872162485,1995,5620,374,198,80,4140,27,830,79,27
"411","2020-05-08",167,5,47,563,3348,0.815710872162485,1995,5620,374,198,69,4209,16,846,67,16
"412","2020-05-09",159,5,45,553,3348,0.815710872162485,1995,5620,374,198,53,4262,14,860,52,14
"413","2020-05-10",172,5,50,549,3348,0.815710872162485,1995,5620,374,198,96,4358,13,873,94,13
"414","2020-05-11",171,5,46,538,3348,0.815710872162485,1995,5620,374,198,70,4428,9,882,68,9
"415","2020-05-12",179,5,56,553,3348,0.815710872162485,1995,5620,374,198,69,4497,25,907,66,25
"416","2020-05-13",171,5,49,542,3348,0.815710872162485,1995,5620,374,198,51,4548,18,925,50,18
"417","2020-05-14",169,5,46,530,3348,0.815710872162485,1995,5620,374,198,37,4585,37,962,37,37
"418","2020-05-15",182,5,51,522,3348,0.815710872162485,1995,5620,374,198,56,4641,20,982,54,20
"419","2020-05-16",197,5,50,522,3348,0.815710872162485,1995,5620,374,198,53,4694,16,998,52,16
"420","2020-05-17",168,5,50,505,3348,0.815710872162485,1995,5620,374,198,40,4734,21,1019,35,21
"421","2020-05-18",161,5,51,522,3348,0.815710872162485,1995,5620,374,198,39,4773,23,1042,38,23
"422","2020-05-19",159,5,56,518,3348,0.815710872162485,1995,5620,374,198,41,4814,25,1067,38,25
"423","2020-05-20",167,5,55,493,3348,0.815710872162485,1995,5620,374,198,34,4848,28,1095,34,28
"424","2020-05-21",167,5,55,465,3348,0.815710872162485,1995,5620,374,198,30,4878,16,1111,26,16
"425","2020-05-22",166,5,64,444,3348,0.815710872162485,1995,5620,374,198,24,4902,22,1133,23,22
"426","2020-05-23",160,5,64,445,3348,0.815710872162485,1995,5620,374,198,24,4926,19,1152,23,19
"427","2020-05-24",167,5,70,438,3348,0.815710872162485,1995,5620,374,198,33,4959,20,1172,31,20
"428","2020-05-25",167,5,72,423,3348,0.815710872162485,1995,5620,374,198,30,4989,19,1191,25,19
"429","2020-05-26",161,5,73,396,3348,0.815710872162485,1995,5620,374,198,17,5006,20,1211,17,20
"430","2020-05-27",149,5,66,380,3348,0.815710872162485,1995,5620,374,198,19,5025,23,1234,16,23
"431","2020-05-28",151,5,67,350,3348,0.815710872162485,1995,5620,374,198,27,5052,30,1264,25,30
"432","2020-05-29",147,5,71,334,3348,0.815710872162485,1995,5620,374,198,12,5064,23,1287,11,23
"433","2020-05-30",138,5,73,316,3348,0.815710872162485,1995,5620,374,198,16,5080,20,1307,15,20
"434","2020-05-31",120,5,69,294,3348,0.815710872162485,1995,5620,374,198,10,5090,19,1326,8,19
"435","2020-06-01",107,5,59,288,3348,0.815710872162485,1995,5620,374,198,19,5109,20,1346,19,20
"436","2020-06-02",104,5,54,269,3348,0.815710872162485,1995,5620,374,198,3,5112,18,1364,3,18
"437","2020-06-03",102,5,54,248,3348,0.815710872162485,1995,5620,374,198,13,5125,10,1374,11,10
"438","2020-06-04",98,5,54,229,3348,0.815710872162485,1995,5620,374,198,6,5131,9,1383,6,9
"439","2020-06-05",85,5,47,224,3348,0.815710872162485,1995,5620,374,198,10,5141,11,1394,10,11
"440","2020-06-06",79,5,46,209,3348,0.815710872162485,1995,5620,374,198,14,5155,14,1408,13,14
"441","2020-06-07",73,5,40,192,3348,0.815710872162485,1995,5620,374,198,11,5166,6,1414,11,6
"442","2020-03-07",2,6,0,0,2831,0.841752031084422,1950,4806,316,361,NA,NA,NA,NA,NA,NA
"443","2020-03-08",3,6,0,0,2831,0.841752031084422,1950,4806,316,361,NA,NA,NA,NA,NA,NA
"444","2020-03-09",1,6,0,0,2831,0.841752031084422,1950,4806,316,361,NA,NA,NA,NA,NA,NA
"445","2020-03-10",0,6,0,0,2831,0.841752031084422,1950,4806,316,361,NA,NA,NA,NA,NA,NA
"446","2020-03-11",0,6,0,0,2831,0.841752031084422,1950,4806,316,361,2,2,7,7,NA,7
"447","2020-03-12",0,6,0,0,2831,0.841752031084422,1950,4806,316,361,8,10,3,10,NA,3
"448","2020-03-13",3,6,16,18,2831,0.841752031084422,1950,4806,316,361,4,14,NA,NA,1,NA
"449","2020-03-14",4,6,11,27,2831,0.841752031084422,1950,4806,316,361,3,17,1,11,NA,1
"450","2020-03-15",1,6,14,34,2831,0.841752031084422,1950,4806,316,361,9,26,3,14,4,3
"451","2020-03-16",3,6,17,43,2831,0.841752031084422,1950,4806,316,361,5,31,4,18,1,4
"452","2020-03-17",4,6,30,55,2831,0.841752031084422,1950,4806,316,361,10,41,8,26,2,8
"453","2020-03-18",6,6,42,70,2831,0.841752031084422,1950,4806,316,361,14,55,3,29,6,3
"454","2020-03-19",8,6,45,88,2831,0.841752031084422,1950,4806,316,361,23,78,8,37,16,8
"455","2020-03-20",16,6,49,104,2831,0.841752031084422,1950,4806,316,361,20,98,9,46,14,9
"456","2020-03-21",24,6,51,123,2831,0.841752031084422,1950,4806,316,361,13,111,6,52,8,6
"457","2020-03-22",29,6,57,140,2831,0.841752031084422,1950,4806,316,361,13,124,6,58,8,6
"458","2020-03-23",30,6,59,158,2831,0.841752031084422,1950,4806,316,361,24,148,11,69,16,11
"459","2020-03-24",32,6,61,177,2831,0.841752031084422,1950,4806,316,361,17,165,8,77,9,8
"460","2020-03-25",36,6,70,193,2831,0.841752031084422,1950,4806,316,361,22,187,16,93,16,16
"461","2020-03-26",39,6,78,204,2831,0.841752031084422,1950,4806,316,361,21,208,2,95,15,2
"462","2020-03-27",43,6,69,219,2831,0.841752031084422,1950,4806,316,361,30,238,3,98,20,3
"463","2020-03-28",47,6,63,239,2831,0.841752031084422,1950,4806,316,361,29,267,4,102,21,4
"464","2020-03-29",52,6,56,266,2831,0.841752031084422,1950,4806,316,361,28,295,14,116,19,14
"465","2020-03-30",59,6,59,282,2831,0.841752031084422,1950,4806,316,361,38,333,7,123,31,7
"466","2020-03-31",72,6,49,305,2831,0.841752031084422,1950,4806,316,361,30,363,9,132,27,9
"467","2020-04-01",79,6,59,320,2831,0.841752031084422,1950,4806,316,361,43,406,10,142,36,10
"468","2020-04-02",89,6,61,337,2831,0.841752031084422,1950,4806,316,361,28,434,11,153,23,11
"469","2020-04-03",104,6,70,357,2831,0.841752031084422,1950,4806,316,361,40,474,12,165,30,12
"470","2020-04-04",109,6,62,388,2831,0.841752031084422,1950,4806,316,361,54,528,5,170,46,5
"471","2020-04-05",118,6,58,397,2831,0.841752031084422,1950,4806,316,361,57,585,6,176,51,6
"472","2020-04-06",124,6,65,415,2831,0.841752031084422,1950,4806,316,361,63,648,3,179,51,3
"473","2020-04-07",127,6,78,426,2831,0.841752031084422,1950,4806,316,361,60,708,12,191,53,12
"474","2020-04-08",131,6,75,423,2831,0.841752031084422,1950,4806,316,361,56,764,8,199,49,8
"475","2020-04-09",133,6,59,418,2831,0.841752031084422,1950,4806,316,361,51,815,9,208,41,9
"476","2020-04-10",137,6,59,423,2831,0.841752031084422,1950,4806,316,361,77,892,5,213,71,5
"477","2020-04-11",162,6,66,426,2831,0.841752031084422,1950,4806,316,361,71,963,13,226,60,13
"478","2020-04-12",148,6,57,433,2831,0.841752031084422,1950,4806,316,361,42,1005,23,249,38,23
"479","2020-04-13",138,6,45,443,2831,0.841752031084422,1950,4806,316,361,67,1072,17,266,55,17
"480","2020-04-14",139,6,47,437,2831,0.841752031084422,1950,4806,316,361,68,1140,10,276,56,10
"481","2020-04-15",139,6,61,433,2831,0.841752031084422,1950,4806,316,361,60,1200,13,289,53,13
"482","2020-04-16",141,6,60,429,2831,0.841752031084422,1950,4806,316,361,82,1282,16,305,74,16
"483","2020-04-17",158,6,71,421,2831,0.841752031084422,1950,4806,316,361,66,1348,19,324,59,19
"484","2020-04-18",137,6,86,430,2831,0.841752031084422,1950,4806,316,361,75,1423,13,337,67,13
"485","2020-04-19",138,6,92,433,2831,0.841752031084422,1950,4806,316,361,74,1497,18,355,64,18
"486","2020-04-20",141,6,98,441,2831,0.841752031084422,1950,4806,316,361,78,1575,12,367,69,12
"487","2020-04-21",141,6,79,463,2831,0.841752031084422,1950,4806,316,361,65,1640,22,389,60,22
"488","2020-04-22",139,6,102,458,2831,0.841752031084422,1950,4806,316,361,70,1710,21,410,59,21
"489","2020-04-23",131,6,117,476,2831,0.841752031084422,1950,4806,316,361,72,1782,15,425,67,15
"490","2020-04-24",145,6,121,484,2831,0.841752031084422,1950,4806,316,361,56,1838,24,449,51,24
"491","2020-04-25",174,6,108,477,2831,0.841752031084422,1950,4806,316,361,78,1916,25,474,70,25
"492","2020-04-26",164,6,103,487,2831,0.841752031084422,1950,4806,316,361,54,1970,26,500,40,26
"493","2020-04-27",160,6,102,498,2831,0.841752031084422,1950,4806,316,361,77,2047,29,529,71,29
"494","2020-04-28",157,6,109,494,2831,0.841752031084422,1950,4806,316,361,59,2106,17,546,54,17
"495","2020-04-29",151,6,119,485,2831,0.841752031084422,1950,4806,316,361,69,2175,17,563,58,17
"496","2020-04-30",166,6,116,479,2831,0.841752031084422,1950,4806,316,361,60,2235,24,587,48,24
"497","2020-05-01",166,6,111,485,2831,0.841752031084422,1950,4806,316,361,71,2306,15,602,61,15
"498","2020-05-02",155,6,88,485,2831,0.841752031084422,1950,4806,316,361,64,2370,19,621,53,19
"499","2020-05-03",149,6,77,495,2831,0.841752031084422,1950,4806,316,361,65,2435,6,627,54,6
"500","2020-05-04",148,6,74,487,2831,0.841752031084422,1950,4806,316,361,53,2488,14,641,43,14
"501","2020-05-05",149,6,68,478,2831,0.841752031084422,1950,4806,316,361,66,2554,6,647,55,6
"502","2020-05-06",160,6,60,468,2831,0.841752031084422,1950,4806,316,361,55,2609,14,661,45,14
"503","2020-05-07",153,6,62,460,2831,0.841752031084422,1950,4806,316,361,41,2650,9,670,39,9
"504","2020-05-08",155,6,61,458,2831,0.841752031084422,1950,4806,316,361,50,2700,17,687,44,17
"505","2020-05-09",154,6,69,458,2831,0.841752031084422,1950,4806,316,361,47,2747,8,695,43,8
"506","2020-05-10",158,6,59,453,2831,0.841752031084422,1950,4806,316,361,63,2810,13,708,54,13
"507","2020-05-11",158,6,55,441,2831,0.841752031084422,1950,4806,316,361,49,2859,7,715,45,7
"508","2020-05-12",149,6,53,424,2831,0.841752031084422,1950,4806,316,361,51,2910,15,730,46,15
"509","2020-05-13",145,6,46,420,2831,0.841752031084422,1950,4806,316,361,38,2948,6,736,32,6
"510","2020-05-14",142,6,54,407,2831,0.841752031084422,1950,4806,316,361,51,2999,19,755,44,19
"511","2020-05-15",145,6,51,395,2831,0.841752031084422,1950,4806,316,361,49,3048,11,766,43,11
"512","2020-05-16",137,6,47,381,2831,0.841752031084422,1950,4806,316,361,39,3087,17,783,31,17
"513","2020-05-17",141,6,44,367,2831,0.841752031084422,1950,4806,316,361,34,3121,10,793,30,10
"514","2020-05-18",137,6,46,354,2831,0.841752031084422,1950,4806,316,361,37,3158,21,814,28,21
"515","2020-05-19",129,6,52,347,2831,0.841752031084422,1950,4806,316,361,32,3190,17,831,28,17
"516","2020-05-20",127,6,42,347,2831,0.841752031084422,1950,4806,316,361,33,3223,15,846,26,15
"517","2020-05-21",122,6,33,334,2831,0.841752031084422,1950,4806,316,361,51,3274,20,866,46,20
"518","2020-05-22",131,6,43,327,2831,0.841752031084422,1950,4806,316,361,33,3307,21,887,27,21
"519","2020-05-23",136,6,49,300,2831,0.841752031084422,1950,4806,316,361,33,3340,20,907,30,20
"520","2020-05-24",119,6,67,319,2831,0.841752031084422,1950,4806,316,361,29,3369,13,920,26,13
"521","2020-05-25",117,6,61,302,2831,0.841752031084422,1950,4806,316,361,25,3394,8,928,24,8
"522","2020-05-26",112,6,64,296,2831,0.841752031084422,1950,4806,316,361,28,3422,7,935,27,7
"523","2020-05-27",112,6,71,283,2831,0.841752031084422,1950,4806,316,361,33,3455,9,944,30,9
"524","2020-05-28",111,6,71,273,2831,0.841752031084422,1950,4806,316,361,28,3483,10,954,27,10
"525","2020-05-29",103,6,74,260,2831,0.841752031084422,1950,4806,316,361,24,3507,7,961,21,7
"526","2020-05-30",93,6,64,245,2831,0.841752031084422,1950,4806,316,361,23,3530,1,962,21,1
"527","2020-05-31",91,6,63,241,2831,0.841752031084422,1950,4806,316,361,26,3556,6,968,23,6
"528","2020-06-01",85,6,61,240,2831,0.841752031084422,1950,4806,316,361,21,3577,7,975,20,7
"529","2020-06-02",76,6,55,231,2831,0.841752031084422,1950,4806,316,361,20,3597,4,979,18,4
"530","2020-06-03",68,6,45,225,2831,0.841752031084422,1950,4806,316,361,23,3620,17,996,21,17
"531","2020-06-04",65,6,38,214,2831,0.841752031084422,1950,4806,316,361,21,3641,14,1010,20,14
"532","2020-06-05",60,6,39,207,2831,0.841752031084422,1950,4806,316,361,17,3658,4,1014,13,4
"533","2020-06-06",64,6,41,197,2831,0.841752031084422,1950,4806,316,361,19,3677,3,1017,14,3
"534","2020-06-07",54,6,35,200,2831,0.841752031084422,1950,4806,316,361,22,3699,9,1026,18,9
"535","2020-03-07",1,7,0,0,2486,0.539018503620273,2040,5184,257,150,NA,NA,NA,NA,NA,NA
"536","2020-03-08",1,7,0,0,2486,0.539018503620273,2040,5184,257,150,NA,NA,NA,NA,NA,NA
"537","2020-03-09",0,7,0,0,2486,0.539018503620273,2040,5184,257,150,NA,NA,NA,NA,NA,NA
"538","2020-03-10",0,7,0,0,2486,0.539018503620273,2040,5184,257,150,NA,NA,NA,NA,NA,NA
"539","2020-03-11",0,7,0,0,2486,0.539018503620273,2040,5184,257,150,2,2,7,7,NA,7
"540","2020-03-12",0,7,0,0,2486,0.539018503620273,2040,5184,257,150,1,3,4,11,NA,4
"541","2020-03-13",0,7,0,0,2486,0.539018503620273,2040,5184,257,150,7,10,9,20,2,9
"542","2020-03-14",1,7,14,57,2486,0.539018503620273,2040,5184,257,150,6,16,12,32,3,12
"543","2020-03-15",4,7,21,71,2486,0.539018503620273,2040,5184,257,150,4,20,12,44,2,12
"544","2020-03-16",7,7,17,90,2486,0.539018503620273,2040,5184,257,150,7,27,9,53,3,9
"545","2020-03-17",10,7,20,105,2486,0.539018503620273,2040,5184,257,150,9,36,9,62,4,9
"546","2020-03-18",14,7,27,121,2486,0.539018503620273,2040,5184,257,150,8,44,11,73,5,11
"547","2020-03-19",20,7,30,139,2486,0.539018503620273,2040,5184,257,150,11,55,19,92,8,19
"548","2020-03-20",32,7,29,159,2486,0.539018503620273,2040,5184,257,150,12,67,6,98,8,6
"549","2020-03-21",40,7,30,179,2486,0.539018503620273,2040,5184,257,150,14,81,10,108,11,10
"550","2020-03-22",53,7,33,193,2486,0.539018503620273,2040,5184,257,150,9,90,3,111,7,3
"551","2020-03-23",57,7,36,214,2486,0.539018503620273,2040,5184,257,150,21,111,2,113,19,2
"552","2020-03-24",60,7,31,223,2486,0.539018503620273,2040,5184,257,150,24,135,9,122,22,9
"553","2020-03-25",63,7,28,224,2486,0.539018503620273,2040,5184,257,150,19,154,4,126,18,4
"554","2020-03-26",68,7,26,243,2486,0.539018503620273,2040,5184,257,150,24,178,12,138,18,12
"555","2020-03-27",68,7,26,262,2486,0.539018503620273,2040,5184,257,150,22,200,12,150,21,12
"556","2020-03-28",71,7,29,272,2486,0.539018503620273,2040,5184,257,150,31,231,14,164,28,14
"557","2020-03-29",71,7,32,285,2486,0.539018503620273,2040,5184,257,150,28,259,13,177,25,13
"558","2020-03-30",78,7,34,302,2486,0.539018503620273,2040,5184,257,150,25,284,12,189,25,12
"559","2020-03-31",80,7,39,307,2486,0.539018503620273,2040,5184,257,150,27,311,20,209,26,20
"560","2020-04-01",82,7,44,319,2486,0.539018503620273,2040,5184,257,150,41,352,9,218,36,9
"561","2020-04-02",91,7,42,323,2486,0.539018503620273,2040,5184,257,150,49,401,14,232,43,14
"562","2020-04-03",104,7,38,351,2486,0.539018503620273,2040,5184,257,150,37,438,18,250,30,18
"563","2020-04-04",128,7,35,362,2486,0.539018503620273,2040,5184,257,150,33,471,20,270,28,20
"564","2020-04-05",119,7,32,378,2486,0.539018503620273,2040,5184,257,150,60,531,12,282,53,12
"565","2020-04-06",117,7,33,383,2486,0.539018503620273,2040,5184,257,150,51,582,13,295,47,13
"566","2020-04-07",117,7,31,386,2486,0.539018503620273,2040,5184,257,150,58,640,11,306,52,11
"567","2020-04-08",126,7,37,387,2486,0.539018503620273,2040,5184,257,150,57,697,7,313,53,7
"568","2020-04-09",118,7,31,391,2486,0.539018503620273,2040,5184,257,150,67,764,5,318,61,5
"569","2020-04-10",142,7,38,372,2486,0.539018503620273,2040,5184,257,150,60,824,6,324,49,6
"570","2020-04-11",140,7,40,373,2486,0.539018503620273,2040,5184,257,150,60,884,14,338,50,14
"571","2020-04-12",151,7,42,376,2486,0.539018503620273,2040,5184,257,150,81,965,16,354,75,16
"572","2020-04-13",140,7,48,381,2486,0.539018503620273,2040,5184,257,150,78,1043,10,364,76,10
"573","2020-04-14",140,7,43,391,2486,0.539018503620273,2040,5184,257,150,77,1120,6,370,70,6
"574","2020-04-15",134,7,36,389,2486,0.539018503620273,2040,5184,257,150,70,1190,6,376,66,6
"575","2020-04-16",140,7,34,386,2486,0.539018503620273,2040,5184,257,150,95,1285,4,380,92,4
"576","2020-04-17",136,7,44,380,2486,0.539018503620273,2040,5184,257,150,94,1379,5,385,87,5
"577","2020-04-18",139,7,52,375,2486,0.539018503620273,2040,5184,257,150,92,1471,3,388,89,3
"578","2020-04-19",127,7,55,392,2486,0.539018503620273,2040,5184,257,150,93,1564,18,406,90,18
"579","2020-04-20",134,7,51,407,2486,0.539018503620273,2040,5184,257,150,100,1664,29,435,95,29
"580","2020-04-21",128,7,47,400,2486,0.539018503620273,2040,5184,257,150,103,1767,10,445,99,11
"581","2020-04-22",131,7,49,409,2486,0.539018503620273,2040,5184,257,150,92,1859,23,468,88,23
"582","2020-04-23",131,7,43,416,2486,0.539018503620273,2040,5184,257,150,103,1962,18,486,101,18
"583","2020-04-24",135,7,52,403,2486,0.539018503620273,2040,5184,257,150,133,2095,15,501,126,15
"584","2020-04-25",123,7,39,405,2486,0.539018503620273,2040,5184,257,150,118,2213,16,517,114,16
"585","2020-04-26",147,7,35,409,2486,0.539018503620273,2040,5184,257,150,84,2297,8,525,82,8
"586","2020-04-27",140,7,36,415,2486,0.539018503620273,2040,5184,257,150,118,2415,12,537,113,12
"587","2020-04-28",140,7,32,406,2486,0.539018503620273,2040,5184,257,150,123,2538,27,564,117,27
"588","2020-04-29",142,7,39,402,2486,0.539018503620273,2040,5184,257,150,91,2629,25,589,91,25
"589","2020-04-30",141,7,36,392,2486,0.539018503620273,2040,5184,257,150,99,2728,6,595,95,6
"590","2020-05-01",150,7,40,396,2486,0.539018503620273,2040,5184,257,150,115,2843,17,612,109,17
"591","2020-05-02",157,7,46,391,2486,0.539018503620273,2040,5184,257,150,110,2953,20,632,105,20
"592","2020-05-03",142,7,44,394,2486,0.539018503620273,2040,5184,257,150,86,3039,8,640,82,8
"593","2020-05-04",140,7,40,395,2486,0.539018503620273,2040,5184,257,150,83,3122,13,653,80,13
"594","2020-05-05",135,7,42,388,2486,0.539018503620273,2040,5184,257,150,83,3205,3,656,80,3
"595","2020-05-06",132,7,50,387,2486,0.539018503620273,2040,5184,257,150,89,3294,22,678,87,22
"596","2020-05-07",123,7,47,371,2486,0.539018503620273,2040,5184,257,150,101,3395,13,691,100,13
"597","2020-05-08",131,7,55,375,2486,0.539018503620273,2040,5184,257,150,88,3483,20,711,86,20
"598","2020-05-09",136,7,57,355,2486,0.539018503620273,2040,5184,257,150,92,3575,15,726,92,15
"599","2020-05-10",118,7,54,361,2486,0.539018503620273,2040,5184,257,150,73,3648,22,748,72,22
"600","2020-05-11",117,7,48,345,2486,0.539018503620273,2040,5184,257,150,72,3720,13,761,69,13
"601","2020-05-12",115,7,58,343,2486,0.539018503620273,2040,5184,257,150,63,3783,6,767,53,6
"602","2020-05-13",117,7,54,338,2486,0.539018503620273,2040,5184,257,150,73,3856,11,778,72,11
"603","2020-05-14",119,7,58,322,2486,0.539018503620273,2040,5184,257,150,65,3921,4,782,60,4
"604","2020-05-15",110,7,54,306,2486,0.539018503620273,2040,5184,257,150,56,3977,7,789,53,7
"605","2020-05-16",104,7,52,297,2486,0.539018503620273,2040,5184,257,150,56,4033,3,792,55,3
"606","2020-05-17",102,7,58,280,2486,0.539018503620273,2040,5184,257,150,56,4089,12,804,52,12
"607","2020-05-18",97,7,52,271,2486,0.539018503620273,2040,5184,257,150,39,4128,15,819,37,15
"608","2020-05-19",90,7,49,272,2486,0.539018503620273,2040,5184,257,150,43,4171,9,828,39,9
"609","2020-05-20",80,7,51,261,2486,0.539018503620273,2040,5184,257,150,36,4207,9,837,35,9
"610","2020-05-21",78,7,55,264,2486,0.539018503620273,2040,5184,257,150,35,4242,18,855,32,18
"611","2020-05-22",71,7,60,267,2486,0.539018503620273,2040,5184,257,150,35,4277,16,871,33,16
"612","2020-05-23",72,7,59,266,2486,0.539018503620273,2040,5184,257,150,28,4305,21,892,27,21
"613","2020-05-24",61,7,53,268,2486,0.539018503620273,2040,5184,257,150,26,4331,16,908,25,16
"614","2020-05-25",64,7,54,270,2486,0.539018503620273,2040,5184,257,150,35,4366,6,914,33,6
"615","2020-05-26",58,7,55,265,2486,0.539018503620273,2040,5184,257,150,27,4393,10,924,27,10
"616","2020-05-27",61,7,50,250,2486,0.539018503620273,2040,5184,257,150,22,4415,15,939,21,15
"617","2020-05-28",60,7,51,239,2486,0.539018503620273,2040,5184,257,150,21,4436,13,952,18,13
"618","2020-05-29",72,7,41,232,2486,0.539018503620273,2040,5184,257,150,22,4458,14,966,20,14
"619","2020-05-30",73,7,43,222,2486,0.539018503620273,2040,5184,257,150,31,4489,14,980,29,14
"620","2020-05-31",75,7,40,214,2486,0.539018503620273,2040,5184,257,150,16,4505,5,985,14,5
"621","2020-06-01",69,7,32,199,2486,0.539018503620273,2040,5184,257,150,15,4520,6,991,15,6
"622","2020-06-02",81,7,34,190,2486,0.539018503620273,2040,5184,257,150,14,4534,14,1005,14,14
"623","2020-06-03",76,7,32,183,2486,0.539018503620273,2040,5184,257,150,14,4548,5,1010,14,5
"624","2020-06-04",74,7,29,174,2486,0.539018503620273,2040,5184,257,150,10,4558,9,1019,9,9
"625","2020-06-05",74,7,28,161,2486,0.539018503620273,2040,5184,257,150,13,4571,11,1030,13,11
"626","2020-06-06",69,7,27,160,2486,0.539018503620273,2040,5184,257,150,16,4587,3,1033,16,3
"627","2020-06-07",59,7,24,144,2486,0.539018503620273,2040,5184,257,150,7,4594,6,1039,7,6
"628","2020-03-14",5,8,38,41,3454,0.776491024898668,2085,6379,326,446,6,31,1,7,1,1
"629","2020-03-15",6,8,39,53,3454,0.776491024898668,2085,6379,326,446,3,34,1,8,NA,1
"630","2020-03-16",7,8,43,66,3454,0.776491024898668,2085,6379,326,446,14,48,1,9,5,1
"631","2020-03-17",8,8,57,82,3454,0.776491024898668,2085,6379,326,446,9,57,3,12,6,3
"632","2020-03-18",12,8,51,99,3454,0.776491024898668,2085,6379,326,446,7,64,3,15,3,3
"633","2020-03-19",15,8,51,121,3454,0.776491024898668,2085,6379,326,446,18,82,2,17,7,2
"634","2020-03-20",24,8,54,143,3454,0.776491024898668,2085,6379,326,446,11,93,NA,NA,3,NA
"635","2020-03-21",32,8,55,162,3454,0.776491024898668,2085,6379,326,446,13,106,1,18,8,1
"636","2020-03-22",32,8,59,177,3454,0.776491024898668,2085,6379,326,446,7,113,4,22,4,4
"637","2020-03-23",38,8,68,193,3454,0.776491024898668,2085,6379,326,446,8,121,1,23,6,1
"638","2020-03-24",45,8,70,206,3454,0.776491024898668,2085,6379,326,446,10,131,5,28,4,5
"639","2020-03-25",51,8,76,224,3454,0.776491024898668,2085,6379,326,446,14,145,2,30,7,2
"640","2020-03-26",58,8,78,238,3454,0.776491024898668,2085,6379,326,446,21,166,7,37,13,7
"641","2020-03-27",74,8,89,272,3454,0.776491024898668,2085,6379,326,446,12,178,3,40,5,3
"642","2020-03-28",82,8,93,299,3454,0.776491024898668,2085,6379,326,446,12,190,4,44,8,4
"643","2020-03-29",98,8,104,314,3454,0.776491024898668,2085,6379,326,446,14,204,2,46,11,2
"644","2020-03-30",103,8,95,350,3454,0.776491024898668,2085,6379,326,446,17,221,4,50,11,4
"645","2020-03-31",109,8,98,359,3454,0.776491024898668,2085,6379,326,446,20,241,10,60,13,10
"646","2020-04-01",108,8,107,384,3454,0.776491024898668,2085,6379,326,446,28,269,7,67,18,7
"647","2020-04-02",111,8,122,398,3454,0.776491024898668,2085,6379,326,446,23,292,8,75,11,8
"648","2020-04-03",134,8,160,416,3454,0.776491024898668,2085,6379,326,446,13,305,4,79,9,4
"649","2020-04-04",136,8,167,436,3454,0.776491024898668,2085,6379,326,446,33,338,5,84,17,5
"650","2020-04-05",141,8,177,467,3454,0.776491024898668,2085,6379,326,446,23,361,1,85,17,1
"651","2020-04-06",135,8,169,468,3454,0.776491024898668,2085,6379,326,446,36,397,4,89,24,4
"652","2020-04-07",136,8,171,501,3454,0.776491024898668,2085,6379,326,446,23,420,6,95,14,6
"653","2020-04-08",142,8,170,517,3454,0.776491024898668,2085,6379,326,446,23,443,15,110,16,15
"654","2020-04-09",143,8,166,541,3454,0.776491024898668,2085,6379,326,446,33,476,6,116,24,6
"655","2020-04-10",168,8,142,552,3454,0.776491024898668,2085,6379,326,446,35,511,8,124,29,8
"656","2020-04-11",177,8,147,567,3454,0.776491024898668,2085,6379,326,446,36,547,7,131,26,7
"657","2020-04-12",179,8,151,580,3454,0.776491024898668,2085,6379,326,446,28,575,13,144,22,13
"658","2020-04-13",187,8,172,588,3454,0.776491024898668,2085,6379,326,446,32,607,16,160,23,16
"659","2020-04-14",184,8,180,599,3454,0.776491024898668,2085,6379,326,446,46,653,11,171,34,11
"660","2020-04-15",190,8,186,607,3454,0.776491024898668,2085,6379,326,446,28,681,14,185,21,14
"661","2020-04-16",197,8,168,617,3454,0.776491024898668,2085,6379,326,446,37,718,16,201,21,16
"662","2020-04-17",200,8,157,609,3454,0.776491024898668,2085,6379,326,446,27,745,25,226,19,25
"663","2020-04-18",210,8,155,610,3454,0.776491024898668,2085,6379,326,446,32,777,14,240,21,14
"664","2020-04-19",194,8,154,634,3454,0.776491024898668,2085,6379,326,446,45,822,12,252,32,12
"665","2020-04-20",189,8,139,645,3454,0.776491024898668,2085,6379,326,446,35,857,8,260,25,8
"666","2020-04-21",185,8,137,642,3454,0.776491024898668,2085,6379,326,446,36,893,9,269,25,9
"667","2020-04-22",190,8,129,663,3454,0.776491024898668,2085,6379,326,446,39,932,9,278,28,9
"668","2020-04-23",183,8,125,677,3454,0.776491024898668,2085,6379,326,446,38,970,5,283,31,5
"669","2020-04-24",202,8,111,683,3454,0.776491024898668,2085,6379,326,446,32,1002,5,288,26,5
"670","2020-04-25",226,8,113,702,3454,0.776491024898668,2085,6379,326,446,31,1033,5,293,23,5
"671","2020-04-26",227,8,123,716,3454,0.776491024898668,2085,6379,326,446,35,1068,13,306,25,13
"672","2020-04-27",219,8,122,704,3454,0.776491024898668,2085,6379,326,446,30,1098,9,315,18,9
"673","2020-04-28",216,8,122,703,3454,0.776491024898668,2085,6379,326,446,28,1126,15,330,23,15
"674","2020-04-29",214,8,132,685,3454,0.776491024898668,2085,6379,326,446,34,1160,20,350,24,20
"675","2020-04-30",229,8,138,663,3454,0.776491024898668,2085,6379,326,446,41,1201,10,360,31,10
"676","2020-05-01",244,8,127,647,3454,0.776491024898668,2085,6379,326,446,31,1232,13,373,22,13
"677","2020-05-02",262,8,128,641,3454,0.776491024898668,2085,6379,326,446,50,1282,9,382,34,9
"678","2020-05-03",246,8,127,652,3454,0.776491024898668,2085,6379,326,446,21,1303,16,398,19,16
"679","2020-05-04",226,8,129,627,3454,0.776491024898668,2085,6379,326,446,34,1337,16,414,22,16
"680","2020-05-05",234,8,138,607,3454,0.776491024898668,2085,6379,326,446,35,1372,7,421,24,7
"681","2020-05-06",231,8,135,562,3454,0.776491024898668,2085,6379,326,446,39,1411,22,443,30,22
"682","2020-05-07",218,8,137,548,3454,0.776491024898668,2085,6379,326,446,26,1437,21,464,21,21
"683","2020-05-08",210,8,121,541,3454,0.776491024898668,2085,6379,326,446,35,1472,18,482,28,18
"684","2020-05-09",187,8,125,542,3454,0.776491024898668,2085,6379,326,446,21,1493,15,497,16,15
"685","2020-05-10",173,8,129,524,3454,0.776491024898668,2085,6379,326,446,28,1521,16,513,23,16
"686","2020-05-11",181,8,131,489,3454,0.776491024898668,2085,6379,326,446,27,1548,8,521,23,8
"687","2020-05-12",171,8,138,463,3454,0.776491024898668,2085,6379,326,446,31,1579,18,539,25,18
"688","2020-05-13",166,8,130,454,3454,0.776491024898668,2085,6379,326,446,40,1619,10,549,33,10
"689","2020-05-14",171,8,120,438,3454,0.776491024898668,2085,6379,326,446,30,1649,13,562,22,13
"690","2020-05-15",157,8,119,421,3454,0.776491024898668,2085,6379,326,446,27,1676,11,573,22,11
"691","2020-05-16",149,8,136,397,3454,0.776491024898668,2085,6379,326,446,34,1710,10,583,24,10
"692","2020-05-17",149,8,140,384,3454,0.776491024898668,2085,6379,326,446,25,1735,12,595,18,12
"693","2020-05-18",132,8,152,373,3454,0.776491024898668,2085,6379,326,446,21,1756,5,600,18,5
"694","2020-05-19",121,8,142,369,3454,0.776491024898668,2085,6379,326,446,32,1788,15,615,24,15
"695","2020-05-20",123,8,150,361,3454,0.776491024898668,2085,6379,326,446,20,1808,13,628,12,13
"696","2020-05-21",113,8,143,344,3454,0.776491024898668,2085,6379,326,446,30,1838,8,636,25,8
"697","2020-05-22",122,8,137,338,3454,0.776491024898668,2085,6379,326,446,20,1858,8,644,18,8
"698","2020-05-23",127,8,149,326,3454,0.776491024898668,2085,6379,326,446,27,1885,7,651,20,7
"699","2020-05-24",108,8,146,313,3454,0.776491024898668,2085,6379,326,446,15,1900,12,663,11,12
"700","2020-05-25",106,8,138,301,3454,0.776491024898668,2085,6379,326,446,20,1920,11,674,14,11
"701","2020-05-26",108,8,130,295,3454,0.776491024898668,2085,6379,326,446,29,1949,11,685,22,11
"702","2020-05-27",105,8,123,283,3454,0.776491024898668,2085,6379,326,446,18,1967,9,694,14,9
"703","2020-05-28",103,8,126,266,3454,0.776491024898668,2085,6379,326,446,29,1996,13,707,23,13
"704","2020-05-29",91,8,121,250,3454,0.776491024898668,2085,6379,326,446,19,2015,4,711,14,4
"705","2020-05-30",90,8,119,241,3454,0.776491024898668,2085,6379,326,446,19,2034,4,715,16,4
"706","2020-05-31",94,8,140,234,3454,0.776491024898668,2085,6379,326,446,15,2049,6,721,11,6
"707","2020-06-01",88,8,141,233,3454,0.776491024898668,2085,6379,326,446,18,2067,4,725,13,4
"708","2020-06-02",81,8,142,224,3454,0.776491024898668,2085,6379,326,446,24,2091,13,738,20,13
"709","2020-06-03",77,8,146,204,3454,0.776491024898668,2085,6379,326,446,15,2106,7,745,10,7
"710","2020-06-04",76,8,157,199,3454,0.776491024898668,2085,6379,326,446,15,2121,8,753,11,8
"711","2020-06-05",73,8,146,193,3454,0.776491024898668,2085,6379,326,446,5,2126,9,762,4,9
"712","2020-06-06",65,8,142,195,3454,0.776491024898668,2085,6379,326,446,13,2139,12,774,12,12
"713","2020-06-07",60,8,127,189,3454,0.776491024898668,2085,6379,326,446,5,2144,21,795,4,21
"714","2020-03-15",1,9,18,17,5180,0.973938223938224,2115,7409,616,304,9,16,12,27,5,12
"715","2020-03-16",1,9,21,25,5180,0.973938223938224,2115,7409,616,304,6,22,10,37,4,10
"716","2020-03-17",1,9,22,40,5180,0.973938223938224,2115,7409,616,304,11,33,11,48,9,11
"717","2020-03-18",2,9,31,51,5180,0.973938223938224,2115,7409,616,304,5,38,10,58,4,10
"718","2020-03-19",4,9,30,61,5180,0.973938223938224,2115,7409,616,304,6,44,7,65,6,7
"719","2020-03-20",7,9,37,66,5180,0.973938223938224,2115,7409,616,304,9,53,5,70,9,5
"720","2020-03-21",8,9,41,85,5180,0.973938223938224,2115,7409,616,304,12,65,3,73,12,3
"721","2020-03-22",14,9,34,102,5180,0.973938223938224,2115,7409,616,304,9,74,16,89,9,16
"722","2020-03-23",17,9,28,109,5180,0.973938223938224,2115,7409,616,304,17,91,10,99,16,10
"723","2020-03-24",26,9,28,133,5180,0.973938223938224,2115,7409,616,304,20,111,18,117,18,18
"724","2020-03-25",28,9,29,139,5180,0.973938223938224,2115,7409,616,304,20,131,14,131,18,14
"725","2020-03-26",30,9,26,156,5180,0.973938223938224,2115,7409,616,304,29,160,18,149,28,18
"726","2020-03-27",34,9,21,175,5180,0.973938223938224,2115,7409,616,304,23,183,6,155,22,6
"727","2020-03-28",56,9,24,196,5180,0.973938223938224,2115,7409,616,304,32,215,8,163,30,8
"728","2020-03-29",59,9,26,207,5180,0.973938223938224,2115,7409,616,304,28,243,15,178,27,15
"729","2020-03-30",60,9,33,229,5180,0.973938223938224,2115,7409,616,304,39,282,10,188,37,10
"730","2020-03-31",57,9,40,250,5180,0.973938223938224,2115,7409,616,304,49,331,5,193,48,5
"731","2020-04-01",64,9,41,271,5180,0.973938223938224,2115,7409,616,304,66,397,3,196,62,3
"732","2020-04-02",77,9,39,317,5180,0.973938223938224,2115,7409,616,304,62,459,10,206,59,10
"733","2020-04-03",98,9,38,344,5180,0.973938223938224,2115,7409,616,304,65,524,5,211,65,5
"734","2020-04-04",91,9,40,389,5180,0.973938223938224,2115,7409,616,304,60,584,13,224,60,13
"735","2020-04-05",103,9,49,442,5180,0.973938223938224,2115,7409,616,304,62,646,7,231,62,7
"736","2020-04-06",114,9,47,490,5180,0.973938223938224,2115,7409,616,304,70,716,3,234,68,3
"737","2020-04-07",116,9,50,546,5180,0.973938223938224,2115,7409,616,304,103,819,5,239,102,5
"738","2020-04-08",118,9,53,589,5180,0.973938223938224,2115,7409,616,304,105,924,11,250,104,11
"739","2020-04-09",126,9,46,640,5180,0.973938223938224,2115,7409,616,304,103,1027,6,256,101,6
"740","2020-04-10",161,9,46,715,5180,0.973938223938224,2115,7409,616,304,94,1121,2,258,93,2
"741","2020-04-11",187,9,52,782,5180,0.973938223938224,2115,7409,616,304,111,1232,8,266,109,8
"742","2020-04-12",232,9,43,821,5180,0.973938223938224,2115,7409,616,304,138,1370,4,270,138,4
"743","2020-04-13",233,9,56,880,5180,0.973938223938224,2115,7409,616,304,112,1482,6,276,110,6
"744","2020-04-14",229,9,46,915,5180,0.973938223938224,2115,7409,616,304,119,1601,3,279,119,3
"745","2020-04-15",254,9,50,979,5180,0.973938223938224,2115,7409,616,304,133,1734,3,282,130,3
"746","2020-04-16",268,9,59,1032,5180,0.973938223938224,2115,7409,616,304,131,1865,16,298,129,16
"747","2020-04-17",349,9,73,1084,5180,0.973938223938224,2115,7409,616,304,140,2005,22,320,137,22
"748","2020-04-18",399,9,66,1126,5180,0.973938223938224,2115,7409,616,304,167,2172,6,326,164,6
"749","2020-04-19",362,9,65,1155,5180,0.973938223938224,2115,7409,616,304,128,2300,14,340,125,14
"750","2020-04-20",352,9,56,1195,5180,0.973938223938224,2115,7409,616,304,125,2425,10,350,125,10
"751","2020-04-21",370,9,54,1257,5180,0.973938223938224,2115,7409,616,304,171,2596,8,358,170,8
"752","2020-04-22",377,9,58,1291,5180,0.973938223938224,2115,7409,616,304,142,2738,1,359,139,1
"753","2020-04-23",381,9,61,1353,5180,0.973938223938224,2115,7409,616,304,134,2872,16,375,129,16
"754","2020-04-24",435,9,62,1378,5180,0.973938223938224,2115,7409,616,304,153,3025,10,385,151,10
"755","2020-04-25",421,9,58,1373,5180,0.973938223938224,2115,7409,616,304,105,3130,6,391,105,6
"756","2020-04-26",440,9,56,1389,5180,0.973938223938224,2115,7409,616,304,125,3255,14,405,125,14
"757","2020-04-27",451,9,53,1402,5180,0.973938223938224,2115,7409,616,304,103,3358,12,417,101,12
"758","2020-04-28",443,9,68,1435,5180,0.973938223938224,2115,7409,616,304,118,3476,6,423,116,6
"759","2020-04-29",450,9,86,1388,5180,0.973938223938224,2115,7409,616,304,116,3592,13,436,114,13
"760","2020-04-30",463,9,85,1361,5180,0.973938223938224,2115,7409,616,304,92,3684,25,461,89,25
"761","2020-05-01",502,9,75,1367,5180,0.973938223938224,2115,7409,616,304,92,3776,10,471,92,10
"762","2020-05-02",506,9,70,1371,5180,0.973938223938224,2115,7409,616,304,91,3867,15,486,91,15
"763","2020-05-03",456,9,63,1375,5180,0.973938223938224,2115,7409,616,304,88,3955,10,496,87,10
"764","2020-05-04",466,9,64,1346,5180,0.973938223938224,2115,7409,616,304,88,4043,2,498,88,2
"765","2020-05-05",472,9,57,1287,5180,0.973938223938224,2115,7409,616,304,88,4131,10,508,86,10
"766","2020-05-06",464,9,57,1251,5180,0.973938223938224,2115,7409,616,304,53,4184,11,519,52,11
"767","2020-05-07",460,9,66,1249,5180,0.973938223938224,2115,7409,616,304,69,4253,9,528,69,9
"768","2020-05-08",483,9,66,1202,5180,0.973938223938224,2115,7409,616,304,68,4321,19,547,67,19
"769","2020-05-09",484,9,68,1142,5180,0.973938223938224,2115,7409,616,304,69,4390,15,562,69,15
"770","2020-05-10",445,9,54,1093,5180,0.973938223938224,2115,7409,616,304,81,4471,16,578,79,16
"771","2020-05-11",423,9,56,1023,5180,0.973938223938224,2115,7409,616,304,53,4524,6,584,52,6
"772","2020-05-12",393,9,46,979,5180,0.973938223938224,2115,7409,616,304,54,4578,4,588,52,4
"773","2020-05-13",398,9,40,936,5180,0.973938223938224,2115,7409,616,304,39,4617,10,598,38,10
"774","2020-05-14",378,9,41,865,5180,0.973938223938224,2115,7409,616,304,37,4654,10,608,36,10
"775","2020-05-15",347,9,36,807,5180,0.973938223938224,2115,7409,616,304,39,4693,16,624,39,16
"776","2020-05-16",336,9,30,748,5180,0.973938223938224,2115,7409,616,304,34,4727,13,637,33,13
"777","2020-05-17",297,9,34,677,5180,0.973938223938224,2115,7409,616,304,30,4757,5,642,30,5
"778","2020-05-18",278,9,38,638,5180,0.973938223938224,2115,7409,616,304,20,4777,21,663,20,21
"779","2020-05-19",273,9,39,582,5180,0.973938223938224,2115,7409,616,304,25,4802,12,675,25,12
"780","2020-05-20",253,9,35,519,5180,0.973938223938224,2115,7409,616,304,26,4828,17,692,24,17
"781","2020-05-21",240,9,38,488,5180,0.973938223938224,2115,7409,616,304,21,4849,10,702,21,10
"782","2020-05-22",200,9,29,443,5180,0.973938223938224,2115,7409,616,304,19,4868,19,721,19,19
"783","2020-05-23",186,9,35,396,5180,0.973938223938224,2115,7409,616,304,19,4887,21,742,18,21
"784","2020-05-24",174,9,45,364,5180,0.973938223938224,2115,7409,616,304,12,4899,17,759,12,17
"785","2020-05-25",159,9,44,324,5180,0.973938223938224,2115,7409,616,304,14,4913,16,775,14,16
"786","2020-05-26",135,9,38,294,5180,0.973938223938224,2115,7409,616,304,19,4932,10,785,15,10
"787","2020-05-27",115,9,35,262,5180,0.973938223938224,2115,7409,616,304,8,4940,24,809,8,24
"788","2020-05-28",103,9,42,242,5180,0.973938223938224,2115,7409,616,304,18,4958,14,823,18,14
"789","2020-05-29",95,9,38,227,5180,0.973938223938224,2115,7409,616,304,9,4967,18,841,9,18
"790","2020-05-30",84,9,47,202,5180,0.973938223938224,2115,7409,616,304,13,4980,13,854,12,13
"791","2020-05-31",66,9,51,187,5180,0.973938223938224,2115,7409,616,304,8,4988,7,861,7,7
"792","2020-06-01",58,9,54,167,5180,0.973938223938224,2115,7409,616,304,8,4996,8,869,8,8
"793","2020-06-02",53,9,52,146,5180,0.973938223938224,2115,7409,616,304,7,5003,10,879,6,10
"794","2020-06-03",53,9,50,141,5180,0.973938223938224,2115,7409,616,304,8,5011,12,891,8,12
"795","2020-06-04",50,9,41,129,5180,0.973938223938224,2115,7409,616,304,9,5020,15,906,9,15
"796","2020-06-05",47,9,36,131,5180,0.973938223938224,2115,7409,616,304,5,5025,20,926,5,20
"797","2020-06-06",45,9,29,123,5180,0.973938223938224,2115,7409,616,304,11,5036,8,934,10,8
"798","2020-06-07",44,9,29,120,5180,0.973938223938224,2115,7409,616,304,6,5042,9,943,6,9
"799","2020-03-08",1,10,0,0,5294,0.967699282206271,2100,7292,494,348,NA,NA,NA,NA,NA,NA
"800","2020-03-09",1,10,0,0,5294,0.967699282206271,2100,7292,494,348,NA,NA,NA,NA,NA,NA
"801","2020-03-10",0,10,0,0,5294,0.967699282206271,2100,7292,494,348,NA,NA,NA,NA,NA,NA
"802","2020-03-11",0,10,0,0,5294,0.967699282206271,2100,7292,494,348,8,8,NA,NA,NA,NA
"803","2020-03-12",0,10,0,0,5294,0.967699282206271,2100,7292,494,348,15,23,3,3,2,3
"804","2020-03-13",2,10,20,7,5294,0.967699282206271,2100,7292,494,348,5,28,7,10,2,7
"805","2020-03-14",2,10,22,12,5294,0.967699282206271,2100,7292,494,348,8,36,7,17,5,7
"806","2020-03-15",1,10,18,17,5294,0.967699282206271,2100,7292,494,348,15,51,6,23,7,6
"807","2020-03-16",3,10,22,19,5294,0.967699282206271,2100,7292,494,348,5,56,2,25,2,2
"808","2020-03-17",3,10,26,29,5294,0.967699282206271,2100,7292,494,348,12,68,2,27,7,2
"809","2020-03-18",3,10,23,31,5294,0.967699282206271,2100,7292,494,348,17,85,1,28,13,1
"810","2020-03-19",4,10,23,36,5294,0.967699282206271,2100,7292,494,348,18,103,NA,NA,10,NA
"811","2020-03-20",5,10,34,42,5294,0.967699282206271,2100,7292,494,348,13,116,9,37,10,9
"812","2020-03-21",7,10,34,49,5294,0.967699282206271,2100,7292,494,348,27,143,1,38,23,1
"813","2020-03-22",11,10,38,55,5294,0.967699282206271,2100,7292,494,348,27,170,9,47,21,9
"814","2020-03-23",10,10,34,61,5294,0.967699282206271,2100,7292,494,348,22,192,6,53,15,6
"815","2020-03-24",8,10,34,70,5294,0.967699282206271,2100,7292,494,348,27,219,3,56,23,3
"816","2020-03-25",9,10,35,84,5294,0.967699282206271,2100,7292,494,348,36,255,5,61,30,5
"817","2020-03-26",10,10,37,98,5294,0.967699282206271,2100,7292,494,348,30,285,6,67,23,6
"818","2020-03-27",16,10,44,107,5294,0.967699282206271,2100,7292,494,348,45,330,2,69,38,2
"819","2020-03-28",21,10,53,131,5294,0.967699282206271,2100,7292,494,348,34,364,1,70,30,1
"820","2020-03-29",24,10,41,147,5294,0.967699282206271,2100,7292,494,348,45,409,6,76,39,6
"821","2020-03-30",29,10,40,164,5294,0.967699282206271,2100,7292,494,348,43,452,3,79,34,3
"822","2020-03-31",36,10,39,189,5294,0.967699282206271,2100,7292,494,348,49,501,4,83,37,4
"823","2020-04-01",45,10,34,221,5294,0.967699282206271,2100,7292,494,348,47,548,3,86,41,3
"824","2020-04-02",48,10,28,244,5294,0.967699282206271,2100,7292,494,348,45,593,3,89,36,3
"825","2020-04-03",66,10,24,271,5294,0.967699282206271,2100,7292,494,348,53,646,2,91,47,2
"826","2020-04-04",75,10,26,305,5294,0.967699282206271,2100,7292,494,348,56,702,11,102,51,11
"827","2020-04-05",81,10,31,336,5294,0.967699282206271,2100,7292,494,348,42,744,11,113,34,11
"828","2020-04-06",84,10,46,346,5294,0.967699282206271,2100,7292,494,348,61,805,6,119,56,6
"829","2020-04-07",90,10,52,395,5294,0.967699282206271,2100,7292,494,348,64,869,5,124,55,5
"830","2020-04-08",93,10,52,426,5294,0.967699282206271,2100,7292,494,348,49,918,8,132,38,8
"831","2020-04-09",102,10,48,482,5294,0.967699282206271,2100,7292,494,348,62,980,9,141,52,9
"832","2020-04-10",115,10,47,530,5294,0.967699282206271,2100,7292,494,348,65,1045,8,149,58,8
"833","2020-04-11",124,10,47,579,5294,0.967699282206271,2100,7292,494,348,44,1089,6,155,36,6
"834","2020-04-12",166,10,51,607,5294,0.967699282206271,2100,7292,494,348,63,1152,6,161,52,6
"835","2020-04-13",172,10,51,647,5294,0.967699282206271,2100,7292,494,348,73,1225,7,168,60,7
"836","2020-04-14",165,10,59,702,5294,0.967699282206271,2100,7292,494,348,65,1290,5,173,60,5
"837","2020-04-15",173,10,69,743,5294,0.967699282206271,2100,7292,494,348,62,1352,2,175,50,2
"838","2020-04-16",183,10,73,797,5294,0.967699282206271,2100,7292,494,348,69,1421,3,178,62,3
"839","2020-04-17",252,10,78,854,5294,0.967699282206271,2100,7292,494,348,66,1487,10,188,58,10
"840","2020-04-18",265,10,70,914,5294,0.967699282206271,2100,7292,494,348,80,1567,8,196,70,8
"841","2020-04-19",242,10,72,974,5294,0.967699282206271,2100,7292,494,348,69,1636,9,205,60,9
"842","2020-04-20",253,10,80,1048,5294,0.967699282206271,2100,7292,494,348,83,1719,5,210,77,5
"843","2020-04-21",257,10,86,1093,5294,0.967699282206271,2100,7292,494,348,59,1778,6,216,48,6
"844","2020-04-22",279,10,86,1104,5294,0.967699282206271,2100,7292,494,348,95,1873,8,224,89,8
"845","2020-04-23",302,10,94,1176,5294,0.967699282206271,2100,7292,494,348,74,1947,3,227,68,3
"846","2020-04-24",356,10,88,1210,5294,0.967699282206271,2100,7292,494,348,75,2022,10,237,73,10
"847","2020-04-25",452,10,92,1260,5294,0.967699282206271,2100,7292,494,348,82,2104,12,249,68,12
"848","2020-04-26",437,10,104,1335,5294,0.967699282206271,2100,7292,494,348,72,2176,8,257,70,8
"849","2020-04-27",426,10,114,1371,5294,0.967699282206271,2100,7292,494,348,66,2242,13,270,62,13
"850","2020-04-28",442,10,118,1432,5294,0.967699282206271,2100,7292,494,348,69,2311,7,277,64,7
"851","2020-04-29",459,10,113,1470,5294,0.967699282206271,2100,7292,494,348,61,2372,5,282,50,5
"852","2020-04-30",476,10,113,1471,5294,0.967699282206271,2100,7292,494,348,53,2425,9,291,47,9
"853","2020-05-01",568,10,116,1459,5294,0.967699282206271,2100,7292,494,348,78,2503,5,296,71,5
"854","2020-05-02",524,10,122,1452,5294,0.967699282206271,2100,7292,494,348,59,2562,8,304,55,8
"855","2020-05-03",500,10,110,1462,5294,0.967699282206271,2100,7292,494,348,78,2640,5,309,75,5
"856","2020-05-04",502,10,101,1453,5294,0.967699282206271,2100,7292,494,348,71,2711,3,312,68,3
"857","2020-05-05",502,10,92,1415,5294,0.967699282206271,2100,7292,494,348,62,2773,3,315,54,3
"858","2020-05-06",496,10,83,1412,5294,0.967699282206271,2100,7292,494,348,67,2840,3,318,60,3
"859","2020-05-07",489,10,89,1366,5294,0.967699282206271,2100,7292,494,348,72,2912,15,333,66,15
"860","2020-05-08",502,10,80,1349,5294,0.967699282206271,2100,7292,494,348,49,2961,6,339,41,6
"861","2020-05-09",498,10,91,1312,5294,0.967699282206271,2100,7292,494,348,66,3027,7,346,63,7
"862","2020-05-10",452,10,114,1315,5294,0.967699282206271,2100,7292,494,348,53,3080,15,361,51,15
"863","2020-05-11",448,10,117,1275,5294,0.967699282206271,2100,7292,494,348,49,3129,12,373,47,12
"864","2020-05-12",436,10,102,1223,5294,0.967699282206271,2100,7292,494,348,58,3187,9,382,57,9
"865","2020-05-13",437,10,102,1172,5294,0.967699282206271,2100,7292,494,348,41,3228,12,394,37,12
"866","2020-05-14",423,10,102,1096,5294,0.967699282206271,2100,7292,494,348,48,3276,9,403,44,9
"867","2020-05-15",403,10,87,1029,5294,0.967699282206271,2100,7292,494,348,52,3328,12,415,44,12
"868","2020-05-16",417,10,87,992,5294,0.967699282206271,2100,7292,494,348,42,3370,7,422,39,7
"869","2020-05-17",393,10,81,931,5294,0.967699282206271,2100,7292,494,348,47,3417,10,432,40,10
"870","2020-05-18",378,10,84,854,5294,0.967699282206271,2100,7292,494,348,49,3466,2,434,44,2
"871","2020-05-19",355,10,92,804,5294,0.967699282206271,2100,7292,494,348,48,3514,9,443,45,9
"872","2020-05-20",327,10,86,743,5294,0.967699282206271,2100,7292,494,348,44,3558,12,455,37,12
"873","2020-05-21",312,10,94,695,5294,0.967699282206271,2100,7292,494,348,47,3605,8,463,40,8
"874","2020-05-22",250,10,86,630,5294,0.967699282206271,2100,7292,494,348,30,3635,4,467,26,4
"875","2020-05-23",226,10,75,570,5294,0.967699282206271,2100,7292,494,348,32,3667,17,484,28,17
"876","2020-05-24",216,10,69,518,5294,0.967699282206271,2100,7292,494,348,25,3692,13,497,22,13
"877","2020-05-25",193,10,68,481,5294,0.967699282206271,2100,7292,494,348,20,3712,6,503,16,6
"878","2020-05-26",184,10,62,432,5294,0.967699282206271,2100,7292,494,348,31,3743,8,511,28,8
"879","2020-05-27",177,10,56,398,5294,0.967699282206271,2100,7292,494,348,25,3768,12,523,23,12
"880","2020-05-28",162,10,49,370,5294,0.967699282206271,2100,7292,494,348,26,3794,9,532,22,9
"881","2020-05-29",166,10,51,326,5294,0.967699282206271,2100,7292,494,348,16,3810,3,535,14,3
"882","2020-05-30",150,10,48,309,5294,0.967699282206271,2100,7292,494,348,20,3830,1,536,20,1
"883","2020-05-31",129,10,54,287,5294,0.967699282206271,2100,7292,494,348,11,3841,NA,NA,11,NA
"884","2020-06-01",124,10,48,263,5294,0.967699282206271,2100,7292,494,348,15,3856,NA,NA,14,NA
"885","2020-06-02",112,10,46,230,5294,0.967699282206271,2100,7292,494,348,20,3876,1,537,20,1
"886","2020-06-03",103,10,45,204,5294,0.967699282206271,2100,7292,494,348,15,3891,1,538,13,1
"887","2020-06-04",99,10,48,179,5294,0.967699282206271,2100,7292,494,348,10,3901,5,543,9,5
"888","2020-06-05",85,10,45,171,5294,0.967699282206271,2100,7292,494,348,8,3909,2,545,5,2
"889","2020-06-06",76,10,46,153,5294,0.967699282206271,2100,7292,494,348,12,3921,2,547,8,2
"890","2020-06-07",72,10,40,136,5294,0.967699282206271,2100,7292,494,348,12,3933,2,549,11,2
"891","2020-03-14",3,11,16,35,5102,0.884359074872599,2085,7305,484,288,11,51,16,55,4,16
"892","2020-03-15",7,11,23,47,5102,0.884359074872599,2085,7305,484,288,18,69,15,70,8,15
"893","2020-03-16",8,11,27,55,5102,0.884359074872599,2085,7305,484,288,14,83,11,81,7,11
"894","2020-03-17",11,11,38,69,5102,0.884359074872599,2085,7305,484,288,20,103,16,97,5,16
"895","2020-03-18",16,11,38,88,5102,0.884359074872599,2085,7305,484,288,23,126,20,117,11,20
"896","2020-03-19",19,11,43,111,5102,0.884359074872599,2085,7305,484,288,30,156,19,136,20,19
"897","2020-03-20",28,11,48,128,5102,0.884359074872599,2085,7305,484,288,26,182,24,160,14,24
"898","2020-03-21",31,11,45,170,5102,0.884359074872599,2085,7305,484,288,26,208,23,183,18,23
"899","2020-03-22",32,11,38,198,5102,0.884359074872599,2085,7305,484,288,29,237,28,211,19,28
"900","2020-03-23",42,11,43,225,5102,0.884359074872599,2085,7305,484,288,37,274,22,233,28,22
"901","2020-03-24",42,11,39,265,5102,0.884359074872599,2085,7305,484,288,34,308,23,256,19,23
"902","2020-03-25",45,11,50,302,5102,0.884359074872599,2085,7305,484,288,37,345,23,279,21,23
"903","2020-03-26",60,11,44,334,5102,0.884359074872599,2085,7305,484,288,31,376,18,297,21,18
"904","2020-03-27",72,11,50,387,5102,0.884359074872599,2085,7305,484,288,43,419,27,324,26,27
"905","2020-03-28",91,11,60,420,5102,0.884359074872599,2085,7305,484,288,30,449,21,345,22,21
"906","2020-03-29",106,11,51,466,5102,0.884359074872599,2085,7305,484,288,45,494,25,370,33,25
"907","2020-03-30",109,11,56,515,5102,0.884359074872599,2085,7305,484,288,38,532,25,395,25,25
"908","2020-03-31",118,11,58,551,5102,0.884359074872599,2085,7305,484,288,49,581,21,416,37,21
"909","2020-04-01",129,11,52,620,5102,0.884359074872599,2085,7305,484,288,45,626,16,432,32,16
"910","2020-04-02",130,11,55,668,5102,0.884359074872599,2085,7305,484,288,43,669,20,452,27,20
"911","2020-04-03",174,11,62,716,5102,0.884359074872599,2085,7305,484,288,49,718,26,478,39,26
"912","2020-04-04",219,11,74,793,5102,0.884359074872599,2085,7305,484,288,47,765,38,516,37,38
"913","2020-04-05",239,11,72,857,5102,0.884359074872599,2085,7305,484,288,56,821,31,547,41,31
"914","2020-04-06",243,11,73,917,5102,0.884359074872599,2085,7305,484,288,56,877,24,571,45,24
"915","2020-04-07",249,11,66,976,5102,0.884359074872599,2085,7305,484,288,46,923,28,599,30,28
"916","2020-04-08",277,11,80,1017,5102,0.884359074872599,2085,7305,484,288,49,972,31,630,33,31
"917","2020-04-09",293,11,84,1062,5102,0.884359074872599,2085,7305,484,288,80,1052,35,665,64,35
"918","2020-04-10",390,11,84,1118,5102,0.884359074872599,2085,7305,484,288,50,1102,25,690,42,25
"919","2020-04-11",410,11,81,1122,5102,0.884359074872599,2085,7305,484,288,55,1157,41,731,49,41
"920","2020-04-12",388,11,89,1152,5102,0.884359074872599,2085,7305,484,288,53,1210,34,765,39,34
"921","2020-04-13",387,11,90,1176,5102,0.884359074872599,2085,7305,484,288,53,1263,34,799,45,34
"922","2020-04-14",409,11,100,1183,5102,0.884359074872599,2085,7305,484,288,63,1326,36,835,53,36
"923","2020-04-15",394,11,106,1189,5102,0.884359074872599,2085,7305,484,288,56,1382,38,873,41,38
"924","2020-04-16",400,11,126,1235,5102,0.884359074872599,2085,7305,484,288,59,1441,35,908,46,35
"925","2020-04-17",430,11,123,1230,5102,0.884359074872599,2085,7305,484,288,59,1500,33,941,45,33
"926","2020-04-18",428,11,106,1224,5102,0.884359074872599,2085,7305,484,288,74,1574,32,973,61,32
"927","2020-04-19",401,11,112,1257,5102,0.884359074872599,2085,7305,484,288,69,1643,36,1009,59,36
"928","2020-04-20",405,11,110,1288,5102,0.884359074872599,2085,7305,484,288,73,1716,39,1048,60,39
"929","2020-04-21",395,11,120,1248,5102,0.884359074872599,2085,7305,484,288,71,1787,27,1075,64,27
"930","2020-04-22",409,11,121,1226,5102,0.884359074872599,2085,7305,484,288,46,1833,32,1107,36,32
"931","2020-04-23",420,11,117,1251,5102,0.884359074872599,2085,7305,484,288,73,1906,28,1135,58,28
"932","2020-04-24",442,11,104,1264,5102,0.884359074872599,2085,7305,484,288,77,1983,40,1175,61,40
"933","2020-04-25",432,11,97,1243,5102,0.884359074872599,2085,7305,484,288,65,2048,45,1220,53,45
"934","2020-04-26",409,11,87,1217,5102,0.884359074872599,2085,7305,484,288,89,2137,46,1266,73,46
"935","2020-04-27",410,11,74,1217,5102,0.884359074872599,2085,7305,484,288,55,2192,40,1306,45,40
"936","2020-04-28",406,11,67,1194,5102,0.884359074872599,2085,7305,484,288,66,2258,31,1337,56,31
"937","2020-04-29",407,11,60,1186,5102,0.884359074872599,2085,7305,484,288,53,2311,46,1383,41,46
"938","2020-04-30",403,11,63,1170,5102,0.884359074872599,2085,7305,484,288,55,2366,42,1425,50,42
"939","2020-05-01",418,11,72,1109,5102,0.884359074872599,2085,7305,484,288,62,2428,35,1460,49,35
"940","2020-05-02",414,11,70,1059,5102,0.884359074872599,2085,7305,484,288,60,2488,45,1505,51,45
"941","2020-05-03",399,11,67,985,5102,0.884359074872599,2085,7305,484,288,76,2564,38,1543,60,38
"942","2020-05-04",393,11,75,976,5102,0.884359074872599,2085,7305,484,288,35,2599,43,1586,27,43
"943","2020-05-05",375,11,83,939,5102,0.884359074872599,2085,7305,484,288,58,2657,33,1619,44,33
"944","2020-05-06",357,11,87,878,5102,0.884359074872599,2085,7305,484,288,54,2711,37,1656,45,37
"945","2020-05-07",350,11,80,806,5102,0.884359074872599,2085,7305,484,288,51,2762,44,1700,45,44
"946","2020-05-08",333,11,78,753,5102,0.884359074872599,2085,7305,484,288,58,2820,36,1736,46,36
"947","2020-05-09",327,11,71,710,5102,0.884359074872599,2085,7305,484,288,46,2866,38,1774,35,38
"948","2020-05-10",292,11,78,668,5102,0.884359074872599,2085,7305,484,288,37,2903,46,1820,26,46
"949","2020-05-11",262,11,68,617,5102,0.884359074872599,2085,7305,484,288,51,2954,42,1862,41,42
"950","2020-05-12",256,11,56,567,5102,0.884359074872599,2085,7305,484,288,37,2991,50,1912,29,50
"951","2020-05-13",249,11,51,522,5102,0.884359074872599,2085,7305,484,288,40,3031,51,1963,34,51
"952","2020-05-14",229,11,48,484,5102,0.884359074872599,2085,7305,484,288,58,3089,52,2015,45,52
"953","2020-05-15",188,11,54,454,5102,0.884359074872599,2085,7305,484,288,39,3128,44,2059,32,44
"954","2020-05-16",181,11,63,409,5102,0.884359074872599,2085,7305,484,288,32,3160,31,2090,25,31
"955","2020-05-17",168,11,70,387,5102,0.884359074872599,2085,7305,484,288,43,3203,45,2135,35,45
"956","2020-05-18",151,11,66,364,5102,0.884359074872599,2085,7305,484,288,40,3243,45,2180,36,45
"957","2020-05-19",139,11,66,345,5102,0.884359074872599,2085,7305,484,288,37,3280,39,2219,26,39
"958","2020-05-20",130,11,64,331,5102,0.884359074872599,2085,7305,484,288,25,3305,42,2261,19,42
"959","2020-05-21",119,11,67,312,5102,0.884359074872599,2085,7305,484,288,44,3349,37,2298,37,37
"960","2020-05-22",108,11,79,278,5102,0.884359074872599,2085,7305,484,288,30,3379,32,2330,25,32
"961","2020-05-23",101,11,65,256,5102,0.884359074872599,2085,7305,484,288,32,3411,29,2359,21,29
"962","2020-05-24",100,11,62,234,5102,0.884359074872599,2085,7305,484,288,28,3439,36,2395,27,36
"963","2020-05-25",103,11,57,227,5102,0.884359074872599,2085,7305,484,288,37,3476,25,2420,26,25
"964","2020-05-26",88,11,58,214,5102,0.884359074872599,2085,7305,484,288,26,3502,16,2436,17,16
"965","2020-05-27",83,11,64,208,5102,0.884359074872599,2085,7305,484,288,23,3525,36,2472,20,36
"966","2020-05-28",79,11,57,195,5102,0.884359074872599,2085,7305,484,288,24,3549,29,2501,18,29
"967","2020-05-29",72,11,50,183,5102,0.884359074872599,2085,7305,484,288,16,3565,19,2520,10,19
"968","2020-05-30",66,11,43,171,5102,0.884359074872599,2085,7305,484,288,20,3585,21,2541,18,21
"969","2020-05-31",51,11,42,165,5102,0.884359074872599,2085,7305,484,288,22,3607,24,2565,17,24
"970","2020-06-01",46,11,36,159,5102,0.884359074872599,2085,7305,484,288,16,3623,20,2585,14,20
"971","2020-06-02",49,11,41,163,5102,0.884359074872599,2085,7305,484,288,24,3647,27,2612,22,27
"972","2020-06-03",50,11,44,147,5102,0.884359074872599,2085,7305,484,288,22,3669,26,2638,15,26
"973","2020-06-04",49,11,54,138,5102,0.884359074872599,2085,7305,484,288,15,3684,18,2656,14,18
"974","2020-06-05",54,11,60,129,5102,0.884359074872599,2085,7305,484,288,16,3700,25,2681,13,25
"975","2020-06-06",48,11,56,120,5102,0.884359074872599,2085,7305,484,288,22,3722,23,2704,19,23
"976","2020-06-07",51,11,54,112,5102,0.884359074872599,2085,7305,484,288,18,3740,12,2716,11,12
"977","2020-03-13",2,12,20,34,2371,0.629270350063264,2040,5123,226,241,6,14,4,14,1,4
"978","2020-03-14",5,12,19,41,2371,0.629270350063264,2040,5123,226,241,9,23,NA,NA,7,NA
"979","2020-03-15",6,12,21,54,2371,0.629270350063264,2040,5123,226,241,7,30,2,16,6,2
"980","2020-03-16",6,12,25,68,2371,0.629270350063264,2040,5123,226,241,8,38,6,22,4,6
"981","2020-03-17",8,12,32,74,2371,0.629270350063264,2040,5123,226,241,10,48,3,25,7,3
"982","2020-03-18",13,12,31,88,2371,0.629270350063264,2040,5123,226,241,18,66,4,29,11,4
"983","2020-03-19",16,12,37,97,2371,0.629270350063264,2040,5123,226,241,11,77,9,38,6,9
"984","2020-03-20",18,12,43,114,2371,0.629270350063264,2040,5123,226,241,18,95,7,45,13,7
"985","2020-03-21",22,12,41,122,2371,0.629270350063264,2040,5123,226,241,15,110,1,46,13,1
"986","2020-03-22",24,12,35,140,2371,0.629270350063264,2040,5123,226,241,17,127,NA,NA,14,NA
"987","2020-03-23",31,12,30,149,2371,0.629270350063264,2040,5123,226,241,30,157,1,47,25,1
"988","2020-03-24",32,12,33,160,2371,0.629270350063264,2040,5123,226,241,23,180,NA,NA,18,NA
"989","2020-03-25",36,12,40,174,2371,0.629270350063264,2040,5123,226,241,26,206,1,48,16,1
"990","2020-03-26",38,12,45,180,2371,0.629270350063264,2040,5123,226,241,16,222,5,53,11,5
"991","2020-03-27",45,12,32,201,2371,0.629270350063264,2040,5123,226,241,31,253,4,57,24,4
"992","2020-03-28",58,12,39,210,2371,0.629270350063264,2040,5123,226,241,31,284,2,59,25,2
"993","2020-03-29",67,12,42,218,2371,0.629270350063264,2040,5123,226,241,39,323,3,62,35,3
"994","2020-03-30",61,12,43,236,2371,0.629270350063264,2040,5123,226,241,25,348,5,67,23,5
"995","2020-03-31",66,12,40,242,2371,0.629270350063264,2040,5123,226,241,36,384,4,71,33,4
"996","2020-04-01",69,12,38,253,2371,0.629270350063264,2040,5123,226,241,39,423,2,73,31,2
"997","2020-04-02",75,12,37,266,2371,0.629270350063264,2040,5123,226,241,35,458,3,76,33,3
"998","2020-04-03",86,12,34,271,2371,0.629270350063264,2040,5123,226,241,45,503,1,77,37,1
"999","2020-04-04",93,12,29,289,2371,0.629270350063264,2040,5123,226,241,40,543,2,79,35,2
"1000","2020-04-05",94,12,26,294,2371,0.629270350063264,2040,5123,226,241,33,576,NA,NA,28,NA
"1001","2020-04-06",88,12,26,291,2371,0.629270350063264,2040,5123,226,241,40,616,1,80,36,1
"1002","2020-04-07",86,12,25,306,2371,0.629270350063264,2040,5123,226,241,37,653,NA,NA,34,NA
"1003","2020-04-08",84,12,27,316,2371,0.629270350063264,2040,5123,226,241,46,699,NA,NA,42,NA
"1004","2020-04-09",80,12,23,323,2371,0.629270350063264,2040,5123,226,241,46,745,2,82,36,2
"1005","2020-04-10",100,12,25,336,2371,0.629270350063264,2040,5123,226,241,43,788,7,89,34,7
"1006","2020-04-11",116,12,30,333,2371,0.629270350063264,2040,5123,226,241,53,841,1,90,50,1
"1007","2020-04-12",115,12,35,332,2371,0.629270350063264,2040,5123,226,241,44,885,3,93,35,3
"1008","2020-04-13",117,12,40,334,2371,0.629270350063264,2040,5123,226,241,52,937,3,96,47,3
"1009","2020-04-14",120,12,40,338,2371,0.629270350063264,2040,5123,226,241,48,985,5,101,42,5
"1010","2020-04-15",122,12,37,334,2371,0.629270350063264,2040,5123,226,241,57,1042,5,106,54,5
"1011","2020-04-16",124,12,41,325,2371,0.629270350063264,2040,5123,226,241,40,1082,4,110,36,4
"1012","2020-04-17",125,12,52,328,2371,0.629270350063264,2040,5123,226,241,66,1148,6,116,60,6
"1013","2020-04-18",121,12,54,315,2371,0.629270350063264,2040,5123,226,241,54,1202,11,127,49,11
"1014","2020-04-19",110,12,61,308,2371,0.629270350063264,2040,5123,226,241,58,1260,3,130,53,3
"1015","2020-04-20",104,12,50,328,2371,0.629270350063264,2040,5123,226,241,52,1312,6,136,50,6
"1016","2020-04-21",108,12,54,327,2371,0.629270350063264,2040,5123,226,241,58,1370,NA,NA,50,NA
"1017","2020-04-22",106,12,62,334,2371,0.629270350063264,2040,5123,226,241,50,1420,1,137,43,1
"1018","2020-04-23",104,12,61,342,2371,0.629270350063264,2040,5123,226,241,56,1476,13,150,45,13
"1019","2020-04-24",109,12,56,357,2371,0.629270350063264,2040,5123,226,241,56,1532,11,161,48,11
"1020","2020-04-25",117,12,52,366,2371,0.629270350063264,2040,5123,226,241,60,1592,16,177,57,16
"1021","2020-04-26",109,12,61,382,2371,0.629270350063264,2040,5123,226,241,57,1649,10,187,46,10
"1022","2020-04-27",104,12,62,380,2371,0.629270350063264,2040,5123,226,241,49,1698,7,194,47,7
"1023","2020-04-28",101,12,61,368,2371,0.629270350063264,2040,5123,226,241,64,1762,9,203,57,9
"1024","2020-04-29",104,12,55,389,2371,0.629270350063264,2040,5123,226,241,53,1815,5,208,51,5
"1025","2020-04-30",110,12,54,387,2371,0.629270350063264,2040,5123,226,241,46,1861,8,216,41,8
"1026","2020-05-01",127,12,57,396,2371,0.629270350063264,2040,5123,226,241,54,1915,7,223,48,7
"1027","2020-05-02",129,12,58,405,2371,0.629270350063264,2040,5123,226,241,60,1975,4,227,56,4
"1028","2020-05-03",132,12,60,411,2371,0.629270350063264,2040,5123,226,241,47,2022,19,246,43,19
"1029","2020-05-04",135,12,64,409,2371,0.629270350063264,2040,5123,226,241,50,2072,9,255,47,9
"1030","2020-05-05",138,12,62,408,2371,0.629270350063264,2040,5123,226,241,46,2118,12,267,43,12
"1031","2020-05-06",141,12,66,402,2371,0.629270350063264,2040,5123,226,241,66,2184,8,275,62,8
"1032","2020-05-07",144,12,57,402,2371,0.629270350063264,2040,5123,226,241,50,2234,12,287,42,12
"1033","2020-05-08",142,12,54,389,2371,0.629270350063264,2040,5123,226,241,34,2268,10,297,33,10
"1034","2020-05-09",133,12,63,379,2371,0.629270350063264,2040,5123,226,241,34,2302,16,313,32,16
"1035","2020-05-10",127,12,64,380,2371,0.629270350063264,2040,5123,226,241,39,2341,17,330,37,17
"1036","2020-05-11",125,12,65,378,2371,0.629270350063264,2040,5123,226,241,48,2389,11,341,42,11
"1037","2020-05-12",118,12,63,357,2371,0.629270350063264,2040,5123,226,241,54,2443,10,351,49,10
"1038","2020-05-13",117,12,61,352,2371,0.629270350063264,2040,5123,226,241,56,2499,9,360,51,9
"1039","2020-05-14",114,12,54,345,2371,0.629270350063264,2040,5123,226,241,38,2537,9,369,35,9
"1040","2020-05-15",116,12,54,342,2371,0.629270350063264,2040,5123,226,241,46,2583,16,385,42,16
"1041","2020-05-16",129,12,53,333,2371,0.629270350063264,2040,5123,226,241,28,2611,7,392,22,7
"1042","2020-05-17",121,12,49,321,2371,0.629270350063264,2040,5123,226,241,33,2644,15,407,31,15
"1043","2020-05-18",115,12,60,321,2371,0.629270350063264,2040,5123,226,241,28,2672,10,417,25,10
"1044","2020-05-19",117,12,63,321,2371,0.629270350063264,2040,5123,226,241,36,2708,8,425,34,8
"1045","2020-05-20",116,12,61,318,2371,0.629270350063264,2040,5123,226,241,54,2762,7,432,48,7
"1046","2020-05-21",118,12,78,320,2371,0.629270350063264,2040,5123,226,241,32,2794,12,444,27,12
"1047","2020-05-22",120,12,67,304,2371,0.629270350063264,2040,5123,226,241,42,2836,7,451,35,7
"1048","2020-05-23",115,12,67,295,2371,0.629270350063264,2040,5123,226,241,29,2865,7,458,24,7
"1049","2020-05-24",115,12,59,297,2371,0.629270350063264,2040,5123,226,241,23,2888,5,463,21,5
"1050","2020-05-25",116,12,69,281,2371,0.629270350063264,2040,5123,226,241,38,2926,NA,NA,36,NA
"1051","2020-05-26",104,12,78,274,2371,0.629270350063264,2040,5123,226,241,26,2952,3,466,24,3
"1052","2020-05-27",97,12,82,270,2371,0.629270350063264,2040,5123,226,241,29,2981,1,467,25,1
"1053","2020-05-28",93,12,82,276,2371,0.629270350063264,2040,5123,226,241,39,3020,4,471,36,4
"1054","2020-05-29",108,12,86,264,2371,0.629270350063264,2040,5123,226,241,19,3039,8,479,18,8
"1055","2020-05-30",107,12,90,251,2371,0.629270350063264,2040,5123,226,241,31,3070,7,486,29,7
"1056","2020-05-31",90,12,84,242,2371,0.629270350063264,2040,5123,226,241,20,3090,2,488,17,2
"1057","2020-06-01",86,12,82,240,2371,0.629270350063264,2040,5123,226,241,20,3110,NA,NA,19,NA
"1058","2020-06-02",85,12,79,235,2371,0.629270350063264,2040,5123,226,241,21,3131,8,496,19,8
"1059","2020-06-03",87,12,61,222,2371,0.629270350063264,2040,5123,226,241,19,3150,4,500,14,4
"1060","2020-06-04",85,12,69,214,2371,0.629270350063264,2040,5123,226,241,16,3166,2,502,15,2
"1061","2020-06-05",75,12,82,204,2371,0.629270350063264,2040,5123,226,241,20,3186,NA,NA,17,NA
"1062","2020-06-06",68,12,76,193,2371,0.629270350063264,2040,5123,226,241,15,3201,1,503,15,1
"1063","2020-06-07",59,12,77,182,2371,0.629270350063264,2040,5123,226,241,27,3228,1,504,24,1
"1064","2020-03-07",1,13,0,0,5115,0.954838709677419,2010,7042,466,208,NA,NA,NA,NA,NA,NA
"1065","2020-03-08",1,13,0,0,5115,0.954838709677419,2010,7042,466,208,NA,NA,NA,NA,NA,NA
"1066","2020-03-09",0,13,0,0,5115,0.954838709677419,2010,7042,466,208,NA,NA,NA,NA,NA,NA
"1067","2020-03-10",0,13,0,0,5115,0.954838709677419,2010,7042,466,208,NA,NA,NA,NA,NA,NA
"1068","2020-03-11",0,13,0,0,5115,0.954838709677419,2010,7042,466,208,7,7,3,3,NA,3
"1069","2020-03-12",0,13,0,0,5115,0.954838709677419,2010,7042,466,208,2,9,1,4,NA,1
"1070","2020-03-13",0,13,0,0,5115,0.954838709677419,2010,7042,466,208,6,15,3,7,1,3
"1071","2020-03-14",3,13,10,15,5115,0.954838709677419,2010,7042,466,208,3,18,2,9,1,2
"1072","2020-03-15",3,13,10,18,5115,0.954838709677419,2010,7042,466,208,8,26,2,11,2,2
"1073","2020-03-16",3,13,18,23,5115,0.954838709677419,2010,7042,466,208,7,33,2,13,4,2
"1074","2020-03-17",3,13,21,29,5115,0.954838709677419,2010,7042,466,208,11,44,1,14,6,1
"1075","2020-03-18",4,13,22,31,5115,0.954838709677419,2010,7042,466,208,9,53,3,17,6,3
"1076","2020-03-19",5,13,18,41,5115,0.954838709677419,2010,7042,466,208,5,58,1,18,1,1
"1077","2020-03-20",9,13,22,49,5115,0.954838709677419,2010,7042,466,208,7,65,1,19,5,1
"1078","2020-03-21",12,13,21,62,5115,0.954838709677419,2010,7042,466,208,14,79,3,22,4,3
"1079","2020-03-22",15,13,15,70,5115,0.954838709677419,2010,7042,466,208,14,93,5,27,6,5
"1080","2020-03-23",17,13,15,78,5115,0.954838709677419,2010,7042,466,208,15,108,3,30,6,3
"1081","2020-03-24",18,13,16,83,5115,0.954838709677419,2010,7042,466,208,15,123,4,34,7,4
"1082","2020-03-25",19,13,16,100,5115,0.954838709677419,2010,7042,466,208,23,146,1,35,19,1
"1083","2020-03-26",22,13,23,115,5115,0.954838709677419,2010,7042,466,208,18,164,3,38,11,3
"1084","2020-03-27",31,13,23,135,5115,0.954838709677419,2010,7042,466,208,29,193,2,40,17,2
"1085","2020-03-28",32,13,27,151,5115,0.954838709677419,2010,7042,466,208,30,223,2,42,18,2
"1086","2020-03-29",35,13,23,168,5115,0.954838709677419,2010,7042,466,208,34,257,2,44,29,2
"1087","2020-03-30",35,13,23,195,5115,0.954838709677419,2010,7042,466,208,33,290,4,48,24,4
"1088","2020-03-31",35,13,23,219,5115,0.954838709677419,2010,7042,466,208,39,329,7,55,32,7
"1089","2020-04-01",40,13,19,249,5115,0.954838709677419,2010,7042,466,208,39,368,3,58,30,3
"1090","2020-04-02",41,13,21,278,5115,0.954838709677419,2010,7042,466,208,38,406,7,65,34,7
"1091","2020-04-03",46,13,25,301,5115,0.954838709677419,2010,7042,466,208,39,445,8,73,31,8
"1092","2020-04-04",65,13,29,336,5115,0.954838709677419,2010,7042,466,208,45,490,3,76,37,3
"1093","2020-04-05",79,13,32,370,5115,0.954838709677419,2010,7042,466,208,57,547,7,83,43,7
"1094","2020-04-06",85,13,44,430,5115,0.954838709677419,2010,7042,466,208,36,583,6,89,30,6
"1095","2020-04-07",104,13,54,480,5115,0.954838709677419,2010,7042,466,208,46,629,6,95,42,6
"1096","2020-04-08",109,13,49,510,5115,0.954838709677419,2010,7042,466,208,59,688,15,110,52,15
"1097","2020-04-09",119,13,59,556,5115,0.954838709677419,2010,7042,466,208,49,737,10,120,42,10
"1098","2020-04-10",134,13,56,596,5115,0.954838709677419,2010,7042,466,208,47,784,7,127,39,7
"1099","2020-04-11",152,13,54,647,5115,0.954838709677419,2010,7042,466,208,70,854,10,137,52,10
"1100","2020-04-12",185,13,49,701,5115,0.954838709677419,2010,7042,466,208,49,903,4,141,39,4
"1101","2020-04-13",201,13,54,757,5115,0.954838709677419,2010,7042,466,208,45,948,15,156,41,15
"1102","2020-04-14",197,13,54,811,5115,0.954838709677419,2010,7042,466,208,57,1005,7,163,50,7
"1103","2020-04-15",210,13,51,864,5115,0.954838709677419,2010,7042,466,208,57,1062,9,172,50,9
"1104","2020-04-16",226,13,58,875,5115,0.954838709677419,2010,7042,466,208,53,1115,6,178,46,6
"1105","2020-04-17",305,13,63,949,5115,0.954838709677419,2010,7042,466,208,55,1170,8,186,42,8
"1106","2020-04-18",311,13,69,995,5115,0.954838709677419,2010,7042,466,208,76,1246,8,194,67,8
"1107","2020-04-19",285,13,74,1032,5115,0.954838709677419,2010,7042,466,208,59,1305,10,204,56,10
"1108","2020-04-20",289,13,61,1065,5115,0.954838709677419,2010,7042,466,208,72,1377,3,207,62,3
"1109","2020-04-21",290,13,77,1091,5115,0.954838709677419,2010,7042,466,208,55,1432,6,213,51,6
"1110","2020-04-22",310,13,75,1140,5115,0.954838709677419,2010,7042,466,208,59,1491,5,218,52,5
"1111","2020-04-23",321,13,75,1179,5115,0.954838709677419,2010,7042,466,208,56,1547,3,221,43,3
"1112","2020-04-24",350,13,70,1187,5115,0.954838709677419,2010,7042,466,208,47,1594,3,224,40,3
"1113","2020-04-25",399,13,65,1199,5115,0.954838709677419,2010,7042,466,208,54,1648,6,230,49,6
"1114","2020-04-26",399,13,65,1219,5115,0.954838709677419,2010,7042,466,208,54,1702,9,239,46,9
"1115","2020-04-27",401,13,66,1229,5115,0.954838709677419,2010,7042,466,208,65,1767,8,247,52,8
"1116","2020-04-28",420,13,60,1257,5115,0.954838709677419,2010,7042,466,208,64,1831,7,254,58,7
"1117","2020-04-29",424,13,53,1254,5115,0.954838709677419,2010,7042,466,208,65,1896,2,256,55,2
"1118","2020-04-30",414,13,55,1265,5115,0.954838709677419,2010,7042,466,208,51,1947,10,266,43,10
"1119","2020-05-01",464,13,66,1258,5115,0.954838709677419,2010,7042,466,208,37,1984,6,272,30,6
"1120","2020-05-02",457,13,66,1268,5115,0.954838709677419,2010,7042,466,208,52,2036,11,283,44,11
"1121","2020-05-03",407,13,66,1279,5115,0.954838709677419,2010,7042,466,208,41,2077,11,294,34,11
"1122","2020-05-04",400,13,65,1247,5115,0.954838709677419,2010,7042,466,208,64,2141,19,313,55,19
"1123","2020-05-05",391,13,59,1201,5115,0.954838709677419,2010,7042,466,208,48,2189,9,322,40,9
"1124","2020-05-06",384,13,57,1184,5115,0.954838709677419,2010,7042,466,208,43,2232,10,332,34,10
"1125","2020-05-07",403,13,57,1178,5115,0.954838709677419,2010,7042,466,208,55,2287,4,336,46,4
"1126","2020-05-08",408,13,57,1163,5115,0.954838709677419,2010,7042,466,208,56,2343,5,341,46,5
"1127","2020-05-09",378,13,67,1135,5115,0.954838709677419,2010,7042,466,208,49,2392,2,343,40,2
"1128","2020-05-10",397,13,61,1099,5115,0.954838709677419,2010,7042,466,208,46,2438,10,353,43,10
"1129","2020-05-11",389,13,61,1066,5115,0.954838709677419,2010,7042,466,208,46,2484,6,359,41,6
"1130","2020-05-12",376,13,66,1012,5115,0.954838709677419,2010,7042,466,208,60,2544,14,373,49,14
"1131","2020-05-13",371,13,63,979,5115,0.954838709677419,2010,7042,466,208,45,2589,8,381,36,8
"1132","2020-05-14",354,13,60,955,5115,0.954838709677419,2010,7042,466,208,46,2635,2,383,41,2
"1133","2020-05-15",351,13,59,902,5115,0.954838709677419,2010,7042,466,208,42,2677,10,393,40,10
"1134","2020-05-16",360,13,54,862,5115,0.954838709677419,2010,7042,466,208,41,2718,9,402,35,9
"1135","2020-05-17",314,13,58,830,5115,0.954838709677419,2010,7042,466,208,39,2757,7,409,38,7
"1136","2020-05-18",307,13,73,789,5115,0.954838709677419,2010,7042,466,208,62,2819,11,420,59,11
"1137","2020-05-19",296,13,68,753,5115,0.954838709677419,2010,7042,466,208,41,2860,10,430,37,10
"1138","2020-05-20",285,13,63,716,5115,0.954838709677419,2010,7042,466,208,32,2892,6,436,28,6
"1139","2020-05-21",278,13,66,676,5115,0.954838709677419,2010,7042,466,208,24,2916,9,445,22,9
"1140","2020-05-22",262,13,71,620,5115,0.954838709677419,2010,7042,466,208,27,2943,16,461,23,16
"1141","2020-05-23",271,13,69,598,5115,0.954838709677419,2010,7042,466,208,40,2983,12,473,31,12
"1142","2020-05-24",230,13,73,553,5115,0.954838709677419,2010,7042,466,208,36,3019,12,485,31,12
"1143","2020-05-25",217,13,77,504,5115,0.954838709677419,2010,7042,466,208,35,3054,15,500,31,15
"1144","2020-05-26",204,13,79,476,5115,0.954838709677419,2010,7042,466,208,27,3081,10,510,24,10
"1145","2020-05-27",201,13,79,446,5115,0.954838709677419,2010,7042,466,208,27,3108,7,517,23,7
"1146","2020-05-28",185,13,81,408,5115,0.954838709677419,2010,7042,466,208,22,3130,14,531,16,14
"1147","2020-05-29",172,13,74,378,5115,0.954838709677419,2010,7042,466,208,20,3150,10,541,16,10
"1148","2020-05-30",151,13,84,345,5115,0.954838709677419,2010,7042,466,208,17,3167,11,552,14,11
"1149","2020-05-31",136,13,82,315,5115,0.954838709677419,2010,7042,466,208,18,3185,5,557,16,5
"1150","2020-06-01",122,13,68,296,5115,0.954838709677419,2010,7042,466,208,23,3208,6,563,17,6
"1151","2020-06-02",116,13,65,271,5115,0.954838709677419,2010,7042,466,208,12,3220,7,570,9,7
"1152","2020-06-03",103,13,71,243,5115,0.954838709677419,2010,7042,466,208,18,3238,8,578,13,8
"1153","2020-06-04",106,13,65,220,5115,0.954838709677419,2010,7042,466,208,13,3251,6,584,12,6
"1154","2020-06-05",92,13,62,201,5115,0.954838709677419,2010,7042,466,208,21,3272,3,587,18,3
"1155","2020-06-06",77,13,73,186,5115,0.954838709677419,2010,7042,466,208,16,3288,7,594,13,7
"1156","2020-06-07",69,13,71,181,5115,0.954838709677419,2010,7042,466,208,14,3302,2,596,12,2
"1157","2020-03-13",1,14,18,12,4881,0.938537185003073,2085,7063,461,329,4,18,2,11,2,2
"1158","2020-03-14",3,14,19,19,4881,0.938537185003073,2085,7063,461,329,9,27,NA,NA,6,NA
"1159","2020-03-15",4,14,17,28,4881,0.938537185003073,2085,7063,461,329,7,34,3,14,4,3
"1160","2020-03-16",2,14,16,40,4881,0.938537185003073,2085,7063,461,329,9,43,6,20,5,6
"1161","2020-03-17",3,14,12,52,4881,0.938537185003073,2085,7063,461,329,12,55,10,30,6,10
"1162","2020-03-18",5,14,22,63,4881,0.938537185003073,2085,7063,461,329,17,72,13,43,13,13
"1163","2020-03-19",7,14,17,77,4881,0.938537185003073,2085,7063,461,329,20,92,8,51,14,8
"1164","2020-03-20",10,14,16,104,4881,0.938537185003073,2085,7063,461,329,17,109,13,64,12,13
"1165","2020-03-21",20,14,25,118,4881,0.938537185003073,2085,7063,461,329,22,131,10,74,14,10
"1166","2020-03-22",24,14,28,132,4881,0.938537185003073,2085,7063,461,329,22,153,11,85,21,11
"1167","2020-03-23",23,14,24,157,4881,0.938537185003073,2085,7063,461,329,22,175,10,95,17,10
"1168","2020-03-24",32,14,24,182,4881,0.938537185003073,2085,7063,461,329,25,200,15,110,16,15
"1169","2020-03-25",36,14,30,207,4881,0.938537185003073,2085,7063,461,329,27,227,16,126,18,16
"1170","2020-03-26",42,14,29,225,4881,0.938537185003073,2085,7063,461,329,29,256,17,143,25,17
"1171","2020-03-27",57,14,30,266,4881,0.938537185003073,2085,7063,461,329,27,283,6,149,25,6
"1172","2020-03-28",88,14,29,298,4881,0.938537185003073,2085,7063,461,329,29,312,4,153,21,4
"1173","2020-03-29",98,14,33,321,4881,0.938537185003073,2085,7063,461,329,42,354,5,158,35,5
"1174","2020-03-30",94,14,37,351,4881,0.938537185003073,2085,7063,461,329,31,385,9,167,22,9
"1175","2020-03-31",95,14,35,388,4881,0.938537185003073,2085,7063,461,329,40,425,6,173,33,6
"1176","2020-04-01",105,14,29,414,4881,0.938537185003073,2085,7063,461,329,35,460,15,188,30,15
"1177","2020-04-02",109,14,40,433,4881,0.938537185003073,2085,7063,461,329,46,506,10,198,37,10
"1178","2020-04-03",123,14,48,481,4881,0.938537185003073,2085,7063,461,329,36,542,14,212,32,14
"1179","2020-04-04",131,14,44,518,4881,0.938537185003073,2085,7063,461,329,56,598,8,220,47,8
"1180","2020-04-05",125,14,48,561,4881,0.938537185003073,2085,7063,461,329,37,635,5,225,29,5
"1181","2020-04-06",127,14,51,628,4881,0.938537185003073,2085,7063,461,329,41,676,13,238,32,13
"1182","2020-04-07",136,14,65,680,4881,0.938537185003073,2085,7063,461,329,39,715,15,253,32,15
"1183","2020-04-08",138,14,71,743,4881,0.938537185003073,2085,7063,461,329,32,747,8,261,26,8
"1184","2020-04-09",151,14,64,799,4881,0.938537185003073,2085,7063,461,329,36,783,5,266,30,5
"1185","2020-04-10",199,14,66,835,4881,0.938537185003073,2085,7063,461,329,36,819,9,275,35,9
"1186","2020-04-11",222,14,64,874,4881,0.938537185003073,2085,7063,461,329,40,859,14,289,33,14
"1187","2020-04-12",240,14,59,948,4881,0.938537185003073,2085,7063,461,329,52,911,3,292,44,3
"1188","2020-04-13",250,14,65,977,4881,0.938537185003073,2085,7063,461,329,45,956,5,297,39,5
"1189","2020-04-14",261,14,78,1040,4881,0.938537185003073,2085,7063,461,329,37,993,9,306,34,9
"1190","2020-04-15",287,14,83,1095,4881,0.938537185003073,2085,7063,461,329,39,1032,15,321,35,15
"1191","2020-04-16",309,14,86,1138,4881,0.938537185003073,2085,7063,461,329,45,1077,8,329,34,8
"1192","2020-04-17",383,14,87,1151,4881,0.938537185003073,2085,7063,461,329,36,1113,18,347,30,18
"1193","2020-04-18",387,14,95,1172,4881,0.938537185003073,2085,7063,461,329,52,1165,21,368,43,21
"1194","2020-04-19",402,14,94,1185,4881,0.938537185003073,2085,7063,461,329,36,1201,22,390,25,22
"1195","2020-04-20",413,14,94,1203,4881,0.938537185003073,2085,7063,461,329,49,1250,15,405,46,15
"1196","2020-04-21",406,14,86,1230,4881,0.938537185003073,2085,7063,461,329,54,1304,10,415,50,10
"1197","2020-04-22",396,14,84,1238,4881,0.938537185003073,2085,7063,461,329,43,1347,32,447,38,32
"1198","2020-04-23",388,14,99,1230,4881,0.938537185003073,2085,7063,461,329,58,1405,25,472,55,25
"1199","2020-04-24",416,14,104,1249,4881,0.938537185003073,2085,7063,461,329,40,1445,29,501,35,29
"1200","2020-04-25",417,14,91,1223,4881,0.938537185003073,2085,7063,461,329,37,1482,16,517,33,16
"1201","2020-04-26",408,14,94,1207,4881,0.938537185003073,2085,7063,461,329,53,1535,14,531,41,14
"1202","2020-04-27",408,14,94,1180,4881,0.938537185003073,2085,7063,461,329,46,1581,15,546,40,15
"1203","2020-04-28",396,14,88,1156,4881,0.938537185003073,2085,7063,461,329,43,1624,19,565,35,19
"1204","2020-04-29",409,14,83,1148,4881,0.938537185003073,2085,7063,461,329,43,1667,22,587,39,22
"1205","2020-04-30",425,14,76,1117,4881,0.938537185003073,2085,7063,461,329,38,1705,19,606,31,19
"1206","2020-05-01",462,14,72,1118,4881,0.938537185003073,2085,7063,461,329,50,1755,17,623,47,17
"1207","2020-05-02",453,14,64,1053,4881,0.938537185003073,2085,7063,461,329,44,1799,8,631,41,8
"1208","2020-05-03",398,14,62,1004,4881,0.938537185003073,2085,7063,461,329,48,1847,9,640,46,9
"1209","2020-05-04",375,14,69,951,4881,0.938537185003073,2085,7063,461,329,43,1890,5,645,38,5
"1210","2020-05-05",372,14,72,931,4881,0.938537185003073,2085,7063,461,329,37,1927,5,650,32,5
"1211","2020-05-06",363,14,68,875,4881,0.938537185003073,2085,7063,461,329,35,1962,6,656,32,6
"1212","2020-05-07",340,14,74,841,4881,0.938537185003073,2085,7063,461,329,43,2005,8,664,38,8
"1213","2020-05-08",302,14,81,823,4881,0.938537185003073,2085,7063,461,329,40,2045,11,675,36,11
"1214","2020-05-09",300,14,79,775,4881,0.938537185003073,2085,7063,461,329,38,2083,17,692,36,17
"1215","2020-05-10",277,14,87,735,4881,0.938537185003073,2085,7063,461,329,33,2116,8,700,28,8
"1216","2020-05-11",279,14,95,704,4881,0.938537185003073,2085,7063,461,329,35,2151,5,705,29,5
"1217","2020-05-12",258,14,83,649,4881,0.938537185003073,2085,7063,461,329,35,2186,4,709,32,4
"1218","2020-05-13",244,14,88,621,4881,0.938537185003073,2085,7063,461,329,35,2221,4,713,27,4
"1219","2020-05-14",238,14,78,605,4881,0.938537185003073,2085,7063,461,329,34,2255,13,726,30,13
"1220","2020-05-15",218,14,72,561,4881,0.938537185003073,2085,7063,461,329,34,2289,5,731,31,5
"1221","2020-05-16",217,14,79,531,4881,0.938537185003073,2085,7063,461,329,34,2323,6,737,31,6
"1222","2020-05-17",211,14,88,520,4881,0.938537185003073,2085,7063,461,329,30,2353,2,739,24,2
"1223","2020-05-18",193,14,80,494,4881,0.938537185003073,2085,7063,461,329,21,2374,12,751,18,12
"1224","2020-05-19",181,14,74,456,4881,0.938537185003073,2085,7063,461,329,20,2394,6,757,17,6
"1225","2020-05-20",176,14,69,428,4881,0.938537185003073,2085,7063,461,329,33,2427,1,758,25,1
"1226","2020-05-21",164,14,76,403,4881,0.938537185003073,2085,7063,461,329,23,2450,NA,NA,22,NA
"1227","2020-05-22",166,14,73,379,4881,0.938537185003073,2085,7063,461,329,30,2480,13,771,24,13
"1228","2020-05-23",157,14,82,358,4881,0.938537185003073,2085,7063,461,329,13,2493,11,782,12,11
"1229","2020-05-24",135,14,90,345,4881,0.938537185003073,2085,7063,461,329,50,2543,16,798,41,16
"1230","2020-05-25",128,14,89,323,4881,0.938537185003073,2085,7063,461,329,17,2560,11,809,13,11
"1231","2020-05-26",123,14,88,304,4881,0.938537185003073,2085,7063,461,329,25,2585,11,820,22,11
"1232","2020-05-27",118,14,92,299,4881,0.938537185003073,2085,7063,461,329,15,2600,16,836,15,16
"1233","2020-05-28",114,14,101,286,4881,0.938537185003073,2085,7063,461,329,12,2612,14,850,11,14
"1234","2020-05-29",109,14,103,280,4881,0.938537185003073,2085,7063,461,329,21,2633,17,867,20,17
"1235","2020-05-30",102,14,106,249,4881,0.938537185003073,2085,7063,461,329,12,2645,9,876,11,9
"1236","2020-05-31",94,14,104,250,4881,0.938537185003073,2085,7063,461,329,20,2665,10,886,18,10
"1237","2020-06-01",95,14,104,228,4881,0.938537185003073,2085,7063,461,329,20,2685,12,898,18,12
"1238","2020-06-02",84,14,92,223,4881,0.938537185003073,2085,7063,461,329,19,2704,4,902,17,4
"1239","2020-06-03",80,14,76,210,4881,0.938537185003073,2085,7063,461,329,25,2729,3,905,23,3
"1240","2020-06-04",76,14,74,209,4881,0.938537185003073,2085,7063,461,329,12,2741,2,907,9,2
"1241","2020-06-05",67,14,72,196,4881,0.938537185003073,2085,7063,461,329,18,2759,9,916,14,9
"1242","2020-06-06",79,14,69,195,4881,0.938537185003073,2085,7063,461,329,16,2775,5,921,14,5
"1243","2020-06-07",79,14,65,189,4881,0.938537185003073,2085,7063,461,329,22,2797,2,923,22,2
"1244","2020-03-14",4,15,32,44,2921,0.651146867511126,2010,5120,313,516,12,58,7,11,2,7
"1245","2020-03-15",5,15,41,58,2921,0.651146867511126,2010,5120,313,516,14,72,7,18,6,7
"1246","2020-03-16",8,15,50,71,2921,0.651146867511126,2010,5120,313,516,19,91,2,20,8,2
"1247","2020-03-17",9,15,52,92,2921,0.651146867511126,2010,5120,313,516,16,107,6,26,6,6
"1248","2020-03-18",11,15,51,121,2921,0.651146867511126,2010,5120,313,516,18,125,6,32,6,6
"1249","2020-03-19",14,15,49,137,2921,0.651146867511126,2010,5120,313,516,20,145,8,40,7,8
"1250","2020-03-20",21,15,62,167,2921,0.651146867511126,2010,5120,313,516,24,169,5,45,11,5
"1251","2020-03-21",23,15,56,181,2921,0.651146867511126,2010,5120,313,516,25,194,6,51,15,6
"1252","2020-03-22",38,15,47,205,2921,0.651146867511126,2010,5120,313,516,23,217,9,60,12,9
"1253","2020-03-23",37,15,48,227,2921,0.651146867511126,2010,5120,313,516,32,249,8,68,16,8
"1254","2020-03-24",42,15,49,250,2921,0.651146867511126,2010,5120,313,516,24,273,NA,NA,10,NA
"1255","2020-03-25",53,15,46,266,2921,0.651146867511126,2010,5120,313,516,23,296,4,72,17,4
"1256","2020-03-26",64,15,43,271,2921,0.651146867511126,2010,5120,313,516,28,324,5,77,18,5
"1257","2020-03-27",79,15,36,282,2921,0.651146867511126,2010,5120,313,516,35,359,6,83,18,6
"1258","2020-03-28",90,15,31,293,2921,0.651146867511126,2010,5120,313,516,31,390,6,89,16,6
"1259","2020-03-29",84,15,24,311,2921,0.651146867511126,2010,5120,313,516,32,422,7,96,19,7
"1260","2020-03-30",93,15,19,318,2921,0.651146867511126,2010,5120,313,516,38,460,6,102,24,6
"1261","2020-03-31",98,15,26,314,2921,0.651146867511126,2010,5120,313,516,30,490,11,113,18,11
"1262","2020-04-01",100,15,35,322,2921,0.651146867511126,2010,5120,313,516,33,523,7,120,18,7
"1263","2020-04-02",104,15,48,335,2921,0.651146867511126,2010,5120,313,516,31,554,6,126,16,6
"1264","2020-04-03",104,15,46,344,2921,0.651146867511126,2010,5120,313,516,44,598,2,128,28,2
"1265","2020-04-04",120,15,47,348,2921,0.651146867511126,2010,5120,313,516,33,631,NA,NA,18,NA
"1266","2020-04-05",121,15,62,342,2921,0.651146867511126,2010,5120,313,516,42,673,4,132,24,4
"1267","2020-04-06",117,15,71,348,2921,0.651146867511126,2010,5120,313,516,34,707,7,139,23,7
"1268","2020-04-07",113,15,85,357,2921,0.651146867511126,2010,5120,313,516,42,749,2,141,26,2
"1269","2020-04-08",115,15,88,357,2921,0.651146867511126,2010,5120,313,516,34,783,6,147,19,6
"1270","2020-04-09",110,15,107,369,2921,0.651146867511126,2010,5120,313,516,31,814,6,153,17,6
"1271","2020-04-10",134,15,125,370,2921,0.651146867511126,2010,5120,313,516,29,843,10,163,18,10
"1272","2020-04-11",121,15,122,395,2921,0.651146867511126,2010,5120,313,516,33,876,6,169,16,6
"1273","2020-04-12",116,15,121,414,2921,0.651146867511126,2010,5120,313,516,34,910,9,178,19,9
"1274","2020-04-13",116,15,107,429,2921,0.651146867511126,2010,5120,313,516,36,946,10,188,22,10
"1275","2020-04-14",119,15,90,447,2921,0.651146867511126,2010,5120,313,516,40,986,6,194,23,6
"1276","2020-04-15",114,15,77,442,2921,0.651146867511126,2010,5120,313,516,36,1022,1,195,15,1
"1277","2020-04-16",120,15,69,457,2921,0.651146867511126,2010,5120,313,516,32,1054,8,203,13,8
"1278","2020-04-17",126,15,67,479,2921,0.651146867511126,2010,5120,313,516,35,1089,15,218,18,15
"1279","2020-04-18",141,15,54,480,2921,0.651146867511126,2010,5120,313,516,37,1126,14,232,21,14
"1280","2020-04-19",149,15,45,478,2921,0.651146867511126,2010,5120,313,516,47,1173,10,242,27,10
"1281","2020-04-20",155,15,49,472,2921,0.651146867511126,2010,5120,313,516,42,1215,6,248,21,6
"1282","2020-04-21",151,15,60,480,2921,0.651146867511126,2010,5120,313,516,33,1248,5,253,18,5
"1283","2020-04-22",152,15,75,467,2921,0.651146867511126,2010,5120,313,516,39,1287,8,261,21,8
"1284","2020-04-23",153,15,79,482,2921,0.651146867511126,2010,5120,313,516,42,1329,7,268,24,7
"1285","2020-04-24",195,15,78,478,2921,0.651146867511126,2010,5120,313,516,25,1354,11,279,10,11
"1286","2020-04-25",193,15,104,474,2921,0.651146867511126,2010,5120,313,516,45,1399,7,286,27,7
"1287","2020-04-26",159,15,118,472,2921,0.651146867511126,2010,5120,313,516,34,1433,4,290,22,4
"1288","2020-04-27",146,15,111,468,2921,0.651146867511126,2010,5120,313,516,42,1475,8,298,21,8
"1289","2020-04-28",147,15,94,456,2921,0.651146867511126,2010,5120,313,516,28,1503,6,304,13,6
"1290","2020-04-29",148,15,110,449,2921,0.651146867511126,2010,5120,313,516,30,1533,10,314,18,10
"1291","2020-04-30",145,15,118,437,2921,0.651146867511126,2010,5120,313,516,38,1571,5,319,17,5
"1292","2020-05-01",134,15,99,453,2921,0.651146867511126,2010,5120,313,516,37,1608,11,330,20,11
"1293","2020-05-02",138,15,107,430,2921,0.651146867511126,2010,5120,313,516,33,1641,8,338,20,8
"1294","2020-05-03",148,15,106,428,2921,0.651146867511126,2010,5120,313,516,41,1682,7,345,16,7
"1295","2020-05-04",148,15,115,438,2921,0.651146867511126,2010,5120,313,516,39,1721,5,350,26,5
"1296","2020-05-05",145,15,102,439,2921,0.651146867511126,2010,5120,313,516,30,1751,9,359,15,9
"1297","2020-05-06",151,15,109,439,2921,0.651146867511126,2010,5120,313,516,31,1782,11,370,15,11
"1298","2020-05-07",152,15,124,459,2921,0.651146867511126,2010,5120,313,516,20,1802,9,379,12,9
"1299","2020-05-08",160,15,113,460,2921,0.651146867511126,2010,5120,313,516,40,1842,11,390,22,11
"1300","2020-05-09",161,15,97,448,2921,0.651146867511126,2010,5120,313,516,23,1865,9,399,14,9
"1301","2020-05-10",153,15,82,444,2921,0.651146867511126,2010,5120,313,516,38,1903,9,408,21,9
"1302","2020-05-11",157,15,78,440,2921,0.651146867511126,2010,5120,313,516,16,1919,4,412,11,4
"1303","2020-05-12",161,15,81,428,2921,0.651146867511126,2010,5120,313,516,33,1952,17,429,20,17
"1304","2020-05-13",166,15,89,411,2921,0.651146867511126,2010,5120,313,516,29,1981,8,437,19,8
"1305","2020-05-14",161,15,103,405,2921,0.651146867511126,2010,5120,313,516,25,2006,12,449,14,12
"1306","2020-05-15",140,15,132,409,2921,0.651146867511126,2010,5120,313,516,18,2024,10,459,8,10
"1307","2020-05-16",133,15,128,401,2921,0.651146867511126,2010,5120,313,516,23,2047,10,469,13,10
"1308","2020-05-17",136,15,118,407,2921,0.651146867511126,2010,5120,313,516,23,2070,10,479,13,10
"1309","2020-05-18",134,15,119,403,2921,0.651146867511126,2010,5120,313,516,24,2094,8,487,15,8
"1310","2020-05-19",125,15,114,384,2921,0.651146867511126,2010,5120,313,516,27,2121,9,496,13,9
"1311","2020-05-20",115,15,114,358,2921,0.651146867511126,2010,5120,313,516,21,2142,9,505,16,9
"1312","2020-05-21",121,15,101,363,2921,0.651146867511126,2010,5120,313,516,27,2169,16,521,16,16
"1313","2020-05-22",131,15,103,355,2921,0.651146867511126,2010,5120,313,516,21,2190,14,535,14,14
"1314","2020-05-23",134,15,92,351,2921,0.651146867511126,2010,5120,313,516,25,2215,8,543,15,8
"1315","2020-05-24",127,15,74,349,2921,0.651146867511126,2010,5120,313,516,21,2236,4,547,12,4
"1316","2020-05-25",124,15,69,338,2921,0.651146867511126,2010,5120,313,516,23,2259,11,558,15,11
"1317","2020-05-26",117,15,75,323,2921,0.651146867511126,2010,5120,313,516,24,2283,8,566,17,8
"1318","2020-05-27",125,15,82,314,2921,0.651146867511126,2010,5120,313,516,24,2307,9,575,19,9
"1319","2020-05-28",119,15,82,309,2921,0.651146867511126,2010,5120,313,516,17,2324,8,583,9,8
"1320","2020-05-29",121,15,83,299,2921,0.651146867511126,2010,5120,313,516,17,2341,3,586,11,3
"1321","2020-05-30",120,15,90,294,2921,0.651146867511126,2010,5120,313,516,11,2352,9,595,9,9
"1322","2020-05-31",112,15,79,282,2921,0.651146867511126,2010,5120,313,516,20,2372,8,603,11,8
"1323","2020-06-01",104,15,71,263,2921,0.651146867511126,2010,5120,313,516,11,2383,1,604,4,1
"1324","2020-06-02",99,15,72,246,2921,0.651146867511126,2010,5120,313,516,6,2389,6,610,2,6
"1325","2020-06-03",86,15,68,248,2921,0.651146867511126,2010,5120,313,516,15,2404,4,614,6,4
"1326","2020-06-04",86,15,55,231,2921,0.651146867511126,2010,5120,313,516,15,2419,3,617,11,3
"1327","2020-06-05",82,15,54,213,2921,0.651146867511126,2010,5120,313,516,9,2428,4,621,9,4
"1328","2020-06-06",79,15,68,198,2921,0.651146867511126,2010,5120,313,516,9,2437,2,623,6,2
"1329","2020-06-07",74,15,82,191,2921,0.651146867511126,2010,5120,313,516,5,2442,4,627,2,4
"1330","2020-03-07",1,16,0,0,5218,0.939632042928325,2070,7196,524,421,NA,NA,NA,NA,NA,NA
"1331","2020-03-08",1,16,0,0,5218,0.939632042928325,2070,7196,524,421,NA,NA,NA,NA,NA,NA
"1332","2020-03-09",0,16,0,0,5218,0.939632042928325,2070,7196,524,421,NA,NA,NA,NA,NA,NA
"1333","2020-03-10",0,16,0,0,5218,0.939632042928325,2070,7196,524,421,NA,NA,NA,NA,NA,NA
"1334","2020-03-11",0,16,0,0,5218,0.939632042928325,2070,7196,524,421,7,7,1,1,1,1
"1335","2020-03-12",0,16,0,0,5218,0.939632042928325,2070,7196,524,421,11,18,4,5,2,4
"1336","2020-03-13",0,16,0,0,5218,0.939632042928325,2070,7196,524,421,14,32,9,14,1,9
"1337","2020-03-14",1,16,19,17,5218,0.939632042928325,2070,7196,524,421,9,41,13,27,3,13
"1338","2020-03-15",2,16,20,21,5218,0.939632042928325,2070,7196,524,421,12,53,8,35,7,8
"1339","2020-03-16",1,16,21,31,5218,0.939632042928325,2070,7196,524,421,13,66,12,47,9,12
"1340","2020-03-17",3,16,20,41,5218,0.939632042928325,2070,7196,524,421,16,82,19,66,11,19
"1341","2020-03-18",5,16,17,51,5218,0.939632042928325,2070,7196,524,421,17,99,8,74,11,8
"1342","2020-03-19",5,16,23,64,5218,0.939632042928325,2070,7196,524,421,23,122,9,83,14,9
"1343","2020-03-20",9,16,25,71,5218,0.939632042928325,2070,7196,524,421,23,145,9,92,12,9
"1344","2020-03-21",16,16,21,80,5218,0.939632042928325,2070,7196,524,421,21,166,11,103,15,11
"1345","2020-03-22",22,16,26,92,5218,0.939632042928325,2070,7196,524,421,25,191,11,114,15,11
"1346","2020-03-23",24,16,37,108,5218,0.939632042928325,2070,7196,524,421,24,215,19,133,15,19
"1347","2020-03-24",24,16,37,127,5218,0.939632042928325,2070,7196,524,421,28,243,19,152,20,19
"1348","2020-03-25",25,16,43,147,5218,0.939632042928325,2070,7196,524,421,30,273,15,167,17,15
"1349","2020-03-26",33,16,45,170,5218,0.939632042928325,2070,7196,524,421,31,304,13,180,23,13
"1350","2020-03-27",39,16,48,189,5218,0.939632042928325,2070,7196,524,421,46,350,20,200,34,20
"1351","2020-03-28",43,16,47,218,5218,0.939632042928325,2070,7196,524,421,34,384,21,221,21,21
"1352","2020-03-29",65,16,50,233,5218,0.939632042928325,2070,7196,524,421,32,416,22,243,23,22
"1353","2020-03-30",67,16,59,287,5218,0.939632042928325,2070,7196,524,421,51,467,22,265,39,22
"1354","2020-03-31",66,16,55,317,5218,0.939632042928325,2070,7196,524,421,36,503,26,291,28,26
"1355","2020-04-01",75,16,66,343,5218,0.939632042928325,2070,7196,524,421,49,552,28,319,43,28
"1356","2020-04-02",81,16,66,388,5218,0.939632042928325,2070,7196,524,421,49,601,33,352,39,33
"1357","2020-04-03",112,16,79,423,5218,0.939632042928325,2070,7196,524,421,36,637,45,397,28,45
"1358","2020-04-04",122,16,90,459,5218,0.939632042928325,2070,7196,524,421,52,689,40,437,44,40
"1359","2020-04-05",113,16,85,500,5218,0.939632042928325,2070,7196,524,421,58,747,37,474,47,37
"1360","2020-04-06",128,16,73,545,5218,0.939632042928325,2070,7196,524,421,39,786,30,504,31,30
"1361","2020-04-07",139,16,70,572,5218,0.939632042928325,2070,7196,524,421,60,846,36,540,50,36
"1362","2020-04-08",150,16,52,625,5218,0.939632042928325,2070,7196,524,421,52,898,30,570,41,30
"1363","2020-04-09",162,16,56,674,5218,0.939632042928325,2070,7196,524,421,72,970,25,595,59,25
"1364","2020-04-10",195,16,55,698,5218,0.939632042928325,2070,7196,524,421,64,1034,21,616,52,21
"1365","2020-04-11",220,16,65,726,5218,0.939632042928325,2070,7196,524,421,52,1086,33,649,38,33
"1366","2020-04-12",236,16,73,784,5218,0.939632042928325,2070,7196,524,421,51,1137,39,688,46,39
"1367","2020-04-13",235,16,72,816,5218,0.939632042928325,2070,7196,524,421,65,1202,48,736,48,48
"1368","2020-04-14",241,16,69,845,5218,0.939632042928325,2070,7196,524,421,46,1248,37,773,37,37
"1369","2020-04-15",250,16,75,893,5218,0.939632042928325,2070,7196,524,421,57,1305,37,810,50,37
"1370","2020-04-16",259,16,76,915,5218,0.939632042928325,2070,7196,524,421,62,1367,28,838,50,28
"1371","2020-04-17",303,16,92,959,5218,0.939632042928325,2070,7196,524,421,53,1420,25,863,41,25
"1372","2020-04-18",319,16,93,1026,5218,0.939632042928325,2070,7196,524,421,57,1477,26,889,43,26
"1373","2020-04-19",302,16,81,1067,5218,0.939632042928325,2070,7196,524,421,70,1547,23,912,56,23
"1374","2020-04-20",306,16,90,1106,5218,0.939632042928325,2070,7196,524,421,61,1608,27,939,50,27
"1375","2020-04-21",305,16,96,1138,5218,0.939632042928325,2070,7196,524,421,51,1659,18,957,42,18
"1376","2020-04-22",306,16,97,1181,5218,0.939632042928325,2070,7196,524,421,76,1735,17,974,66,17
"1377","2020-04-23",326,16,89,1214,5218,0.939632042928325,2070,7196,524,421,78,1813,23,997,68,23
"1378","2020-04-24",399,16,93,1270,5218,0.939632042928325,2070,7196,524,421,69,1882,16,1013,59,16
"1379","2020-04-25",413,16,86,1287,5218,0.939632042928325,2070,7196,524,421,69,1951,24,1037,61,24
"1380","2020-04-26",428,16,86,1320,5218,0.939632042928325,2070,7196,524,421,68,2019,22,1059,54,22
"1381","2020-04-27",439,16,93,1379,5218,0.939632042928325,2070,7196,524,421,61,2080,37,1096,43,37
"1382","2020-04-28",445,16,108,1386,5218,0.939632042928325,2070,7196,524,421,56,2136,17,1113,48,17
"1383","2020-04-29",471,16,120,1399,5218,0.939632042928325,2070,7196,524,421,54,2190,27,1140,45,27
"1384","2020-04-30",478,16,134,1395,5218,0.939632042928325,2070,7196,524,421,47,2237,30,1170,40,30
"1385","2020-05-01",494,16,141,1364,5218,0.939632042928325,2070,7196,524,421,55,2292,13,1183,49,13
"1386","2020-05-02",508,16,137,1358,5218,0.939632042928325,2070,7196,524,421,47,2339,25,1208,39,25
"1387","2020-05-03",494,16,132,1356,5218,0.939632042928325,2070,7196,524,421,69,2408,27,1235,56,27
"1388","2020-05-04",472,16,136,1340,5218,0.939632042928325,2070,7196,524,421,45,2453,24,1259,34,24
"1389","2020-05-05",450,16,148,1321,5218,0.939632042928325,2070,7196,524,421,43,2496,29,1288,36,29
"1390","2020-05-06",438,16,139,1287,5218,0.939632042928325,2070,7196,524,421,38,2534,29,1317,31,29
"1391","2020-05-07",427,16,143,1245,5218,0.939632042928325,2070,7196,524,421,46,2580,22,1339,35,22
"1392","2020-05-08",473,16,126,1178,5218,0.939632042928325,2070,7196,524,421,49,2629,17,1356,43,17
"1393","2020-05-09",449,16,114,1096,5218,0.939632042928325,2070,7196,524,421,48,2677,25,1381,40,25
"1394","2020-05-10",405,16,101,1060,5218,0.939632042928325,2070,7196,524,421,32,2709,21,1402,29,21
"1395","2020-05-11",407,16,91,1023,5218,0.939632042928325,2070,7196,524,421,34,2743,25,1427,24,25
"1396","2020-05-12",386,16,97,974,5218,0.939632042928325,2070,7196,524,421,28,2771,28,1455,24,28
"1397","2020-05-13",379,16,101,905,5218,0.939632042928325,2070,7196,524,421,43,2814,19,1474,30,19
"1398","2020-05-14",368,16,127,841,5218,0.939632042928325,2070,7196,524,421,34,2848,20,1494,29,20
"1399","2020-05-15",320,16,130,793,5218,0.939632042928325,2070,7196,524,421,28,2876,20,1514,25,20
"1400","2020-05-16",299,16,122,751,5218,0.939632042928325,2070,7196,524,421,31,2907,33,1547,27,33
"1401","2020-05-17",268,16,123,684,5218,0.939632042928325,2070,7196,524,421,32,2939,30,1577,29,30
"1402","2020-05-18",253,16,124,634,5218,0.939632042928325,2070,7196,524,421,31,2970,33,1610,20,33
"1403","2020-05-19",242,16,119,580,5218,0.939632042928325,2070,7196,524,421,33,3003,23,1633,28,23
"1404","2020-05-20",225,16,121,555,5218,0.939632042928325,2070,7196,524,421,28,3031,28,1661,22,28
"1405","2020-05-21",197,16,109,529,5218,0.939632042928325,2070,7196,524,421,25,3056,22,1683,21,22
"1406","2020-05-22",171,16,115,490,5218,0.939632042928325,2070,7196,524,421,31,3087,18,1701,22,18
"1407","2020-05-23",186,16,108,446,5218,0.939632042928325,2070,7196,524,421,19,3106,37,1738,15,37
"1408","2020-05-24",175,16,113,415,5218,0.939632042928325,2070,7196,524,421,19,3125,26,1764,13,26
"1409","2020-05-25",169,16,117,386,5218,0.939632042928325,2070,7196,524,421,26,3151,19,1783,23,19
"1410","2020-05-26",162,16,116,351,5218,0.939632042928325,2070,7196,524,421,32,3183,18,1801,28,18
"1411","2020-05-27",154,16,127,335,5218,0.939632042928325,2070,7196,524,421,19,3202,24,1825,17,24
"1412","2020-05-28",159,16,121,324,5218,0.939632042928325,2070,7196,524,421,20,3222,25,1850,18,25
"1413","2020-05-29",137,16,125,299,5218,0.939632042928325,2070,7196,524,421,13,3235,16,1866,11,16
"1414","2020-05-30",132,16,116,265,5218,0.939632042928325,2070,7196,524,421,17,3252,21,1887,15,21
"1415","2020-05-31",116,16,109,251,5218,0.939632042928325,2070,7196,524,421,21,3273,34,1921,15,34
"1416","2020-06-01",99,16,111,227,5218,0.939632042928325,2070,7196,524,421,19,3292,24,1945,16,24
"1417","2020-06-02",93,16,102,197,5218,0.939632042928325,2070,7196,524,421,13,3305,26,1971,7,26
"1418","2020-06-03",88,16,101,188,5218,0.939632042928325,2070,7196,524,421,14,3319,24,1995,11,24
"1419","2020-06-04",75,16,77,173,5218,0.939632042928325,2070,7196,524,421,21,3340,37,2032,18,37
"1420","2020-06-05",72,16,80,159,5218,0.939632042928325,2070,7196,524,421,9,3349,23,2055,7,23
"1421","2020-06-06",56,16,75,152,5218,0.939632042928325,2070,7196,524,421,22,3371,22,2077,18,22
"1422","2020-06-07",54,16,70,143,5218,0.939632042928325,2070,7196,524,421,11,3382,18,2095,10,18
"1423","2020-03-14",2,17,14,17,3740,0.836363636363636,2010,5968,372,309,2,13,3,16,1,3
"1424","2020-03-15",4,17,13,26,3740,0.836363636363636,2010,5968,372,309,4,17,2,18,4,2
"1425","2020-03-16",5,17,17,31,3740,0.836363636363636,2010,5968,372,309,8,25,6,24,8,6
"1426","2020-03-17",4,17,24,41,3740,0.836363636363636,2010,5968,372,309,15,40,4,28,10,4
"1427","2020-03-18",6,17,28,55,3740,0.836363636363636,2010,5968,372,309,11,51,8,36,10,8
"1428","2020-03-19",8,17,34,77,3740,0.836363636363636,2010,5968,372,309,12,63,9,45,10,9
"1429","2020-03-20",12,17,32,94,3740,0.836363636363636,2010,5968,372,309,6,69,8,53,5,8
"1430","2020-03-21",14,17,35,102,3740,0.836363636363636,2010,5968,372,309,20,89,7,60,19,7
"1431","2020-03-22",22,17,32,115,3740,0.836363636363636,2010,5968,372,309,18,107,2,62,14,2
"1432","2020-03-23",22,17,42,135,3740,0.836363636363636,2010,5968,372,309,12,119,3,65,11,3
"1433","2020-03-24",22,17,40,147,3740,0.836363636363636,2010,5968,372,309,27,146,5,70,26,5
"1434","2020-03-25",27,17,50,163,3740,0.836363636363636,2010,5968,372,309,15,161,5,75,14,5
"1435","2020-03-26",30,17,37,176,3740,0.836363636363636,2010,5968,372,309,23,184,2,77,22,2
"1436","2020-03-27",34,17,30,193,3740,0.836363636363636,2010,5968,372,309,25,209,4,81,24,4
"1437","2020-03-28",34,17,24,210,3740,0.836363636363636,2010,5968,372,309,37,246,2,83,36,2
"1438","2020-03-29",47,17,37,226,3740,0.836363636363636,2010,5968,372,309,25,271,7,90,25,7
"1439","2020-03-30",57,17,37,248,3740,0.836363636363636,2010,5968,372,309,33,304,7,97,30,7
"1440","2020-03-31",59,17,40,264,3740,0.836363636363636,2010,5968,372,309,36,340,8,105,34,8
"1441","2020-04-01",65,17,49,287,3740,0.836363636363636,2010,5968,372,309,37,377,4,109,34,4
"1442","2020-04-02",77,17,50,297,3740,0.836363636363636,2010,5968,372,309,57,434,4,113,55,4
"1443","2020-04-03",82,17,57,317,3740,0.836363636363636,2010,5968,372,309,39,473,3,116,37,3
"1444","2020-04-04",103,17,54,347,3740,0.836363636363636,2010,5968,372,309,74,547,10,126,73,10
"1445","2020-04-05",107,17,50,383,3740,0.836363636363636,2010,5968,372,309,67,614,13,139,64,13
"1446","2020-04-06",103,17,44,429,3740,0.836363636363636,2010,5968,372,309,67,681,9,148,66,9
"1447","2020-04-07",116,17,52,457,3740,0.836363636363636,2010,5968,372,309,85,766,7,155,82,7
"1448","2020-04-08",113,17,57,481,3740,0.836363636363636,2010,5968,372,309,79,845,8,163,78,8
"1449","2020-04-09",113,17,51,494,3740,0.836363636363636,2010,5968,372,309,86,931,8,171,85,8
"1450","2020-04-10",149,17,43,538,3740,0.836363636363636,2010,5968,372,309,107,1038,5,176,103,5
"1451","2020-04-11",148,17,55,573,3740,0.836363636363636,2010,5968,372,309,106,1144,14,190,104,14
"1452","2020-04-12",159,17,73,572,3740,0.836363636363636,2010,5968,372,309,93,1237,4,194,91,4
"1453","2020-04-13",168,17,80,592,3740,0.836363636363636,2010,5968,372,309,107,1344,12,206,107,12
"1454","2020-04-14",163,17,78,628,3740,0.836363636363636,2010,5968,372,309,87,1431,5,211,87,5
"1455","2020-04-15",182,17,69,634,3740,0.836363636363636,2010,5968,372,309,127,1558,6,217,125,6
"1456","2020-04-16",189,17,79,669,3740,0.836363636363636,2010,5968,372,309,121,1679,17,234,117,17
"1457","2020-04-17",224,17,74,691,3740,0.836363636363636,2010,5968,372,309,130,1809,17,251,129,17
"1458","2020-04-18",248,17,77,707,3740,0.836363636363636,2010,5968,372,309,120,1929,9,260,116,9
"1459","2020-04-19",229,17,84,713,3740,0.836363636363636,2010,5968,372,309,112,2041,15,275,111,15
"1460","2020-04-20",230,17,86,725,3740,0.836363636363636,2010,5968,372,309,132,2173,9,284,129,9
"1461","2020-04-21",228,17,87,730,3740,0.836363636363636,2010,5968,372,309,140,2313,7,291,139,7
"1462","2020-04-22",233,17,102,744,3740,0.836363636363636,2010,5968,372,309,125,2438,12,303,123,12
"1463","2020-04-23",247,17,92,760,3740,0.836363636363636,2010,5968,372,309,167,2605,12,315,164,12
"1464","2020-04-24",270,17,98,749,3740,0.836363636363636,2010,5968,372,309,128,2733,13,328,127,13
"1465","2020-04-25",269,17,102,775,3740,0.836363636363636,2010,5968,372,309,103,2836,8,336,101,8
"1466","2020-04-26",282,17,116,761,3740,0.836363636363636,2010,5968,372,309,127,2963,8,344,126,8
"1467","2020-04-27",270,17,123,771,3740,0.836363636363636,2010,5968,372,309,132,3095,9,353,132,9
"1468","2020-04-28",271,17,112,751,3740,0.836363636363636,2010,5968,372,309,143,3238,19,372,141,19
"1469","2020-04-29",271,17,102,743,3740,0.836363636363636,2010,5968,372,309,81,3319,23,395,79,23
"1470","2020-04-30",256,17,112,727,3740,0.836363636363636,2010,5968,372,309,117,3436,12,407,115,12
"1471","2020-05-01",269,17,106,731,3740,0.836363636363636,2010,5968,372,309,134,3570,10,417,133,10
"1472","2020-05-02",275,17,110,734,3740,0.836363636363636,2010,5968,372,309,141,3711,7,424,138,7
"1473","2020-05-03",261,17,99,734,3740,0.836363636363636,2010,5968,372,309,126,3837,8,432,123,8
"1474","2020-05-04",263,17,92,707,3740,0.836363636363636,2010,5968,372,309,95,3932,13,445,92,13
"1475","2020-05-05",251,17,77,710,3740,0.836363636363636,2010,5968,372,309,84,4016,5,450,84,5
"1476","2020-05-06",240,17,87,690,3740,0.836363636363636,2010,5968,372,309,85,4101,11,461,83,11
"1477","2020-05-07",236,17,75,664,3740,0.836363636363636,2010,5968,372,309,101,4202,17,478,100,17
"1478","2020-05-08",244,17,85,655,3740,0.836363636363636,2010,5968,372,309,82,4284,7,485,80,7
"1479","2020-05-09",243,17,82,640,3740,0.836363636363636,2010,5968,372,309,76,4360,13,498,75,13
"1480","2020-05-10",212,17,76,633,3740,0.836363636363636,2010,5968,372,309,87,4447,8,506,87,8
"1481","2020-05-11",206,17,74,629,3740,0.836363636363636,2010,5968,372,309,53,4500,9,515,53,9
"1482","2020-05-12",201,17,68,616,3740,0.836363636363636,2010,5968,372,309,59,4559,2,517,59,2
"1483","2020-05-13",211,17,68,587,3740,0.836363636363636,2010,5968,372,309,66,4625,4,521,64,4
"1484","2020-05-14",217,17,70,558,3740,0.836363636363636,2010,5968,372,309,46,4671,4,525,45,4
"1485","2020-05-15",217,17,73,544,3740,0.836363636363636,2010,5968,372,309,58,4729,2,527,58,2
"1486","2020-05-16",212,17,83,532,3740,0.836363636363636,2010,5968,372,309,37,4766,3,530,37,3
"1487","2020-05-17",214,17,84,498,3740,0.836363636363636,2010,5968,372,309,34,4800,7,537,34,7
"1488","2020-05-18",207,17,89,483,3740,0.836363636363636,2010,5968,372,309,28,4828,4,541,27,4
"1489","2020-05-19",202,17,96,470,3740,0.836363636363636,2010,5968,372,309,24,4852,5,546,23,5
"1490","2020-05-20",186,17,93,461,3740,0.836363636363636,2010,5968,372,309,25,4877,6,552,24,6
"1491","2020-05-21",179,17,98,461,3740,0.836363636363636,2010,5968,372,309,37,4914,6,558,35,6
"1492","2020-05-22",153,17,104,449,3740,0.836363636363636,2010,5968,372,309,27,4941,3,561,27,3
"1493","2020-05-23",147,17,100,431,3740,0.836363636363636,2010,5968,372,309,17,4958,7,568,17,7
"1494","2020-05-24",140,17,92,405,3740,0.836363636363636,2010,5968,372,309,24,4982,16,584,22,16
"1495","2020-05-25",141,17,74,380,3740,0.836363636363636,2010,5968,372,309,7,4989,6,590,7,6
"1496","2020-05-26",142,17,61,372,3740,0.836363636363636,2010,5968,372,309,15,5004,4,594,15,4
"1497","2020-05-27",144,17,61,357,3740,0.836363636363636,2010,5968,372,309,10,5014,6,600,10,6
"1498","2020-05-28",142,17,61,355,3740,0.836363636363636,2010,5968,372,309,16,5030,10,610,16,10
"1499","2020-05-29",139,17,55,334,3740,0.836363636363636,2010,5968,372,309,14,5044,5,615,14,5
"1500","2020-05-30",137,17,41,321,3740,0.836363636363636,2010,5968,372,309,12,5056,14,629,12,14
"1501","2020-05-31",132,17,39,308,3740,0.836363636363636,2010,5968,372,309,13,5069,12,641,13,12
"1502","2020-06-01",125,17,41,293,3740,0.836363636363636,2010,5968,372,309,4,5073,11,652,4,11
"1503","2020-06-02",109,17,44,286,3740,0.836363636363636,2010,5968,372,309,10,5083,6,658,9,6
"1504","2020-06-03",97,17,55,271,3740,0.836363636363636,2010,5968,372,309,16,5099,5,663,16,5
"1505","2020-06-04",94,17,62,269,3740,0.836363636363636,2010,5968,372,309,5,5104,3,666,5,3
"1506","2020-06-05",86,17,58,252,3740,0.836363636363636,2010,5968,372,309,10,5114,NA,NA,10,NA
"1507","2020-06-06",85,17,51,245,3740,0.836363636363636,2010,5968,372,309,11,5125,2,668,11,2
"1508","2020-06-07",73,17,52,240,3740,0.836363636363636,2010,5968,372,309,10,5135,4,672,9,4
"1509","2020-03-13",1,18,30,10,4642,0.929771650150797,2100,6748,555,440,2,7,6,16,1,6
"1510","2020-03-14",1,18,38,16,4642,0.929771650150797,2100,6748,555,440,5,12,1,17,2,1
"1511","2020-03-15",1,18,50,20,4642,0.929771650150797,2100,6748,555,440,5,17,1,18,1,1
"1512","2020-03-16",2,18,53,27,4642,0.929771650150797,2100,6748,555,440,2,19,7,25,NA,7
"1513","2020-03-17",2,18,56,36,4642,0.929771650150797,2100,6748,555,440,10,29,4,29,8,4
"1514","2020-03-18",4,18,53,44,4642,0.929771650150797,2100,6748,555,440,2,31,NA,NA,2,NA
"1515","2020-03-19",7,18,65,54,4642,0.929771650150797,2100,6748,555,440,5,36,6,35,4,6
"1516","2020-03-20",8,18,59,66,4642,0.929771650150797,2100,6748,555,440,7,43,12,47,7,12
"1517","2020-03-21",16,18,64,77,4642,0.929771650150797,2100,6748,555,440,7,50,10,57,7,10
"1518","2020-03-22",18,18,55,85,4642,0.929771650150797,2100,6748,555,440,8,58,5,62,4,5
"1519","2020-03-23",18,18,42,103,4642,0.929771650150797,2100,6748,555,440,10,68,8,70,8,8
"1520","2020-03-24",19,18,45,121,4642,0.929771650150797,2100,6748,555,440,11,79,NA,NA,9,NA
"1521","2020-03-25",24,18,37,136,4642,0.929771650150797,2100,6748,555,440,18,97,10,80,14,10
"1522","2020-03-26",27,18,45,154,4642,0.929771650150797,2100,6748,555,440,21,118,7,87,19,7
"1523","2020-03-27",37,18,55,166,4642,0.929771650150797,2100,6748,555,440,14,132,12,99,13,12
"1524","2020-03-28",47,18,52,186,4642,0.929771650150797,2100,6748,555,440,30,162,13,112,27,13
"1525","2020-03-29",45,18,54,207,4642,0.929771650150797,2100,6748,555,440,22,184,2,114,20,2
"1526","2020-03-30",45,18,66,219,4642,0.929771650150797,2100,6748,555,440,25,209,10,124,23,10
"1527","2020-03-31",52,18,81,232,4642,0.929771650150797,2100,6748,555,440,32,241,5,129,25,5
"1528","2020-04-01",65,18,76,262,4642,0.929771650150797,2100,6748,555,440,39,280,4,133,36,4
"1529","2020-04-02",70,18,76,299,4642,0.929771650150797,2100,6748,555,440,33,313,2,135,30,2
"1530","2020-04-03",88,18,84,318,4642,0.929771650150797,2100,6748,555,440,38,351,2,137,37,2
"1531","2020-04-04",109,18,89,332,4642,0.929771650150797,2100,6748,555,440,49,400,4,141,47,4
"1532","2020-04-05",112,18,75,372,4642,0.929771650150797,2100,6748,555,440,52,452,7,148,50,7
"1533","2020-04-06",112,18,72,397,4642,0.929771650150797,2100,6748,555,440,30,482,12,160,30,12
"1534","2020-04-07",116,18,64,432,4642,0.929771650150797,2100,6748,555,440,65,547,12,172,62,12
"1535","2020-04-08",116,18,63,460,4642,0.929771650150797,2100,6748,555,440,59,606,7,179,58,7
"1536","2020-04-09",121,18,54,498,4642,0.929771650150797,2100,6748,555,440,81,687,3,182,81,3
"1537","2020-04-10",146,18,57,520,4642,0.929771650150797,2100,6748,555,440,76,763,8,190,74,8
"1538","2020-04-11",166,18,58,551,4642,0.929771650150797,2100,6748,555,440,68,831,11,201,67,11
"1539","2020-04-12",172,18,67,596,4642,0.929771650150797,2100,6748,555,440,63,894,10,211,61,10
"1540","2020-04-13",161,18,64,638,4642,0.929771650150797,2100,6748,555,440,79,973,8,219,76,8
"1541","2020-04-14",165,18,56,670,4642,0.929771650150797,2100,6748,555,440,94,1067,12,231,92,12
"1542","2020-04-15",170,18,53,688,4642,0.929771650150797,2100,6748,555,440,95,1162,18,249,90,18
"1543","2020-04-16",182,18,46,739,4642,0.929771650150797,2100,6748,555,440,105,1267,17,266,102,17
"1544","2020-04-17",229,18,46,792,4642,0.929771650150797,2100,6748,555,440,114,1381,19,285,109,19
"1545","2020-04-18",256,18,46,828,4642,0.929771650150797,2100,6748,555,440,113,1494,3,288,112,3
"1546","2020-04-19",246,18,58,854,4642,0.929771650150797,2100,6748,555,440,131,1625,7,295,129,7
"1547","2020-04-20",255,18,83,898,4642,0.929771650150797,2100,6748,555,440,138,1763,18,313,135,18
"1548","2020-04-21",266,18,91,938,4642,0.929771650150797,2100,6748,555,440,121,1884,22,335,118,22
"1549","2020-04-22",278,18,90,962,4642,0.929771650150797,2100,6748,555,440,92,1976,13,348,91,13
"1550","2020-04-23",283,18,91,1000,4642,0.929771650150797,2100,6748,555,440,156,2132,22,370,152,22
"1551","2020-04-24",310,18,85,1041,4642,0.929771650150797,2100,6748,555,440,121,2253,15,385,119,15
"1552","2020-04-25",289,18,87,1080,4642,0.929771650150797,2100,6748,555,440,136,2389,17,402,135,17
"1553","2020-04-26",346,18,77,1085,4642,0.929771650150797,2100,6748,555,440,160,2549,19,421,160,19
"1554","2020-04-27",346,18,73,1123,4642,0.929771650150797,2100,6748,555,440,146,2695,24,445,145,24
"1555","2020-04-28",343,18,100,1138,4642,0.929771650150797,2100,6748,555,440,153,2848,22,467,151,22
"1556","2020-04-29",342,18,102,1124,4642,0.929771650150797,2100,6748,555,440,151,2999,25,492,149,25
"1557","2020-04-30",346,18,84,1124,4642,0.929771650150797,2100,6748,555,440,113,3112,23,515,112,23
"1558","2020-05-01",419,18,85,1144,4642,0.929771650150797,2100,6748,555,440,120,3232,21,536,119,21
"1559","2020-05-02",432,18,88,1177,4642,0.929771650150797,2100,6748,555,440,129,3361,19,555,125,19
"1560","2020-05-03",381,18,73,1167,4642,0.929771650150797,2100,6748,555,440,133,3494,20,575,132,20
"1561","2020-05-04",379,18,74,1137,4642,0.929771650150797,2100,6748,555,440,114,3608,12,587,111,12
"1562","2020-05-05",368,18,67,1114,4642,0.929771650150797,2100,6748,555,440,111,3719,12,599,110,12
"1563","2020-05-06",376,18,79,1094,4642,0.929771650150797,2100,6748,555,440,141,3860,11,610,140,11
"1564","2020-05-07",371,18,87,1079,4642,0.929771650150797,2100,6748,555,440,93,3953,18,628,91,18
"1565","2020-05-08",380,18,87,1054,4642,0.929771650150797,2100,6748,555,440,105,4058,13,641,104,13
"1566","2020-05-09",406,18,82,1035,4642,0.929771650150797,2100,6748,555,440,96,4154,20,661,93,20
"1567","2020-05-10",343,18,94,996,4642,0.929771650150797,2100,6748,555,440,135,4289,30,691,132,30
"1568","2020-05-11",333,18,90,967,4642,0.929771650150797,2100,6748,555,440,88,4377,26,717,86,26
"1569","2020-05-12",331,18,78,932,4642,0.929771650150797,2100,6748,555,440,83,4460,15,732,82,15
"1570","2020-05-13",320,18,67,926,4642,0.929771650150797,2100,6748,555,440,80,4540,11,743,79,11
"1571","2020-05-14",320,18,64,894,4642,0.929771650150797,2100,6748,555,440,69,4609,13,756,69,13
"1572","2020-05-15",291,18,60,850,4642,0.929771650150797,2100,6748,555,440,54,4663,9,765,53,9
"1573","2020-05-16",284,18,61,814,4642,0.929771650150797,2100,6748,555,440,78,4741,11,776,78,11
"1574","2020-05-17",289,18,61,792,4642,0.929771650150797,2100,6748,555,440,57,4798,11,787,57,11
"1575","2020-05-18",280,18,68,733,4642,0.929771650150797,2100,6748,555,440,32,4830,9,796,32,9
"1576","2020-05-19",272,18,66,689,4642,0.929771650150797,2100,6748,555,440,52,4882,24,820,49,24
"1577","2020-05-20",269,18,60,645,4642,0.929771650150797,2100,6748,555,440,38,4920,11,831,36,11
"1578","2020-05-21",269,18,65,611,4642,0.929771650150797,2100,6748,555,440,40,4960,17,848,36,17
"1579","2020-05-22",270,18,77,570,4642,0.929771650150797,2100,6748,555,440,40,5000,11,859,40,11
"1580","2020-05-23",253,18,81,523,4642,0.929771650150797,2100,6748,555,440,38,5038,10,869,37,10
"1581","2020-05-24",228,18,81,484,4642,0.929771650150797,2100,6748,555,440,25,5063,7,876,25,7
"1582","2020-05-25",216,18,70,453,4642,0.929771650150797,2100,6748,555,440,20,5083,9,885,19,9
"1583","2020-05-26",201,18,73,417,4642,0.929771650150797,2100,6748,555,440,26,5109,6,891,26,6
"1584","2020-05-27",183,18,73,389,4642,0.929771650150797,2100,6748,555,440,19,5128,4,895,19,4
"1585","2020-05-28",161,18,75,348,4642,0.929771650150797,2100,6748,555,440,23,5151,2,897,23,2
"1586","2020-05-29",137,18,74,333,4642,0.929771650150797,2100,6748,555,440,12,5163,8,905,12,8
"1587","2020-05-30",127,18,83,320,4642,0.929771650150797,2100,6748,555,440,21,5184,5,910,21,5
"1588","2020-05-31",110,18,68,294,4642,0.929771650150797,2100,6748,555,440,15,5199,7,917,15,7
"1589","2020-06-01",97,18,68,276,4642,0.929771650150797,2100,6748,555,440,13,5212,2,919,13,2
"1590","2020-06-02",91,18,70,253,4642,0.929771650150797,2100,6748,555,440,11,5223,7,926,10,7
"1591","2020-06-03",85,18,58,235,4642,0.929771650150797,2100,6748,555,440,10,5233,7,933,10,7
"1592","2020-06-04",89,18,58,216,4642,0.929771650150797,2100,6748,555,440,6,5239,8,941,6,8
"1593","2020-06-05",82,18,60,208,4642,0.929771650150797,2100,6748,555,440,16,5255,4,945,16,4
"1594","2020-06-06",82,18,51,202,4642,0.929771650150797,2100,6748,555,440,5,5260,8,953,5,8
"1595","2020-06-07",76,18,50,174,4642,0.929771650150797,2100,6748,555,440,6,5266,3,956,6,3
"1596","2020-03-07",1,19,0,0,2176,0.696231617647059,2070,4722,194,204,NA,NA,NA,NA,NA,NA
"1597","2020-03-08",1,19,0,0,2176,0.696231617647059,2070,4722,194,204,NA,NA,NA,NA,NA,NA
"1598","2020-03-09",0,19,0,0,2176,0.696231617647059,2070,4722,194,204,NA,NA,NA,NA,NA,NA
"1599","2020-03-10",0,19,0,0,2176,0.696231617647059,2070,4722,194,204,NA,NA,NA,NA,NA,NA
"1600","2020-03-11",0,19,0,0,2176,0.696231617647059,2070,4722,194,204,10,10,4,4,NA,4
"1601","2020-03-12",0,19,0,0,2176,0.696231617647059,2070,4722,194,204,9,19,9,13,NA,9
"1602","2020-03-13",2,19,11,25,2176,0.696231617647059,2070,4722,194,204,8,27,6,19,NA,6
"1603","2020-03-14",2,19,14,31,2176,0.696231617647059,2070,4722,194,204,8,35,1,20,3,1
"1604","2020-03-15",3,19,12,34,2176,0.696231617647059,2070,4722,194,204,12,47,6,26,4,6
"1605","2020-03-16",3,19,10,48,2176,0.696231617647059,2070,4722,194,204,8,55,6,32,3,6
"1606","2020-03-17",5,19,11,57,2176,0.696231617647059,2070,4722,194,204,15,70,8,40,6,8
"1607","2020-03-18",7,19,15,64,2176,0.696231617647059,2070,4722,194,204,19,89,12,52,10,12
"1608","2020-03-19",8,19,14,78,2176,0.696231617647059,2070,4722,194,204,26,115,10,62,15,10
"1609","2020-03-20",13,19,14,88,2176,0.696231617647059,2070,4722,194,204,20,135,8,70,11,8
"1610","2020-03-21",22,19,13,95,2176,0.696231617647059,2070,4722,194,204,44,179,6,76,28,6
"1611","2020-03-22",29,19,12,97,2176,0.696231617647059,2070,4722,194,204,30,209,6,82,27,6
"1612","2020-03-23",33,19,15,99,2176,0.696231617647059,2070,4722,194,204,32,241,10,92,23,10
"1613","2020-03-24",32,19,19,102,2176,0.696231617647059,2070,4722,194,204,48,289,6,98,43,6
"1614","2020-03-25",35,19,21,110,2176,0.696231617647059,2070,4722,194,204,49,338,11,109,39,11
"1615","2020-03-26",42,19,27,123,2176,0.696231617647059,2070,4722,194,204,51,389,5,114,46,5
"1616","2020-03-27",50,19,27,123,2176,0.696231617647059,2070,4722,194,204,67,456,3,117,57,3
"1617","2020-03-28",49,19,24,128,2176,0.696231617647059,2070,4722,194,204,53,509,15,132,41,15
"1618","2020-03-29",41,19,24,132,2176,0.696231617647059,2070,4722,194,204,61,570,7,139,53,7
"1619","2020-03-30",41,19,25,145,2176,0.696231617647059,2070,4722,194,204,76,646,13,152,63,13
"1620","2020-03-31",47,19,30,154,2176,0.696231617647059,2070,4722,194,204,69,715,13,165,64,13
"1621","2020-04-01",45,19,38,171,2176,0.696231617647059,2070,4722,194,204,101,816,7,172,94,7
"1622","2020-04-02",44,19,38,183,2176,0.696231617647059,2070,4722,194,204,80,896,11,183,74,11
"1623","2020-04-03",45,19,34,183,2176,0.696231617647059,2070,4722,194,204,86,982,17,200,82,17
"1624","2020-04-04",46,19,37,205,2176,0.696231617647059,2070,4722,194,204,109,1091,28,228,100,28
"1625","2020-04-05",44,19,22,217,2176,0.696231617647059,2070,4722,194,204,114,1205,13,241,105,13
"1626","2020-04-06",51,19,26,231,2176,0.696231617647059,2070,4722,194,204,119,1324,10,251,110,10
"1627","2020-04-07",53,19,30,239,2176,0.696231617647059,2070,4722,194,204,118,1442,11,262,112,11
"1628","2020-04-08",62,19,39,244,2176,0.696231617647059,2070,4722,194,204,112,1554,23,285,104,23
"1629","2020-04-09",62,19,40,262,2176,0.696231617647059,2070,4722,194,204,116,1670,17,302,107,17
"1630","2020-04-10",63,19,42,282,2176,0.696231617647059,2070,4722,194,204,120,1790,12,314,113,12
"1631","2020-04-11",72,19,45,295,2176,0.696231617647059,2070,4722,194,204,96,1886,18,332,87,18
"1632","2020-04-12",94,19,55,304,2176,0.696231617647059,2070,4722,194,204,121,2007,19,351,113,19
"1633","2020-04-13",91,19,53,318,2176,0.696231617647059,2070,4722,194,204,99,2106,19,370,93,19
"1634","2020-04-14",91,19,55,339,2176,0.696231617647059,2070,4722,194,204,120,2226,22,392,110,22
"1635","2020-04-15",92,19,62,334,2176,0.696231617647059,2070,4722,194,204,107,2333,26,418,97,26
"1636","2020-04-16",91,19,74,354,2176,0.696231617647059,2070,4722,194,204,127,2460,26,444,118,26
"1637","2020-04-17",108,19,86,347,2176,0.696231617647059,2070,4722,194,204,91,2551,26,470,87,26
"1638","2020-04-18",108,19,89,343,2176,0.696231617647059,2070,4722,194,204,121,2672,18,488,107,18
"1639","2020-04-19",116,19,83,355,2176,0.696231617647059,2070,4722,194,204,142,2814,18,506,139,18
"1640","2020-04-20",122,19,67,354,2176,0.696231617647059,2070,4722,194,204,137,2951,25,531,127,25
"1641","2020-04-21",115,19,65,355,2176,0.696231617647059,2070,4722,194,204,79,3030,29,560,74,29
"1642","2020-04-22",121,19,61,367,2176,0.696231617647059,2070,4722,194,204,108,3138,24,584,101,24
"1643","2020-04-23",135,19,55,377,2176,0.696231617647059,2070,4722,194,204,128,3266,25,609,119,25
"1644","2020-04-24",133,19,40,388,2176,0.696231617647059,2070,4722,194,204,125,3391,7,616,120,7
"1645","2020-04-25",139,19,45,387,2176,0.696231617647059,2070,4722,194,204,96,3487,17,633,92,17
"1646","2020-04-26",130,19,56,394,2176,0.696231617647059,2070,4722,194,204,89,3576,15,648,83,15
"1647","2020-04-27",129,19,52,380,2176,0.696231617647059,2070,4722,194,204,110,3686,8,656,106,8
"1648","2020-04-28",127,19,62,366,2176,0.696231617647059,2070,4722,194,204,91,3777,5,661,84,5
"1649","2020-04-29",126,19,71,368,2176,0.696231617647059,2070,4722,194,204,107,3884,9,670,100,9
"1650","2020-04-30",122,19,71,379,2176,0.696231617647059,2070,4722,194,204,91,3975,10,680,82,10
"1651","2020-05-01",131,19,70,369,2176,0.696231617647059,2070,4722,194,204,53,4028,22,702,50,22
"1652","2020-05-02",129,19,65,383,2176,0.696231617647059,2070,4722,194,204,76,4104,10,712,71,10
"1653","2020-05-03",128,19,73,373,2176,0.696231617647059,2070,4722,194,204,39,4143,12,724,37,12
"1654","2020-05-04",123,19,81,371,2176,0.696231617647059,2070,4722,194,204,91,4234,17,741,84,17
"1655","2020-05-05",115,19,77,372,2176,0.696231617647059,2070,4722,194,204,60,4294,28,769,58,28
"1656","2020-05-06",114,19,85,379,2176,0.696231617647059,2070,4722,194,204,55,4349,12,781,51,12
"1657","2020-05-07",113,19,92,359,2176,0.696231617647059,2070,4722,194,204,47,4396,8,789,43,8
"1658","2020-05-08",115,19,96,355,2176,0.696231617647059,2070,4722,194,204,51,4447,13,802,47,13
"1659","2020-05-09",114,19,98,348,2176,0.696231617647059,2070,4722,194,204,42,4489,14,816,36,14
"1660","2020-05-10",107,19,94,336,2176,0.696231617647059,2070,4722,194,204,39,4528,15,831,35,15
"1661","2020-05-11",107,19,80,331,2176,0.696231617647059,2070,4722,194,204,35,4563,8,839,32,8
"1662","2020-05-12",108,19,88,330,2176,0.696231617647059,2070,4722,194,204,25,4588,2,841,23,2
"1663","2020-05-13",105,19,91,341,2176,0.696231617647059,2070,4722,194,204,26,4614,1,842,26,1
"1664","2020-05-14",107,19,75,337,2176,0.696231617647059,2070,4722,194,204,34,4648,9,851,31,9
"1665","2020-05-15",111,19,75,329,2176,0.696231617647059,2070,4722,194,204,28,4676,12,863,25,12
"1666","2020-05-16",112,19,66,329,2176,0.696231617647059,2070,4722,194,204,19,4695,18,881,12,18
"1667","2020-05-17",107,19,63,333,2176,0.696231617647059,2070,4722,194,204,32,4727,20,901,26,20
"1668","2020-05-18",107,19,61,316,2176,0.696231617647059,2070,4722,194,204,31,4758,12,913,26,12
"1669","2020-05-19",111,19,66,313,2176,0.696231617647059,2070,4722,194,204,17,4775,8,921,17,8
"1670","2020-05-20",108,19,66,306,2176,0.696231617647059,2070,4722,194,204,20,4795,13,934,18,13
"1671","2020-05-21",103,19,63,305,2176,0.696231617647059,2070,4722,194,204,20,4815,15,949,18,15
"1672","2020-05-22",96,19,61,288,2176,0.696231617647059,2070,4722,194,204,12,4827,21,970,11,21
"1673","2020-05-23",99,19,57,291,2176,0.696231617647059,2070,4722,194,204,13,4840,6,976,11,6
"1674","2020-05-24",89,19,56,277,2176,0.696231617647059,2070,4722,194,204,16,4856,7,983,11,7
"1675","2020-05-25",84,19,56,275,2176,0.696231617647059,2070,4722,194,204,23,4879,5,988,18,5
"1676","2020-05-26",82,19,54,268,2176,0.696231617647059,2070,4722,194,204,11,4890,9,997,9,9
"1677","2020-05-27",83,19,52,259,2176,0.696231617647059,2070,4722,194,204,20,4910,12,1009,15,12
"1678","2020-05-28",81,19,59,261,2176,0.696231617647059,2070,4722,194,204,15,4925,6,1015,12,6
"1679","2020-05-29",90,19,50,254,2176,0.696231617647059,2070,4722,194,204,11,4936,5,1020,8,5
"1680","2020-05-30",86,19,45,247,2176,0.696231617647059,2070,4722,194,204,9,4945,2,1022,6,2
"1681","2020-05-31",94,19,45,236,2176,0.696231617647059,2070,4722,194,204,12,4957,10,1032,11,10
"1682","2020-06-01",90,19,44,244,2176,0.696231617647059,2070,4722,194,204,11,4968,5,1037,11,5
"1683","2020-06-02",86,19,55,243,2176,0.696231617647059,2070,4722,194,204,13,4981,7,1044,12,7
"1684","2020-06-03",85,19,55,221,2176,0.696231617647059,2070,4722,194,204,13,4994,9,1053,10,9
"1685","2020-06-04",88,19,53,210,2176,0.696231617647059,2070,4722,194,204,10,5004,10,1063,9,10
"1686","2020-06-05",80,19,56,190,2176,0.696231617647059,2070,4722,194,204,8,5012,18,1081,6,18
"1687","2020-06-06",89,19,58,188,2176,0.696231617647059,2070,4722,194,204,7,5019,8,1089,5,8
"1688","2020-06-07",76,19,64,174,2176,0.696231617647059,2070,4722,194,204,6,5025,14,1103,5,14
"1689","2020-03-07",1,20,0,0,5071,0.976533228160126,2145,6964,497,290,NA,NA,NA,NA,NA,NA
"1690","2020-03-08",1,20,0,0,5071,0.976533228160126,2145,6964,497,290,NA,NA,NA,NA,NA,NA
"1691","2020-03-09",0,20,0,0,5071,0.976533228160126,2145,6964,497,290,NA,NA,NA,NA,NA,NA
"1692","2020-03-10",0,20,0,0,5071,0.976533228160126,2145,6964,497,290,NA,NA,NA,NA,NA,NA
"1693","2020-03-11",0,20,0,0,5071,0.976533228160126,2145,6964,497,290,3,3,NA,NA,NA,NA
"1694","2020-03-12",0,20,0,0,5071,0.976533228160126,2145,6964,497,290,3,6,NA,NA,1,NA
"1695","2020-03-13",1,20,17,6,5071,0.976533228160126,2145,6964,497,290,6,12,2,2,1,2
"1696","2020-03-14",3,20,18,7,5071,0.976533228160126,2145,6964,497,290,3,15,5,7,2,5
"1697","2020-03-15",3,20,32,16,5071,0.976533228160126,2145,6964,497,290,3,18,4,11,NA,4
"1698","2020-03-16",1,20,37,22,5071,0.976533228160126,2145,6964,497,290,5,23,10,21,2,10
"1699","2020-03-17",1,20,46,33,5071,0.976533228160126,2145,6964,497,290,6,29,5,26,5,5
"1700","2020-03-18",2,20,48,37,5071,0.976533228160126,2145,6964,497,290,3,32,4,30,2,4
"1701","2020-03-19",3,20,46,42,5071,0.976533228160126,2145,6964,497,290,12,44,4,34,11,4
"1702","2020-03-20",6,20,46,51,5071,0.976533228160126,2145,6964,497,290,10,54,3,37,9,3
"1703","2020-03-21",7,20,37,62,5071,0.976533228160126,2145,6964,497,290,15,69,3,40,8,3
"1704","2020-03-22",8,20,53,69,5071,0.976533228160126,2145,6964,497,290,8,77,1,41,6,1
"1705","2020-03-23",10,20,53,84,5071,0.976533228160126,2145,6964,497,290,12,89,5,46,9,5
"1706","2020-03-24",13,20,61,102,5071,0.976533228160126,2145,6964,497,290,6,95,7,53,6,7
"1707","2020-03-25",17,20,70,120,5071,0.976533228160126,2145,6964,497,290,20,115,2,55,16,2
"1708","2020-03-26",22,20,72,141,5071,0.976533228160126,2145,6964,497,290,18,133,7,62,16,7
"1709","2020-03-27",23,20,70,157,5071,0.976533228160126,2145,6964,497,290,23,156,5,67,21,5
"1710","2020-03-28",35,20,61,180,5071,0.976533228160126,2145,6964,497,290,24,180,8,75,22,8
"1711","2020-03-29",38,20,67,198,5071,0.976533228160126,2145,6964,497,290,27,207,4,79,26,4
"1712","2020-03-30",41,20,65,231,5071,0.976533228160126,2145,6964,497,290,35,242,5,84,34,5
"1713","2020-03-31",45,20,56,264,5071,0.976533228160126,2145,6964,497,290,37,279,5,89,34,5
"1714","2020-04-01",57,20,50,319,5071,0.976533228160126,2145,6964,497,290,44,323,2,91,39,2
"1715","2020-04-02",65,20,54,366,5071,0.976533228160126,2145,6964,497,290,40,363,5,96,35,5
"1716","2020-04-03",82,20,45,421,5071,0.976533228160126,2145,6964,497,290,39,402,5,101,38,5
"1717","2020-04-04",95,20,47,460,5071,0.976533228160126,2145,6964,497,290,48,450,7,108,43,7
"1718","2020-04-05",124,20,49,503,5071,0.976533228160126,2145,6964,497,290,50,500,8,116,48,8
"1719","2020-04-06",133,20,40,550,5071,0.976533228160126,2145,6964,497,290,83,583,15,131,81,15
"1720","2020-04-07",140,20,37,623,5071,0.976533228160126,2145,6964,497,290,71,654,17,148,65,17
"1721","2020-04-08",153,20,46,697,5071,0.976533228160126,2145,6964,497,290,57,711,10,158,54,10
"1722","2020-04-09",165,20,44,759,5071,0.976533228160126,2145,6964,497,290,79,790,16,174,76,16
"1723","2020-04-10",225,20,34,804,5071,0.976533228160126,2145,6964,497,290,70,860,12,186,67,12
"1724","2020-04-11",283,20,39,873,5071,0.976533228160126,2145,6964,497,290,91,951,7,193,87,7
"1725","2020-04-12",271,20,37,967,5071,0.976533228160126,2145,6964,497,290,90,1041,4,197,86,4
"1726","2020-04-13",281,20,38,1019,5071,0.976533228160126,2145,6964,497,290,98,1139,16,213,94,16
"1727","2020-04-14",302,20,34,1058,5071,0.976533228160126,2145,6964,497,290,107,1246,8,221,104,8
"1728","2020-04-15",312,20,36,1123,5071,0.976533228160126,2145,6964,497,290,103,1349,6,227,102,6
"1729","2020-04-16",328,20,49,1169,5071,0.976533228160126,2145,6964,497,290,72,1421,12,239,68,12
"1730","2020-04-17",409,20,62,1229,5071,0.976533228160126,2145,6964,497,290,123,1544,18,257,116,18
"1731","2020-04-18",396,20,59,1296,5071,0.976533228160126,2145,6964,497,290,111,1655,17,274,106,17
"1732","2020-04-19",393,20,67,1344,5071,0.976533228160126,2145,6964,497,290,102,1757,13,287,100,13
"1733","2020-04-20",397,20,62,1360,5071,0.976533228160126,2145,6964,497,290,112,1869,7,294,111,7
"1734","2020-04-21",392,20,60,1412,5071,0.976533228160126,2145,6964,497,290,102,1971,24,318,96,24
"1735","2020-04-22",411,20,46,1456,5071,0.976533228160126,2145,6964,497,290,142,2113,10,328,136,10
"1736","2020-04-23",421,20,51,1463,5071,0.976533228160126,2145,6964,497,290,132,2245,16,344,129,16
"1737","2020-04-24",470,20,49,1501,5071,0.976533228160126,2145,6964,497,290,107,2352,14,358,105,14
"1738","2020-04-25",528,20,54,1479,5071,0.976533228160126,2145,6964,497,290,108,2460,4,362,105,4
"1739","2020-04-26",497,20,60,1464,5071,0.976533228160126,2145,6964,497,290,124,2584,13,375,122,13
"1740","2020-04-27",473,20,61,1431,5071,0.976533228160126,2145,6964,497,290,113,2697,14,389,111,14
"1741","2020-04-28",487,20,60,1418,5071,0.976533228160126,2145,6964,497,290,119,2816,6,395,116,6
"1742","2020-04-29",481,20,72,1382,5071,0.976533228160126,2145,6964,497,290,106,2922,10,405,100,10
"1743","2020-04-30",473,20,85,1328,5071,0.976533228160126,2145,6964,497,290,123,3045,9,414,115,9
"1744","2020-05-01",488,20,81,1273,5071,0.976533228160126,2145,6964,497,290,110,3155,18,432,107,18
"1745","2020-05-02",437,20,82,1236,5071,0.976533228160126,2145,6964,497,290,146,3301,10,442,142,10
"1746","2020-05-03",408,20,67,1193,5071,0.976533228160126,2145,6964,497,290,120,3421,14,456,116,14
"1747","2020-05-04",410,20,54,1153,5071,0.976533228160126,2145,6964,497,290,102,3523,13,469,102,13
"1748","2020-05-05",394,20,53,1129,5071,0.976533228160126,2145,6964,497,290,75,3598,9,478,72,9
"1749","2020-05-06",374,20,57,1071,5071,0.976533228160126,2145,6964,497,290,94,3692,7,485,92,7
"1750","2020-05-07",366,20,53,1011,5071,0.976533228160126,2145,6964,497,290,107,3799,10,495,104,10
"1751","2020-05-08",341,20,66,954,5071,0.976533228160126,2145,6964,497,290,95,3894,11,506,92,11
"1752","2020-05-09",352,20,65,918,5071,0.976533228160126,2145,6964,497,290,88,3982,16,522,83,16
"1753","2020-05-10",344,20,72,887,5071,0.976533228160126,2145,6964,497,290,72,4054,7,529,71,7
"1754","2020-05-11",327,20,67,823,5071,0.976533228160126,2145,6964,497,290,80,4134,8,537,79,8
"1755","2020-05-12",309,20,43,800,5071,0.976533228160126,2145,6964,497,290,70,4204,14,551,69,14
"1756","2020-05-13",307,20,45,749,5071,0.976533228160126,2145,6964,497,290,71,4275,11,562,68,11
"1757","2020-05-14",302,20,45,709,5071,0.976533228160126,2145,6964,497,290,78,4353,10,572,76,10
"1758","2020-05-15",307,20,56,655,5071,0.976533228160126,2145,6964,497,290,69,4422,10,582,69,10
"1759","2020-05-16",304,20,56,604,5071,0.976533228160126,2145,6964,497,290,58,4480,10,592,57,10
"1760","2020-05-17",251,20,39,556,5071,0.976533228160126,2145,6964,497,290,66,4546,13,605,65,13
"1761","2020-05-18",237,20,56,506,5071,0.976533228160126,2145,6964,497,290,56,4602,16,621,53,16
"1762","2020-05-19",218,20,64,464,5071,0.976533228160126,2145,6964,497,290,45,4647,14,635,44,14
"1763","2020-05-20",210,20,66,418,5071,0.976533228160126,2145,6964,497,290,49,4696,13,648,48,13
"1764","2020-05-21",192,20,67,382,5071,0.976533228160126,2145,6964,497,290,37,4733,9,657,35,9
"1765","2020-05-22",164,20,75,347,5071,0.976533228160126,2145,6964,497,290,37,4770,11,668,35,11
"1766","2020-05-23",144,20,79,323,5071,0.976533228160126,2145,6964,497,290,41,4811,9,677,38,9
"1767","2020-05-24",127,20,84,282,5071,0.976533228160126,2145,6964,497,290,29,4840,15,692,29,15
"1768","2020-05-25",114,20,80,264,5071,0.976533228160126,2145,6964,497,290,25,4865,11,703,25,11
"1769","2020-05-26",113,20,77,251,5071,0.976533228160126,2145,6964,497,290,31,4896,13,716,30,13
"1770","2020-05-27",96,20,86,221,5071,0.976533228160126,2145,6964,497,290,28,4924,9,725,28,9
"1771","2020-05-28",94,20,89,210,5071,0.976533228160126,2145,6964,497,290,24,4948,20,745,23,20
"1772","2020-05-29",81,20,96,190,5071,0.976533228160126,2145,6964,497,290,26,4974,7,752,24,7
"1773","2020-05-30",78,20,93,171,5071,0.976533228160126,2145,6964,497,290,19,4993,20,772,19,20
"1774","2020-05-31",71,20,78,167,5071,0.976533228160126,2145,6964,497,290,21,5014,10,782,20,10
"1775","2020-06-01",62,20,68,150,5071,0.976533228160126,2145,6964,497,290,17,5031,8,790,17,8
"1776","2020-06-02",52,20,65,136,5071,0.976533228160126,2145,6964,497,290,15,5046,10,800,15,10
"1777","2020-06-03",54,20,67,126,5071,0.976533228160126,2145,6964,497,290,9,5055,16,816,9,16
"1778","2020-06-04",51,20,68,121,5071,0.976533228160126,2145,6964,497,290,11,5066,9,825,11,9
"1779","2020-06-05",44,20,71,111,5071,0.976533228160126,2145,6964,497,290,9,5075,9,834,9,9
"1780","2020-06-06",37,20,62,112,5071,0.976533228160126,2145,6964,497,290,14,5089,16,850,13,16
"1781","2020-06-07",38,20,52,102,5071,0.976533228160126,2145,6964,497,290,9,5098,9,859,8,9
