"","Date","Absents","Paramset","Infections_or_Exposed_per_day_Patient","Infections_or_Exposed_per_day_HCW","total_infections","nosocomial_proportion","PCR_pooled","LFD_pooled","HCW_symp_test","patient_symp_test","new_hcw_infs","cumulative_hcw_infs","new_pat_infs","cumulative_pats_infs","new_nosocomial_hcw_infs","new_nosocomial_pat_infs"
"1","2020-03-15",3,1,34,115,6232,0.718228498074454,0,0,570,349,25,115,7,35,11,7
"2","2020-03-16",9,1,28,143,6232,0.718228498074454,0,0,570,349,28,143,1,36,8,1
"3","2020-03-17",15,1,30,172,6232,0.718228498074454,0,0,570,349,29,172,6,42,12,6
"4","2020-03-18",20,1,45,205,6232,0.718228498074454,0,0,570,349,36,208,17,59,18,17
"5","2020-03-19",26,1,51,252,6232,0.718228498074454,0,0,570,349,54,262,9,68,30,9
"6","2020-03-20",36,1,54,279,6232,0.718228498074454,0,0,570,349,38,300,11,79,16,11
"7","2020-03-21",47,1,56,331,6232,0.718228498074454,0,0,570,349,56,356,17,96,25,17
"8","2020-03-22",58,1,54,375,6232,0.718228498074454,0,0,570,349,58,414,9,105,38,9
"9","2020-03-23",67,1,77,422,6232,0.718228498074454,0,0,570,349,69,483,27,132,42,27
"10","2020-03-24",71,1,78,486,6232,0.718228498074454,0,0,570,349,81,564,13,145,50,13
"11","2020-03-25",90,1,68,550,6232,0.718228498074454,0,0,570,349,89,653,7,152,73,7
"12","2020-03-26",109,1,61,599,6232,0.718228498074454,0,0,570,349,74,727,11,163,58,11
"13","2020-03-27",122,1,61,638,6232,0.718228498074454,0,0,570,349,70,797,11,174,43,11
"14","2020-03-28",130,1,56,672,6232,0.718228498074454,0,0,570,349,63,860,5,179,46,5
"15","2020-03-29",145,1,53,734,6232,0.718228498074454,0,0,570,349,98,958,7,186,66,7
"16","2020-03-30",164,1,53,790,6232,0.718228498074454,0,0,570,349,98,1056,7,193,79,7
"17","2020-03-31",194,1,69,845,6232,0.718228498074454,0,0,570,349,106,1162,20,213,83,20
"18","2020-04-01",197,1,79,888,6232,0.718228498074454,0,0,570,349,89,1251,23,236,60,23
"19","2020-04-02",198,1,71,941,6232,0.718228498074454,0,0,570,349,111,1362,11,247,87,11
"20","2020-04-03",206,1,75,967,6232,0.718228498074454,0,0,570,349,89,1451,14,261,72,14
"21","2020-04-04",223,1,70,1001,6232,0.718228498074454,0,0,570,349,109,1560,15,276,90,15
"22","2020-04-05",235,1,64,1043,6232,0.718228498074454,0,0,570,349,108,1668,11,287,86,11
"23","2020-04-06",241,1,88,1061,6232,0.718228498074454,0,0,570,349,115,1783,25,312,90,25
"24","2020-04-07",246,1,107,1095,6232,0.718228498074454,0,0,570,349,117,1900,25,337,98,25
"25","2020-04-08",275,1,101,1131,6232,0.718228498074454,0,0,570,349,121,2021,22,359,98,22
"26","2020-04-09",282,1,101,1148,6232,0.718228498074454,0,0,570,349,122,2143,14,373,101,14
"27","2020-04-10",298,1,110,1215,6232,0.718228498074454,0,0,570,349,148,2291,26,399,119,26
"28","2020-04-11",319,1,104,1284,6232,0.718228498074454,0,0,570,349,152,2443,13,412,130,13
"29","2020-04-12",330,1,104,1324,6232,0.718228498074454,0,0,570,349,144,2587,19,431,126,19
"30","2020-04-13",346,1,103,1390,6232,0.718228498074454,0,0,570,349,152,2739,15,446,123,15
"31","2020-04-14",358,1,98,1405,6232,0.718228498074454,0,0,570,349,121,2860,10,456,102,10
"32","2020-04-15",359,1,87,1474,6232,0.718228498074454,0,0,570,349,182,3042,14,470,157,14
"33","2020-04-16",390,1,100,1479,6232,0.718228498074454,0,0,570,349,116,3158,25,495,90,25
"34","2020-04-17",397,1,107,1471,6232,0.718228498074454,0,0,570,349,115,3273,22,517,97,22
"35","2020-04-18",420,1,122,1467,6232,0.718228498074454,0,0,570,349,112,3385,27,544,92,27
"36","2020-04-19",437,1,130,1452,6232,0.718228498074454,0,0,570,349,91,3476,30,574,71,30
"37","2020-04-20",437,1,124,1443,6232,0.718228498074454,0,0,570,349,120,3596,20,594,101,20
"38","2020-04-21",433,1,120,1429,6232,0.718228498074454,0,0,570,349,111,3707,22,616,95,22
"39","2020-04-22",447,1,128,1429,6232,0.718228498074454,0,0,570,349,123,3830,22,638,101,22
"40","2020-04-23",433,1,124,1412,6232,0.718228498074454,0,0,570,349,127,3957,22,660,108,22
"41","2020-04-24",422,1,134,1385,6232,0.718228498074454,0,0,570,349,117,4074,29,689,86,29
"42","2020-04-25",384,1,131,1348,6232,0.718228498074454,0,0,570,349,112,4186,25,714,93,25
"43","2020-04-26",368,1,117,1314,6232,0.718228498074454,0,0,570,349,104,4290,15,729,87,15
"44","2020-04-27",365,1,124,1258,6232,0.718228498074454,0,0,570,349,89,4379,30,759,70,30
"45","2020-04-28",371,1,120,1219,6232,0.718228498074454,0,0,570,349,87,4466,17,776,71,17
"46","2020-04-29",353,1,114,1205,6232,0.718228498074454,0,0,570,349,99,4565,14,790,78,14
"47","2020-04-30",349,1,104,1177,6232,0.718228498074454,0,0,570,349,102,4667,18,808,90,18
"48","2020-05-01",350,1,118,1124,6232,0.718228498074454,0,0,570,349,61,4728,32,840,55,32
"49","2020-05-02",356,1,131,1084,6232,0.718228498074454,0,0,570,349,73,4801,38,878,58,38
"50","2020-05-03",338,1,149,1050,6232,0.718228498074454,0,0,570,349,77,4878,38,916,57,38
"51","2020-05-04",327,1,148,1002,6232,0.718228498074454,0,0,570,349,63,4941,23,939,53,23
"52","2020-05-05",311,1,144,983,6232,0.718228498074454,0,0,570,349,73,5014,23,962,58,23
"53","2020-05-06",311,1,142,951,6232,0.718228498074454,0,0,570,349,80,5094,19,981,66,19
"54","2020-05-07",300,1,138,891,6232,0.718228498074454,0,0,570,349,57,5151,17,998,46,17
"55","2020-05-08",293,1,132,863,6232,0.718228498074454,0,0,570,349,61,5212,26,1024,49,26
"56","2020-05-09",276,1,123,823,6232,0.718228498074454,0,0,570,349,52,5264,28,1052,38,28
"57","2020-05-10",265,1,115,793,6232,0.718228498074454,0,0,570,349,48,5312,7,1059,38,7
"58","2020-05-11",262,1,107,743,6232,0.718228498074454,0,0,570,349,46,5358,17,1076,32,17
"59","2020-05-12",248,1,100,696,6232,0.718228498074454,0,0,570,349,29,5387,15,1091,20,15
"60","2020-05-13",222,1,97,658,6232,0.718228498074454,0,0,570,349,41,5428,18,1109,29,18
"61","2020-05-14",214,1,92,621,6232,0.718228498074454,0,0,570,349,46,5474,8,1117,29,8
"62","2020-05-15",200,1,89,583,6232,0.718228498074454,0,0,570,349,35,5509,17,1134,32,17
"63","2020-05-16",199,1,87,531,6232,0.718228498074454,0,0,570,349,26,5535,14,1148,18,14
"64","2020-05-17",200,1,98,487,6232,0.718228498074454,0,0,570,349,23,5558,22,1170,19,22
"65","2020-05-18",177,1,90,460,6232,0.718228498074454,0,0,570,349,30,5588,17,1187,19,17
"66","2020-05-19",162,1,89,414,6232,0.718228498074454,0,0,570,349,21,5609,8,1195,14,8
"67","2020-05-20",153,1,93,385,6232,0.718228498074454,0,0,570,349,18,5627,20,1215,12,20
"68","2020-05-21",140,1,96,359,6232,0.718228498074454,0,0,570,349,18,5645,20,1235,12,20
"69","2020-05-22",124,1,107,319,6232,0.718228498074454,0,0,570,349,13,5658,25,1260,8,25
"70","2020-05-23",108,1,108,289,6232,0.718228498074454,0,0,570,349,9,5667,30,1290,5,30
"71","2020-05-24",93,1,116,264,6232,0.718228498074454,0,0,570,349,15,5682,19,1309,11,19
"72","2020-05-25",85,1,99,248,6232,0.718228498074454,0,0,570,349,13,5695,10,1319,11,10
"73","2020-05-26",85,1,95,221,6232,0.718228498074454,0,0,570,349,11,5706,12,1331,2,12
"74","2020-05-27",71,1,103,204,6232,0.718228498074454,0,0,570,349,17,5723,27,1358,11,27
"75","2020-05-28",68,1,97,194,6232,0.718228498074454,0,0,570,349,16,5739,15,1373,7,15
"76","2020-05-29",64,1,100,192,6232,0.718228498074454,0,0,570,349,20,5759,16,1389,10,16
"77","2020-05-30",62,1,111,189,6232,0.718228498074454,0,0,570,349,18,5777,22,1411,9,22
"78","2020-05-31",58,1,110,180,6232,0.718228498074454,0,0,570,349,12,5789,23,1434,3,23
"79","2020-06-01",56,1,108,169,6232,0.718228498074454,0,0,570,349,11,5800,20,1454,6,20
"80","2020-06-02",47,1,96,162,6232,0.718228498074454,0,0,570,349,12,5812,10,1464,7,10
"81","2020-06-03",50,1,89,161,6232,0.718228498074454,0,0,570,349,15,5827,9,1473,8,9
"82","2020-06-04",48,1,83,161,6232,0.718228498074454,0,0,570,349,14,5841,12,1485,11,12
"83","2020-06-05",53,1,76,156,6232,0.718228498074454,0,0,570,349,6,5847,13,1498,3,13
"84","2020-06-06",47,1,77,156,6232,0.718228498074454,0,0,570,349,13,5860,16,1514,6,16
"85","2020-06-07",48,1,79,148,6232,0.718228498074454,0,0,570,349,6,5866,12,1526,2,12
"86","2020-03-14",1,2,11,48,3778,0.744044467972472,0,0,316,235,19,81,16,32,1,16
"87","2020-03-15",4,2,16,63,3778,0.744044467972472,0,0,316,235,25,106,9,41,7,9
"88","2020-03-16",4,2,10,81,3778,0.744044467972472,0,0,316,235,32,138,10,51,12,10
"89","2020-03-17",8,2,16,100,3778,0.744044467972472,0,0,316,235,23,161,14,65,7,14
"90","2020-03-18",12,2,32,124,3778,0.744044467972472,0,0,316,235,28,189,14,79,10,14
"91","2020-03-19",16,2,38,139,3778,0.744044467972472,0,0,316,235,28,217,16,95,14,16
"92","2020-03-20",20,2,42,161,3778,0.744044467972472,0,0,316,235,42,259,15,110,18,15
"93","2020-03-21",25,2,49,188,3778,0.744044467972472,0,0,316,235,30,289,9,119,12,9
"94","2020-03-22",26,2,46,203,3778,0.744044467972472,0,0,316,235,27,316,21,140,11,21
"95","2020-03-23",35,2,40,244,3778,0.744044467972472,0,0,316,235,40,356,12,152,19,12
"96","2020-03-24",41,2,34,259,3778,0.744044467972472,0,0,316,235,26,382,14,166,13,14
"97","2020-03-25",51,2,29,282,3778,0.744044467972472,0,0,316,235,34,416,13,179,14,13
"98","2020-03-26",59,2,28,286,3778,0.744044467972472,0,0,316,235,44,460,17,196,22,17
"99","2020-03-27",71,2,27,305,3778,0.744044467972472,0,0,316,235,41,501,7,203,20,7
"100","2020-03-28",71,2,30,336,3778,0.744044467972472,0,0,316,235,39,540,9,212,19,9
"101","2020-03-29",81,2,37,364,3778,0.744044467972472,0,0,316,235,37,577,12,224,23,12
"102","2020-03-30",84,2,38,383,3778,0.744044467972472,0,0,316,235,41,618,6,230,22,6
"103","2020-03-31",88,2,38,417,3778,0.744044467972472,0,0,316,235,39,657,20,250,21,20
"104","2020-04-01",90,2,33,438,3778,0.744044467972472,0,0,316,235,30,687,12,262,11,12
"105","2020-04-02",101,2,39,470,3778,0.744044467972472,0,0,316,235,40,727,19,281,18,19
"106","2020-04-03",107,2,42,477,3778,0.744044467972472,0,0,316,235,46,773,12,293,24,12
"107","2020-04-04",130,2,40,516,3778,0.744044467972472,0,0,316,235,35,808,13,306,13,13
"108","2020-04-05",136,2,47,539,3778,0.744044467972472,0,0,316,235,53,861,19,325,24,19
"109","2020-04-06",144,2,51,570,3778,0.744044467972472,0,0,316,235,39,900,20,345,17,20
"110","2020-04-07",146,2,49,564,3778,0.744044467972472,0,0,316,235,41,941,21,366,16,21
"111","2020-04-08",147,2,46,591,3778,0.744044467972472,0,0,316,235,49,990,35,401,18,35
"112","2020-04-09",144,2,45,615,3778,0.744044467972472,0,0,316,235,39,1029,28,429,16,28
"113","2020-04-10",147,2,44,629,3778,0.744044467972472,0,0,316,235,27,1056,18,447,9,18
"114","2020-04-11",136,2,44,651,3778,0.744044467972472,0,0,316,235,33,1089,24,471,18,24
"115","2020-04-12",149,2,63,647,3778,0.744044467972472,0,0,316,235,55,1144,17,488,28,17
"116","2020-04-13",151,2,78,655,3778,0.744044467972472,0,0,316,235,48,1192,29,517,17,29
"117","2020-04-14",170,2,83,671,3778,0.744044467972472,0,0,316,235,29,1221,23,540,10,23
"118","2020-04-15",185,2,76,695,3778,0.744044467972472,0,0,316,235,34,1255,23,563,10,23
"119","2020-04-16",196,2,67,688,3778,0.744044467972472,0,0,316,235,35,1290,15,578,16,15
"120","2020-04-17",195,2,61,690,3778,0.744044467972472,0,0,316,235,47,1337,23,601,18,23
"121","2020-04-18",209,2,54,681,3778,0.744044467972472,0,0,316,235,40,1377,33,634,21,33
"122","2020-04-19",205,2,47,703,3778,0.744044467972472,0,0,316,235,39,1416,18,652,19,18
"123","2020-04-20",213,2,45,715,3778,0.744044467972472,0,0,316,235,36,1452,35,687,15,35
"124","2020-04-21",202,2,55,718,3778,0.744044467972472,0,0,316,235,34,1486,28,715,9,28
"125","2020-04-22",193,2,63,710,3778,0.744044467972472,0,0,316,235,43,1529,34,749,15,34
"126","2020-04-23",191,2,65,712,3778,0.744044467972472,0,0,316,235,28,1557,21,770,9,21
"127","2020-04-24",200,2,66,702,3778,0.744044467972472,0,0,316,235,31,1588,23,793,15,23
"128","2020-04-25",187,2,81,708,3778,0.744044467972472,0,0,316,235,34,1622,28,821,12,28
"129","2020-04-26",182,2,73,695,3778,0.744044467972472,0,0,316,235,39,1661,22,843,13,22
"130","2020-04-27",183,2,74,694,3778,0.744044467972472,0,0,316,235,48,1709,34,877,21,34
"131","2020-04-28",186,2,77,686,3778,0.744044467972472,0,0,316,235,40,1749,17,894,21,17
"132","2020-04-29",187,2,80,691,3778,0.744044467972472,0,0,316,235,32,1781,29,923,11,29
"133","2020-04-30",180,2,79,693,3778,0.744044467972472,0,0,316,235,32,1813,27,950,9,27
"134","2020-05-01",173,2,86,670,3778,0.744044467972472,0,0,316,235,27,1840,29,979,9,29
"135","2020-05-02",180,2,85,658,3778,0.744044467972472,0,0,316,235,35,1875,21,1000,14,21
"136","2020-05-03",189,2,94,643,3778,0.744044467972472,0,0,316,235,28,1903,26,1026,11,26
"137","2020-05-04",181,2,93,618,3778,0.744044467972472,0,0,316,235,32,1935,33,1059,8,33
"138","2020-05-05",177,2,106,622,3778,0.744044467972472,0,0,316,235,32,1967,25,1084,11,25
"139","2020-05-06",177,2,121,606,3778,0.744044467972472,0,0,316,235,32,1999,32,1116,9,32
"140","2020-05-07",178,2,134,594,3778,0.744044467972472,0,0,316,235,34,2033,26,1142,13,26
"141","2020-05-08",182,2,135,571,3778,0.744044467972472,0,0,316,235,28,2061,31,1173,9,31
"142","2020-05-09",181,2,133,543,3778,0.744044467972472,0,0,316,235,43,2104,17,1190,12,17
"143","2020-05-10",169,2,138,527,3778,0.744044467972472,0,0,316,235,26,2130,38,1228,8,38
"144","2020-05-11",163,2,144,529,3778,0.744044467972472,0,0,316,235,22,2152,22,1250,6,22
"145","2020-05-12",166,2,137,518,3778,0.744044467972472,0,0,316,235,18,2170,23,1273,10,23
"146","2020-05-13",156,2,125,517,3778,0.744044467972472,0,0,316,235,25,2195,19,1292,8,19
"147","2020-05-14",153,2,109,491,3778,0.744044467972472,0,0,316,235,34,2229,25,1317,9,25
"148","2020-05-15",145,2,94,487,3778,0.744044467972472,0,0,316,235,24,2253,23,1340,8,23
"149","2020-05-16",142,2,91,468,3778,0.744044467972472,0,0,316,235,29,2282,23,1363,7,23
"150","2020-05-17",140,2,91,440,3778,0.744044467972472,0,0,316,235,20,2302,20,1383,9,20
"151","2020-05-18",142,2,92,427,3778,0.744044467972472,0,0,316,235,25,2327,19,1402,11,19
"152","2020-05-19",130,2,98,411,3778,0.744044467972472,0,0,316,235,28,2355,14,1416,13,14
"153","2020-05-20",125,2,101,399,3778,0.744044467972472,0,0,316,235,31,2386,23,1439,16,23
"154","2020-05-21",119,2,96,390,3778,0.744044467972472,0,0,316,235,20,2406,15,1454,8,15
"155","2020-05-22",117,2,94,375,3778,0.744044467972472,0,0,316,235,25,2431,29,1483,9,29
"156","2020-05-23",111,2,81,367,3778,0.744044467972472,0,0,316,235,19,2450,19,1502,5,19
"157","2020-05-24",104,2,84,370,3778,0.744044467972472,0,0,316,235,27,2477,26,1528,9,26
"158","2020-05-25",99,2,85,343,3778,0.744044467972472,0,0,316,235,25,2502,26,1554,9,26
"159","2020-05-26",103,2,70,330,3778,0.744044467972472,0,0,316,235,21,2523,24,1578,8,24
"160","2020-05-27",109,2,74,333,3778,0.744044467972472,0,0,316,235,22,2545,26,1604,15,26
"161","2020-05-28",105,2,83,310,3778,0.744044467972472,0,0,316,235,17,2562,24,1628,10,24
"162","2020-05-29",98,2,79,309,3778,0.744044467972472,0,0,316,235,19,2581,25,1653,7,25
"163","2020-05-30",97,2,77,292,3778,0.744044467972472,0,0,316,235,18,2599,23,1676,6,23
"164","2020-05-31",94,2,73,284,3778,0.744044467972472,0,0,316,235,23,2622,28,1704,13,28
"165","2020-06-01",91,2,67,278,3778,0.744044467972472,0,0,316,235,14,2636,23,1727,6,23
"166","2020-06-02",78,2,66,272,3778,0.744044467972472,0,0,316,235,21,2657,12,1739,9,12
"167","2020-06-03",79,2,62,261,3778,0.744044467972472,0,0,316,235,17,2674,17,1756,7,17
"168","2020-06-04",80,2,60,231,3778,0.744044467972472,0,0,316,235,19,2693,11,1767,6,11
"169","2020-06-05",76,2,64,225,3778,0.744044467972472,0,0,316,235,17,2710,19,1786,5,19
"170","2020-06-06",75,2,53,208,3778,0.744044467972472,0,0,316,235,21,2731,12,1798,5,12
"171","2020-06-07",78,2,39,200,3778,0.744044467972472,0,0,316,235,10,2741,13,1811,8,13
"172","2020-03-14",1,3,61,74,3496,0.492276887871854,0,0,347,623,15,39,14,32,8,14
"173","2020-03-15",2,3,66,96,3496,0.492276887871854,0,0,347,623,21,60,13,45,12,13
"174","2020-03-16",5,3,73,124,3496,0.492276887871854,0,0,347,623,21,81,16,61,16,16
"175","2020-03-17",12,3,76,157,3496,0.492276887871854,0,0,347,623,37,118,6,67,27,6
"176","2020-03-18",19,3,81,187,3496,0.492276887871854,0,0,347,623,22,140,13,80,20,13
"177","2020-03-19",27,3,86,219,3496,0.492276887871854,0,0,347,623,49,189,11,91,44,11
"178","2020-03-20",36,3,88,241,3496,0.492276887871854,0,0,347,623,48,237,11,102,38,11
"179","2020-03-21",45,3,98,270,3496,0.492276887871854,0,0,347,623,42,279,5,107,36,5
"180","2020-03-22",58,3,105,301,3496,0.492276887871854,0,0,347,623,57,336,5,112,53,5
"181","2020-03-23",62,3,128,330,3496,0.492276887871854,0,0,347,623,61,397,17,129,53,17
"182","2020-03-24",68,3,130,358,3496,0.492276887871854,0,0,347,623,51,448,19,148,48,19
"183","2020-03-25",78,3,130,385,3496,0.492276887871854,0,0,347,623,61,509,24,172,52,24
"184","2020-03-26",83,3,137,413,3496,0.492276887871854,0,0,347,623,99,608,17,189,93,17
"185","2020-03-27",90,3,150,437,3496,0.492276887871854,0,0,347,623,84,692,28,217,76,28
"186","2020-03-28",101,3,133,473,3496,0.492276887871854,0,0,347,623,82,774,24,241,76,24
"187","2020-03-29",115,3,146,490,3496,0.492276887871854,0,0,347,623,80,854,27,268,73,27
"188","2020-03-30",128,3,161,514,3496,0.492276887871854,0,0,347,623,103,957,24,292,97,24
"189","2020-03-31",131,3,172,531,3496,0.492276887871854,0,0,347,623,78,1035,20,312,73,20
"190","2020-04-01",135,3,199,544,3496,0.492276887871854,0,0,347,623,120,1155,24,336,118,24
"191","2020-04-02",148,3,231,585,3496,0.492276887871854,0,0,347,623,84,1239,13,349,70,13
"192","2020-04-03",158,3,247,579,3496,0.492276887871854,0,0,347,623,160,1399,15,364,157,15
"193","2020-04-04",164,3,261,576,3496,0.492276887871854,0,0,347,623,152,1551,26,390,145,26
"194","2020-04-05",165,3,240,571,3496,0.492276887871854,0,0,347,623,127,1678,21,411,119,21
"195","2020-04-06",175,3,260,572,3496,0.492276887871854,0,0,347,623,134,1812,27,438,131,27
"196","2020-04-07",186,3,248,557,3496,0.492276887871854,0,0,347,623,139,1951,40,478,133,40
"197","2020-04-08",179,3,234,552,3496,0.492276887871854,0,0,347,623,185,2136,27,505,177,27
"198","2020-04-09",179,3,253,553,3496,0.492276887871854,0,0,347,623,155,2291,13,518,152,13
"199","2020-04-10",181,3,233,550,3496,0.492276887871854,0,0,347,623,189,2480,17,535,180,17
"200","2020-04-11",178,3,214,548,3496,0.492276887871854,0,0,347,623,177,2657,26,561,168,26
"201","2020-04-12",165,3,205,542,3496,0.492276887871854,0,0,347,623,167,2824,18,579,163,18
"202","2020-04-13",159,3,209,528,3496,0.492276887871854,0,0,347,623,130,2954,18,597,128,18
"203","2020-04-14",153,3,247,515,3496,0.492276887871854,0,0,347,623,160,3114,29,626,156,29
"204","2020-04-15",153,3,256,525,3496,0.492276887871854,0,0,347,623,159,3273,27,653,153,27
"205","2020-04-16",152,3,246,519,3496,0.492276887871854,0,0,347,623,186,3459,26,679,180,26
"206","2020-04-17",148,3,228,527,3496,0.492276887871854,0,0,347,623,143,3602,35,714,137,35
"207","2020-04-18",138,3,237,523,3496,0.492276887871854,0,0,347,623,160,3762,29,743,154,29
"208","2020-04-19",139,3,246,527,3496,0.492276887871854,0,0,347,623,150,3912,31,774,146,31
"209","2020-04-20",131,3,287,533,3496,0.492276887871854,0,0,347,623,143,4055,19,793,134,19
"210","2020-04-21",136,3,290,556,3496,0.492276887871854,0,0,347,623,136,4191,17,810,134,17
"211","2020-04-22",146,3,285,550,3496,0.492276887871854,0,0,347,623,149,4340,13,823,145,13
"212","2020-04-23",142,3,282,551,3496,0.492276887871854,0,0,347,623,112,4452,30,853,106,30
"213","2020-04-24",144,3,284,554,3496,0.492276887871854,0,0,347,623,93,4545,25,878,90,25
"214","2020-04-25",148,3,276,564,3496,0.492276887871854,0,0,347,623,103,4648,23,901,96,23
"215","2020-04-26",147,3,280,563,3496,0.492276887871854,0,0,347,623,80,4728,24,925,78,24
"216","2020-04-27",157,3,281,564,3496,0.492276887871854,0,0,347,623,97,4825,26,951,93,26
"217","2020-04-28",160,3,296,547,3496,0.492276887871854,0,0,347,623,91,4916,19,970,89,19
"218","2020-04-29",163,3,286,544,3496,0.492276887871854,0,0,347,623,79,4995,14,984,78,14
"219","2020-04-30",162,3,273,546,3496,0.492276887871854,0,0,347,623,64,5059,20,1004,60,20
"220","2020-05-01",153,3,251,556,3496,0.492276887871854,0,0,347,623,69,5128,20,1024,67,20
"221","2020-05-02",159,3,243,537,3496,0.492276887871854,0,0,347,623,68,5196,15,1039,66,15
"222","2020-05-03",170,3,237,537,3496,0.492276887871854,0,0,347,623,68,5264,12,1051,66,12
"223","2020-05-04",160,3,254,515,3496,0.492276887871854,0,0,347,623,38,5302,23,1074,37,23
"224","2020-05-05",150,3,263,508,3496,0.492276887871854,0,0,347,623,50,5352,19,1093,45,19
"225","2020-05-06",153,3,263,506,3496,0.492276887871854,0,0,347,623,42,5394,17,1110,39,17
"226","2020-05-07",150,3,267,489,3496,0.492276887871854,0,0,347,623,38,5432,18,1128,36,18
"227","2020-05-08",159,3,259,475,3496,0.492276887871854,0,0,347,623,36,5468,19,1147,33,19
"228","2020-05-09",146,3,241,476,3496,0.492276887871854,0,0,347,623,18,5486,19,1166,16,19
"229","2020-05-10",137,3,251,471,3496,0.492276887871854,0,0,347,623,34,5520,14,1180,33,14
"230","2020-05-11",143,3,261,467,3496,0.492276887871854,0,0,347,623,19,5539,10,1190,14,10
"231","2020-05-12",136,3,272,465,3496,0.492276887871854,0,0,347,623,22,5561,18,1208,19,18
"232","2020-05-13",123,3,296,455,3496,0.492276887871854,0,0,347,623,20,5581,16,1224,18,16
"233","2020-05-14",120,3,304,426,3496,0.492276887871854,0,0,347,623,21,5602,11,1235,18,11
"234","2020-05-15",116,3,293,429,3496,0.492276887871854,0,0,347,623,17,5619,21,1256,16,21
"235","2020-05-16",123,3,277,415,3496,0.492276887871854,0,0,347,623,17,5636,13,1269,13,13
"236","2020-05-17",124,3,283,390,3496,0.492276887871854,0,0,347,623,19,5655,26,1295,14,26
"237","2020-05-18",118,3,275,371,3496,0.492276887871854,0,0,347,623,15,5670,27,1322,12,27
"238","2020-05-19",123,3,261,360,3496,0.492276887871854,0,0,347,623,12,5682,27,1349,10,27
"239","2020-05-20",120,3,236,342,3496,0.492276887871854,0,0,347,623,14,5696,23,1372,13,23
"240","2020-05-21",119,3,213,334,3496,0.492276887871854,0,0,347,623,11,5707,21,1393,9,21
"241","2020-05-22",116,3,215,322,3496,0.492276887871854,0,0,347,623,7,5714,15,1408,6,15
"242","2020-05-23",115,3,243,320,3496,0.492276887871854,0,0,347,623,10,5724,26,1434,7,26
"243","2020-05-24",108,3,231,296,3496,0.492276887871854,0,0,347,623,7,5731,17,1451,7,17
"244","2020-05-25",100,3,209,297,3496,0.492276887871854,0,0,347,623,8,5739,18,1469,7,18
"245","2020-05-26",91,3,181,286,3496,0.492276887871854,0,0,347,623,9,5748,24,1493,7,24
"246","2020-05-27",89,3,185,278,3496,0.492276887871854,0,0,347,623,9,5757,25,1518,8,25
"247","2020-05-28",84,3,187,266,3496,0.492276887871854,0,0,347,623,10,5767,21,1539,8,21
"248","2020-05-29",77,3,206,244,3496,0.492276887871854,0,0,347,623,5,5772,13,1552,4,13
"249","2020-05-30",72,3,188,244,3496,0.492276887871854,0,0,347,623,5,5777,20,1572,4,20
"250","2020-05-31",70,3,208,244,3496,0.492276887871854,0,0,347,623,6,5783,18,1590,5,18
"251","2020-06-01",71,3,195,235,3496,0.492276887871854,0,0,347,623,3,5786,20,1610,1,20
"252","2020-06-02",69,3,196,228,3496,0.492276887871854,0,0,347,623,5,5791,16,1626,4,16
"253","2020-06-03",63,3,195,222,3496,0.492276887871854,0,0,347,623,8,5799,14,1640,5,14
"254","2020-06-04",66,3,189,221,3496,0.492276887871854,0,0,347,623,2,5801,15,1655,2,15
"255","2020-06-05",64,3,176,221,3496,0.492276887871854,0,0,347,623,3,5804,20,1675,2,20
"256","2020-06-06",59,3,163,216,3496,0.492276887871854,0,0,347,623,4,5808,12,1687,4,12
"257","2020-06-07",54,3,160,208,3496,0.492276887871854,0,0,347,623,3,5811,18,1705,2,18
"258","2020-03-13",1,4,37,32,3524,0.774404086265607,0,0,299,345,20,75,20,91,6,20
"259","2020-03-14",1,4,49,46,3524,0.774404086265607,0,0,299,345,31,106,22,113,15,22
"260","2020-03-15",3,4,56,68,3524,0.774404086265607,0,0,299,345,51,157,25,138,32,25
"261","2020-03-16",4,4,55,85,3524,0.774404086265607,0,0,299,345,56,213,9,147,35,9
"262","2020-03-17",6,4,55,109,3524,0.774404086265607,0,0,299,345,61,274,10,157,44,10
"263","2020-03-18",8,4,56,134,3524,0.774404086265607,0,0,299,345,82,356,34,191,61,34
"264","2020-03-19",13,4,57,148,3524,0.774404086265607,0,0,299,345,92,448,29,220,76,29
"265","2020-03-20",19,4,45,173,3524,0.774404086265607,0,0,299,345,133,581,28,248,113,28
"266","2020-03-21",29,4,41,199,3524,0.774404086265607,0,0,299,345,160,741,18,266,142,18
"267","2020-03-22",36,4,42,218,3524,0.774404086265607,0,0,299,345,188,929,8,274,164,8
"268","2020-03-23",42,4,39,231,3524,0.774404086265607,0,0,299,345,188,1117,26,300,167,26
"269","2020-03-24",54,4,29,253,3524,0.774404086265607,0,0,299,345,179,1296,12,312,154,12
"270","2020-03-25",63,4,32,269,3524,0.774404086265607,0,0,299,345,259,1555,39,351,241,39
"271","2020-03-26",66,4,45,280,3524,0.774404086265607,0,0,299,345,305,1860,42,393,289,42
"272","2020-03-27",71,4,54,310,3524,0.774404086265607,0,0,299,345,363,2223,27,420,335,27
"273","2020-03-28",69,4,69,338,3524,0.774404086265607,0,0,299,345,316,2539,50,470,302,50
"274","2020-03-29",75,4,59,350,3524,0.774404086265607,0,0,299,345,437,2976,22,492,423,22
"275","2020-03-30",79,4,59,379,3524,0.774404086265607,0,0,299,345,428,3404,54,546,412,54
"276","2020-03-31",82,4,69,395,3524,0.774404086265607,0,0,299,345,431,3835,55,601,419,55
"277","2020-04-01",85,4,70,438,3524,0.774404086265607,0,0,299,345,519,4354,40,641,502,40
"278","2020-04-02",89,4,79,463,3524,0.774404086265607,0,0,299,345,399,4753,18,659,382,18
"279","2020-04-03",92,4,72,477,3524,0.774404086265607,0,0,299,345,416,5169,21,680,406,22
"280","2020-04-04",113,4,67,488,3524,0.774404086265607,0,0,299,345,369,5538,30,710,367,30
"281","2020-04-05",120,4,63,512,3524,0.774404086265607,0,0,299,345,309,5847,54,764,301,54
"282","2020-04-06",131,4,79,512,3524,0.774404086265607,0,0,299,345,294,6141,56,820,287,56
"283","2020-04-07",132,4,78,527,3524,0.774404086265607,0,0,299,345,304,6445,42,862,301,42
"284","2020-04-08",139,4,86,564,3524,0.774404086265607,0,0,299,345,253,6698,27,889,248,27
"285","2020-04-09",147,4,82,582,3524,0.774404086265607,0,0,299,345,177,6875,40,929,169,40
"286","2020-04-10",154,4,84,590,3524,0.774404086265607,0,0,299,345,162,7037,42,971,158,42
"287","2020-04-11",149,4,96,611,3524,0.774404086265607,0,0,299,345,105,7142,60,1031,104,60
"288","2020-04-12",154,4,124,637,3524,0.774404086265607,0,0,299,345,81,7223,51,1082,77,51
"289","2020-04-13",154,4,125,645,3524,0.774404086265607,0,0,299,345,73,7296,27,1109,70,27
"290","2020-04-14",162,4,127,647,3524,0.774404086265607,0,0,299,345,42,7338,23,1132,41,23
"291","2020-04-15",167,4,114,661,3524,0.774404086265607,0,0,299,345,45,7383,53,1185,43,53
"292","2020-04-16",169,4,104,651,3524,0.774404086265607,0,0,299,345,41,7424,53,1238,38,53
"293","2020-04-17",176,4,95,643,3524,0.774404086265607,0,0,299,345,30,7454,32,1270,30,32
"294","2020-04-18",184,4,91,633,3524,0.774404086265607,0,0,299,345,29,7483,31,1301,26,31
"295","2020-04-19",183,4,82,632,3524,0.774404086265607,0,0,299,345,12,7495,28,1329,9,28
"296","2020-04-20",185,4,81,622,3524,0.774404086265607,0,0,299,345,20,7515,18,1347,20,18
"297","2020-04-21",193,4,77,623,3524,0.774404086265607,0,0,299,345,9,7524,10,1357,8,10
"298","2020-04-22",188,4,89,618,3524,0.774404086265607,0,0,299,345,12,7536,10,1367,9,10
"299","2020-04-23",190,4,88,592,3524,0.774404086265607,0,0,299,345,11,7547,22,1389,10,22
"300","2020-04-24",186,4,78,585,3524,0.774404086265607,0,0,299,345,8,7555,11,1400,8,11
"301","2020-04-25",179,4,76,567,3524,0.774404086265607,0,0,299,345,7,7562,12,1412,5,12
"302","2020-04-26",177,4,82,553,3524,0.774404086265607,0,0,299,345,11,7573,8,1420,8,8
"303","2020-04-27",175,4,93,550,3524,0.774404086265607,0,0,299,345,4,7577,8,1428,1,8
"304","2020-04-28",163,4,91,557,3524,0.774404086265607,0,0,299,345,4,7581,8,1436,2,8
"305","2020-04-29",160,4,75,550,3524,0.774404086265607,0,0,299,345,4,7585,9,1445,2,9
"306","2020-04-30",166,4,76,544,3524,0.774404086265607,0,0,299,345,2,7587,6,1451,2,6
"307","2020-05-01",158,4,87,554,3524,0.774404086265607,0,0,299,345,2,7589,28,1479,NA,28
"308","2020-05-02",153,4,101,555,3524,0.774404086265607,0,0,299,345,2,7591,37,1516,1,37
"309","2020-05-03",148,4,96,565,3524,0.774404086265607,0,0,299,345,4,7595,26,1542,3,26
"310","2020-05-04",145,4,99,557,3524,0.774404086265607,0,0,299,345,5,7600,27,1569,2,27
"311","2020-05-05",145,4,96,550,3524,0.774404086265607,0,0,299,345,4,7604,12,1581,4,12
"312","2020-05-06",150,4,109,547,3524,0.774404086265607,0,0,299,345,3,7607,15,1596,2,15
"313","2020-05-07",144,4,94,560,3524,0.774404086265607,0,0,299,345,5,7612,46,1642,NA,46
"314","2020-05-08",148,4,99,543,3524,0.774404086265607,0,0,299,345,3,7615,20,1662,2,20
"315","2020-05-09",146,4,88,539,3524,0.774404086265607,0,0,299,345,3,7618,63,1725,1,63
"316","2020-05-10",152,4,111,521,3524,0.774404086265607,0,0,299,345,3,7621,47,1772,1,47
"317","2020-05-11",154,4,118,518,3524,0.774404086265607,0,0,299,345,4,7625,25,1797,4,25
"318","2020-05-12",155,4,116,509,3524,0.774404086265607,0,0,299,345,1,7626,16,1813,NA,16
"319","2020-05-13",150,4,111,501,3524,0.774404086265607,0,0,299,345,2,7628,11,1824,2,11
"320","2020-05-14",142,4,105,489,3524,0.774404086265607,0,0,299,345,2,7630,15,1839,NA,15
"321","2020-05-15",146,4,102,477,3524,0.774404086265607,0,0,299,345,1,7631,61,1900,NA,61
"322","2020-05-16",143,4,117,478,3524,0.774404086265607,0,0,299,345,5,7636,56,1956,2,56
"323","2020-05-17",138,4,120,460,3524,0.774404086265607,0,0,299,345,5,7641,30,1986,2,30
"324","2020-05-18",144,4,108,426,3524,0.774404086265607,0,0,299,345,NA,NA,47,2033,NA,47
"325","2020-05-19",135,4,102,419,3524,0.774404086265607,0,0,299,345,2,7643,22,2055,1,22
"326","2020-05-20",132,4,106,405,3524,0.774404086265607,0,0,299,345,1,7644,34,2089,NA,34
"327","2020-05-21",131,4,104,395,3524,0.774404086265607,0,0,299,345,5,7649,39,2128,NA,39
"328","2020-05-22",122,4,103,380,3524,0.774404086265607,0,0,299,345,3,7652,50,2178,NA,50
"329","2020-05-23",122,4,103,367,3524,0.774404086265607,0,0,299,345,5,7657,51,2229,4,51
"330","2020-05-24",115,4,97,355,3524,0.774404086265607,0,0,299,345,3,7660,46,2275,2,46
"331","2020-05-25",99,4,82,339,3524,0.774404086265607,0,0,299,345,NA,NA,21,2296,NA,21
"332","2020-05-26",101,4,64,324,3524,0.774404086265607,0,0,299,345,1,7661,27,2323,NA,27
"333","2020-05-27",104,4,71,322,3524,0.774404086265607,0,0,299,345,3,7664,12,2335,1,12
"334","2020-05-28",101,4,71,309,3524,0.774404086265607,0,0,299,345,3,7667,16,2351,2,16
"335","2020-05-29",92,4,79,280,3524,0.774404086265607,0,0,299,345,NA,NA,23,2374,NA,23
"336","2020-05-30",88,4,91,282,3524,0.774404086265607,0,0,299,345,1,7668,31,2405,1,31
"337","2020-05-31",83,4,88,262,3524,0.774404086265607,0,0,299,345,1,7669,51,2456,1,51
"338","2020-06-01",85,4,83,253,3524,0.774404086265607,0,0,299,345,NA,NA,44,2500,NA,44
"339","2020-06-02",89,4,91,240,3524,0.774404086265607,0,0,299,345,1,7670,35,2535,NA,35
"340","2020-06-03",78,4,89,222,3524,0.774404086265607,0,0,299,345,1,7671,22,2557,NA,22
"341","2020-06-04",78,4,84,217,3524,0.774404086265607,0,0,299,345,3,7674,31,2588,3,31
"342","2020-06-05",77,4,80,204,3524,0.774404086265607,0,0,299,345,2,7676,35,2623,1,35
"343","2020-06-06",73,4,73,195,3524,0.774404086265607,0,0,299,345,NA,NA,22,2645,NA,22
"344","2020-06-07",72,4,72,187,3524,0.774404086265607,0,0,299,345,1,7677,43,2688,NA,43
"345","2020-03-14",2,5,26,52,2922,0.59719370294319,0,0,245,223,9,39,9,22,3,9
"346","2020-03-15",4,5,37,63,2922,0.59719370294319,0,0,245,223,5,44,5,27,2,5
"347","2020-03-16",6,5,33,90,2922,0.59719370294319,0,0,245,223,18,62,5,32,10,5
"348","2020-03-17",11,5,37,111,2922,0.59719370294319,0,0,245,223,24,86,4,36,19,4
"349","2020-03-18",14,5,36,130,2922,0.59719370294319,0,0,245,223,21,107,20,56,17,20
"350","2020-03-19",21,5,38,140,2922,0.59719370294319,0,0,245,223,23,130,15,71,15,15
"351","2020-03-20",27,5,34,151,2922,0.59719370294319,0,0,245,223,22,152,19,90,15,19
"352","2020-03-21",32,5,31,169,2922,0.59719370294319,0,0,245,223,18,170,10,100,12,10
"353","2020-03-22",36,5,34,188,2922,0.59719370294319,0,0,245,223,26,196,8,108,23,8
"354","2020-03-23",42,5,33,213,2922,0.59719370294319,0,0,245,223,34,230,15,123,26,15
"355","2020-03-24",46,5,39,229,2922,0.59719370294319,0,0,245,223,26,256,11,134,20,11
"356","2020-03-25",51,5,42,244,2922,0.59719370294319,0,0,245,223,28,284,18,152,22,18
"357","2020-03-26",52,5,47,264,2922,0.59719370294319,0,0,245,223,25,309,15,167,20,15
"358","2020-03-27",57,5,43,280,2922,0.59719370294319,0,0,245,223,32,341,24,191,27,24
"359","2020-03-28",61,5,46,307,2922,0.59719370294319,0,0,245,223,25,366,32,223,17,32
"360","2020-03-29",66,5,47,321,2922,0.59719370294319,0,0,245,223,42,408,21,244,39,21
"361","2020-03-30",72,5,56,338,2922,0.59719370294319,0,0,245,223,20,428,13,257,15,13
"362","2020-03-31",79,5,54,351,2922,0.59719370294319,0,0,245,223,37,465,17,274,29,17
"363","2020-04-01",92,5,52,352,2922,0.59719370294319,0,0,245,223,42,507,22,296,31,22
"364","2020-04-02",97,5,46,356,2922,0.59719370294319,0,0,245,223,35,542,13,309,31,13
"365","2020-04-03",100,5,52,371,2922,0.59719370294319,0,0,245,223,30,572,25,334,28,25
"366","2020-04-04",104,5,45,381,2922,0.59719370294319,0,0,245,223,37,609,14,348,28,14
"367","2020-04-05",105,5,50,397,2922,0.59719370294319,0,0,245,223,37,646,13,361,28,13
"368","2020-04-06",103,5,51,395,2922,0.59719370294319,0,0,245,223,48,694,13,374,40,13
"369","2020-04-07",100,5,58,400,2922,0.59719370294319,0,0,245,223,56,750,11,385,47,11
"370","2020-04-08",91,5,60,398,2922,0.59719370294319,0,0,245,223,47,797,12,397,38,12
"371","2020-04-09",92,5,52,406,2922,0.59719370294319,0,0,245,223,42,839,26,423,34,26
"372","2020-04-10",86,5,62,431,2922,0.59719370294319,0,0,245,223,33,872,24,447,26,24
"373","2020-04-11",89,5,59,444,2922,0.59719370294319,0,0,245,223,64,936,24,471,53,24
"374","2020-04-12",98,5,58,451,2922,0.59719370294319,0,0,245,223,52,988,24,495,40,24
"375","2020-04-13",103,5,59,467,2922,0.59719370294319,0,0,245,223,45,1033,19,514,33,19
"376","2020-04-14",107,5,61,479,2922,0.59719370294319,0,0,245,223,42,1075,13,527,33,13
"377","2020-04-15",115,5,79,490,2922,0.59719370294319,0,0,245,223,49,1124,16,543,42,16
"378","2020-04-16",114,5,95,504,2922,0.59719370294319,0,0,245,223,57,1181,23,566,49,23
"379","2020-04-17",129,5,91,501,2922,0.59719370294319,0,0,245,223,49,1230,44,610,39,44
"380","2020-04-18",130,5,71,516,2922,0.59719370294319,0,0,245,223,49,1279,36,646,41,36
"381","2020-04-19",135,5,80,529,2922,0.59719370294319,0,0,245,223,34,1313,47,693,28,47
"382","2020-04-20",144,5,81,544,2922,0.59719370294319,0,0,245,223,36,1349,26,719,26,26
"383","2020-04-21",156,5,82,537,2922,0.59719370294319,0,0,245,223,52,1401,32,751,37,32
"384","2020-04-22",159,5,78,532,2922,0.59719370294319,0,0,245,223,29,1430,28,779,20,28
"385","2020-04-23",171,5,82,525,2922,0.59719370294319,0,0,245,223,46,1476,53,832,37,53
"386","2020-04-24",167,5,91,512,2922,0.59719370294319,0,0,245,223,32,1508,43,875,22,43
"387","2020-04-25",165,5,100,505,2922,0.59719370294319,0,0,245,223,26,1534,56,931,21,56
"388","2020-04-26",154,5,84,510,2922,0.59719370294319,0,0,245,223,43,1577,29,960,30,29
"389","2020-04-27",151,5,68,518,2922,0.59719370294319,0,0,245,223,31,1608,35,995,23,35
"390","2020-04-28",146,5,71,500,2922,0.59719370294319,0,0,245,223,32,1640,32,1027,29,32
"391","2020-04-29",142,5,84,502,2922,0.59719370294319,0,0,245,223,29,1669,21,1048,20,21
"392","2020-04-30",137,5,81,485,2922,0.59719370294319,0,0,245,223,35,1704,39,1087,27,39
"393","2020-05-01",133,5,75,483,2922,0.59719370294319,0,0,245,223,31,1735,31,1118,27,31
"394","2020-05-02",134,5,72,459,2922,0.59719370294319,0,0,245,223,30,1765,9,1127,21,9
"395","2020-05-03",135,5,71,441,2922,0.59719370294319,0,0,245,223,23,1788,25,1152,18,25
"396","2020-05-04",123,5,75,432,2922,0.59719370294319,0,0,245,223,40,1828,33,1185,24,33
"397","2020-05-05",115,5,69,429,2922,0.59719370294319,0,0,245,223,25,1853,31,1216,16,31
"398","2020-05-06",109,5,69,416,2922,0.59719370294319,0,0,245,223,22,1875,22,1238,16,22
"399","2020-05-07",99,5,64,407,2922,0.59719370294319,0,0,245,223,21,1896,26,1264,16,26
"400","2020-05-08",106,5,66,397,2922,0.59719370294319,0,0,245,223,29,1925,26,1290,22,26
"401","2020-05-09",113,5,61,400,2922,0.59719370294319,0,0,245,223,24,1949,43,1333,14,43
"402","2020-05-10",113,5,61,406,2922,0.59719370294319,0,0,245,223,25,1974,40,1373,19,40
"403","2020-05-11",115,5,58,389,2922,0.59719370294319,0,0,245,223,14,1988,43,1416,10,43
"404","2020-05-12",111,5,52,372,2922,0.59719370294319,0,0,245,223,21,2009,29,1445,15,29
"405","2020-05-13",117,5,54,371,2922,0.59719370294319,0,0,245,223,15,2024,26,1471,11,26
"406","2020-05-14",116,5,57,370,2922,0.59719370294319,0,0,245,223,19,2043,21,1492,15,21
"407","2020-05-15",111,5,54,380,2922,0.59719370294319,0,0,245,223,22,2065,19,1511,17,19
"408","2020-05-16",97,5,57,371,2922,0.59719370294319,0,0,245,223,28,2093,23,1534,21,23
"409","2020-05-17",90,5,66,384,2922,0.59719370294319,0,0,245,223,32,2125,26,1560,21,26
"410","2020-05-18",89,5,73,376,2922,0.59719370294319,0,0,245,223,19,2144,33,1593,16,33
"411","2020-05-19",94,5,94,351,2922,0.59719370294319,0,0,245,223,23,2167,18,1611,14,18
"412","2020-05-20",91,5,89,350,2922,0.59719370294319,0,0,245,223,16,2183,21,1632,14,21
"413","2020-05-21",100,5,81,355,2922,0.59719370294319,0,0,245,223,20,2203,18,1650,16,18
"414","2020-05-22",98,5,68,340,2922,0.59719370294319,0,0,245,223,25,2228,11,1661,22,11
"415","2020-05-23",99,5,58,333,2922,0.59719370294319,0,0,245,223,22,2250,10,1671,15,10
"416","2020-05-24",97,5,65,319,2922,0.59719370294319,0,0,245,223,20,2270,30,1701,14,30
"417","2020-05-25",102,5,69,314,2922,0.59719370294319,0,0,245,223,17,2287,20,1721,13,20
"418","2020-05-26",99,5,68,296,2922,0.59719370294319,0,0,245,223,20,2307,27,1748,17,27
"419","2020-05-27",94,5,60,282,2922,0.59719370294319,0,0,245,223,15,2322,17,1765,11,17
"420","2020-05-28",85,5,48,277,2922,0.59719370294319,0,0,245,223,11,2333,21,1786,8,21
"421","2020-05-29",85,5,46,256,2922,0.59719370294319,0,0,245,223,17,2350,26,1812,15,26
"422","2020-05-30",85,5,45,244,2922,0.59719370294319,0,0,245,223,21,2371,27,1839,14,27
"423","2020-05-31",88,5,40,230,2922,0.59719370294319,0,0,245,223,16,2387,16,1855,13,16
"424","2020-06-01",85,5,35,209,2922,0.59719370294319,0,0,245,223,13,2400,24,1879,8,24
"425","2020-06-02",78,5,34,197,2922,0.59719370294319,0,0,245,223,18,2418,17,1896,15,17
"426","2020-06-03",75,5,40,191,2922,0.59719370294319,0,0,245,223,14,2432,31,1927,9,31
"427","2020-06-04",73,5,48,185,2922,0.59719370294319,0,0,245,223,16,2448,18,1945,10,18
"428","2020-06-05",64,5,41,179,2922,0.59719370294319,0,0,245,223,14,2462,13,1958,12,13
"429","2020-06-06",57,5,41,170,2922,0.59719370294319,0,0,245,223,9,2471,16,1974,8,16
"430","2020-06-07",56,5,44,155,2922,0.59719370294319,0,0,245,223,9,2480,13,1987,7,13
"431","2020-03-12",1,6,30,27,7481,0.922737601924876,0,0,667,498,15,21,7,16,1,7
"432","2020-03-13",1,6,43,46,7481,0.922737601924876,0,0,667,498,8,29,5,21,NA,5
"433","2020-03-14",1,6,41,72,7481,0.922737601924876,0,0,667,498,12,41,9,30,1,9
"434","2020-03-15",4,6,52,95,7481,0.922737601924876,0,0,667,498,8,49,14,44,NA,14
"435","2020-03-16",5,6,50,132,7481,0.922737601924876,0,0,667,498,15,64,6,50,3,6
"436","2020-03-17",11,6,47,182,7481,0.922737601924876,0,0,667,498,15,79,11,61,4,11
"437","2020-03-18",15,6,44,221,7481,0.922737601924876,0,0,667,498,27,106,5,66,11,5
"438","2020-03-19",17,6,39,262,7481,0.922737601924876,0,0,667,498,21,127,4,70,11,4
"439","2020-03-20",28,6,45,291,7481,0.922737601924876,0,0,667,498,30,157,5,75,14,5
"440","2020-03-21",35,6,48,329,7481,0.922737601924876,0,0,667,498,29,186,7,82,10,7
"441","2020-03-22",50,6,41,379,7481,0.922737601924876,0,0,667,498,34,220,5,87,15,5
"442","2020-03-23",68,6,49,429,7481,0.922737601924876,0,0,667,498,39,259,6,93,27,6
"443","2020-03-24",78,6,51,475,7481,0.922737601924876,0,0,667,498,37,296,16,109,26,16
"444","2020-03-25",91,6,64,518,7481,0.922737601924876,0,0,667,498,25,321,3,112,18,3
"445","2020-03-26",112,6,63,593,7481,0.922737601924876,0,0,667,498,38,359,14,126,22,14
"446","2020-03-27",132,6,56,652,7481,0.922737601924876,0,0,667,498,43,402,16,142,27,16
"447","2020-03-28",145,6,50,730,7481,0.922737601924876,0,0,667,498,45,447,22,164,26,22
"448","2020-03-29",159,6,70,851,7481,0.922737601924876,0,0,667,498,43,490,27,191,31,27
"449","2020-03-30",174,6,80,929,7481,0.922737601924876,0,0,667,498,45,535,34,225,23,34
"450","2020-03-31",199,6,97,1051,7481,0.922737601924876,0,0,667,498,46,581,27,252,26,27
"451","2020-04-01",222,6,112,1191,7481,0.922737601924876,0,0,667,498,41,622,11,263,25,11
"452","2020-04-02",242,6,131,1326,7481,0.922737601924876,0,0,667,498,44,666,17,280,24,17
"453","2020-04-03",267,6,116,1488,7481,0.922737601924876,0,0,667,498,36,702,28,308,25,28
"454","2020-04-04",299,6,106,1705,7481,0.922737601924876,0,0,667,498,41,743,33,341,23,33
"455","2020-04-05",336,6,93,1901,7481,0.922737601924876,0,0,667,498,44,787,27,368,19,27
"456","2020-04-06",365,6,100,2077,7481,0.922737601924876,0,0,667,498,34,821,13,381,16,13
"457","2020-04-07",418,6,108,2248,7481,0.922737601924876,0,0,667,498,28,849,11,392,14,11
"458","2020-04-08",461,6,111,2439,7481,0.922737601924876,0,0,667,498,31,880,11,403,24,11
"459","2020-04-09",508,6,113,2616,7481,0.922737601924876,0,0,667,498,38,918,31,434,22,31
"460","2020-04-10",551,6,117,2815,7481,0.922737601924876,0,0,667,498,31,949,15,449,15,15
"461","2020-04-11",618,6,113,2938,7481,0.922737601924876,0,0,667,498,27,976,14,463,12,14
"462","2020-04-12",657,6,130,3062,7481,0.922737601924876,0,0,667,498,33,1009,18,481,17,18
"463","2020-04-13",729,6,153,3134,7481,0.922737601924876,0,0,667,498,30,1039,23,504,13,23
"464","2020-04-14",789,6,143,3224,7481,0.922737601924876,0,0,667,498,21,1060,19,523,9,19
"465","2020-04-15",836,6,122,3253,7481,0.922737601924876,0,0,667,498,23,1083,21,544,11,21
"466","2020-04-16",874,6,133,3183,7481,0.922737601924876,0,0,667,498,23,1106,15,559,9,15
"467","2020-04-17",924,6,132,3100,7481,0.922737601924876,0,0,667,498,26,1132,39,598,6,39
"468","2020-04-18",946,6,122,3035,7481,0.922737601924876,0,0,667,498,29,1161,25,623,9,25
"469","2020-04-19",952,6,104,2890,7481,0.922737601924876,0,0,667,498,27,1188,44,667,16,44
"470","2020-04-20",940,6,99,2724,7481,0.922737601924876,0,0,667,498,29,1217,37,704,10,37
"471","2020-04-21",917,6,105,2514,7481,0.922737601924876,0,0,667,498,24,1241,25,729,9,25
"472","2020-04-22",876,6,120,2263,7481,0.922737601924876,0,0,667,498,31,1272,27,756,11,27
"473","2020-04-23",833,6,141,2076,7481,0.922737601924876,0,0,667,498,37,1309,14,770,11,14
"474","2020-04-24",777,6,143,1844,7481,0.922737601924876,0,0,667,498,38,1347,13,783,14,13
"475","2020-04-25",707,6,151,1626,7481,0.922737601924876,0,0,667,498,34,1381,11,794,14,11
"476","2020-04-26",658,6,136,1402,7481,0.922737601924876,0,0,667,498,33,1414,9,803,15,9
"477","2020-04-27",596,6,146,1203,7481,0.922737601924876,0,0,667,498,28,1442,15,818,10,15
"478","2020-04-28",515,6,127,1039,7481,0.922737601924876,0,0,667,498,40,1482,37,855,19,37
"479","2020-04-29",471,6,122,892,7481,0.922737601924876,0,0,667,498,31,1513,29,884,15,29
"480","2020-04-30",415,6,118,757,7481,0.922737601924876,0,0,667,498,29,1542,25,909,12,25
"481","2020-05-01",351,6,113,635,7481,0.922737601924876,0,0,667,498,30,1572,22,931,12,22
"482","2020-05-02",307,6,104,545,7481,0.922737601924876,0,0,667,498,28,1600,28,959,11,28
"483","2020-05-03",268,6,123,433,7481,0.922737601924876,0,0,667,498,34,1634,18,977,14,18
"484","2020-05-04",218,6,117,376,7481,0.922737601924876,0,0,667,498,30,1664,33,1010,11,33
"485","2020-05-05",180,6,111,325,7481,0.922737601924876,0,0,667,498,22,1686,25,1035,8,25
"486","2020-05-06",149,6,92,277,7481,0.922737601924876,0,0,667,498,40,1726,33,1068,13,33
"487","2020-05-07",129,6,122,241,7481,0.922737601924876,0,0,667,498,25,1751,19,1087,11,19
"488","2020-05-08",110,6,117,201,7481,0.922737601924876,0,0,667,498,23,1774,17,1104,8,17
"489","2020-05-09",93,6,151,168,7481,0.922737601924876,0,0,667,498,26,1800,17,1121,7,17
"490","2020-05-10",78,6,180,140,7481,0.922737601924876,0,0,667,498,22,1822,9,1130,14,9
"491","2020-05-11",73,6,174,119,7481,0.922737601924876,0,0,667,498,25,1847,30,1160,10,30
"492","2020-05-12",62,6,177,102,7481,0.922737601924876,0,0,667,498,29,1876,31,1191,13,31
"493","2020-05-13",50,6,156,86,7481,0.922737601924876,0,0,667,498,22,1898,21,1212,8,21
"494","2020-05-14",45,6,137,80,7481,0.922737601924876,0,0,667,498,30,1928,36,1248,13,36
"495","2020-05-15",36,6,132,77,7481,0.922737601924876,0,0,667,498,19,1947,25,1273,9,25
"496","2020-05-16",29,6,109,77,7481,0.922737601924876,0,0,667,498,23,1970,21,1294,9,21
"497","2020-05-17",21,6,97,75,7481,0.922737601924876,0,0,667,498,20,1990,31,1325,9,31
"498","2020-05-18",18,6,103,73,7481,0.922737601924876,0,0,667,498,19,2009,26,1351,6,26
"499","2020-05-19",20,6,98,64,7481,0.922737601924876,0,0,667,498,18,2027,12,1363,4,12
"500","2020-05-20",20,6,92,61,7481,0.922737601924876,0,0,667,498,17,2044,9,1372,10,9
"501","2020-05-21",20,6,100,56,7481,0.922737601924876,0,0,667,498,13,2057,25,1397,5,25
"502","2020-05-22",24,6,106,53,7481,0.922737601924876,0,0,667,498,24,2081,17,1414,10,17
"503","2020-05-23",23,6,101,51,7481,0.922737601924876,0,0,667,498,21,2102,39,1453,7,39
"504","2020-05-24",22,6,102,41,7481,0.922737601924876,0,0,667,498,16,2118,16,1469,8,16
"505","2020-05-25",22,6,96,37,7481,0.922737601924876,0,0,667,498,17,2135,15,1484,8,15
"506","2020-05-26",20,6,119,36,7481,0.922737601924876,0,0,667,498,11,2146,13,1497,3,13
"507","2020-05-27",20,6,125,36,7481,0.922737601924876,0,0,667,498,22,2168,13,1510,12,13
"508","2020-05-28",16,6,119,30,7481,0.922737601924876,0,0,667,498,15,2183,21,1531,3,21
"509","2020-05-29",12,6,114,29,7481,0.922737601924876,0,0,667,498,19,2202,27,1558,9,27
"510","2020-05-30",11,6,121,29,7481,0.922737601924876,0,0,667,498,18,2220,31,1589,7,31
"511","2020-05-31",10,6,127,29,7481,0.922737601924876,0,0,667,498,12,2232,26,1615,6,26
"512","2020-06-01",8,6,121,29,7481,0.922737601924876,0,0,667,498,16,2248,26,1641,9,26
"513","2020-06-02",8,6,121,24,7481,0.922737601924876,0,0,667,498,14,2262,12,1653,8,12
"514","2020-06-03",7,6,120,21,7481,0.922737601924876,0,0,667,498,14,2276,12,1665,11,12
"515","2020-06-04",8,6,111,21,7481,0.922737601924876,0,0,667,498,17,2293,10,1675,12,10
"516","2020-06-05",7,6,113,20,7481,0.922737601924876,0,0,667,498,14,2307,25,1700,8,25
"517","2020-06-06",7,6,113,20,7481,0.922737601924876,0,0,667,498,9,2316,12,1712,8,12
"518","2020-06-07",8,6,106,21,7481,0.922737601924876,0,0,667,498,12,2328,10,1722,10,10
"519","2020-03-14",2,7,25,103,3381,0.385684708666075,0,0,295,186,10,26,1,26,4,1
"520","2020-03-15",5,7,27,132,3381,0.385684708666075,0,0,295,186,9,35,NA,NA,2,NA
"521","2020-03-16",10,7,35,166,3381,0.385684708666075,0,0,295,186,10,45,8,34,5,8
"522","2020-03-17",18,7,31,195,3381,0.385684708666075,0,0,295,186,11,56,12,46,5,12
"523","2020-03-18",24,7,38,230,3381,0.385684708666075,0,0,295,186,7,63,18,64,4,18
"524","2020-03-19",31,7,41,267,3381,0.385684708666075,0,0,295,186,13,76,24,88,8,24
"525","2020-03-20",42,7,43,290,3381,0.385684708666075,0,0,295,186,13,89,14,102,7,14
"526","2020-03-21",46,7,45,321,3381,0.385684708666075,0,0,295,186,13,102,25,127,10,25
"527","2020-03-22",59,7,48,348,3381,0.385684708666075,0,0,295,186,20,122,25,152,12,25
"528","2020-03-23",69,7,44,375,3381,0.385684708666075,0,0,295,186,18,140,14,166,11,14
"529","2020-03-24",68,7,44,397,3381,0.385684708666075,0,0,295,186,25,165,5,171,13,5
"530","2020-03-25",87,7,46,410,3381,0.385684708666075,0,0,295,186,16,181,23,194,10,23
"531","2020-03-26",98,7,44,418,3381,0.385684708666075,0,0,295,186,29,210,17,211,17,17
"532","2020-03-27",100,7,51,426,3381,0.385684708666075,0,0,295,186,19,229,8,219,13,8
"533","2020-03-28",110,7,46,436,3381,0.385684708666075,0,0,295,186,24,253,11,230,14,11
"534","2020-03-29",118,7,41,452,3381,0.385684708666075,0,0,295,186,28,281,22,252,20,22
"535","2020-03-30",125,7,34,464,3381,0.385684708666075,0,0,295,186,32,313,13,265,19,13
"536","2020-03-31",140,7,30,481,3381,0.385684708666075,0,0,295,186,26,339,28,293,16,28
"537","2020-04-01",136,7,28,487,3381,0.385684708666075,0,0,295,186,28,367,33,326,22,33
"538","2020-04-02",127,7,26,493,3381,0.385684708666075,0,0,295,186,34,401,18,344,25,18
"539","2020-04-03",136,7,27,487,3381,0.385684708666075,0,0,295,186,30,431,37,381,21,37
"540","2020-04-04",137,7,33,491,3381,0.385684708666075,0,0,295,186,18,449,22,403,14,22
"541","2020-04-05",131,7,37,500,3381,0.385684708666075,0,0,295,186,30,479,33,436,21,33
"542","2020-04-06",125,7,39,490,3381,0.385684708666075,0,0,295,186,33,512,39,475,26,39
"543","2020-04-07",122,7,38,511,3381,0.385684708666075,0,0,295,186,35,547,17,492,28,17
"544","2020-04-08",125,7,42,513,3381,0.385684708666075,0,0,295,186,26,573,19,511,17,19
"545","2020-04-09",129,7,56,516,3381,0.385684708666075,0,0,295,186,39,612,33,544,26,33
"546","2020-04-10",129,7,50,519,3381,0.385684708666075,0,0,295,186,29,641,15,559,17,15
"547","2020-04-11",141,7,59,523,3381,0.385684708666075,0,0,295,186,37,678,20,579,28,20
"548","2020-04-12",147,7,63,526,3381,0.385684708666075,0,0,295,186,41,719,41,620,33,41
"549","2020-04-13",156,7,64,530,3381,0.385684708666075,0,0,295,186,43,762,49,669,37,49
"550","2020-04-14",154,7,63,551,3381,0.385684708666075,0,0,295,186,30,792,31,700,20,31
"551","2020-04-15",152,7,84,542,3381,0.385684708666075,0,0,295,186,39,831,28,728,30,28
"552","2020-04-16",156,7,80,539,3381,0.385684708666075,0,0,295,186,32,863,49,777,20,49
"553","2020-04-17",159,7,89,547,3381,0.385684708666075,0,0,295,186,31,894,23,800,23,23
"554","2020-04-18",154,7,89,543,3381,0.385684708666075,0,0,295,186,35,929,11,811,26,11
"555","2020-04-19",154,7,99,532,3381,0.385684708666075,0,0,295,186,31,960,8,819,21,8
"556","2020-04-20",155,7,88,527,3381,0.385684708666075,0,0,295,186,24,984,33,852,14,33
"557","2020-04-21",159,7,74,528,3381,0.385684708666075,0,0,295,186,32,1016,35,887,24,35
"558","2020-04-22",158,7,68,521,3381,0.385684708666075,0,0,295,186,34,1050,21,908,21,21
"559","2020-04-23",163,7,78,536,3381,0.385684708666075,0,0,295,186,30,1080,38,946,22,38
"560","2020-04-24",157,7,94,556,3381,0.385684708666075,0,0,295,186,23,1103,53,999,18,53
"561","2020-04-25",161,7,95,550,3381,0.385684708666075,0,0,295,186,30,1133,54,1053,20,54
"562","2020-04-26",157,7,96,535,3381,0.385684708666075,0,0,295,186,22,1155,32,1085,16,32
"563","2020-04-27",150,7,100,533,3381,0.385684708666075,0,0,295,186,20,1175,21,1106,13,21
"564","2020-04-28",154,7,99,545,3381,0.385684708666075,0,0,295,186,36,1211,16,1122,23,16
"565","2020-04-29",153,7,102,530,3381,0.385684708666075,0,0,295,186,27,1238,30,1152,22,30
"566","2020-04-30",151,7,88,520,3381,0.385684708666075,0,0,295,186,24,1262,39,1191,19,39
"567","2020-05-01",145,7,89,514,3381,0.385684708666075,0,0,295,186,35,1297,44,1235,23,44
"568","2020-05-02",142,7,74,518,3381,0.385684708666075,0,0,295,186,32,1329,24,1259,20,24
"569","2020-05-03",143,7,65,517,3381,0.385684708666075,0,0,295,186,24,1353,20,1279,18,20
"570","2020-05-04",144,7,67,507,3381,0.385684708666075,0,0,295,186,28,1381,33,1312,19,33
"571","2020-05-05",138,7,73,496,3381,0.385684708666075,0,0,295,186,37,1418,34,1346,23,34
"572","2020-05-06",141,7,83,484,3381,0.385684708666075,0,0,295,186,30,1448,32,1378,21,32
"573","2020-05-07",140,7,81,472,3381,0.385684708666075,0,0,295,186,34,1482,23,1401,23,23
"574","2020-05-08",140,7,92,456,3381,0.385684708666075,0,0,295,186,20,1502,14,1415,13,14
"575","2020-05-09",133,7,104,457,3381,0.385684708666075,0,0,295,186,34,1536,27,1442,20,27
"576","2020-05-10",128,7,103,440,3381,0.385684708666075,0,0,295,186,20,1556,44,1486,15,44
"577","2020-05-11",124,7,99,431,3381,0.385684708666075,0,0,295,186,22,1578,32,1518,15,32
"578","2020-05-12",127,7,88,416,3381,0.385684708666075,0,0,295,186,29,1607,25,1543,12,25
"579","2020-05-13",117,7,78,406,3381,0.385684708666075,0,0,295,186,33,1640,9,1552,24,9
"580","2020-05-14",109,7,69,391,3381,0.385684708666075,0,0,295,186,26,1666,33,1585,23,33
"581","2020-05-15",110,7,69,362,3381,0.385684708666075,0,0,295,186,24,1690,35,1620,18,35
"582","2020-05-16",105,7,65,350,3381,0.385684708666075,0,0,295,186,23,1713,19,1639,15,19
"583","2020-05-17",99,7,61,323,3381,0.385684708666075,0,0,295,186,11,1724,42,1681,6,42
"584","2020-05-18",97,7,49,320,3381,0.385684708666075,0,0,295,186,25,1749,17,1698,20,17
"585","2020-05-19",90,7,46,305,3381,0.385684708666075,0,0,295,186,25,1774,31,1729,17,31
"586","2020-05-20",90,7,46,291,3381,0.385684708666075,0,0,295,186,22,1796,24,1753,13,24
"587","2020-05-21",89,7,46,286,3381,0.385684708666075,0,0,295,186,33,1829,23,1776,24,23
"588","2020-05-22",84,7,46,283,3381,0.385684708666075,0,0,295,186,26,1855,25,1801,20,25
"589","2020-05-23",79,7,39,260,3381,0.385684708666075,0,0,295,186,14,1869,21,1822,9,21
"590","2020-05-24",81,7,35,260,3381,0.385684708666075,0,0,295,186,28,1897,12,1834,22,12
"591","2020-05-25",80,7,44,262,3381,0.385684708666075,0,0,295,186,22,1919,17,1851,18,17
"592","2020-05-26",73,7,39,258,3381,0.385684708666075,0,0,295,186,20,1939,7,1858,15,7
"593","2020-05-27",75,7,46,260,3381,0.385684708666075,0,0,295,186,16,1955,14,1872,13,14
"594","2020-05-28",83,7,46,263,3381,0.385684708666075,0,0,295,186,31,1986,18,1890,24,18
"595","2020-05-29",89,7,40,251,3381,0.385684708666075,0,0,295,186,14,2000,8,1898,11,8
"596","2020-05-30",91,7,39,246,3381,0.385684708666075,0,0,295,186,21,2021,3,1901,18,3
"597","2020-05-31",90,7,43,237,3381,0.385684708666075,0,0,295,186,18,2039,13,1914,16,13
"598","2020-06-01",85,7,46,230,3381,0.385684708666075,0,0,295,186,20,2059,30,1944,17,30
"599","2020-06-02",81,7,50,226,3381,0.385684708666075,0,0,295,186,17,2076,27,1971,15,27
"600","2020-06-03",72,7,46,218,3381,0.385684708666075,0,0,295,186,18,2094,20,1991,14,20
"601","2020-06-04",65,7,42,206,3381,0.385684708666075,0,0,295,186,13,2107,20,2011,7,20
"602","2020-06-05",56,7,41,194,3381,0.385684708666075,0,0,295,186,19,2126,20,2031,16,20
"603","2020-06-06",52,7,35,191,3381,0.385684708666075,0,0,295,186,21,2147,19,2050,20,19
"604","2020-06-07",51,7,30,177,3381,0.385684708666075,0,0,295,186,12,2159,20,2070,10,20
"605","2020-03-14",1,8,50,68,3044,0.496714848883049,0,0,270,664,10,39,1,30,1,1
"606","2020-03-15",4,8,52,90,3044,0.496714848883049,0,0,270,664,20,59,3,33,3,3
"607","2020-03-16",7,8,71,113,3044,0.496714848883049,0,0,270,664,17,76,2,35,6,2
"608","2020-03-17",9,8,84,134,3044,0.496714848883049,0,0,270,664,17,93,10,45,3,10
"609","2020-03-18",18,8,96,149,3044,0.496714848883049,0,0,270,664,11,104,2,47,4,2
"610","2020-03-19",22,8,96,169,3044,0.496714848883049,0,0,270,664,18,122,7,54,6,7
"611","2020-03-20",27,8,100,190,3044,0.496714848883049,0,0,270,664,15,137,9,63,7,9
"612","2020-03-21",35,8,113,221,3044,0.496714848883049,0,0,270,664,18,155,1,64,7,1
"613","2020-03-22",39,8,133,246,3044,0.496714848883049,0,0,270,664,27,182,13,77,15,13
"614","2020-03-23",47,8,122,267,3044,0.496714848883049,0,0,270,664,31,213,8,85,14,8
"615","2020-03-24",56,8,127,289,3044,0.496714848883049,0,0,270,664,38,251,7,92,14,7
"616","2020-03-25",53,8,151,300,3044,0.496714848883049,0,0,270,664,22,273,7,99,15,7
"617","2020-03-26",70,8,154,322,3044,0.496714848883049,0,0,270,664,30,303,12,111,16,12
"618","2020-03-27",72,8,177,345,3044,0.496714848883049,0,0,270,664,28,331,11,122,9,11
"619","2020-03-28",79,8,188,366,3044,0.496714848883049,0,0,270,664,29,360,16,138,15,16
"620","2020-03-29",81,8,171,387,3044,0.496714848883049,0,0,270,664,25,385,12,150,13,12
"621","2020-03-30",83,8,180,395,3044,0.496714848883049,0,0,270,664,33,418,14,164,17,14
"622","2020-03-31",86,8,183,418,3044,0.496714848883049,0,0,270,664,27,445,7,171,14,7
"623","2020-04-01",88,8,190,427,3044,0.496714848883049,0,0,270,664,22,467,4,175,9,4
"624","2020-04-02",76,8,199,441,3044,0.496714848883049,0,0,270,664,31,498,11,186,17,11
"625","2020-04-03",96,8,177,439,3044,0.496714848883049,0,0,270,664,32,530,7,193,16,7
"626","2020-04-04",94,8,179,440,3044,0.496714848883049,0,0,270,664,28,558,14,207,17,14
"627","2020-04-05",103,8,164,443,3044,0.496714848883049,0,0,270,664,25,583,12,219,17,12
"628","2020-04-06",112,8,155,453,3044,0.496714848883049,0,0,270,664,15,598,23,242,8,23
"629","2020-04-07",116,8,174,469,3044,0.496714848883049,0,0,270,664,35,633,15,257,15,15
"630","2020-04-08",130,8,175,473,3044,0.496714848883049,0,0,270,664,27,660,22,279,12,22
"631","2020-04-09",132,8,176,486,3044,0.496714848883049,0,0,270,664,29,689,14,293,8,14
"632","2020-04-10",120,8,180,480,3044,0.496714848883049,0,0,270,664,33,722,4,297,13,4
"633","2020-04-11",129,8,192,507,3044,0.496714848883049,0,0,270,664,19,741,18,315,9,18
"634","2020-04-12",133,8,181,497,3044,0.496714848883049,0,0,270,664,27,768,18,333,6,18
"635","2020-04-13",140,8,173,475,3044,0.496714848883049,0,0,270,664,29,797,11,344,9,11
"636","2020-04-14",142,8,175,484,3044,0.496714848883049,0,0,270,664,23,820,11,355,8,11
"637","2020-04-15",136,8,193,473,3044,0.496714848883049,0,0,270,664,33,853,14,369,11,14
"638","2020-04-16",149,8,185,474,3044,0.496714848883049,0,0,270,664,27,880,16,385,8,16
"639","2020-04-17",164,8,172,491,3044,0.496714848883049,0,0,270,664,26,906,13,398,11,13
"640","2020-04-18",157,8,195,495,3044,0.496714848883049,0,0,270,664,41,947,13,411,20,13
"641","2020-04-19",152,8,216,502,3044,0.496714848883049,0,0,270,664,36,983,15,426,19,15
"642","2020-04-20",139,8,251,505,3044,0.496714848883049,0,0,270,664,37,1020,17,443,21,17
"643","2020-04-21",137,8,266,502,3044,0.496714848883049,0,0,270,664,20,1040,14,457,13,14
"644","2020-04-22",150,8,251,493,3044,0.496714848883049,0,0,270,664,24,1064,20,477,10,20
"645","2020-04-23",151,8,261,495,3044,0.496714848883049,0,0,270,664,34,1098,19,496,19,19
"646","2020-04-24",140,8,276,485,3044,0.496714848883049,0,0,270,664,33,1131,42,538,20,42
"647","2020-04-25",140,8,266,484,3044,0.496714848883049,0,0,270,664,46,1177,38,576,20,38
"648","2020-04-26",143,8,258,471,3044,0.496714848883049,0,0,270,664,26,1203,36,612,10,36
"649","2020-04-27",145,8,246,464,3044,0.496714848883049,0,0,270,664,31,1234,15,627,5,15
"650","2020-04-28",159,8,243,464,3044,0.496714848883049,0,0,270,664,30,1264,13,640,13,13
"651","2020-04-29",147,8,255,457,3044,0.496714848883049,0,0,270,664,18,1282,15,655,6,15
"652","2020-04-30",144,8,252,443,3044,0.496714848883049,0,0,270,664,39,1321,12,667,18,12
"653","2020-05-01",141,8,250,432,3044,0.496714848883049,0,0,270,664,24,1345,14,681,12,14
"654","2020-05-02",143,8,246,428,3044,0.496714848883049,0,0,270,664,34,1379,17,698,11,17
"655","2020-05-03",139,8,229,423,3044,0.496714848883049,0,0,270,664,31,1410,14,712,12,14
"656","2020-05-04",135,8,257,430,3044,0.496714848883049,0,0,270,664,26,1436,20,732,9,20
"657","2020-05-05",122,8,244,422,3044,0.496714848883049,0,0,270,664,24,1460,15,747,11,15
"658","2020-05-06",119,8,233,426,3044,0.496714848883049,0,0,270,664,26,1486,19,766,15,19
"659","2020-05-07",118,8,230,423,3044,0.496714848883049,0,0,270,664,24,1510,22,788,6,22
"660","2020-05-08",122,8,244,419,3044,0.496714848883049,0,0,270,664,27,1537,10,798,8,10
"661","2020-05-09",112,8,251,408,3044,0.496714848883049,0,0,270,664,19,1556,13,811,7,13
"662","2020-05-10",109,8,236,403,3044,0.496714848883049,0,0,270,664,30,1586,25,836,14,25
"663","2020-05-11",120,8,239,400,3044,0.496714848883049,0,0,270,664,28,1614,13,849,13,13
"664","2020-05-12",119,8,249,393,3044,0.496714848883049,0,0,270,664,30,1644,35,884,14,35
"665","2020-05-13",125,8,246,397,3044,0.496714848883049,0,0,270,664,21,1665,23,907,8,23
"666","2020-05-14",121,8,222,384,3044,0.496714848883049,0,0,270,664,21,1686,18,925,7,18
"667","2020-05-15",117,8,218,367,3044,0.496714848883049,0,0,270,664,18,1704,31,956,6,31
"668","2020-05-16",123,8,204,375,3044,0.496714848883049,0,0,270,664,22,1726,21,977,5,21
"669","2020-05-17",126,8,206,376,3044,0.496714848883049,0,0,270,664,20,1746,17,994,9,17
"670","2020-05-18",111,8,208,377,3044,0.496714848883049,0,0,270,664,22,1768,14,1008,6,14
"671","2020-05-19",105,8,217,361,3044,0.496714848883049,0,0,270,664,21,1789,14,1022,9,14
"672","2020-05-20",95,8,220,350,3044,0.496714848883049,0,0,270,664,11,1800,15,1037,4,15
"673","2020-05-21",98,8,201,337,3044,0.496714848883049,0,0,270,664,17,1817,9,1046,3,9
"674","2020-05-22",108,8,210,334,3044,0.496714848883049,0,0,270,664,16,1833,3,1049,8,3
"675","2020-05-23",104,8,226,322,3044,0.496714848883049,0,0,270,664,24,1857,6,1055,14,6
"676","2020-05-24",98,8,230,304,3044,0.496714848883049,0,0,270,664,15,1872,16,1071,4,16
"677","2020-05-25",98,8,238,294,3044,0.496714848883049,0,0,270,664,14,1886,5,1076,5,5
"678","2020-05-26",96,8,231,285,3044,0.496714848883049,0,0,270,664,14,1900,9,1085,10,9
"679","2020-05-27",97,8,243,289,3044,0.496714848883049,0,0,270,664,16,1916,14,1099,7,14
"680","2020-05-28",89,8,237,277,3044,0.496714848883049,0,0,270,664,9,1925,10,1109,1,10
"681","2020-05-29",72,8,238,256,3044,0.496714848883049,0,0,270,664,17,1942,4,1113,5,4
"682","2020-05-30",73,8,243,241,3044,0.496714848883049,0,0,270,664,20,1962,15,1128,8,15
"683","2020-05-31",68,8,246,231,3044,0.496714848883049,0,0,270,664,8,1970,9,1137,4,9
"684","2020-06-01",64,8,246,229,3044,0.496714848883049,0,0,270,664,18,1988,8,1145,7,8
"685","2020-06-02",63,8,246,214,3044,0.496714848883049,0,0,270,664,9,1997,16,1161,4,16
"686","2020-06-03",59,8,241,210,3044,0.496714848883049,0,0,270,664,9,2006,12,1173,5,12
"687","2020-06-04",50,8,228,205,3044,0.496714848883049,0,0,270,664,14,2020,9,1182,8,9
"688","2020-06-05",53,8,227,208,3044,0.496714848883049,0,0,270,664,13,2033,11,1193,7,11
"689","2020-06-06",50,8,212,205,3044,0.496714848883049,0,0,270,664,18,2051,9,1202,10,9
"690","2020-06-07",56,8,202,195,3044,0.496714848883049,0,0,270,664,15,2066,11,1213,7,11
"691","2020-03-14",1,9,29,24,7179,0.974230394205321,0,0,576,384,10,23,11,60,5,11
"692","2020-03-15",3,9,48,41,7179,0.974230394205321,0,0,576,384,5,28,16,76,3,16
"693","2020-03-16",4,9,65,52,7179,0.974230394205321,0,0,576,384,10,38,20,96,8,20
"694","2020-03-17",6,9,57,67,7179,0.974230394205321,0,0,576,384,12,50,15,111,9,15
"695","2020-03-18",8,9,58,88,7179,0.974230394205321,0,0,576,384,10,60,24,135,8,24
"696","2020-03-19",9,9,56,107,7179,0.974230394205321,0,0,576,384,11,71,14,149,11,14
"697","2020-03-20",12,9,61,129,7179,0.974230394205321,0,0,576,384,25,96,19,168,17,19
"698","2020-03-21",14,9,59,158,7179,0.974230394205321,0,0,576,384,13,109,9,177,11,9
"699","2020-03-22",19,9,50,188,7179,0.974230394205321,0,0,576,384,22,131,30,207,19,30
"700","2020-03-23",27,9,51,217,7179,0.974230394205321,0,0,576,384,20,151,21,228,17,21
"701","2020-03-24",31,9,61,251,7179,0.974230394205321,0,0,576,384,20,171,26,254,17,26
"702","2020-03-25",39,9,52,291,7179,0.974230394205321,0,0,576,384,24,195,31,285,22,31
"703","2020-03-26",49,9,57,329,7179,0.974230394205321,0,0,576,384,26,221,32,317,24,32
"704","2020-03-27",57,9,57,386,7179,0.974230394205321,0,0,576,384,23,244,25,342,19,25
"705","2020-03-28",63,9,55,467,7179,0.974230394205321,0,0,576,384,27,271,27,369,23,27
"706","2020-03-29",76,9,50,541,7179,0.974230394205321,0,0,576,384,42,313,22,391,35,22
"707","2020-03-30",91,9,42,635,7179,0.974230394205321,0,0,576,384,26,339,30,421,21,30
"708","2020-03-31",104,9,39,730,7179,0.974230394205321,0,0,576,384,22,361,22,443,18,22
"709","2020-04-01",121,9,51,834,7179,0.974230394205321,0,0,576,384,45,406,12,455,42,12
"710","2020-04-02",138,9,71,924,7179,0.974230394205321,0,0,576,384,41,447,36,491,37,36
"711","2020-04-03",161,9,83,1117,7179,0.974230394205321,0,0,576,384,45,492,46,537,42,46
"712","2020-04-04",191,9,87,1229,7179,0.974230394205321,0,0,576,384,35,527,38,575,34,38
"713","2020-04-05",226,9,108,1375,7179,0.974230394205321,0,0,576,384,52,579,35,610,49,35
"714","2020-04-06",242,9,128,1531,7179,0.974230394205321,0,0,576,384,54,633,30,640,47,30
"715","2020-04-07",281,9,132,1712,7179,0.974230394205321,0,0,576,384,59,692,19,659,56,19
"716","2020-04-08",320,9,134,1943,7179,0.974230394205321,0,0,576,384,58,750,14,673,54,14
"717","2020-04-09",365,9,132,2171,7179,0.974230394205321,0,0,576,384,46,796,20,693,42,20
"718","2020-04-10",416,9,130,2401,7179,0.974230394205321,0,0,576,384,59,855,36,729,56,36
"719","2020-04-11",477,9,128,2537,7179,0.974230394205321,0,0,576,384,66,921,25,754,62,25
"720","2020-04-12",519,9,138,2763,7179,0.974230394205321,0,0,576,384,57,978,14,768,54,14
"721","2020-04-13",595,9,130,2890,7179,0.974230394205321,0,0,576,384,61,1039,16,784,54,16
"722","2020-04-14",648,9,150,3019,7179,0.974230394205321,0,0,576,384,60,1099,42,826,55,42
"723","2020-04-15",715,9,135,3117,7179,0.974230394205321,0,0,576,384,62,1161,11,837,54,11
"724","2020-04-16",766,9,135,3192,7179,0.974230394205321,0,0,576,384,57,1218,27,864,55,27
"725","2020-04-17",813,9,154,3215,7179,0.974230394205321,0,0,576,384,65,1283,15,879,62,15
"726","2020-04-18",858,9,155,3198,7179,0.974230394205321,0,0,576,384,65,1348,17,896,60,17
"727","2020-04-19",897,9,169,3128,7179,0.974230394205321,0,0,576,384,85,1433,22,918,83,22
"728","2020-04-20",906,9,173,2986,7179,0.974230394205321,0,0,576,384,52,1485,10,928,50,10
"729","2020-04-21",921,9,157,2885,7179,0.974230394205321,0,0,576,384,72,1557,7,935,70,7
"730","2020-04-22",929,9,135,2661,7179,0.974230394205321,0,0,576,384,75,1632,33,968,72,33
"731","2020-04-23",919,9,144,2481,7179,0.974230394205321,0,0,576,384,90,1722,16,984,84,16
"732","2020-04-24",908,9,143,2325,7179,0.974230394205321,0,0,576,384,65,1787,11,995,64,11
"733","2020-04-25",854,9,141,2090,7179,0.974230394205321,0,0,576,384,72,1859,33,1028,71,33
"734","2020-04-26",810,9,129,1844,7179,0.974230394205321,0,0,576,384,85,1944,44,1072,80,44
"735","2020-04-27",764,9,111,1643,7179,0.974230394205321,0,0,576,384,85,2029,27,1099,81,27
"736","2020-04-28",706,9,110,1431,7179,0.974230394205321,0,0,576,384,57,2086,19,1118,56,19
"737","2020-04-29",621,9,141,1252,7179,0.974230394205321,0,0,576,384,80,2166,41,1159,74,41
"738","2020-04-30",566,9,147,1085,7179,0.974230394205321,0,0,576,384,69,2235,34,1193,63,34
"739","2020-05-01",481,9,137,946,7179,0.974230394205321,0,0,576,384,58,2293,22,1215,55,22
"740","2020-05-02",422,9,154,808,7179,0.974230394205321,0,0,576,384,70,2363,13,1228,67,13
"741","2020-05-03",363,9,136,672,7179,0.974230394205321,0,0,576,384,63,2426,12,1240,61,12
"742","2020-05-04",308,9,126,578,7179,0.974230394205321,0,0,576,384,58,2484,9,1249,55,9
"743","2020-05-05",265,9,129,489,7179,0.974230394205321,0,0,576,384,68,2552,35,1284,66,35
"744","2020-05-06",227,9,125,422,7179,0.974230394205321,0,0,576,384,58,2610,22,1306,57,22
"745","2020-05-07",188,9,115,364,7179,0.974230394205321,0,0,576,384,57,2667,15,1321,53,15
"746","2020-05-08",167,9,130,321,7179,0.974230394205321,0,0,576,384,50,2717,43,1364,48,43
"747","2020-05-09",153,9,138,280,7179,0.974230394205321,0,0,576,384,49,2766,30,1394,48,30
"748","2020-05-10",130,9,138,253,7179,0.974230394205321,0,0,576,384,54,2820,19,1413,53,19
"749","2020-05-11",114,9,124,207,7179,0.974230394205321,0,0,576,384,41,2861,16,1429,39,16
"750","2020-05-12",93,9,113,177,7179,0.974230394205321,0,0,576,384,55,2916,16,1445,52,16
"751","2020-05-13",80,9,123,148,7179,0.974230394205321,0,0,576,384,45,2961,9,1454,42,9
"752","2020-05-14",63,9,122,125,7179,0.974230394205321,0,0,576,384,49,3010,12,1466,47,12
"753","2020-05-15",56,9,125,119,7179,0.974230394205321,0,0,576,384,63,3073,34,1500,60,34
"754","2020-05-16",43,9,128,109,7179,0.974230394205321,0,0,576,384,43,3116,53,1553,40,53
"755","2020-05-17",37,9,117,91,7179,0.974230394205321,0,0,576,384,40,3156,50,1603,38,50
"756","2020-05-18",32,9,115,81,7179,0.974230394205321,0,0,576,384,44,3200,55,1658,40,55
"757","2020-05-19",33,9,143,73,7179,0.974230394205321,0,0,576,384,38,3238,29,1687,36,29
"758","2020-05-20",35,9,158,68,7179,0.974230394205321,0,0,576,384,39,3277,33,1720,36,33
"759","2020-05-21",35,9,155,60,7179,0.974230394205321,0,0,576,384,41,3318,25,1745,40,25
"760","2020-05-22",27,9,148,54,7179,0.974230394205321,0,0,576,384,46,3364,17,1762,43,17
"761","2020-05-23",24,9,143,54,7179,0.974230394205321,0,0,576,384,36,3400,29,1791,35,29
"762","2020-05-24",20,9,152,48,7179,0.974230394205321,0,0,576,384,22,3422,19,1810,21,19
"763","2020-05-25",22,9,164,41,7179,0.974230394205321,0,0,576,384,39,3461,22,1832,36,22
"764","2020-05-26",20,9,147,43,7179,0.974230394205321,0,0,576,384,40,3501,22,1854,40,22
"765","2020-05-27",14,9,120,40,7179,0.974230394205321,0,0,576,384,39,3540,21,1875,38,21
"766","2020-05-28",11,9,117,34,7179,0.974230394205321,0,0,576,384,27,3567,26,1901,27,26
"767","2020-05-29",13,9,118,31,7179,0.974230394205321,0,0,576,384,33,3600,19,1920,32,19
"768","2020-05-30",12,9,104,30,7179,0.974230394205321,0,0,576,384,31,3631,16,1936,31,16
"769","2020-05-31",15,9,93,30,7179,0.974230394205321,0,0,576,384,29,3660,15,1951,27,15
"770","2020-06-01",12,9,70,27,7179,0.974230394205321,0,0,576,384,25,3685,12,1963,22,12
"771","2020-06-02",11,9,57,21,7179,0.974230394205321,0,0,576,384,27,3712,18,1981,26,18
"772","2020-06-03",10,9,48,22,7179,0.974230394205321,0,0,576,384,26,3738,24,2005,26,24
"773","2020-06-04",11,9,57,20,7179,0.974230394205321,0,0,576,384,19,3757,26,2031,19,26
"774","2020-06-05",11,9,65,18,7179,0.974230394205321,0,0,576,384,31,3788,23,2054,30,23
"775","2020-06-06",10,9,73,18,7179,0.974230394205321,0,0,576,384,20,3808,21,2075,19,21
"776","2020-06-07",7,9,72,18,7179,0.974230394205321,0,0,576,384,15,3823,11,2086,15,11
"777","2020-03-18",1,10,67,35,2344,0.824232081911263,0,0,201,390,24,124,12,33,12,12
"778","2020-03-19",3,10,59,40,2344,0.824232081911263,0,0,201,390,19,143,9,42,13,9
"779","2020-03-20",6,10,51,45,2344,0.824232081911263,0,0,201,390,27,170,6,48,16,6
"780","2020-03-21",8,10,50,57,2344,0.824232081911263,0,0,201,390,35,205,11,59,24,11
"781","2020-03-22",9,10,53,68,2344,0.824232081911263,0,0,201,390,22,227,8,67,16,8
"782","2020-03-23",12,10,39,80,2344,0.824232081911263,0,0,201,390,47,274,7,74,28,7
"783","2020-03-24",15,10,48,88,2344,0.824232081911263,0,0,201,390,29,303,5,79,15,5
"784","2020-03-25",17,10,62,102,2344,0.824232081911263,0,0,201,390,43,346,4,83,32,4
"785","2020-03-26",21,10,86,109,2344,0.824232081911263,0,0,201,390,24,370,2,85,16,2
"786","2020-03-27",24,10,76,129,2344,0.824232081911263,0,0,201,390,38,408,1,86,26,1
"787","2020-03-28",26,10,82,146,2344,0.824232081911263,0,0,201,390,48,456,9,95,37,9
"788","2020-03-29",31,10,79,164,2344,0.824232081911263,0,0,201,390,51,507,9,104,36,9
"789","2020-03-30",35,10,87,178,2344,0.824232081911263,0,0,201,390,46,553,4,108,31,4
"790","2020-03-31",40,10,103,189,2344,0.824232081911263,0,0,201,390,58,611,5,113,53,5
"791","2020-04-01",46,10,104,199,2344,0.824232081911263,0,0,201,390,50,661,9,122,42,9
"792","2020-04-02",52,10,109,205,2344,0.824232081911263,0,0,201,390,52,713,7,129,39,7
"793","2020-04-03",52,10,98,224,2344,0.824232081911263,0,0,201,390,43,756,13,142,31,13
"794","2020-04-04",50,10,106,236,2344,0.824232081911263,0,0,201,390,70,826,4,146,52,4
"795","2020-04-05",53,10,121,248,2344,0.824232081911263,0,0,201,390,59,885,12,158,46,12
"796","2020-04-06",54,10,124,247,2344,0.824232081911263,0,0,201,390,69,954,12,170,55,12
"797","2020-04-07",56,10,120,243,2344,0.824232081911263,0,0,201,390,40,994,9,179,36,9
"798","2020-04-08",56,10,113,241,2344,0.824232081911263,0,0,201,390,67,1061,7,186,56,7
"799","2020-04-09",57,10,109,241,2344,0.824232081911263,0,0,201,390,72,1133,7,193,49,7
"800","2020-04-10",57,10,113,239,2344,0.824232081911263,0,0,201,390,74,1207,4,197,60,4
"801","2020-04-11",68,10,116,240,2344,0.824232081911263,0,0,201,390,71,1278,11,208,51,11
"802","2020-04-12",67,10,128,238,2344,0.824232081911263,0,0,201,390,61,1339,17,225,50,17
"803","2020-04-13",70,10,132,251,2344,0.824232081911263,0,0,201,390,66,1405,19,244,51,19
"804","2020-04-14",69,10,127,262,2344,0.824232081911263,0,0,201,390,57,1462,16,260,42,16
"805","2020-04-15",71,10,125,267,2344,0.824232081911263,0,0,201,390,62,1524,6,266,54,6
"806","2020-04-16",70,10,121,263,2344,0.824232081911263,0,0,201,390,69,1593,3,269,58,3
"807","2020-04-17",80,10,103,256,2344,0.824232081911263,0,0,201,390,59,1652,7,276,50,7
"808","2020-04-18",78,10,77,271,2344,0.824232081911263,0,0,201,390,53,1705,6,282,43,6
"809","2020-04-19",80,10,75,284,2344,0.824232081911263,0,0,201,390,78,1783,1,283,63,1
"810","2020-04-20",81,10,84,300,2344,0.824232081911263,0,0,201,390,68,1851,8,291,54,8
"811","2020-04-21",83,10,108,308,2344,0.824232081911263,0,0,201,390,60,1911,17,308,42,17
"812","2020-04-22",85,10,114,307,2344,0.824232081911263,0,0,201,390,57,1968,15,323,44,15
"813","2020-04-23",94,10,113,311,2344,0.824232081911263,0,0,201,390,63,2031,12,335,49,12
"814","2020-04-24",91,10,102,312,2344,0.824232081911263,0,0,201,390,69,2100,4,339,57,4
"815","2020-04-25",96,10,95,305,2344,0.824232081911263,0,0,201,390,67,2167,20,359,52,20
"816","2020-04-26",94,10,86,291,2344,0.824232081911263,0,0,201,390,58,2225,8,367,50,8
"817","2020-04-27",95,10,76,281,2344,0.824232081911263,0,0,201,390,61,2286,12,379,50,12
"818","2020-04-28",96,10,80,284,2344,0.824232081911263,0,0,201,390,52,2338,17,396,45,17
"819","2020-04-29",90,10,87,294,2344,0.824232081911263,0,0,201,390,63,2401,12,408,52,12
"820","2020-04-30",79,10,90,295,2344,0.824232081911263,0,0,201,390,65,2466,13,421,57,13
"821","2020-05-01",77,10,84,284,2344,0.824232081911263,0,0,201,390,54,2520,17,438,45,17
"822","2020-05-02",72,10,93,285,2344,0.824232081911263,0,0,201,390,54,2574,18,456,41,18
"823","2020-05-03",77,10,98,293,2344,0.824232081911263,0,0,201,390,46,2620,19,475,38,19
"824","2020-05-04",78,10,89,289,2344,0.824232081911263,0,0,201,390,44,2664,19,494,33,19
"825","2020-05-05",81,10,85,294,2344,0.824232081911263,0,0,201,390,58,2722,31,525,47,31
"826","2020-05-06",82,10,79,298,2344,0.824232081911263,0,0,201,390,47,2769,32,557,40,32
"827","2020-05-07",86,10,74,310,2344,0.824232081911263,0,0,201,390,51,2820,32,589,39,32
"828","2020-05-08",84,10,65,314,2344,0.824232081911263,0,0,201,390,40,2860,21,610,29,21
"829","2020-05-09",85,10,69,316,2344,0.824232081911263,0,0,201,390,31,2891,18,628,21,18
"830","2020-05-10",90,10,92,332,2344,0.824232081911263,0,0,201,390,39,2930,33,661,28,33
"831","2020-05-11",80,10,89,334,2344,0.824232081911263,0,0,201,390,40,2970,27,688,33,27
"832","2020-05-12",74,10,85,342,2344,0.824232081911263,0,0,201,390,43,3013,16,704,32,16
"833","2020-05-13",81,10,74,344,2344,0.824232081911263,0,0,201,390,55,3068,15,719,42,15
"834","2020-05-14",89,10,84,344,2344,0.824232081911263,0,0,201,390,37,3105,14,733,25,14
"835","2020-05-15",99,10,84,358,2344,0.824232081911263,0,0,201,390,33,3138,9,742,21,9
"836","2020-05-16",102,10,73,348,2344,0.824232081911263,0,0,201,390,28,3166,10,752,20,10
"837","2020-05-17",99,10,70,350,2344,0.824232081911263,0,0,201,390,25,3191,26,778,21,26
"838","2020-05-18",109,10,62,347,2344,0.824232081911263,0,0,201,390,36,3227,12,790,29,12
"839","2020-05-19",116,10,63,364,2344,0.824232081911263,0,0,201,390,41,3268,25,815,26,25
"840","2020-05-20",115,10,53,364,2344,0.824232081911263,0,0,201,390,29,3297,15,830,22,15
"841","2020-05-21",106,10,55,364,2344,0.824232081911263,0,0,201,390,38,3335,13,843,31,13
"842","2020-05-22",102,10,51,362,2344,0.824232081911263,0,0,201,390,23,3358,11,854,15,11
"843","2020-05-23",99,10,50,377,2344,0.824232081911263,0,0,201,390,37,3395,6,860,31,6
"844","2020-05-24",100,10,55,401,2344,0.824232081911263,0,0,201,390,27,3422,13,873,20,13
"845","2020-05-25",96,10,50,427,2344,0.824232081911263,0,0,201,390,15,3437,11,884,12,11
"846","2020-05-26",101,10,62,438,2344,0.824232081911263,0,0,201,390,24,3461,4,888,17,4
"847","2020-05-27",102,10,84,443,2344,0.824232081911263,0,0,201,390,32,3493,15,903,26,15
"848","2020-05-28",109,10,91,447,2344,0.824232081911263,0,0,201,390,19,3512,23,926,13,23
"849","2020-05-29",117,10,88,447,2344,0.824232081911263,0,0,201,390,30,3542,10,936,25,10
"850","2020-05-30",119,10,82,433,2344,0.824232081911263,0,0,201,390,16,3558,12,948,14,12
"851","2020-05-31",124,10,81,439,2344,0.824232081911263,0,0,201,390,24,3582,13,961,15,13
"852","2020-06-01",135,10,92,424,2344,0.824232081911263,0,0,201,390,23,3605,5,966,19,5
"853","2020-06-02",129,10,86,415,2344,0.824232081911263,0,0,201,390,19,3624,9,975,13,9
"854","2020-06-03",134,10,85,406,2344,0.824232081911263,0,0,201,390,17,3641,9,984,12,9
"855","2020-06-04",129,10,87,408,2344,0.824232081911263,0,0,201,390,19,3660,3,987,17,3
"856","2020-06-05",124,10,85,408,2344,0.824232081911263,0,0,201,390,11,3671,12,999,7,12
"857","2020-06-06",123,10,78,391,2344,0.824232081911263,0,0,201,390,9,3680,6,1005,8,6
"858","2020-06-07",114,10,74,376,2344,0.824232081911263,0,0,201,390,12,3692,2,1007,9,2
"859","2020-03-13",1,11,15,52,3297,0.592053381862299,0,0,315,394,20,53,15,46,2,15
"860","2020-03-14",3,11,28,83,3297,0.592053381862299,0,0,315,394,21,74,10,56,3,10
"861","2020-03-15",6,11,38,115,3297,0.592053381862299,0,0,315,394,22,96,20,76,8,20
"862","2020-03-16",8,11,37,144,3297,0.592053381862299,0,0,315,394,28,124,20,96,12,20
"863","2020-03-17",12,11,40,177,3297,0.592053381862299,0,0,315,394,33,157,17,113,15,17
"864","2020-03-18",23,11,48,209,3297,0.592053381862299,0,0,315,394,33,190,15,128,16,15
"865","2020-03-19",31,11,55,246,3297,0.592053381862299,0,0,315,394,40,230,17,145,20,17
"866","2020-03-20",43,11,68,290,3297,0.592053381862299,0,0,315,394,32,262,12,157,14,12
"867","2020-03-21",54,11,67,326,3297,0.592053381862299,0,0,315,394,38,300,25,182,20,25
"868","2020-03-22",70,11,82,368,3297,0.592053381862299,0,0,315,394,40,340,23,205,12,23
"869","2020-03-23",79,11,97,400,3297,0.592053381862299,0,0,315,394,45,385,37,242,23,37
"870","2020-03-24",103,11,100,416,3297,0.592053381862299,0,0,315,394,42,427,26,268,27,26
"871","2020-03-25",105,11,99,468,3297,0.592053381862299,0,0,315,394,43,470,26,294,25,26
"872","2020-03-26",118,11,112,485,3297,0.592053381862299,0,0,315,394,52,522,24,318,27,24
"873","2020-03-27",123,11,110,501,3297,0.592053381862299,0,0,315,394,45,567,37,355,25,37
"874","2020-03-28",124,11,116,494,3297,0.592053381862299,0,0,315,394,63,630,23,378,47,23
"875","2020-03-29",126,11,98,510,3297,0.592053381862299,0,0,315,394,51,681,25,403,25,25
"876","2020-03-30",138,11,85,515,3297,0.592053381862299,0,0,315,394,59,740,35,438,37,35
"877","2020-03-31",125,11,73,540,3297,0.592053381862299,0,0,315,394,62,802,35,473,40,35
"878","2020-04-01",132,11,60,555,3297,0.592053381862299,0,0,315,394,53,855,53,526,28,53
"879","2020-04-02",136,11,62,538,3297,0.592053381862299,0,0,315,394,65,920,57,583,40,57
"880","2020-04-03",134,11,80,549,3297,0.592053381862299,0,0,315,394,41,961,46,629,23,46
"881","2020-04-04",144,11,80,558,3297,0.592053381862299,0,0,315,394,46,1007,59,688,27,59
"882","2020-04-05",152,11,76,603,3297,0.592053381862299,0,0,315,394,46,1053,40,728,21,40
"883","2020-04-06",154,11,87,628,3297,0.592053381862299,0,0,315,394,49,1102,59,787,25,59
"884","2020-04-07",164,11,110,631,3297,0.592053381862299,0,0,315,394,48,1150,46,833,27,46
"885","2020-04-08",177,11,101,625,3297,0.592053381862299,0,0,315,394,44,1194,29,862,26,29
"886","2020-04-09",173,11,105,638,3297,0.592053381862299,0,0,315,394,56,1250,44,906,30,44
"887","2020-04-10",182,11,91,651,3297,0.592053381862299,0,0,315,394,43,1293,42,948,24,42
"888","2020-04-11",186,11,93,670,3297,0.592053381862299,0,0,315,394,47,1340,35,983,20,35
"889","2020-04-12",185,11,104,671,3297,0.592053381862299,0,0,315,394,45,1385,26,1009,25,26
"890","2020-04-13",176,11,124,662,3297,0.592053381862299,0,0,315,394,42,1427,45,1054,19,45
"891","2020-04-14",181,11,131,670,3297,0.592053381862299,0,0,315,394,46,1473,72,1126,23,72
"892","2020-04-15",176,11,139,661,3297,0.592053381862299,0,0,315,394,57,1530,48,1174,30,48
"893","2020-04-16",183,11,132,637,3297,0.592053381862299,0,0,315,394,46,1576,45,1219,26,45
"894","2020-04-17",189,11,142,629,3297,0.592053381862299,0,0,315,394,50,1626,22,1241,25,22
"895","2020-04-18",198,11,138,613,3297,0.592053381862299,0,0,315,394,44,1670,41,1282,15,41
"896","2020-04-19",202,11,134,591,3297,0.592053381862299,0,0,315,394,49,1719,47,1329,25,47
"897","2020-04-20",208,11,129,586,3297,0.592053381862299,0,0,315,394,58,1777,71,1400,33,71
"898","2020-04-21",205,11,149,564,3297,0.592053381862299,0,0,315,394,61,1838,61,1461,30,61
"899","2020-04-22",191,11,159,545,3297,0.592053381862299,0,0,315,394,36,1874,49,1510,17,49
"900","2020-04-23",185,11,173,521,3297,0.592053381862299,0,0,315,394,44,1918,46,1556,27,46
"901","2020-04-24",171,11,181,499,3297,0.592053381862299,0,0,315,394,59,1977,43,1599,29,43
"902","2020-04-25",159,11,182,472,3297,0.592053381862299,0,0,315,394,55,2032,42,1641,30,42
"903","2020-04-26",146,11,191,459,3297,0.592053381862299,0,0,315,394,50,2082,56,1697,23,56
"904","2020-04-27",142,11,183,438,3297,0.592053381862299,0,0,315,394,47,2129,51,1748,21,51
"905","2020-04-28",136,11,167,428,3297,0.592053381862299,0,0,315,394,29,2158,68,1816,14,68
"906","2020-04-29",139,11,163,414,3297,0.592053381862299,0,0,315,394,49,2207,35,1851,23,35
"907","2020-04-30",134,11,184,404,3297,0.592053381862299,0,0,315,394,46,2253,33,1884,29,33
"908","2020-05-01",140,11,185,385,3297,0.592053381862299,0,0,315,394,65,2318,40,1924,34,40
"909","2020-05-02",136,11,166,376,3297,0.592053381862299,0,0,315,394,35,2353,28,1952,15,28
"910","2020-05-03",136,11,132,366,3297,0.592053381862299,0,0,315,394,47,2400,41,1993,23,41
"911","2020-05-04",134,11,152,331,3297,0.592053381862299,0,0,315,394,40,2440,54,2047,21,54
"912","2020-05-05",124,11,153,331,3297,0.592053381862299,0,0,315,394,37,2477,55,2102,21,55
"913","2020-05-06",113,11,136,329,3297,0.592053381862299,0,0,315,394,46,2523,36,2138,21,36
"914","2020-05-07",110,11,138,320,3297,0.592053381862299,0,0,315,394,35,2558,43,2181,16,43
"915","2020-05-08",101,11,143,320,3297,0.592053381862299,0,0,315,394,39,2597,35,2216,23,35
"916","2020-05-09",93,11,162,322,3297,0.592053381862299,0,0,315,394,49,2646,32,2248,31,32
"917","2020-05-10",91,11,133,311,3297,0.592053381862299,0,0,315,394,48,2694,40,2288,34,40
"918","2020-05-11",86,11,119,297,3297,0.592053381862299,0,0,315,394,31,2725,37,2325,14,37
"919","2020-05-12",84,11,100,299,3297,0.592053381862299,0,0,315,394,33,2758,49,2374,18,49
"920","2020-05-13",87,11,99,301,3297,0.592053381862299,0,0,315,394,34,2792,66,2440,15,66
"921","2020-05-14",82,11,102,297,3297,0.592053381862299,0,0,315,394,26,2818,58,2498,16,58
"922","2020-05-15",76,11,88,289,3297,0.592053381862299,0,0,315,394,40,2858,44,2542,24,44
"923","2020-05-16",74,11,81,289,3297,0.592053381862299,0,0,315,394,27,2885,44,2586,19,44
"924","2020-05-17",63,11,85,295,3297,0.592053381862299,0,0,315,394,25,2910,49,2635,13,49
"925","2020-05-18",62,11,97,293,3297,0.592053381862299,0,0,315,394,22,2932,45,2680,10,45
"926","2020-05-19",67,11,87,278,3297,0.592053381862299,0,0,315,394,30,2962,34,2714,14,34
"927","2020-05-20",70,11,84,278,3297,0.592053381862299,0,0,315,394,25,2987,29,2743,16,29
"928","2020-05-21",74,11,75,273,3297,0.592053381862299,0,0,315,394,29,3016,31,2774,12,31
"929","2020-05-22",83,11,71,269,3297,0.592053381862299,0,0,315,394,18,3034,33,2807,12,33
"930","2020-05-23",84,11,87,274,3297,0.592053381862299,0,0,315,394,27,3061,52,2859,12,52
"931","2020-05-24",94,11,96,269,3297,0.592053381862299,0,0,315,394,16,3077,42,2901,4,42
"932","2020-05-25",92,11,97,267,3297,0.592053381862299,0,0,315,394,27,3104,27,2928,12,27
"933","2020-05-26",86,11,100,248,3297,0.592053381862299,0,0,315,394,20,3124,23,2951,11,23
"934","2020-05-27",87,11,100,252,3297,0.592053381862299,0,0,315,394,16,3140,25,2976,4,25
"935","2020-05-28",80,11,101,245,3297,0.592053381862299,0,0,315,394,20,3160,36,3012,6,36
"936","2020-05-29",71,11,108,247,3297,0.592053381862299,0,0,315,394,14,3174,42,3054,8,42
"937","2020-05-30",74,11,116,256,3297,0.592053381862299,0,0,315,394,28,3202,26,3080,15,26
"938","2020-05-31",66,11,118,248,3297,0.592053381862299,0,0,315,394,20,3222,46,3126,11,46
"939","2020-06-01",72,11,111,244,3297,0.592053381862299,0,0,315,394,16,3238,27,3153,5,27
"940","2020-06-02",71,11,113,237,3297,0.592053381862299,0,0,315,394,22,3260,27,3180,8,27
"941","2020-06-03",67,11,118,230,3297,0.592053381862299,0,0,315,394,19,3279,32,3212,10,32
"942","2020-06-04",71,11,112,219,3297,0.592053381862299,0,0,315,394,19,3298,29,3241,12,29
"943","2020-06-05",74,11,93,207,3297,0.592053381862299,0,0,315,394,15,3313,28,3269,5,28
"944","2020-06-06",75,11,87,204,3297,0.592053381862299,0,0,315,394,20,3333,29,3298,10,29
"945","2020-06-07",79,11,84,199,3297,0.592053381862299,0,0,315,394,13,3346,26,3324,6,26
"946","2020-03-14",7,12,37,81,2838,0.385482734319944,0,0,223,361,14,46,16,48,4,16
"947","2020-03-15",10,12,40,106,2838,0.385482734319944,0,0,223,361,22,68,13,61,11,13
"948","2020-03-16",16,12,48,138,2838,0.385482734319944,0,0,223,361,17,85,7,68,11,7
"949","2020-03-17",22,12,63,160,2838,0.385482734319944,0,0,223,361,24,109,11,79,15,11
"950","2020-03-18",31,12,63,187,2838,0.385482734319944,0,0,223,361,27,136,9,88,18,9
"951","2020-03-19",42,12,71,212,2838,0.385482734319944,0,0,223,361,20,156,7,95,16,7
"952","2020-03-20",50,12,74,248,2838,0.385482734319944,0,0,223,361,27,183,6,101,24,6
"953","2020-03-21",56,12,68,266,2838,0.385482734319944,0,0,223,361,33,216,3,104,24,3
"954","2020-03-22",56,12,81,281,2838,0.385482734319944,0,0,223,361,28,244,8,112,19,8
"955","2020-03-23",60,12,77,302,2838,0.385482734319944,0,0,223,361,26,270,5,117,21,5
"956","2020-03-24",65,12,80,302,2838,0.385482734319944,0,0,223,361,30,300,3,120,20,3
"957","2020-03-25",72,12,82,317,2838,0.385482734319944,0,0,223,361,28,328,8,128,20,8
"958","2020-03-26",74,12,76,333,2838,0.385482734319944,0,0,223,361,30,358,11,139,19,11
"959","2020-03-27",77,12,68,355,2838,0.385482734319944,0,0,223,361,41,399,18,157,29,18
"960","2020-03-28",82,12,67,367,2838,0.385482734319944,0,0,223,361,49,448,20,177,36,20
"961","2020-03-29",92,12,66,378,2838,0.385482734319944,0,0,223,361,40,488,7,184,33,7
"962","2020-03-30",97,12,71,396,2838,0.385482734319944,0,0,223,361,51,539,11,195,42,11
"963","2020-03-31",99,12,77,396,2838,0.385482734319944,0,0,223,361,43,582,19,214,33,19
"964","2020-04-01",101,12,80,403,2838,0.385482734319944,0,0,223,361,66,648,10,224,50,10
"965","2020-04-02",98,12,82,408,2838,0.385482734319944,0,0,223,361,52,700,24,248,47,24
"966","2020-04-03",106,12,81,421,2838,0.385482734319944,0,0,223,361,45,745,11,259,37,11
"967","2020-04-04",102,12,85,423,2838,0.385482734319944,0,0,223,361,44,789,9,268,38,9
"968","2020-04-05",107,12,98,444,2838,0.385482734319944,0,0,223,361,65,854,10,278,52,10
"969","2020-04-06",105,12,102,449,2838,0.385482734319944,0,0,223,361,39,893,24,302,31,24
"970","2020-04-07",107,12,104,453,2838,0.385482734319944,0,0,223,361,52,945,13,315,41,13
"971","2020-04-08",108,12,129,451,2838,0.385482734319944,0,0,223,361,75,1020,17,332,60,17
"972","2020-04-09",117,12,129,447,2838,0.385482734319944,0,0,223,361,58,1078,17,349,48,17
"973","2020-04-10",122,12,123,435,2838,0.385482734319944,0,0,223,361,61,1139,15,364,51,15
"974","2020-04-11",129,12,119,422,2838,0.385482734319944,0,0,223,361,62,1201,25,389,55,25
"975","2020-04-12",129,12,116,431,2838,0.385482734319944,0,0,223,361,67,1268,35,424,61,35
"976","2020-04-13",133,12,131,447,2838,0.385482734319944,0,0,223,361,68,1336,28,452,58,28
"977","2020-04-14",132,12,131,434,2838,0.385482734319944,0,0,223,361,58,1394,27,479,43,27
"978","2020-04-15",127,12,120,428,2838,0.385482734319944,0,0,223,361,66,1460,21,500,57,21
"979","2020-04-16",123,12,114,417,2838,0.385482734319944,0,0,223,361,47,1507,12,512,33,12
"980","2020-04-17",113,12,119,425,2838,0.385482734319944,0,0,223,361,56,1563,12,524,50,12
"981","2020-04-18",116,12,132,430,2838,0.385482734319944,0,0,223,361,41,1604,11,535,35,11
"982","2020-04-19",113,12,130,436,2838,0.385482734319944,0,0,223,361,56,1660,7,542,46,7
"983","2020-04-20",114,12,134,418,2838,0.385482734319944,0,0,223,361,50,1710,9,551,39,9
"984","2020-04-21",122,12,135,411,2838,0.385482734319944,0,0,223,361,62,1772,9,560,46,9
"985","2020-04-22",127,12,147,419,2838,0.385482734319944,0,0,223,361,51,1823,23,583,42,23
"986","2020-04-23",124,12,148,411,2838,0.385482734319944,0,0,223,361,45,1868,14,597,38,14
"987","2020-04-24",123,12,151,416,2838,0.385482734319944,0,0,223,361,48,1916,7,604,38,7
"988","2020-04-25",107,12,156,405,2838,0.385482734319944,0,0,223,361,47,1963,8,612,33,8
"989","2020-04-26",107,12,156,401,2838,0.385482734319944,0,0,223,361,42,2005,23,635,31,23
"990","2020-04-27",105,12,171,419,2838,0.385482734319944,0,0,223,361,59,2064,18,653,46,18
"991","2020-04-28",96,12,152,420,2838,0.385482734319944,0,0,223,361,56,2120,8,661,44,8
"992","2020-04-29",100,12,158,417,2838,0.385482734319944,0,0,223,361,56,2176,8,669,45,8
"993","2020-04-30",100,12,162,410,2838,0.385482734319944,0,0,223,361,51,2227,7,676,40,7
"994","2020-05-01",100,12,165,395,2838,0.385482734319944,0,0,223,361,54,2281,23,699,42,23
"995","2020-05-02",110,12,153,389,2838,0.385482734319944,0,0,223,361,46,2327,28,727,33,28
"996","2020-05-03",107,12,153,388,2838,0.385482734319944,0,0,223,361,57,2384,16,743,49,16
"997","2020-05-04",102,12,161,385,2838,0.385482734319944,0,0,223,361,53,2437,12,755,45,12
"998","2020-05-05",106,12,160,380,2838,0.385482734319944,0,0,223,361,48,2485,21,776,38,21
"999","2020-05-06",100,12,154,368,2838,0.385482734319944,0,0,223,361,48,2533,15,791,37,15
"1000","2020-05-07",102,12,166,370,2838,0.385482734319944,0,0,223,361,47,2580,9,800,40,9
"1001","2020-05-08",100,12,176,365,2838,0.385482734319944,0,0,223,361,44,2624,12,812,39,12
"1002","2020-05-09",93,12,149,365,2838,0.385482734319944,0,0,223,361,42,2666,14,826,32,14
"1003","2020-05-10",94,12,164,354,2838,0.385482734319944,0,0,223,361,43,2709,36,862,33,36
"1004","2020-05-11",97,12,151,339,2838,0.385482734319944,0,0,223,361,45,2754,19,881,34,19
"1005","2020-05-12",90,12,152,322,2838,0.385482734319944,0,0,223,361,43,2797,11,892,34,11
"1006","2020-05-13",89,12,155,321,2838,0.385482734319944,0,0,223,361,35,2832,22,914,27,22
"1007","2020-05-14",88,12,146,324,2838,0.385482734319944,0,0,223,361,41,2873,13,927,27,13
"1008","2020-05-15",90,12,146,318,2838,0.385482734319944,0,0,223,361,35,2908,18,945,28,18
"1009","2020-05-16",98,12,143,314,2838,0.385482734319944,0,0,223,361,50,2958,38,983,42,38
"1010","2020-05-17",98,12,134,298,2838,0.385482734319944,0,0,223,361,29,2987,20,1003,27,20
"1011","2020-05-18",96,12,132,292,2838,0.385482734319944,0,0,223,361,24,3011,16,1019,20,16
"1012","2020-05-19",93,12,126,288,2838,0.385482734319944,0,0,223,361,36,3047,11,1030,24,11
"1013","2020-05-20",86,12,126,287,2838,0.385482734319944,0,0,223,361,30,3077,19,1049,24,19
"1014","2020-05-21",89,12,126,277,2838,0.385482734319944,0,0,223,361,38,3115,19,1068,31,19
"1015","2020-05-22",92,12,134,277,2838,0.385482734319944,0,0,223,361,22,3137,16,1084,16,16
"1016","2020-05-23",85,12,127,272,2838,0.385482734319944,0,0,223,361,31,3168,20,1104,21,20
"1017","2020-05-24",85,12,129,274,2838,0.385482734319944,0,0,223,361,30,3198,12,1116,25,12
"1018","2020-05-25",81,12,132,271,2838,0.385482734319944,0,0,223,361,19,3217,6,1122,16,6
"1019","2020-05-26",83,12,133,263,2838,0.385482734319944,0,0,223,361,28,3245,NA,NA,23,NA
"1020","2020-05-27",82,12,135,264,2838,0.385482734319944,0,0,223,361,19,3264,13,1135,15,13
"1021","2020-05-28",79,12,141,260,2838,0.385482734319944,0,0,223,361,29,3293,16,1151,23,16
"1022","2020-05-29",75,12,136,254,2838,0.385482734319944,0,0,223,361,6,3299,13,1164,5,13
"1023","2020-05-30",73,12,131,242,2838,0.385482734319944,0,0,223,361,29,3328,32,1196,24,32
"1024","2020-05-31",68,12,133,242,2838,0.385482734319944,0,0,223,361,22,3350,17,1213,19,17
"1025","2020-06-01",67,12,137,226,2838,0.385482734319944,0,0,223,361,24,3374,16,1229,22,16
"1026","2020-06-02",72,12,122,218,2838,0.385482734319944,0,0,223,361,15,3389,17,1246,13,17
"1027","2020-06-03",72,12,113,202,2838,0.385482734319944,0,0,223,361,10,3399,16,1262,8,16
"1028","2020-06-04",66,12,104,198,2838,0.385482734319944,0,0,223,361,20,3419,12,1274,17,12
"1029","2020-06-05",65,12,104,190,2838,0.385482734319944,0,0,223,361,13,3432,14,1288,12,14
"1030","2020-06-06",60,12,99,192,2838,0.385482734319944,0,0,223,361,10,3442,9,1297,6,9
"1031","2020-06-07",61,12,89,185,2838,0.385482734319944,0,0,223,361,14,3456,13,1310,10,13
"1032","2020-03-14",1,13,14,23,1743,0.699368904188181,0,0,150,328,19,52,6,23,4,6
"1033","2020-03-15",2,13,21,31,1743,0.699368904188181,0,0,150,328,11,63,10,33,5,10
"1034","2020-03-16",2,13,31,38,1743,0.699368904188181,0,0,150,328,27,90,4,37,5,4
"1035","2020-03-17",3,13,33,48,1743,0.699368904188181,0,0,150,328,21,111,8,45,12,8
"1036","2020-03-18",6,13,46,57,1743,0.699368904188181,0,0,150,328,20,131,11,56,6,11
"1037","2020-03-19",10,13,56,69,1743,0.699368904188181,0,0,150,328,14,145,NA,NA,10,NA
"1038","2020-03-20",14,13,67,86,1743,0.699368904188181,0,0,150,328,20,165,5,61,14,5
"1039","2020-03-21",16,13,68,98,1743,0.699368904188181,0,0,150,328,25,190,5,66,16,5
"1040","2020-03-22",20,13,77,122,1743,0.699368904188181,0,0,150,328,24,214,5,71,13,5
"1041","2020-03-23",25,13,81,130,1743,0.699368904188181,0,0,150,328,31,245,7,78,15,7
"1042","2020-03-24",32,13,78,146,1743,0.699368904188181,0,0,150,328,35,280,12,90,21,12
"1043","2020-03-25",36,13,72,157,1743,0.699368904188181,0,0,150,328,30,310,8,98,16,8
"1044","2020-03-26",35,13,70,166,1743,0.699368904188181,0,0,150,328,35,345,12,110,26,12
"1045","2020-03-27",36,13,70,191,1743,0.699368904188181,0,0,150,328,33,378,4,114,22,4
"1046","2020-03-28",37,13,77,190,1743,0.699368904188181,0,0,150,328,42,420,12,126,30,12
"1047","2020-03-29",40,13,75,201,1743,0.699368904188181,0,0,150,328,37,457,13,139,24,13
"1048","2020-03-30",47,13,75,211,1743,0.699368904188181,0,0,150,328,36,493,10,149,23,10
"1049","2020-03-31",51,13,69,222,1743,0.699368904188181,0,0,150,328,30,523,17,166,16,17
"1050","2020-04-01",51,13,76,232,1743,0.699368904188181,0,0,150,328,27,550,5,171,16,5
"1051","2020-04-02",58,13,77,238,1743,0.699368904188181,0,0,150,328,25,575,4,175,15,4
"1052","2020-04-03",67,13,78,237,1743,0.699368904188181,0,0,150,328,38,613,9,184,26,9
"1053","2020-04-04",69,13,97,254,1743,0.699368904188181,0,0,150,328,43,656,5,189,30,5
"1054","2020-04-05",67,13,106,267,1743,0.699368904188181,0,0,150,328,44,700,11,200,31,11
"1055","2020-04-06",61,13,104,281,1743,0.699368904188181,0,0,150,328,41,741,9,209,20,9
"1056","2020-04-07",60,13,102,285,1743,0.699368904188181,0,0,150,328,44,785,12,221,32,12
"1057","2020-04-08",67,13,115,293,1743,0.699368904188181,0,0,150,328,44,829,8,229,28,8
"1058","2020-04-09",64,13,108,314,1743,0.699368904188181,0,0,150,328,48,877,8,237,24,8
"1059","2020-04-10",63,13,100,314,1743,0.699368904188181,0,0,150,328,58,935,18,255,36,18
"1060","2020-04-11",67,13,105,318,1743,0.699368904188181,0,0,150,328,40,975,7,262,27,7
"1061","2020-04-12",79,13,110,331,1743,0.699368904188181,0,0,150,328,45,1020,17,279,37,17
"1062","2020-04-13",82,13,101,344,1743,0.699368904188181,0,0,150,328,48,1068,11,290,33,11
"1063","2020-04-14",87,13,117,352,1743,0.699368904188181,0,0,150,328,51,1119,12,302,32,12
"1064","2020-04-15",90,13,131,359,1743,0.699368904188181,0,0,150,328,57,1176,26,328,44,26
"1065","2020-04-16",92,13,129,377,1743,0.699368904188181,0,0,150,328,51,1227,27,355,34,27
"1066","2020-04-17",96,13,132,368,1743,0.699368904188181,0,0,150,328,48,1275,14,369,38,14
"1067","2020-04-18",98,13,141,373,1743,0.699368904188181,0,0,150,328,43,1318,9,378,26,9
"1068","2020-04-19",99,13,148,379,1743,0.699368904188181,0,0,150,328,49,1367,17,395,32,17
"1069","2020-04-20",109,13,166,372,1743,0.699368904188181,0,0,150,328,48,1415,13,408,33,13
"1070","2020-04-21",112,13,166,366,1743,0.699368904188181,0,0,150,328,41,1456,16,424,25,16
"1071","2020-04-22",109,13,182,352,1743,0.699368904188181,0,0,150,328,54,1510,13,437,29,13
"1072","2020-04-23",117,13,202,348,1743,0.699368904188181,0,0,150,328,45,1555,18,455,32,18
"1073","2020-04-24",112,13,200,342,1743,0.699368904188181,0,0,150,328,39,1594,14,469,26,14
"1074","2020-04-25",108,13,179,343,1743,0.699368904188181,0,0,150,328,42,1636,21,490,25,21
"1075","2020-04-26",106,13,171,332,1743,0.699368904188181,0,0,150,328,52,1688,10,500,33,10
"1076","2020-04-27",97,13,168,329,1743,0.699368904188181,0,0,150,328,46,1734,8,508,30,8
"1077","2020-04-28",95,13,162,310,1743,0.699368904188181,0,0,150,328,37,1771,13,521,15,13
"1078","2020-04-29",96,13,155,296,1743,0.699368904188181,0,0,150,328,47,1818,25,546,30,25
"1079","2020-04-30",93,13,156,286,1743,0.699368904188181,0,0,150,328,29,1847,13,559,20,13
"1080","2020-05-01",90,13,158,263,1743,0.699368904188181,0,0,150,328,38,1885,8,567,28,8
"1081","2020-05-02",90,13,159,248,1743,0.699368904188181,0,0,150,328,35,1920,13,580,23,13
"1082","2020-05-03",83,13,185,238,1743,0.699368904188181,0,0,150,328,40,1960,13,593,27,13
"1083","2020-05-04",81,13,220,233,1743,0.699368904188181,0,0,150,328,41,2001,10,603,27,10
"1084","2020-05-05",81,13,225,225,1743,0.699368904188181,0,0,150,328,48,2049,8,611,35,8
"1085","2020-05-06",76,13,207,212,1743,0.699368904188181,0,0,150,328,31,2080,9,620,20,9
"1086","2020-05-07",69,13,183,200,1743,0.699368904188181,0,0,150,328,29,2109,11,631,23,11
"1087","2020-05-08",65,13,185,196,1743,0.699368904188181,0,0,150,328,27,2136,12,643,17,12
"1088","2020-05-09",58,13,183,180,1743,0.699368904188181,0,0,150,328,40,2176,6,649,27,6
"1089","2020-05-10",54,13,180,180,1743,0.699368904188181,0,0,150,328,35,2211,5,654,23,5
"1090","2020-05-11",54,13,174,177,1743,0.699368904188181,0,0,150,328,26,2237,4,658,16,4
"1091","2020-05-12",46,13,163,163,1743,0.699368904188181,0,0,150,328,36,2273,5,663,24,5
"1092","2020-05-13",44,13,159,158,1743,0.699368904188181,0,0,150,328,37,2310,12,675,16,12
"1093","2020-05-14",42,13,159,152,1743,0.699368904188181,0,0,150,328,33,2343,10,685,21,10
"1094","2020-05-15",40,13,157,152,1743,0.699368904188181,0,0,150,328,40,2383,2,687,26,2
"1095","2020-05-16",48,13,149,144,1743,0.699368904188181,0,0,150,328,29,2412,13,700,14,13
"1096","2020-05-17",47,13,167,144,1743,0.699368904188181,0,0,150,328,42,2454,12,712,27,12
"1097","2020-05-18",45,13,179,138,1743,0.699368904188181,0,0,150,328,30,2484,22,734,18,22
"1098","2020-05-19",39,13,177,142,1743,0.699368904188181,0,0,150,328,28,2512,29,763,17,29
"1099","2020-05-20",35,13,161,147,1743,0.699368904188181,0,0,150,328,21,2533,13,776,12,13
"1100","2020-05-21",36,13,159,162,1743,0.699368904188181,0,0,150,328,39,2572,9,785,23,9
"1101","2020-05-22",42,13,151,159,1743,0.699368904188181,0,0,150,328,23,2595,6,791,11,6
"1102","2020-05-23",41,13,143,162,1743,0.699368904188181,0,0,150,328,22,2617,7,798,16,7
"1103","2020-05-24",45,13,149,162,1743,0.699368904188181,0,0,150,328,25,2642,17,815,17,17
"1104","2020-05-25",46,13,147,166,1743,0.699368904188181,0,0,150,328,15,2657,17,832,5,17
"1105","2020-05-26",50,13,143,171,1743,0.699368904188181,0,0,150,328,22,2679,10,842,8,10
"1106","2020-05-27",55,13,156,170,1743,0.699368904188181,0,0,150,328,14,2693,10,852,5,10
"1107","2020-05-28",54,13,167,164,1743,0.699368904188181,0,0,150,328,22,2715,4,856,5,4
"1108","2020-05-29",51,13,167,158,1743,0.699368904188181,0,0,150,328,16,2731,7,863,9,7
"1109","2020-05-30",48,13,170,151,1743,0.699368904188181,0,0,150,328,17,2748,3,866,13,3
"1110","2020-05-31",45,13,161,146,1743,0.699368904188181,0,0,150,328,14,2762,3,869,7,3
"1111","2020-06-01",44,13,147,140,1743,0.699368904188181,0,0,150,328,14,2776,6,875,7,6
"1112","2020-06-02",45,13,151,133,1743,0.699368904188181,0,0,150,328,20,2796,3,878,9,3
"1113","2020-06-03",39,13,139,135,1743,0.699368904188181,0,0,150,328,12,2808,9,887,6,9
"1114","2020-06-04",41,13,144,122,1743,0.699368904188181,0,0,150,328,11,2819,10,897,8,10
"1115","2020-06-05",43,13,154,119,1743,0.699368904188181,0,0,150,328,15,2834,9,906,8,9
"1116","2020-06-06",40,13,143,113,1743,0.699368904188181,0,0,150,328,7,2841,8,914,3,8
"1117","2020-06-07",40,13,139,118,1743,0.699368904188181,0,0,150,328,10,2851,6,920,3,6
"1118","2020-03-15",1,14,51,60,5914,0.928474805546162,0,0,513,436,23,95,14,49,14,14
"1119","2020-03-16",3,14,52,81,5914,0.928474805546162,0,0,513,436,37,132,6,55,29,6
"1120","2020-03-17",4,14,54,117,5914,0.928474805546162,0,0,513,436,50,182,3,58,44,3
"1121","2020-03-18",7,14,57,138,5914,0.928474805546162,0,0,513,436,40,222,4,62,33,4
"1122","2020-03-19",10,14,58,184,5914,0.928474805546162,0,0,513,436,46,268,6,68,36,6
"1123","2020-03-20",15,14,60,226,5914,0.928474805546162,0,0,513,436,35,303,5,73,29,5
"1124","2020-03-21",23,14,57,262,5914,0.928474805546162,0,0,513,436,48,351,1,74,39,1
"1125","2020-03-22",33,14,49,311,5914,0.928474805546162,0,0,513,436,61,412,3,77,57,3
"1126","2020-03-23",43,14,61,362,5914,0.928474805546162,0,0,513,436,66,478,5,82,57,5
"1127","2020-03-24",56,14,73,401,5914,0.928474805546162,0,0,513,436,80,558,7,89,65,7
"1128","2020-03-25",69,14,90,445,5914,0.928474805546162,0,0,513,436,69,627,19,108,60,19
"1129","2020-03-26",82,14,94,520,5914,0.928474805546162,0,0,513,436,103,730,10,118,89,10
"1130","2020-03-27",99,14,96,582,5914,0.928474805546162,0,0,513,436,95,825,3,121,86,3
"1131","2020-03-28",113,14,106,627,5914,0.928474805546162,0,0,513,436,115,940,4,125,101,4
"1132","2020-03-29",122,14,121,667,5914,0.928474805546162,0,0,513,436,156,1096,18,143,143,18
"1133","2020-03-30",133,14,123,733,5914,0.928474805546162,0,0,513,436,128,1224,23,166,117,23
"1134","2020-03-31",155,14,117,774,5914,0.928474805546162,0,0,513,436,164,1388,24,190,155,24
"1135","2020-04-01",161,14,116,848,5914,0.928474805546162,0,0,513,436,192,1580,29,219,181,29
"1136","2020-04-02",170,14,116,874,5914,0.928474805546162,0,0,513,436,196,1776,30,249,186,30
"1137","2020-04-03",192,14,109,975,5914,0.928474805546162,0,0,513,436,216,1992,15,264,209,15
"1138","2020-04-04",223,14,116,1060,5914,0.928474805546162,0,0,513,436,298,2290,7,271,285,7
"1139","2020-04-05",233,14,115,1117,5914,0.928474805546162,0,0,513,436,286,2576,11,282,277,11
"1140","2020-04-06",261,14,124,1185,5914,0.928474805546162,0,0,513,436,302,2878,19,301,295,19
"1141","2020-04-07",271,14,137,1253,5914,0.928474805546162,0,0,513,436,292,3170,15,316,280,15
"1142","2020-04-08",295,14,133,1347,5914,0.928474805546162,0,0,513,436,312,3482,25,341,301,25
"1143","2020-04-09",316,14,120,1392,5914,0.928474805546162,0,0,513,436,305,3787,25,366,299,25
"1144","2020-04-10",323,14,115,1488,5914,0.928474805546162,0,0,513,436,352,4139,19,385,345,19
"1145","2020-04-11",332,14,122,1575,5914,0.928474805546162,0,0,513,436,287,4426,20,405,283,20
"1146","2020-04-12",358,14,116,1599,5914,0.928474805546162,0,0,513,436,328,4754,32,437,322,32
"1147","2020-04-13",366,14,114,1609,5914,0.928474805546162,0,0,513,436,300,5054,31,468,295,31
"1148","2020-04-14",388,14,127,1658,5914,0.928474805546162,0,0,513,436,329,5383,13,481,324,13
"1149","2020-04-15",416,14,139,1692,5914,0.928474805546162,0,0,513,436,280,5663,13,494,279,13
"1150","2020-04-16",436,14,139,1731,5914,0.928474805546162,0,0,513,436,204,5867,29,523,198,29
"1151","2020-04-17",452,14,144,1731,5914,0.928474805546162,0,0,513,436,186,6053,22,545,183,22
"1152","2020-04-18",444,14,159,1741,5914,0.928474805546162,0,0,513,436,206,6259,14,559,203,14
"1153","2020-04-19",458,14,160,1735,5914,0.928474805546162,0,0,513,436,154,6413,4,563,150,4
"1154","2020-04-20",473,14,144,1727,5914,0.928474805546162,0,0,513,436,140,6553,12,575,134,12
"1155","2020-04-21",475,14,123,1682,5914,0.928474805546162,0,0,513,436,95,6648,15,590,94,15
"1156","2020-04-22",470,14,120,1668,5914,0.928474805546162,0,0,513,436,70,6718,31,621,68,31
"1157","2020-04-23",474,14,137,1613,5914,0.928474805546162,0,0,513,436,98,6816,38,659,92,38
"1158","2020-04-24",480,14,130,1542,5914,0.928474805546162,0,0,513,436,58,6874,32,691,54,32
"1159","2020-04-25",491,14,129,1484,5914,0.928474805546162,0,0,513,436,49,6923,29,720,46,29
"1160","2020-04-26",469,14,126,1410,5914,0.928474805546162,0,0,513,436,36,6959,19,739,36,19
"1161","2020-04-27",447,14,136,1358,5914,0.928474805546162,0,0,513,436,40,6999,30,769,36,30
"1162","2020-04-28",430,14,138,1297,5914,0.928474805546162,0,0,513,436,26,7025,18,787,22,18
"1163","2020-04-29",411,14,135,1220,5914,0.928474805546162,0,0,513,436,27,7052,13,800,26,13
"1164","2020-04-30",387,14,131,1145,5914,0.928474805546162,0,0,513,436,14,7066,18,818,10,18
"1165","2020-05-01",364,14,118,1083,5914,0.928474805546162,0,0,513,436,19,7085,9,827,17,9
"1166","2020-05-02",329,14,110,1027,5914,0.928474805546162,0,0,513,436,13,7098,11,838,12,11
"1167","2020-05-03",323,14,106,948,5914,0.928474805546162,0,0,513,436,5,7103,31,869,2,31
"1168","2020-05-04",309,14,120,876,5914,0.928474805546162,0,0,513,436,11,7114,14,883,10,14
"1169","2020-05-05",305,14,127,801,5914,0.928474805546162,0,0,513,436,8,7122,9,892,7,9
"1170","2020-05-06",298,14,122,748,5914,0.928474805546162,0,0,513,436,11,7133,5,897,11,5
"1171","2020-05-07",282,14,118,692,5914,0.928474805546162,0,0,513,436,8,7141,30,927,5,30
"1172","2020-05-08",270,14,110,660,5914,0.928474805546162,0,0,513,436,6,7147,22,949,5,22
"1173","2020-05-09",263,14,113,611,5914,0.928474805546162,0,0,513,436,3,7150,45,994,3,45
"1174","2020-05-10",253,14,113,554,5914,0.928474805546162,0,0,513,436,3,7153,44,1038,3,44
"1175","2020-05-11",237,14,104,499,5914,0.928474805546162,0,0,513,436,6,7159,32,1070,3,32
"1176","2020-05-12",202,14,108,450,5914,0.928474805546162,0,0,513,436,7,7166,30,1100,2,30
"1177","2020-05-13",176,14,103,410,5914,0.928474805546162,0,0,513,436,3,7169,12,1112,2,12
"1178","2020-05-14",160,14,101,374,5914,0.928474805546162,0,0,513,436,7,7176,18,1130,6,18
"1179","2020-05-15",137,14,111,334,5914,0.928474805546162,0,0,513,436,5,7181,14,1144,3,14
"1180","2020-05-16",132,14,105,305,5914,0.928474805546162,0,0,513,436,9,7190,13,1157,6,13
"1181","2020-05-17",112,14,105,274,5914,0.928474805546162,0,0,513,436,3,7193,5,1162,3,5
"1182","2020-05-18",97,14,117,249,5914,0.928474805546162,0,0,513,436,8,7201,20,1182,3,20
"1183","2020-05-19",95,14,127,218,5914,0.928474805546162,0,0,513,436,3,7204,13,1195,3,13
"1184","2020-05-20",82,14,120,207,5914,0.928474805546162,0,0,513,436,3,7207,15,1210,2,15
"1185","2020-05-21",75,14,120,192,5914,0.928474805546162,0,0,513,436,4,7211,24,1234,2,24
"1186","2020-05-22",69,14,116,175,5914,0.928474805546162,0,0,513,436,2,7213,25,1259,1,25
"1187","2020-05-23",57,14,122,165,5914,0.928474805546162,0,0,513,436,4,7217,15,1274,2,15
"1188","2020-05-24",48,14,116,152,5914,0.928474805546162,0,0,513,436,NA,NA,15,1289,NA,15
"1189","2020-05-25",50,14,102,143,5914,0.928474805546162,0,0,513,436,3,7220,5,1294,1,5
"1190","2020-05-26",44,14,109,127,5914,0.928474805546162,0,0,513,436,2,7222,33,1327,2,33
"1191","2020-05-27",44,14,120,120,5914,0.928474805546162,0,0,513,436,2,7224,27,1354,NA,27
"1192","2020-05-28",41,14,122,115,5914,0.928474805546162,0,0,513,436,NA,NA,19,1373,NA,19
"1193","2020-05-29",37,14,112,107,5914,0.928474805546162,0,0,513,436,4,7228,13,1386,2,13
"1194","2020-05-30",32,14,115,95,5914,0.928474805546162,0,0,513,436,3,7231,28,1414,2,28
"1195","2020-05-31",32,14,120,90,5914,0.928474805546162,0,0,513,436,1,7232,25,1439,1,25
"1196","2020-06-01",25,14,123,82,5914,0.928474805546162,0,0,513,436,3,7235,19,1458,3,19
"1197","2020-06-02",24,14,110,76,5914,0.928474805546162,0,0,513,436,2,7237,18,1476,NA,18
"1198","2020-06-03",24,14,104,68,5914,0.928474805546162,0,0,513,436,1,7238,22,1498,NA,22
"1199","2020-06-04",28,14,103,65,5914,0.928474805546162,0,0,513,436,1,7239,14,1512,1,14
"1200","2020-06-05",24,14,108,58,5914,0.928474805546162,0,0,513,436,2,7241,23,1535,1,23
"1201","2020-06-06",24,14,106,56,5914,0.928474805546162,0,0,513,436,3,7244,18,1553,3,18
"1202","2020-06-07",23,14,107,53,5914,0.928474805546162,0,0,513,436,1,7245,15,1568,NA,15
"1203","2020-03-13",5,15,94,75,8098,0.894047913064954,0,0,686,584,31,72,7,19,3,7
"1204","2020-03-14",9,15,101,106,8098,0.894047913064954,0,0,686,584,31,103,2,21,4,2
"1205","2020-03-15",14,15,104,157,8098,0.894047913064954,0,0,686,584,29,132,7,28,9,7
"1206","2020-03-16",18,15,95,213,8098,0.894047913064954,0,0,686,584,34,166,5,33,12,5
"1207","2020-03-17",27,15,92,274,8098,0.894047913064954,0,0,686,584,29,195,5,38,6,5
"1208","2020-03-18",34,15,124,353,8098,0.894047913064954,0,0,686,584,39,234,8,46,17,8
"1209","2020-03-19",45,15,134,435,8098,0.894047913064954,0,0,686,584,42,276,11,57,21,11
"1210","2020-03-20",55,15,135,557,8098,0.894047913064954,0,0,686,584,34,310,9,66,12,9
"1211","2020-03-21",63,15,122,704,8098,0.894047913064954,0,0,686,584,41,351,11,77,20,11
"1212","2020-03-22",78,15,109,870,8098,0.894047913064954,0,0,686,584,38,389,6,83,21,6
"1213","2020-03-23",100,15,109,1029,8098,0.894047913064954,0,0,686,584,46,435,6,89,20,7
"1214","2020-03-24",131,15,98,1176,8098,0.894047913064954,0,0,686,584,48,483,6,95,20,6
"1215","2020-03-25",160,15,134,1392,8098,0.894047913064954,0,0,686,584,44,527,7,102,19,7
"1216","2020-03-26",205,15,157,1641,8098,0.894047913064954,0,0,686,584,43,570,5,107,16,5
"1217","2020-03-27",252,15,162,1939,8098,0.894047913064954,0,0,686,584,40,610,10,117,19,10
"1218","2020-03-28",315,15,170,2177,8098,0.894047913064954,0,0,686,584,42,652,7,124,19,7
"1219","2020-03-29",376,15,160,2513,8098,0.894047913064954,0,0,686,584,41,693,3,127,23,3
"1220","2020-03-30",441,15,186,2819,8098,0.894047913064954,0,0,686,584,48,741,2,129,26,2
"1221","2020-03-31",533,15,214,3133,8098,0.894047913064954,0,0,686,584,44,785,NA,NA,18,NA
"1222","2020-04-01",609,15,230,3502,8098,0.894047913064954,0,0,686,584,50,835,3,132,24,3
"1223","2020-04-02",679,15,180,3714,8098,0.894047913064954,0,0,686,584,48,883,2,134,27,2
"1224","2020-04-03",762,15,167,3935,8098,0.894047913064954,0,0,686,584,40,923,2,136,16,2
"1225","2020-04-04",844,15,170,4034,8098,0.894047913064954,0,0,686,584,46,969,8,144,22,8
"1226","2020-04-05",929,15,190,4091,8098,0.894047913064954,0,0,686,584,54,1023,11,155,28,11
"1227","2020-04-06",1007,15,216,4096,8098,0.894047913064954,0,0,686,584,46,1069,7,162,24,7
"1228","2020-04-07",1062,15,222,4071,8098,0.894047913064954,0,0,686,584,58,1127,5,167,22,5
"1229","2020-04-08",1127,15,202,3992,8098,0.894047913064954,0,0,686,584,45,1172,11,178,22,11
"1230","2020-04-09",1157,15,194,3792,8098,0.894047913064954,0,0,686,584,53,1225,16,194,20,16
"1231","2020-04-10",1173,15,209,3549,8098,0.894047913064954,0,0,686,584,51,1276,3,197,21,3
"1232","2020-04-11",1163,15,243,3238,8098,0.894047913064954,0,0,686,584,50,1326,17,214,23,17
"1233","2020-04-12",1126,15,240,2944,8098,0.894047913064954,0,0,686,584,51,1377,12,226,20,12
"1234","2020-04-13",1089,15,231,2592,8098,0.894047913064954,0,0,686,584,48,1425,11,237,27,11
"1235","2020-04-14",1000,15,207,2248,8098,0.894047913064954,0,0,686,584,62,1487,15,252,25,15
"1236","2020-04-15",917,15,231,1967,8098,0.894047913064954,0,0,686,584,40,1527,24,276,21,24
"1237","2020-04-16",861,15,238,1707,8098,0.894047913064954,0,0,686,584,54,1581,14,290,22,14
"1238","2020-04-17",760,15,223,1453,8098,0.894047913064954,0,0,686,584,46,1627,17,307,24,17
"1239","2020-04-18",659,15,211,1252,8098,0.894047913064954,0,0,686,584,49,1676,13,320,19,13
"1240","2020-04-19",585,15,192,1049,8098,0.894047913064954,0,0,686,584,41,1717,17,337,14,17
"1241","2020-04-20",496,15,182,842,8098,0.894047913064954,0,0,686,584,40,1757,6,343,19,6
"1242","2020-04-21",429,15,155,675,8098,0.894047913064954,0,0,686,584,56,1813,6,349,20,6
"1243","2020-04-22",357,15,141,552,8098,0.894047913064954,0,0,686,584,42,1855,11,360,21,11
"1244","2020-04-23",281,15,139,439,8098,0.894047913064954,0,0,686,584,59,1914,18,378,24,18
"1245","2020-04-24",242,15,134,354,8098,0.894047913064954,0,0,686,584,59,1973,25,403,27,25
"1246","2020-04-25",205,15,114,301,8098,0.894047913064954,0,0,686,584,44,2017,23,426,18,23
"1247","2020-04-26",156,15,100,256,8098,0.894047913064954,0,0,686,584,40,2057,11,437,23,11
"1248","2020-04-27",120,15,92,217,8098,0.894047913064954,0,0,686,584,41,2098,17,454,13,17
"1249","2020-04-28",102,15,87,171,8098,0.894047913064954,0,0,686,584,53,2151,14,468,21,14
"1250","2020-04-29",84,15,82,144,8098,0.894047913064954,0,0,686,584,39,2190,11,479,9,11
"1251","2020-04-30",64,15,76,121,8098,0.894047913064954,0,0,686,584,48,2238,9,488,12,9
"1252","2020-05-01",47,15,103,95,8098,0.894047913064954,0,0,686,584,44,2282,5,493,15,5
"1253","2020-05-02",41,15,139,85,8098,0.894047913064954,0,0,686,584,47,2329,3,496,23,3
"1254","2020-05-03",39,15,133,77,8098,0.894047913064954,0,0,686,584,43,2372,1,497,17,1
"1255","2020-05-04",36,15,139,67,8098,0.894047913064954,0,0,686,584,46,2418,14,511,26,14
"1256","2020-05-05",23,15,140,58,8098,0.894047913064954,0,0,686,584,33,2451,17,528,10,17
"1257","2020-05-06",20,15,141,53,8098,0.894047913064954,0,0,686,584,42,2493,18,546,13,18
"1258","2020-05-07",19,15,170,53,8098,0.894047913064954,0,0,686,584,40,2533,8,554,15,8
"1259","2020-05-08",17,15,181,52,8098,0.894047913064954,0,0,686,584,29,2562,17,571,9,17
"1260","2020-05-09",16,15,220,54,8098,0.894047913064954,0,0,686,584,41,2603,27,598,14,27
"1261","2020-05-10",13,15,232,54,8098,0.894047913064954,0,0,686,584,32,2635,17,615,11,17
"1262","2020-05-11",11,15,202,51,8098,0.894047913064954,0,0,686,584,31,2666,16,631,13,16
"1263","2020-05-12",13,15,176,43,8098,0.894047913064954,0,0,686,584,26,2692,10,641,9,10
"1264","2020-05-13",14,15,150,39,8098,0.894047913064954,0,0,686,584,32,2724,10,651,8,10
"1265","2020-05-14",13,15,143,39,8098,0.894047913064954,0,0,686,584,25,2749,8,659,13,8
"1266","2020-05-15",13,15,185,34,8098,0.894047913064954,0,0,686,584,25,2774,8,667,8,8
"1267","2020-05-16",11,15,209,31,8098,0.894047913064954,0,0,686,584,29,2803,4,671,7,4
"1268","2020-05-17",11,15,206,29,8098,0.894047913064954,0,0,686,584,17,2820,7,678,6,7
"1269","2020-05-18",11,15,222,27,8098,0.894047913064954,0,0,686,584,31,2851,3,681,9,3
"1270","2020-05-19",9,15,198,28,8098,0.894047913064954,0,0,686,584,23,2874,2,683,10,2
"1271","2020-05-20",7,15,202,24,8098,0.894047913064954,0,0,686,584,23,2897,3,686,10,3
"1272","2020-05-21",7,15,199,25,8098,0.894047913064954,0,0,686,584,25,2922,7,693,11,7
"1273","2020-05-22",5,15,220,27,8098,0.894047913064954,0,0,686,584,22,2944,5,698,7,5
"1274","2020-05-23",7,15,230,30,8098,0.894047913064954,0,0,686,584,15,2959,4,702,5,4
"1275","2020-05-24",6,15,225,30,8098,0.894047913064954,0,0,686,584,31,2990,6,708,8,6
"1276","2020-05-25",5,15,204,27,8098,0.894047913064954,0,0,686,584,25,3015,15,723,8,15
"1277","2020-05-26",5,15,191,28,8098,0.894047913064954,0,0,686,584,21,3036,7,730,11,7
"1278","2020-05-27",7,15,142,30,8098,0.894047913064954,0,0,686,584,20,3056,9,739,9,9
"1279","2020-05-28",5,15,135,31,8098,0.894047913064954,0,0,686,584,22,3078,10,749,6,10
"1280","2020-05-29",5,15,129,30,8098,0.894047913064954,0,0,686,584,16,3094,4,753,6,4
"1281","2020-05-30",6,15,144,23,8098,0.894047913064954,0,0,686,584,18,3112,5,758,7,5
"1282","2020-05-31",6,15,189,22,8098,0.894047913064954,0,0,686,584,22,3134,10,768,7,10
"1283","2020-06-01",5,15,191,20,8098,0.894047913064954,0,0,686,584,16,3150,6,774,7,6
"1284","2020-06-02",6,15,173,18,8098,0.894047913064954,0,0,686,584,18,3168,8,782,3,8
"1285","2020-06-03",4,15,164,16,8098,0.894047913064954,0,0,686,584,14,3182,9,791,6,9
"1286","2020-06-04",4,15,158,16,8098,0.894047913064954,0,0,686,584,13,3195,8,799,3,8
"1287","2020-06-05",6,15,156,15,8098,0.894047913064954,0,0,686,584,9,3204,8,807,3,8
"1288","2020-06-06",3,15,149,13,8098,0.894047913064954,0,0,686,584,14,3218,5,812,10,5
"1289","2020-06-07",4,15,163,14,8098,0.894047913064954,0,0,686,584,13,3231,4,816,7,4
"1290","2020-03-13",1,16,23,30,2516,0.752782193958665,0,0,237,587,14,50,11,24,2,11
"1291","2020-03-14",1,16,35,39,2516,0.752782193958665,0,0,237,587,18,68,14,38,3,14
"1292","2020-03-15",1,16,33,44,2516,0.752782193958665,0,0,237,587,22,90,13,51,7,13
"1293","2020-03-16",3,16,36,62,2516,0.752782193958665,0,0,237,587,23,113,19,70,9,19
"1294","2020-03-17",5,16,40,85,2516,0.752782193958665,0,0,237,587,23,136,20,90,12,20
"1295","2020-03-18",9,16,51,105,2516,0.752782193958665,0,0,237,587,16,152,23,113,9,23
"1296","2020-03-19",13,16,61,126,2516,0.752782193958665,0,0,237,587,26,178,16,129,14,16
"1297","2020-03-20",19,16,62,141,2516,0.752782193958665,0,0,237,587,29,207,13,142,13,13
"1298","2020-03-21",24,16,67,156,2516,0.752782193958665,0,0,237,587,37,244,30,172,20,30
"1299","2020-03-22",28,16,61,175,2516,0.752782193958665,0,0,237,587,33,277,35,207,15,35
"1300","2020-03-23",31,16,70,203,2516,0.752782193958665,0,0,237,587,35,312,23,230,16,23
"1301","2020-03-24",41,16,75,222,2516,0.752782193958665,0,0,237,587,39,351,21,251,17,21
"1302","2020-03-25",48,16,76,240,2516,0.752782193958665,0,0,237,587,25,376,37,288,10,37
"1303","2020-03-26",51,16,83,251,2516,0.752782193958665,0,0,237,587,37,413,36,324,21,36
"1304","2020-03-27",53,16,100,262,2516,0.752782193958665,0,0,237,587,38,451,44,368,24,44
"1305","2020-03-28",62,16,119,274,2516,0.752782193958665,0,0,237,587,42,493,39,407,22,39
"1306","2020-03-29",65,16,107,290,2516,0.752782193958665,0,0,237,587,44,537,30,437,23,30
"1307","2020-03-30",76,16,100,296,2516,0.752782193958665,0,0,237,587,39,576,48,485,22,48
"1308","2020-03-31",76,16,101,299,2516,0.752782193958665,0,0,237,587,50,626,30,515,23,30
"1309","2020-04-01",71,16,106,314,2516,0.752782193958665,0,0,237,587,52,678,37,552,33,37
"1310","2020-04-02",74,16,96,328,2516,0.752782193958665,0,0,237,587,48,726,37,589,31,37
"1311","2020-04-03",74,16,112,337,2516,0.752782193958665,0,0,237,587,38,764,26,615,23,26
"1312","2020-04-04",72,16,107,346,2516,0.752782193958665,0,0,237,587,33,797,35,650,26,35
"1313","2020-04-05",75,16,99,355,2516,0.752782193958665,0,0,237,587,36,833,20,670,18,20
"1314","2020-04-06",69,16,95,369,2516,0.752782193958665,0,0,237,587,51,884,21,691,34,21
"1315","2020-04-07",75,16,89,393,2516,0.752782193958665,0,0,237,587,49,933,51,742,21,51
"1316","2020-04-08",85,16,94,409,2516,0.752782193958665,0,0,237,587,36,969,30,772,15,30
"1317","2020-04-09",88,16,107,414,2516,0.752782193958665,0,0,237,587,45,1014,29,801,21,29
"1318","2020-04-10",91,16,112,414,2516,0.752782193958665,0,0,237,587,47,1061,34,835,33,34
"1319","2020-04-11",94,16,116,449,2516,0.752782193958665,0,0,237,587,52,1113,39,874,24,39
"1320","2020-04-12",103,16,127,473,2516,0.752782193958665,0,0,237,587,29,1142,27,901,15,27
"1321","2020-04-13",120,16,127,487,2516,0.752782193958665,0,0,237,587,33,1175,20,921,20,20
"1322","2020-04-14",119,16,117,483,2516,0.752782193958665,0,0,237,587,47,1222,31,952,19,31
"1323","2020-04-15",124,16,111,488,2516,0.752782193958665,0,0,237,587,46,1268,34,986,24,34
"1324","2020-04-16",132,16,127,491,2516,0.752782193958665,0,0,237,587,44,1312,24,1010,23,24
"1325","2020-04-17",136,16,149,508,2516,0.752782193958665,0,0,237,587,56,1368,17,1027,31,17
"1326","2020-04-18",144,16,161,516,2516,0.752782193958665,0,0,237,587,41,1409,46,1073,25,46
"1327","2020-04-19",141,16,170,503,2516,0.752782193958665,0,0,237,587,44,1453,43,1116,26,43
"1328","2020-04-20",150,16,162,500,2516,0.752782193958665,0,0,237,587,52,1505,62,1178,28,62
"1329","2020-04-21",156,16,168,513,2516,0.752782193958665,0,0,237,587,46,1551,49,1227,24,49
"1330","2020-04-22",149,16,161,496,2516,0.752782193958665,0,0,237,587,42,1593,43,1270,15,43
"1331","2020-04-23",146,16,183,494,2516,0.752782193958665,0,0,237,587,43,1636,50,1320,21,50
"1332","2020-04-24",148,16,207,469,2516,0.752782193958665,0,0,237,587,41,1677,56,1376,17,56
"1333","2020-04-25",141,16,219,443,2516,0.752782193958665,0,0,237,587,36,1713,36,1412,18,36
"1334","2020-04-26",143,16,215,440,2516,0.752782193958665,0,0,237,587,31,1744,37,1449,15,37
"1335","2020-04-27",125,16,210,432,2516,0.752782193958665,0,0,237,587,33,1777,42,1491,17,42
"1336","2020-04-28",124,16,210,427,2516,0.752782193958665,0,0,237,587,36,1813,34,1525,18,34
"1337","2020-04-29",120,16,197,411,2516,0.752782193958665,0,0,237,587,45,1858,53,1578,26,53
"1338","2020-04-30",115,16,199,396,2516,0.752782193958665,0,0,237,587,21,1879,44,1622,13,44
"1339","2020-05-01",104,16,200,392,2516,0.752782193958665,0,0,237,587,37,1916,47,1669,20,47
"1340","2020-05-02",109,16,174,372,2516,0.752782193958665,0,0,237,587,40,1956,41,1710,21,41
"1341","2020-05-03",99,16,158,346,2516,0.752782193958665,0,0,237,587,35,1991,37,1747,18,37
"1342","2020-05-04",96,16,173,351,2516,0.752782193958665,0,0,237,587,40,2031,58,1805,14,58
"1343","2020-05-05",88,16,174,337,2516,0.752782193958665,0,0,237,587,42,2073,30,1835,17,30
"1344","2020-05-06",91,16,165,326,2516,0.752782193958665,0,0,237,587,39,2112,36,1871,19,36
"1345","2020-05-07",96,16,154,309,2516,0.752782193958665,0,0,237,587,39,2151,36,1907,17,36
"1346","2020-05-08",103,16,158,310,2516,0.752782193958665,0,0,237,587,34,2185,42,1949,14,42
"1347","2020-05-09",96,16,179,315,2516,0.752782193958665,0,0,237,587,35,2220,50,1999,20,50
"1348","2020-05-10",103,16,199,301,2516,0.752782193958665,0,0,237,587,26,2246,38,2037,17,38
"1349","2020-05-11",98,16,203,284,2516,0.752782193958665,0,0,237,587,35,2281,29,2066,18,29
"1350","2020-05-12",92,16,189,264,2516,0.752782193958665,0,0,237,587,36,2317,54,2120,20,54
"1351","2020-05-13",90,16,181,256,2516,0.752782193958665,0,0,237,587,33,2350,42,2162,15,42
"1352","2020-05-14",82,16,170,248,2516,0.752782193958665,0,0,237,587,25,2375,37,2199,9,37
"1353","2020-05-15",78,16,159,236,2516,0.752782193958665,0,0,237,587,29,2404,27,2226,15,27
"1354","2020-05-16",74,16,160,244,2516,0.752782193958665,0,0,237,587,41,2445,24,2250,24,24
"1355","2020-05-17",68,16,157,251,2516,0.752782193958665,0,0,237,587,31,2476,21,2271,13,21
"1356","2020-05-18",67,16,164,247,2516,0.752782193958665,0,0,237,587,31,2507,38,2309,16,38
"1357","2020-05-19",65,16,156,246,2516,0.752782193958665,0,0,237,587,34,2541,32,2341,15,32
"1358","2020-05-20",68,16,147,235,2516,0.752782193958665,0,0,237,587,26,2567,38,2379,16,38
"1359","2020-05-21",71,16,147,237,2516,0.752782193958665,0,0,237,587,23,2590,33,2412,10,33
"1360","2020-05-22",69,16,131,243,2516,0.752782193958665,0,0,237,587,31,2621,35,2447,16,35
"1361","2020-05-23",70,16,117,246,2516,0.752782193958665,0,0,237,587,27,2648,55,2502,17,55
"1362","2020-05-24",72,16,133,247,2516,0.752782193958665,0,0,237,587,14,2662,43,2545,5,43
"1363","2020-05-25",73,16,136,237,2516,0.752782193958665,0,0,237,587,24,2686,43,2588,17,43
"1364","2020-05-26",76,16,141,232,2516,0.752782193958665,0,0,237,587,19,2705,38,2626,10,38
"1365","2020-05-27",74,16,131,229,2516,0.752782193958665,0,0,237,587,24,2729,41,2667,12,41
"1366","2020-05-28",69,16,128,217,2516,0.752782193958665,0,0,237,587,22,2751,52,2719,10,52
"1367","2020-05-29",68,16,138,205,2516,0.752782193958665,0,0,237,587,11,2762,43,2762,5,43
"1368","2020-05-30",71,16,141,204,2516,0.752782193958665,0,0,237,587,15,2777,40,2802,10,40
"1369","2020-05-31",71,16,123,201,2516,0.752782193958665,0,0,237,587,30,2807,44,2846,20,44
"1370","2020-06-01",65,16,128,186,2516,0.752782193958665,0,0,237,587,22,2829,37,2883,13,37
"1371","2020-06-02",61,16,122,183,2516,0.752782193958665,0,0,237,587,11,2840,44,2927,7,44
"1372","2020-06-03",58,16,140,182,2516,0.752782193958665,0,0,237,587,17,2857,32,2959,9,32
"1373","2020-06-04",57,16,137,184,2516,0.752782193958665,0,0,237,587,18,2875,30,2989,8,30
"1374","2020-06-05",56,16,131,180,2516,0.752782193958665,0,0,237,587,24,2899,41,3030,17,41
"1375","2020-06-06",48,16,121,161,2516,0.752782193958665,0,0,237,587,13,2912,27,3057,8,27
"1376","2020-06-07",41,16,115,151,2516,0.752782193958665,0,0,237,587,21,2933,25,3082,15,25
"1377","2020-03-13",1,17,31,29,2379,0.457755359394704,0,0,223,515,8,19,4,30,3,4
"1378","2020-03-14",2,17,39,41,2379,0.457755359394704,0,0,223,515,5,24,6,36,5,6
"1379","2020-03-15",2,17,45,49,2379,0.457755359394704,0,0,223,515,17,41,17,53,14,17
"1380","2020-03-16",5,17,39,63,2379,0.457755359394704,0,0,223,515,11,52,21,74,10,21
"1381","2020-03-17",8,17,43,77,2379,0.457755359394704,0,0,223,515,15,67,5,79,13,5
"1382","2020-03-18",13,17,37,102,2379,0.457755359394704,0,0,223,515,22,89,6,85,20,6
"1383","2020-03-19",15,17,41,122,2379,0.457755359394704,0,0,223,515,20,109,6,91,17,6
"1384","2020-03-20",16,17,46,150,2379,0.457755359394704,0,0,223,515,23,132,14,105,21,14
"1385","2020-03-21",23,17,43,175,2379,0.457755359394704,0,0,223,515,33,165,5,110,32,5
"1386","2020-03-22",27,17,42,202,2379,0.457755359394704,0,0,223,515,36,201,8,118,33,8
"1387","2020-03-23",30,17,44,230,2379,0.457755359394704,0,0,223,515,37,238,9,127,36,9
"1388","2020-03-24",33,17,57,258,2379,0.457755359394704,0,0,223,515,37,275,18,145,32,18
"1389","2020-03-25",33,17,51,270,2379,0.457755359394704,0,0,223,515,52,327,4,149,49,4
"1390","2020-03-26",39,17,59,294,2379,0.457755359394704,0,0,223,515,57,384,13,162,55,13
"1391","2020-03-27",51,17,71,321,2379,0.457755359394704,0,0,223,515,65,449,9,171,58,9
"1392","2020-03-28",49,17,92,347,2379,0.457755359394704,0,0,223,515,100,549,3,174,94,3
"1393","2020-03-29",54,17,97,369,2379,0.457755359394704,0,0,223,515,99,648,4,178,93,4
"1394","2020-03-30",64,17,113,387,2379,0.457755359394704,0,0,223,515,112,760,4,182,110,4
"1395","2020-03-31",71,17,127,409,2379,0.457755359394704,0,0,223,515,120,880,6,188,116,6
"1396","2020-04-01",85,17,112,417,2379,0.457755359394704,0,0,223,515,133,1013,13,201,125,13
"1397","2020-04-02",90,17,105,433,2379,0.457755359394704,0,0,223,515,139,1152,19,220,138,19
"1398","2020-04-03",98,17,122,427,2379,0.457755359394704,0,0,223,515,237,1389,26,246,236,26
"1399","2020-04-04",110,17,126,432,2379,0.457755359394704,0,0,223,515,158,1547,21,267,154,21
"1400","2020-04-05",116,17,136,438,2379,0.457755359394704,0,0,223,515,206,1753,30,297,205,30
"1401","2020-04-06",124,17,126,436,2379,0.457755359394704,0,0,223,515,215,1968,30,327,213,30
"1402","2020-04-07",130,17,111,422,2379,0.457755359394704,0,0,223,515,265,2233,22,349,263,22
"1403","2020-04-08",124,17,98,415,2379,0.457755359394704,0,0,223,515,314,2547,25,374,311,25
"1404","2020-04-09",131,17,114,406,2379,0.457755359394704,0,0,223,515,325,2872,25,399,323,25
"1405","2020-04-10",124,17,109,387,2379,0.457755359394704,0,0,223,515,341,3213,19,418,340,19
"1406","2020-04-11",124,17,107,373,2379,0.457755359394704,0,0,223,515,286,3499,12,430,284,12
"1407","2020-04-12",122,17,110,366,2379,0.457755359394704,0,0,223,515,387,3886,30,460,382,30
"1408","2020-04-13",122,17,113,355,2379,0.457755359394704,0,0,223,515,277,4163,27,487,275,27
"1409","2020-04-14",115,17,111,341,2379,0.457755359394704,0,0,223,515,307,4470,39,526,306,39
"1410","2020-04-15",111,17,116,328,2379,0.457755359394704,0,0,223,515,305,4775,15,541,304,15
"1411","2020-04-16",110,17,115,327,2379,0.457755359394704,0,0,223,515,299,5074,16,557,298,16
"1412","2020-04-17",108,17,124,320,2379,0.457755359394704,0,0,223,515,279,5353,37,594,276,37
"1413","2020-04-18",105,17,133,307,2379,0.457755359394704,0,0,223,515,223,5576,40,634,220,40
"1414","2020-04-19",111,17,150,305,2379,0.457755359394704,0,0,223,515,229,5805,35,669,229,35
"1415","2020-04-20",100,17,153,308,2379,0.457755359394704,0,0,223,515,168,5973,31,700,167,31
"1416","2020-04-21",97,17,143,302,2379,0.457755359394704,0,0,223,515,176,6149,24,724,175,24
"1417","2020-04-22",102,17,147,304,2379,0.457755359394704,0,0,223,515,102,6251,19,743,102,19
"1418","2020-04-23",96,17,132,319,2379,0.457755359394704,0,0,223,515,117,6368,32,775,116,32
"1419","2020-04-24",98,17,125,323,2379,0.457755359394704,0,0,223,515,114,6482,21,796,113,21
"1420","2020-04-25",104,17,103,333,2379,0.457755359394704,0,0,223,515,74,6556,28,824,73,28
"1421","2020-04-26",99,17,105,337,2379,0.457755359394704,0,0,223,515,58,6614,12,836,56,12
"1422","2020-04-27",100,17,108,339,2379,0.457755359394704,0,0,223,515,70,6684,14,850,70,14
"1423","2020-04-28",112,17,127,354,2379,0.457755359394704,0,0,223,515,42,6726,13,863,42,13
"1424","2020-04-29",112,17,145,359,2379,0.457755359394704,0,0,223,515,40,6766,40,903,39,40
"1425","2020-04-30",115,17,143,361,2379,0.457755359394704,0,0,223,515,39,6805,31,934,39,31
"1426","2020-05-01",120,17,143,367,2379,0.457755359394704,0,0,223,515,35,6840,20,954,34,20
"1427","2020-05-02",113,17,142,370,2379,0.457755359394704,0,0,223,515,23,6863,32,986,21,32
"1428","2020-05-03",121,17,126,377,2379,0.457755359394704,0,0,223,515,19,6882,19,1005,19,19
"1429","2020-05-04",125,17,130,376,2379,0.457755359394704,0,0,223,515,23,6905,21,1026,22,21
"1430","2020-05-05",121,17,145,366,2379,0.457755359394704,0,0,223,515,19,6924,29,1055,19,29
"1431","2020-05-06",119,17,158,372,2379,0.457755359394704,0,0,223,515,10,6934,17,1072,9,17
"1432","2020-05-07",113,17,145,352,2379,0.457755359394704,0,0,223,515,16,6950,10,1082,14,10
"1433","2020-05-08",109,17,139,332,2379,0.457755359394704,0,0,223,515,11,6961,33,1115,11,33
"1434","2020-05-09",110,17,127,321,2379,0.457755359394704,0,0,223,515,10,6971,32,1147,8,32
"1435","2020-05-10",100,17,118,311,2379,0.457755359394704,0,0,223,515,11,6982,18,1165,10,18
"1436","2020-05-11",92,17,134,308,2379,0.457755359394704,0,0,223,515,7,6989,18,1183,6,18
"1437","2020-05-12",87,17,130,302,2379,0.457755359394704,0,0,223,515,4,6993,10,1193,4,10
"1438","2020-05-13",89,17,129,300,2379,0.457755359394704,0,0,223,515,8,7001,32,1225,8,32
"1439","2020-05-14",92,17,139,298,2379,0.457755359394704,0,0,223,515,5,7006,16,1241,5,16
"1440","2020-05-15",87,17,134,282,2379,0.457755359394704,0,0,223,515,10,7016,24,1265,10,24
"1441","2020-05-16",94,17,140,273,2379,0.457755359394704,0,0,223,515,7,7023,28,1293,7,28
"1442","2020-05-17",95,17,144,267,2379,0.457755359394704,0,0,223,515,3,7026,11,1304,3,11
"1443","2020-05-18",100,17,144,255,2379,0.457755359394704,0,0,223,515,2,7028,19,1323,NA,19
"1444","2020-05-19",94,17,138,244,2379,0.457755359394704,0,0,223,515,5,7033,41,1364,4,41
"1445","2020-05-20",94,17,122,235,2379,0.457755359394704,0,0,223,515,4,7037,38,1402,4,38
"1446","2020-05-21",91,17,132,230,2379,0.457755359394704,0,0,223,515,2,7039,30,1432,2,30
"1447","2020-05-22",90,17,121,225,2379,0.457755359394704,0,0,223,515,2,7041,19,1451,2,19
"1448","2020-05-23",79,17,144,223,2379,0.457755359394704,0,0,223,515,3,7044,27,1478,2,27
"1449","2020-05-24",73,17,136,217,2379,0.457755359394704,0,0,223,515,2,7046,27,1505,2,27
"1450","2020-05-25",64,17,132,210,2379,0.457755359394704,0,0,223,515,1,7047,39,1544,1,39
"1451","2020-05-26",65,17,123,198,2379,0.457755359394704,0,0,223,515,6,7053,17,1561,6,17
"1452","2020-05-27",57,17,118,201,2379,0.457755359394704,0,0,223,515,2,7055,9,1570,2,9
"1453","2020-05-28",51,17,117,196,2379,0.457755359394704,0,0,223,515,2,7057,18,1588,2,18
"1454","2020-05-29",46,17,112,195,2379,0.457755359394704,0,0,223,515,2,7059,20,1608,1,20
"1455","2020-05-30",43,17,128,191,2379,0.457755359394704,0,0,223,515,1,7060,13,1621,1,13
"1456","2020-05-31",43,17,138,184,2379,0.457755359394704,0,0,223,515,2,7062,6,1627,2,6
"1457","2020-06-01",44,17,137,178,2379,0.457755359394704,0,0,223,515,NA,NA,5,1632,NA,5
"1458","2020-06-02",42,17,116,173,2379,0.457755359394704,0,0,223,515,1,7063,6,1638,1,6
"1459","2020-06-03",52,17,104,169,2379,0.457755359394704,0,0,223,515,3,7066,5,1643,3,5
"1460","2020-06-04",58,17,89,170,2379,0.457755359394704,0,0,223,515,NA,NA,15,1658,NA,15
"1461","2020-06-05",55,17,98,164,2379,0.457755359394704,0,0,223,515,1,7067,14,1672,NA,14
"1462","2020-06-06",58,17,96,158,2379,0.457755359394704,0,0,223,515,2,7069,12,1684,2,12
"1463","2020-06-07",59,17,83,150,2379,0.457755359394704,0,0,223,515,NA,NA,9,1693,NA,9
"1464","2020-03-16",2,18,31,45,2191,0.689183021451392,0,0,177,463,3,23,14,88,1,14
"1465","2020-03-17",4,18,50,56,2191,0.689183021451392,0,0,177,463,6,29,7,95,1,7
"1466","2020-03-18",5,18,64,63,2191,0.689183021451392,0,0,177,463,7,36,7,102,3,7
"1467","2020-03-19",6,18,87,75,2191,0.689183021451392,0,0,177,463,6,42,4,106,3,4
"1468","2020-03-20",9,18,79,87,2191,0.689183021451392,0,0,177,463,6,48,4,110,3,4
"1469","2020-03-21",13,18,95,93,2191,0.689183021451392,0,0,177,463,12,60,3,113,7,3
"1470","2020-03-22",17,18,97,111,2191,0.689183021451392,0,0,177,463,14,74,1,114,11,1
"1471","2020-03-23",19,18,90,124,2191,0.689183021451392,0,0,177,463,15,89,7,121,5,7
"1472","2020-03-24",22,18,79,143,2191,0.689183021451392,0,0,177,463,11,100,14,135,6,14
"1473","2020-03-25",28,18,99,150,2191,0.689183021451392,0,0,177,463,19,119,15,150,16,15
"1474","2020-03-26",38,18,105,168,2191,0.689183021451392,0,0,177,463,14,133,29,179,8,29
"1475","2020-03-27",44,18,90,180,2191,0.689183021451392,0,0,177,463,23,156,7,186,18,7
"1476","2020-03-28",47,18,93,191,2191,0.689183021451392,0,0,177,463,24,180,12,198,18,12
"1477","2020-03-29",52,18,107,208,2191,0.689183021451392,0,0,177,463,25,205,15,213,20,15
"1478","2020-03-30",57,18,106,227,2191,0.689183021451392,0,0,177,463,18,223,17,230,17,17
"1479","2020-03-31",60,18,113,234,2191,0.689183021451392,0,0,177,463,20,243,24,254,16,24
"1480","2020-04-01",61,18,131,253,2191,0.689183021451392,0,0,177,463,25,268,18,272,22,18
"1481","2020-04-02",63,18,126,271,2191,0.689183021451392,0,0,177,463,23,291,22,294,18,22
"1482","2020-04-03",68,18,141,282,2191,0.689183021451392,0,0,177,463,31,322,13,307,28,13
"1483","2020-04-04",70,18,147,279,2191,0.689183021451392,0,0,177,463,24,346,21,328,20,21
"1484","2020-04-05",72,18,154,287,2191,0.689183021451392,0,0,177,463,26,372,31,359,21,31
"1485","2020-04-06",73,18,166,301,2191,0.689183021451392,0,0,177,463,20,392,17,376,16,17
"1486","2020-04-07",75,18,146,311,2191,0.689183021451392,0,0,177,463,14,406,26,402,12,26
"1487","2020-04-08",77,18,141,315,2191,0.689183021451392,0,0,177,463,20,426,15,417,15,15
"1488","2020-04-09",78,18,149,325,2191,0.689183021451392,0,0,177,463,23,449,19,436,16,19
"1489","2020-04-10",80,18,140,325,2191,0.689183021451392,0,0,177,463,25,474,20,456,18,20
"1490","2020-04-11",84,18,137,333,2191,0.689183021451392,0,0,177,463,27,501,23,479,17,23
"1491","2020-04-12",87,18,164,346,2191,0.689183021451392,0,0,177,463,21,522,22,501,16,22
"1492","2020-04-13",92,18,187,363,2191,0.689183021451392,0,0,177,463,26,548,26,527,19,26
"1493","2020-04-14",92,18,184,365,2191,0.689183021451392,0,0,177,463,34,582,17,544,23,17
"1494","2020-04-15",96,18,186,379,2191,0.689183021451392,0,0,177,463,24,606,21,565,20,21
"1495","2020-04-16",100,18,211,380,2191,0.689183021451392,0,0,177,463,22,628,15,580,17,15
"1496","2020-04-17",96,18,191,373,2191,0.689183021451392,0,0,177,463,22,650,2,582,16,2
"1497","2020-04-18",97,18,164,371,2191,0.689183021451392,0,0,177,463,35,685,3,585,32,3
"1498","2020-04-19",101,18,139,370,2191,0.689183021451392,0,0,177,463,32,717,7,592,24,7
"1499","2020-04-20",101,18,151,360,2191,0.689183021451392,0,0,177,463,31,748,24,616,25,24
"1500","2020-04-21",108,18,158,360,2191,0.689183021451392,0,0,177,463,27,775,19,635,20,19
"1501","2020-04-22",107,18,151,364,2191,0.689183021451392,0,0,177,463,37,812,23,658,27,23
"1502","2020-04-23",101,18,173,360,2191,0.689183021451392,0,0,177,463,27,839,15,673,22,15
"1503","2020-04-24",100,18,199,340,2191,0.689183021451392,0,0,177,463,27,866,14,687,23,14
"1504","2020-04-25",98,18,212,329,2191,0.689183021451392,0,0,177,463,19,885,16,703,11,16
"1505","2020-04-26",99,18,220,313,2191,0.689183021451392,0,0,177,463,19,904,8,711,18,8
"1506","2020-04-27",99,18,193,307,2191,0.689183021451392,0,0,177,463,17,921,5,716,10,5
"1507","2020-04-28",96,18,169,311,2191,0.689183021451392,0,0,177,463,26,947,6,722,19,6
"1508","2020-04-29",97,18,175,317,2191,0.689183021451392,0,0,177,463,38,985,15,737,31,15
"1509","2020-04-30",102,18,192,315,2191,0.689183021451392,0,0,177,463,26,1011,20,757,16,20
"1510","2020-05-01",107,18,199,316,2191,0.689183021451392,0,0,177,463,26,1037,6,763,23,6
"1511","2020-05-02",104,18,176,314,2191,0.689183021451392,0,0,177,463,27,1064,20,783,22,20
"1512","2020-05-03",102,18,166,316,2191,0.689183021451392,0,0,177,463,34,1098,10,793,32,10
"1513","2020-05-04",98,18,174,312,2191,0.689183021451392,0,0,177,463,25,1123,9,802,19,9
"1514","2020-05-05",90,18,192,319,2191,0.689183021451392,0,0,177,463,29,1152,3,805,19,3
"1515","2020-05-06",84,18,190,323,2191,0.689183021451392,0,0,177,463,33,1185,4,809,27,4
"1516","2020-05-07",84,18,190,335,2191,0.689183021451392,0,0,177,463,35,1220,6,815,32,6
"1517","2020-05-08",79,18,162,325,2191,0.689183021451392,0,0,177,463,28,1248,4,819,22,4
"1518","2020-05-09",88,18,164,328,2191,0.689183021451392,0,0,177,463,31,1279,11,830,30,11
"1519","2020-05-10",83,18,180,318,2191,0.689183021451392,0,0,177,463,37,1316,26,856,28,26
"1520","2020-05-11",86,18,184,311,2191,0.689183021451392,0,0,177,463,25,1341,9,865,23,9
"1521","2020-05-12",98,18,159,307,2191,0.689183021451392,0,0,177,463,37,1378,7,872,33,7
"1522","2020-05-13",105,18,141,315,2191,0.689183021451392,0,0,177,463,31,1409,5,877,28,5
"1523","2020-05-14",105,18,149,305,2191,0.689183021451392,0,0,177,463,34,1443,15,892,29,15
"1524","2020-05-15",103,18,153,298,2191,0.689183021451392,0,0,177,463,42,1485,8,900,36,8
"1525","2020-05-16",96,18,143,299,2191,0.689183021451392,0,0,177,463,23,1508,10,910,18,10
"1526","2020-05-17",104,18,156,281,2191,0.689183021451392,0,0,177,463,33,1541,6,916,30,6
"1527","2020-05-18",98,18,148,286,2191,0.689183021451392,0,0,177,463,27,1568,5,921,23,5
"1528","2020-05-19",92,18,144,283,2191,0.689183021451392,0,0,177,463,47,1615,2,923,43,2
"1529","2020-05-20",90,18,136,274,2191,0.689183021451392,0,0,177,463,42,1657,2,925,35,2
"1530","2020-05-21",82,18,138,280,2191,0.689183021451392,0,0,177,463,31,1688,4,929,27,4
"1531","2020-05-22",83,18,140,280,2191,0.689183021451392,0,0,177,463,42,1730,2,931,40,2
"1532","2020-05-23",81,18,130,268,2191,0.689183021451392,0,0,177,463,42,1772,4,935,40,4
"1533","2020-05-24",67,18,113,262,2191,0.689183021451392,0,0,177,463,53,1825,4,939,48,4
"1534","2020-05-25",69,18,110,257,2191,0.689183021451392,0,0,177,463,52,1877,7,946,51,7
"1535","2020-05-26",70,18,100,262,2191,0.689183021451392,0,0,177,463,44,1921,16,962,43,16
"1536","2020-05-27",66,18,101,256,2191,0.689183021451392,0,0,177,463,37,1958,22,984,36,22
"1537","2020-05-28",67,18,101,252,2191,0.689183021451392,0,0,177,463,41,1999,13,997,38,13
"1538","2020-05-29",72,18,88,243,2191,0.689183021451392,0,0,177,463,38,2037,9,1006,32,9
"1539","2020-05-30",76,18,72,238,2191,0.689183021451392,0,0,177,463,31,2068,13,1019,29,13
"1540","2020-05-31",77,18,76,236,2191,0.689183021451392,0,0,177,463,43,2111,13,1032,41,13
"1541","2020-06-01",79,18,100,228,2191,0.689183021451392,0,0,177,463,32,2143,13,1045,29,13
"1542","2020-06-02",74,18,117,223,2191,0.689183021451392,0,0,177,463,34,2177,13,1058,31,13
"1543","2020-06-03",72,18,115,213,2191,0.689183021451392,0,0,177,463,29,2206,11,1069,25,11
"1544","2020-06-04",71,18,116,209,2191,0.689183021451392,0,0,177,463,37,2243,13,1082,37,13
"1545","2020-06-05",66,18,110,201,2191,0.689183021451392,0,0,177,463,34,2277,9,1091,34,9
"1546","2020-06-06",60,18,115,207,2191,0.689183021451392,0,0,177,463,24,2301,7,1098,23,7
"1547","2020-06-07",64,18,125,201,2191,0.689183021451392,0,0,177,463,24,2325,9,1107,24,9
"1548","2020-03-14",1,19,24,39,2114,0.411542100283822,0,0,172,271,31,84,12,24,8,12
"1549","2020-03-15",1,19,23,59,2114,0.411542100283822,0,0,172,271,32,116,14,38,14,14
"1550","2020-03-16",3,19,21,76,2114,0.411542100283822,0,0,172,271,29,145,8,46,14,8
"1551","2020-03-17",7,19,31,93,2114,0.411542100283822,0,0,172,271,33,178,4,50,22,4
"1552","2020-03-18",13,19,32,104,2114,0.411542100283822,0,0,172,271,35,213,17,67,20,17
"1553","2020-03-19",17,19,29,119,2114,0.411542100283822,0,0,172,271,43,256,11,78,30,11
"1554","2020-03-20",20,19,36,127,2114,0.411542100283822,0,0,172,271,47,303,19,97,26,19
"1555","2020-03-21",25,19,30,141,2114,0.411542100283822,0,0,172,271,46,349,15,112,27,15
"1556","2020-03-22",28,19,43,160,2114,0.411542100283822,0,0,172,271,54,403,19,131,35,19
"1557","2020-03-23",34,19,45,182,2114,0.411542100283822,0,0,172,271,47,450,25,156,34,25
"1558","2020-03-24",36,19,50,213,2114,0.411542100283822,0,0,172,271,37,487,20,176,28,20
"1559","2020-03-25",41,19,51,223,2114,0.411542100283822,0,0,172,271,66,553,19,195,52,19
"1560","2020-03-26",48,19,51,239,2114,0.411542100283822,0,0,172,271,53,606,25,220,37,25
"1561","2020-03-27",55,19,53,256,2114,0.411542100283822,0,0,172,271,47,653,16,236,24,16
"1562","2020-03-28",56,19,59,264,2114,0.411542100283822,0,0,172,271,31,684,24,260,20,24
"1563","2020-03-29",60,19,62,275,2114,0.411542100283822,0,0,172,271,51,735,11,271,39,11
"1564","2020-03-30",65,19,68,288,2114,0.411542100283822,0,0,172,271,44,779,6,277,31,6
"1565","2020-03-31",67,19,61,295,2114,0.411542100283822,0,0,172,271,71,850,4,281,52,4
"1566","2020-04-01",68,19,57,299,2114,0.411542100283822,0,0,172,271,61,911,2,283,43,2
"1567","2020-04-02",73,19,58,298,2114,0.411542100283822,0,0,172,271,46,957,14,297,30,14
"1568","2020-04-03",75,19,57,296,2114,0.411542100283822,0,0,172,271,65,1022,16,313,50,16
"1569","2020-04-04",80,19,58,298,2114,0.411542100283822,0,0,172,271,52,1074,8,321,38,8
"1570","2020-04-05",93,19,60,295,2114,0.411542100283822,0,0,172,271,86,1160,11,332,70,11
"1571","2020-04-06",92,19,76,284,2114,0.411542100283822,0,0,172,271,66,1226,31,363,43,31
"1572","2020-04-07",93,19,88,290,2114,0.411542100283822,0,0,172,271,57,1283,29,392,43,29
"1573","2020-04-08",88,19,93,294,2114,0.411542100283822,0,0,172,271,51,1334,18,410,34,18
"1574","2020-04-09",82,19,88,293,2114,0.411542100283822,0,0,172,271,71,1405,16,426,49,16
"1575","2020-04-10",81,19,78,304,2114,0.411542100283822,0,0,172,271,61,1466,6,432,41,6
"1576","2020-04-11",85,19,86,298,2114,0.411542100283822,0,0,172,271,66,1532,17,449,47,17
"1577","2020-04-12",82,19,94,297,2114,0.411542100283822,0,0,172,271,63,1595,21,470,53,21
"1578","2020-04-13",85,19,94,301,2114,0.411542100283822,0,0,172,271,57,1652,38,508,36,38
"1579","2020-04-14",86,19,93,295,2114,0.411542100283822,0,0,172,271,65,1717,20,528,43,20
"1580","2020-04-15",95,19,86,297,2114,0.411542100283822,0,0,172,271,51,1768,37,565,35,37
"1581","2020-04-16",96,19,81,295,2114,0.411542100283822,0,0,172,271,42,1810,18,583,25,18
"1582","2020-04-17",97,19,80,292,2114,0.411542100283822,0,0,172,271,48,1858,33,616,30,33
"1583","2020-04-18",93,19,78,316,2114,0.411542100283822,0,0,172,271,34,1892,21,637,17,21
"1584","2020-04-19",83,19,82,330,2114,0.411542100283822,0,0,172,271,47,1939,24,661,28,24
"1585","2020-04-20",81,19,92,345,2114,0.411542100283822,0,0,172,271,42,1981,11,672,26,11
"1586","2020-04-21",83,19,94,331,2114,0.411542100283822,0,0,172,271,40,2021,39,711,19,39
"1587","2020-04-22",77,19,93,320,2114,0.411542100283822,0,0,172,271,34,2055,31,742,11,31
"1588","2020-04-23",82,19,94,327,2114,0.411542100283822,0,0,172,271,49,2104,38,780,29,38
"1589","2020-04-24",80,19,127,338,2114,0.411542100283822,0,0,172,271,23,2127,43,823,14,43
"1590","2020-04-25",84,19,148,354,2114,0.411542100283822,0,0,172,271,24,2151,34,857,17,34
"1591","2020-04-26",85,19,151,353,2114,0.411542100283822,0,0,172,271,33,2184,39,896,17,39
"1592","2020-04-27",84,19,141,350,2114,0.411542100283822,0,0,172,271,32,2216,40,936,15,40
"1593","2020-04-28",91,19,123,347,2114,0.411542100283822,0,0,172,271,36,2252,16,952,23,16
"1594","2020-04-29",93,19,121,332,2114,0.411542100283822,0,0,172,271,37,2289,18,970,19,18
"1595","2020-04-30",88,19,111,345,2114,0.411542100283822,0,0,172,271,31,2320,46,1016,18,46
"1596","2020-05-01",91,19,113,336,2114,0.411542100283822,0,0,172,271,28,2348,31,1047,11,31
"1597","2020-05-02",95,19,109,340,2114,0.411542100283822,0,0,172,271,26,2374,22,1069,8,22
"1598","2020-05-03",96,19,102,340,2114,0.411542100283822,0,0,172,271,26,2400,10,1079,12,10
"1599","2020-05-04",101,19,103,325,2114,0.411542100283822,0,0,172,271,21,2421,35,1114,8,35
"1600","2020-05-05",99,19,101,329,2114,0.411542100283822,0,0,172,271,26,2447,27,1141,11,27
"1601","2020-05-06",99,19,107,327,2114,0.411542100283822,0,0,172,271,32,2479,16,1157,15,16
"1602","2020-05-07",98,19,108,310,2114,0.411542100283822,0,0,172,271,34,2513,29,1186,19,29
"1603","2020-05-08",98,19,96,307,2114,0.411542100283822,0,0,172,271,32,2545,31,1217,8,31
"1604","2020-05-09",88,19,92,295,2114,0.411542100283822,0,0,172,271,32,2577,43,1260,15,43
"1605","2020-05-10",91,19,110,296,2114,0.411542100283822,0,0,172,271,23,2600,13,1273,7,13
"1606","2020-05-11",90,19,104,288,2114,0.411542100283822,0,0,172,271,19,2619,9,1282,7,9
"1607","2020-05-12",90,19,125,294,2114,0.411542100283822,0,0,172,271,27,2646,7,1289,15,7
"1608","2020-05-13",87,19,128,286,2114,0.411542100283822,0,0,172,271,30,2676,11,1300,11,11
"1609","2020-05-14",91,19,119,276,2114,0.411542100283822,0,0,172,271,22,2698,20,1320,9,20
"1610","2020-05-15",86,19,126,267,2114,0.411542100283822,0,0,172,271,25,2723,4,1324,17,4
"1611","2020-05-16",90,19,125,268,2114,0.411542100283822,0,0,172,271,27,2750,5,1329,16,5
"1612","2020-05-17",85,19,119,263,2114,0.411542100283822,0,0,172,271,25,2775,18,1347,17,18
"1613","2020-05-18",80,19,117,257,2114,0.411542100283822,0,0,172,271,26,2801,22,1369,20,22
"1614","2020-05-19",77,19,110,255,2114,0.411542100283822,0,0,172,271,17,2818,12,1381,10,12
"1615","2020-05-20",81,19,101,232,2114,0.411542100283822,0,0,172,271,34,2852,6,1387,18,6
"1616","2020-05-21",74,19,96,231,2114,0.411542100283822,0,0,172,271,22,2874,8,1395,11,8
"1617","2020-05-22",76,19,88,225,2114,0.411542100283822,0,0,172,271,20,2894,4,1399,15,4
"1618","2020-05-23",70,19,78,226,2114,0.411542100283822,0,0,172,271,21,2915,26,1425,13,26
"1619","2020-05-24",71,19,83,207,2114,0.411542100283822,0,0,172,271,26,2941,15,1440,14,15
"1620","2020-05-25",67,19,69,203,2114,0.411542100283822,0,0,172,271,22,2963,11,1451,15,11
"1621","2020-05-26",59,19,76,194,2114,0.411542100283822,0,0,172,271,15,2978,23,1474,11,23
"1622","2020-05-27",54,19,77,186,2114,0.411542100283822,0,0,172,271,25,3003,23,1497,15,23
"1623","2020-05-28",54,19,76,173,2114,0.411542100283822,0,0,172,271,21,3024,15,1512,12,15
"1624","2020-05-29",53,19,66,173,2114,0.411542100283822,0,0,172,271,27,3051,19,1531,15,19
"1625","2020-05-30",50,19,67,173,2114,0.411542100283822,0,0,172,271,26,3077,26,1557,17,26
"1626","2020-05-31",52,19,64,164,2114,0.411542100283822,0,0,172,271,17,3094,28,1585,12,28
"1627","2020-06-01",48,19,63,166,2114,0.411542100283822,0,0,172,271,25,3119,15,1600,15,15
"1628","2020-06-02",46,19,72,162,2114,0.411542100283822,0,0,172,271,19,3138,26,1626,12,26
"1629","2020-06-03",48,19,77,157,2114,0.411542100283822,0,0,172,271,19,3157,20,1646,11,20
"1630","2020-06-04",50,19,67,152,2114,0.411542100283822,0,0,172,271,11,3168,17,1663,7,17
"1631","2020-06-05",45,19,69,149,2114,0.411542100283822,0,0,172,271,8,3176,15,1678,6,15
"1632","2020-06-06",50,19,67,152,2114,0.411542100283822,0,0,172,271,21,3197,13,1691,12,13
"1633","2020-06-07",44,19,70,153,2114,0.411542100283822,0,0,172,271,11,3208,5,1696,6,5
"1634","2020-03-12",1,20,51,9,3869,0.929956060997674,0,0,318,396,3,7,4,4,NA,4
"1635","2020-03-13",1,20,49,13,3869,0.929956060997674,0,0,318,396,11,18,1,5,1,1
"1636","2020-03-14",1,20,51,23,3869,0.929956060997674,0,0,318,396,5,23,4,9,2,4
"1637","2020-03-15",2,20,63,28,3869,0.929956060997674,0,0,318,396,8,31,8,17,2,8
"1638","2020-03-16",2,20,68,38,3869,0.929956060997674,0,0,318,396,7,38,11,28,6,11
"1639","2020-03-17",4,20,72,50,3869,0.929956060997674,0,0,318,396,10,48,9,37,7,9
"1640","2020-03-18",6,20,84,60,3869,0.929956060997674,0,0,318,396,9,57,15,52,8,15
"1641","2020-03-19",6,20,81,70,3869,0.929956060997674,0,0,318,396,14,71,15,67,7,15
"1642","2020-03-20",8,20,93,94,3869,0.929956060997674,0,0,318,396,20,91,20,87,13,20
"1643","2020-03-21",11,20,89,105,3869,0.929956060997674,0,0,318,396,15,106,14,101,12,14
"1644","2020-03-22",16,20,107,126,3869,0.929956060997674,0,0,318,396,25,131,21,122,20,21
"1645","2020-03-23",22,20,117,140,3869,0.929956060997674,0,0,318,396,13,144,17,139,9,17
"1646","2020-03-24",26,20,118,151,3869,0.929956060997674,0,0,318,396,19,163,13,152,13,13
"1647","2020-03-25",33,20,131,168,3869,0.929956060997674,0,0,318,396,22,185,11,163,19,11
"1648","2020-03-26",42,20,149,186,3869,0.929956060997674,0,0,318,396,17,202,5,168,10,5
"1649","2020-03-27",47,20,140,195,3869,0.929956060997674,0,0,318,396,33,235,15,183,25,15
"1650","2020-03-28",52,20,146,215,3869,0.929956060997674,0,0,318,396,14,249,16,199,8,16
"1651","2020-03-29",58,20,130,246,3869,0.929956060997674,0,0,318,396,17,266,16,215,13,16
"1652","2020-03-30",64,20,138,259,3869,0.929956060997674,0,0,318,396,18,284,17,232,15,17
"1653","2020-03-31",65,20,137,263,3869,0.929956060997674,0,0,318,396,32,316,9,241,28,9
"1654","2020-04-01",65,20,123,291,3869,0.929956060997674,0,0,318,396,31,347,14,255,21,14
"1655","2020-04-02",64,20,140,313,3869,0.929956060997674,0,0,318,396,24,371,19,274,20,19
"1656","2020-04-03",69,20,174,346,3869,0.929956060997674,0,0,318,396,22,393,13,287,16,13
"1657","2020-04-04",76,20,189,344,3869,0.929956060997674,0,0,318,396,35,428,26,313,27,26
"1658","2020-04-05",80,20,189,372,3869,0.929956060997674,0,0,318,396,31,459,30,343,26,30
"1659","2020-04-06",79,20,170,395,3869,0.929956060997674,0,0,318,396,29,488,25,368,25,25
"1660","2020-04-07",84,20,150,432,3869,0.929956060997674,0,0,318,396,25,513,20,388,18,20
"1661","2020-04-08",94,20,147,462,3869,0.929956060997674,0,0,318,396,32,545,28,416,25,28
"1662","2020-04-09",102,20,134,477,3869,0.929956060997674,0,0,318,396,40,585,15,431,31,15
"1663","2020-04-10",108,20,153,495,3869,0.929956060997674,0,0,318,396,31,616,15,446,24,15
"1664","2020-04-11",116,20,144,527,3869,0.929956060997674,0,0,318,396,30,646,23,469,26,23
"1665","2020-04-12",119,20,127,542,3869,0.929956060997674,0,0,318,396,34,680,24,493,29,24
"1666","2020-04-13",131,20,124,571,3869,0.929956060997674,0,0,318,396,38,718,10,503,31,10
"1667","2020-04-14",143,20,153,595,3869,0.929956060997674,0,0,318,396,40,758,36,539,30,36
"1668","2020-04-15",143,20,138,602,3869,0.929956060997674,0,0,318,396,36,794,27,566,29,27
"1669","2020-04-16",140,20,131,608,3869,0.929956060997674,0,0,318,396,41,835,20,586,34,20
"1670","2020-04-17",144,20,115,627,3869,0.929956060997674,0,0,318,396,25,860,24,610,21,24
"1671","2020-04-18",158,20,108,636,3869,0.929956060997674,0,0,318,396,37,897,29,639,28,29
"1672","2020-04-19",165,20,111,671,3869,0.929956060997674,0,0,318,396,34,931,37,676,27,37
"1673","2020-04-20",175,20,107,662,3869,0.929956060997674,0,0,318,396,25,956,46,722,19,46
"1674","2020-04-21",185,20,96,671,3869,0.929956060997674,0,0,318,396,27,983,36,758,19,36
"1675","2020-04-22",193,20,111,698,3869,0.929956060997674,0,0,318,396,23,1006,39,797,17,39
"1676","2020-04-23",193,20,115,741,3869,0.929956060997674,0,0,318,396,33,1039,46,843,22,46
"1677","2020-04-24",204,20,104,741,3869,0.929956060997674,0,0,318,396,26,1065,29,872,20,29
"1678","2020-04-25",199,20,126,747,3869,0.929956060997674,0,0,318,396,27,1092,24,896,15,24
"1679","2020-04-26",198,20,150,756,3869,0.929956060997674,0,0,318,396,22,1114,27,923,15,27
"1680","2020-04-27",190,20,147,779,3869,0.929956060997674,0,0,318,396,26,1140,25,948,18,25
"1681","2020-04-28",183,20,137,775,3869,0.929956060997674,0,0,318,396,18,1158,27,975,13,27
"1682","2020-04-29",190,20,159,787,3869,0.929956060997674,0,0,318,396,25,1183,32,1007,15,32
"1683","2020-04-30",211,20,162,779,3869,0.929956060997674,0,0,318,396,23,1206,33,1040,14,33
"1684","2020-05-01",207,20,155,754,3869,0.929956060997674,0,0,318,396,18,1224,33,1073,12,33
"1685","2020-05-02",219,20,142,761,3869,0.929956060997674,0,0,318,396,18,1242,29,1102,10,29
"1686","2020-05-03",224,20,128,758,3869,0.929956060997674,0,0,318,396,17,1259,50,1152,12,50
"1687","2020-05-04",232,20,108,762,3869,0.929956060997674,0,0,318,396,16,1275,56,1208,7,56
"1688","2020-05-05",229,20,131,766,3869,0.929956060997674,0,0,318,396,14,1289,47,1255,9,47
"1689","2020-05-06",221,20,134,744,3869,0.929956060997674,0,0,318,396,16,1305,33,1288,7,33
"1690","2020-05-07",204,20,114,728,3869,0.929956060997674,0,0,318,396,13,1318,22,1310,8,22
"1691","2020-05-08",208,20,143,696,3869,0.929956060997674,0,0,318,396,22,1340,34,1344,12,34
"1692","2020-05-09",198,20,145,654,3869,0.929956060997674,0,0,318,396,10,1350,35,1379,6,35
"1693","2020-05-10",201,20,147,634,3869,0.929956060997674,0,0,318,396,14,1364,27,1406,7,27
"1694","2020-05-11",196,20,130,611,3869,0.929956060997674,0,0,318,396,14,1378,27,1433,9,27
"1695","2020-05-12",198,20,121,604,3869,0.929956060997674,0,0,318,396,3,1381,32,1465,3,32
"1696","2020-05-13",197,20,113,596,3869,0.929956060997674,0,0,318,396,12,1393,29,1494,7,29
"1697","2020-05-14",205,20,102,583,3869,0.929956060997674,0,0,318,396,16,1409,29,1523,11,29
"1698","2020-05-15",200,20,126,591,3869,0.929956060997674,0,0,318,396,19,1428,20,1543,11,20
"1699","2020-05-16",194,20,147,570,3869,0.929956060997674,0,0,318,396,10,1438,27,1570,6,27
"1700","2020-05-17",184,20,170,552,3869,0.929956060997674,0,0,318,396,15,1453,44,1614,11,44
"1701","2020-05-18",179,20,193,535,3869,0.929956060997674,0,0,318,396,12,1465,41,1655,7,41
"1702","2020-05-19",174,20,186,520,3869,0.929956060997674,0,0,318,396,19,1484,38,1693,8,38
"1703","2020-05-20",171,20,194,509,3869,0.929956060997674,0,0,318,396,12,1496,20,1713,8,20
"1704","2020-05-21",158,20,176,497,3869,0.929956060997674,0,0,318,396,25,1521,27,1740,17,27
"1705","2020-05-22",147,20,156,482,3869,0.929956060997674,0,0,318,396,12,1533,27,1767,7,27
"1706","2020-05-23",142,20,151,477,3869,0.929956060997674,0,0,318,396,12,1545,21,1788,12,21
"1707","2020-05-24",137,20,147,449,3869,0.929956060997674,0,0,318,396,14,1559,22,1810,11,22
"1708","2020-05-25",134,20,134,435,3869,0.929956060997674,0,0,318,396,19,1578,23,1833,12,23
"1709","2020-05-26",130,20,122,421,3869,0.929956060997674,0,0,318,396,19,1597,24,1857,14,24
"1710","2020-05-27",126,20,113,417,3869,0.929956060997674,0,0,318,396,12,1609,42,1899,7,42
"1711","2020-05-28",129,20,124,401,3869,0.929956060997674,0,0,318,396,11,1620,34,1933,8,34
"1712","2020-05-29",128,20,123,387,3869,0.929956060997674,0,0,318,396,10,1630,33,1966,8,33
"1713","2020-05-30",121,20,111,377,3869,0.929956060997674,0,0,318,396,6,1636,29,1995,3,29
"1714","2020-05-31",119,20,103,362,3869,0.929956060997674,0,0,318,396,7,1643,29,2024,5,29
"1715","2020-06-01",116,20,95,356,3869,0.929956060997674,0,0,318,396,14,1657,12,2036,9,12
"1716","2020-06-02",116,20,102,352,3869,0.929956060997674,0,0,318,396,11,1668,34,2070,6,34
"1717","2020-06-03",112,20,105,350,3869,0.929956060997674,0,0,318,396,14,1682,24,2094,9,24
"1718","2020-06-04",109,20,114,321,3869,0.929956060997674,0,0,318,396,10,1692,27,2121,4,27
"1719","2020-06-05",108,20,122,325,3869,0.929956060997674,0,0,318,396,10,1702,32,2153,5,32
"1720","2020-06-06",103,20,110,305,3869,0.929956060997674,0,0,318,396,10,1712,19,2172,8,19
"1721","2020-06-07",99,20,103,283,3869,0.929956060997674,0,0,318,396,12,1724,30,2202,10,30
