"","Date","Absents","Paramset","Infections_or_Exposed_per_day_Patient","Infections_or_Exposed_per_day_HCW","total_infections","nosocomial_proportion","PCR_pooled","LFD_pooled","HCW_symp_test","patient_symp_test","new_hcw_infs","cumulative_hcw_infs","new_pat_infs","cumulative_pats_infs","new_nosocomial_hcw_infs","new_nosocomial_pat_infs"
"1","2020-03-12",1,1,85,210,9254,0.562135292846337,0,0,678,1117,109,211,34,53,11,34
"2","2020-03-13",5,1,113,325,9254,0.562135292846337,0,0,678,1117,115,326,24,77,20,24
"3","2020-03-14",12,1,146,451,9254,0.562135292846337,0,0,678,1117,126,452,38,115,33,38
"4","2020-03-15",31,1,167,573,9254,0.562135292846337,0,0,678,1117,122,574,43,158,43,43
"5","2020-03-16",48,1,179,746,9254,0.562135292846337,0,0,678,1117,175,749,34,192,103,34
"6","2020-03-17",72,1,207,930,9254,0.562135292846337,0,0,678,1117,189,938,49,241,111,49
"7","2020-03-18",99,1,227,1114,9254,0.562135292846337,0,0,678,1117,195,1133,53,294,120,53
"8","2020-03-19",127,1,251,1354,9254,0.562135292846337,0,0,678,1117,271,1404,61,355,183,61
"9","2020-03-20",167,1,232,1581,9254,0.562135292846337,0,0,678,1117,266,1670,33,388,201,33
"10","2020-03-21",217,1,241,1819,9254,0.562135292846337,0,0,678,1117,282,1952,57,445,204,57
"11","2020-03-22",275,1,236,2089,9254,0.562135292846337,0,0,678,1117,328,2280,41,486,259,41
"12","2020-03-23",347,1,246,2358,9254,0.562135292846337,0,0,678,1117,347,2627,49,535,284,49
"13","2020-03-24",400,1,216,2567,9254,0.562135292846337,0,0,678,1117,315,2942,27,562,249,27
"14","2020-03-25",478,1,208,2721,9254,0.562135292846337,0,0,678,1117,300,3242,35,597,231,35
"15","2020-03-26",557,1,231,2897,9254,0.562135292846337,0,0,678,1117,315,3557,46,643,250,46
"16","2020-03-27",633,1,227,3064,9254,0.562135292846337,0,0,678,1117,330,3887,44,687,267,44
"17","2020-03-28",685,1,213,3183,9254,0.562135292846337,0,0,678,1117,300,4187,34,721,255,34
"18","2020-03-29",720,1,238,3307,9254,0.562135292846337,0,0,678,1117,349,4536,48,769,291,48
"19","2020-03-30",775,1,229,3476,9254,0.562135292846337,0,0,678,1117,384,4920,31,800,334,31
"20","2020-03-31",855,1,221,3471,9254,0.562135292846337,0,0,678,1117,233,5153,28,828,182,28
"21","2020-04-01",888,1,238,3379,9254,0.562135292846337,0,0,678,1117,175,5328,67,895,149,67
"22","2020-04-02",917,1,229,3321,9254,0.562135292846337,0,0,678,1117,205,5533,34,929,172,34
"23","2020-04-03",925,1,219,3262,9254,0.562135292846337,0,0,678,1117,211,5744,24,953,175,24
"24","2020-04-04",945,1,207,3139,9254,0.562135292846337,0,0,678,1117,165,5909,19,972,130,19
"25","2020-04-05",964,1,188,3026,9254,0.562135292846337,0,0,678,1117,162,6071,8,980,127,8
"26","2020-04-06",928,1,179,2837,9254,0.562135292846337,0,0,678,1117,119,6190,28,1008,92,28
"27","2020-04-07",895,1,205,2634,9254,0.562135292846337,0,0,678,1117,93,6283,42,1050,74,42
"28","2020-04-08",878,1,203,2429,9254,0.562135292846337,0,0,678,1117,95,6378,29,1079,67,29
"29","2020-04-09",838,1,181,2256,9254,0.562135292846337,0,0,678,1117,80,6458,21,1100,43,21
"30","2020-04-10",782,1,166,2061,9254,0.562135292846337,0,0,678,1117,57,6515,10,1110,36,10
"31","2020-04-11",733,1,161,1858,9254,0.562135292846337,0,0,678,1117,75,6590,20,1130,38,20
"32","2020-04-12",667,1,187,1661,9254,0.562135292846337,0,0,678,1117,46,6636,45,1175,35,45
"33","2020-04-13",620,1,213,1512,9254,0.562135292846337,0,0,678,1117,57,6693,37,1212,34,37
"34","2020-04-14",541,1,200,1372,9254,0.562135292846337,0,0,678,1117,48,6741,20,1232,24,20
"35","2020-04-15",472,1,193,1246,9254,0.562135292846337,0,0,678,1117,35,6776,23,1255,17,23
"36","2020-04-16",415,1,205,1122,9254,0.562135292846337,0,0,678,1117,50,6826,33,1288,30,33
"37","2020-04-17",373,1,198,1007,9254,0.562135292846337,0,0,678,1117,40,6866,24,1312,20,24
"38","2020-04-18",327,1,204,934,9254,0.562135292846337,0,0,678,1117,42,6908,22,1334,21,22
"39","2020-04-19",305,1,208,869,9254,0.562135292846337,0,0,678,1117,45,6953,32,1366,23,32
"40","2020-04-20",271,1,195,793,9254,0.562135292846337,0,0,678,1117,32,6985,29,1395,13,29
"41","2020-04-21",250,1,225,745,9254,0.562135292846337,0,0,678,1117,35,7020,45,1440,14,45
"42","2020-04-22",219,1,228,674,9254,0.562135292846337,0,0,678,1117,23,7043,33,1473,10,33
"43","2020-04-23",194,1,279,630,9254,0.562135292846337,0,0,678,1117,25,7068,69,1542,6,69
"44","2020-04-24",174,1,298,586,9254,0.562135292846337,0,0,678,1117,28,7096,47,1589,12,47
"45","2020-04-25",160,1,281,549,9254,0.562135292846337,0,0,678,1117,28,7124,47,1636,15,47
"46","2020-04-26",138,1,276,523,9254,0.562135292846337,0,0,678,1117,32,7156,34,1670,11,34
"47","2020-04-27",123,1,266,487,9254,0.562135292846337,0,0,678,1117,16,7172,33,1703,6,33
"48","2020-04-28",108,1,233,456,9254,0.562135292846337,0,0,678,1117,22,7194,26,1729,9,26
"49","2020-04-29",101,1,229,424,9254,0.562135292846337,0,0,678,1117,19,7213,23,1752,10,23
"50","2020-04-30",100,1,209,396,9254,0.562135292846337,0,0,678,1117,15,7228,16,1768,6,16
"51","2020-05-01",103,1,222,372,9254,0.562135292846337,0,0,678,1117,27,7255,36,1804,9,36
"52","2020-05-02",94,1,216,344,9254,0.562135292846337,0,0,678,1117,21,7276,30,1834,6,30
"53","2020-05-03",82,1,206,334,9254,0.562135292846337,0,0,678,1117,27,7303,14,1848,4,14
"54","2020-05-04",86,1,211,312,9254,0.562135292846337,0,0,678,1117,14,7317,26,1874,5,26
"55","2020-05-05",95,1,208,295,9254,0.562135292846337,0,0,678,1117,21,7338,23,1897,8,23
"56","2020-05-06",85,1,207,287,9254,0.562135292846337,0,0,678,1117,18,7356,19,1916,2,19
"57","2020-05-07",83,1,215,275,9254,0.562135292846337,0,0,678,1117,16,7372,26,1942,6,26
"58","2020-05-08",83,1,205,260,9254,0.562135292846337,0,0,678,1117,10,7382,26,1968,3,26
"59","2020-05-09",80,1,201,246,9254,0.562135292846337,0,0,678,1117,17,7399,13,1981,2,13
"60","2020-05-10",80,1,185,230,9254,0.562135292846337,0,0,678,1117,13,7412,15,1996,1,15
"61","2020-05-11",70,1,170,220,9254,0.562135292846337,0,0,678,1117,10,7422,14,2010,2,14
"62","2020-05-12",59,1,202,208,9254,0.562135292846337,0,0,678,1117,6,7428,41,2051,1,41
"63","2020-05-13",63,1,211,192,9254,0.562135292846337,0,0,678,1117,10,7438,21,2072,2,21
"64","2020-05-14",56,1,263,185,9254,0.562135292846337,0,0,678,1117,12,7450,71,2143,2,71
"65","2020-05-15",50,1,252,165,9254,0.562135292846337,0,0,678,1117,9,7459,38,2181,1,38
"66","2020-05-16",52,1,245,160,9254,0.562135292846337,0,0,678,1117,10,7469,19,2200,1,19
"67","2020-05-17",51,1,215,155,9254,0.562135292846337,0,0,678,1117,9,7478,18,2218,NA,18
"68","2020-05-18",50,1,198,147,9254,0.562135292846337,0,0,678,1117,9,7487,13,2231,2,13
"69","2020-05-19",47,1,199,138,9254,0.562135292846337,0,0,678,1117,7,7494,26,2257,2,26
"70","2020-05-20",41,1,230,133,9254,0.562135292846337,0,0,678,1117,9,7503,47,2304,1,47
"71","2020-05-21",39,1,232,126,9254,0.562135292846337,0,0,678,1117,4,7507,28,2332,1,28
"72","2020-05-22",35,1,238,121,9254,0.562135292846337,0,0,678,1117,8,7515,40,2372,1,40
"73","2020-05-23",29,1,236,117,9254,0.562135292846337,0,0,678,1117,11,7526,34,2406,2,34
"74","2020-05-24",26,1,238,110,9254,0.562135292846337,0,0,678,1117,7,7533,22,2428,3,22
"75","2020-05-25",25,1,214,108,9254,0.562135292846337,0,0,678,1117,12,7545,25,2453,1,25
"76","2020-05-26",26,1,210,98,9254,0.562135292846337,0,0,678,1117,4,7549,25,2478,NA,25
"77","2020-05-27",25,1,200,96,9254,0.562135292846337,0,0,678,1117,7,7556,24,2502,1,24
"78","2020-05-28",26,1,189,97,9254,0.562135292846337,0,0,678,1117,8,7564,18,2520,2,18
"79","2020-05-29",23,1,176,94,9254,0.562135292846337,0,0,678,1117,6,7570,15,2535,NA,15
"80","2020-05-30",27,1,209,94,9254,0.562135292846337,0,0,678,1117,8,7578,46,2581,1,46
"81","2020-05-31",24,1,223,85,9254,0.562135292846337,0,0,678,1117,4,7582,31,2612,2,31
"82","2020-06-01",23,1,219,80,9254,0.562135292846337,0,0,678,1117,3,7585,28,2640,NA,28
"83","2020-06-02",18,1,207,80,9254,0.562135292846337,0,0,678,1117,7,7592,20,2660,1,20
"84","2020-06-03",21,1,194,80,9254,0.562135292846337,0,0,678,1117,6,7598,21,2681,2,21
"85","2020-06-04",17,1,185,75,9254,0.562135292846337,0,0,678,1117,6,7604,13,2694,4,13
"86","2020-06-05",20,1,193,68,9254,0.562135292846337,0,0,678,1117,2,7606,35,2729,NA,35
"87","2020-06-06",14,1,207,68,9254,0.562135292846337,0,0,678,1117,6,7612,33,2762,1,33
"88","2020-06-07",12,1,205,62,9254,0.562135292846337,0,0,678,1117,3,7615,17,2779,1,17
"89","2020-03-13",3,2,37,134,6345,0.493617021276596,0,0,584,744,90,225,9,25,6,9
"90","2020-03-14",7,2,33,189,6345,0.493617021276596,0,0,584,744,75,300,10,35,11,10
"91","2020-03-15",10,2,47,256,6345,0.493617021276596,0,0,584,744,68,368,9,44,15,9
"92","2020-03-16",17,2,76,326,6345,0.493617021276596,0,0,584,744,95,463,28,72,28,28
"93","2020-03-17",30,2,70,410,6345,0.493617021276596,0,0,584,744,88,551,22,94,28,22
"94","2020-03-18",40,2,113,486,6345,0.493617021276596,0,0,584,744,97,648,39,133,27,39
"95","2020-03-19",52,2,136,574,6345,0.493617021276596,0,0,584,744,71,719,54,187,15,54
"96","2020-03-20",66,2,140,648,6345,0.493617021276596,0,0,584,744,79,798,46,233,15,46
"97","2020-03-21",103,2,160,752,6345,0.493617021276596,0,0,584,744,100,898,46,279,22,46
"98","2020-03-22",131,2,182,835,6345,0.493617021276596,0,0,584,744,89,987,56,335,22,56
"99","2020-03-23",160,2,176,881,6345,0.493617021276596,0,0,584,744,71,1058,50,385,18,50
"100","2020-03-24",189,2,145,933,6345,0.493617021276596,0,0,584,744,101,1159,50,435,31,50
"101","2020-03-25",218,2,133,977,6345,0.493617021276596,0,0,584,744,100,1259,46,481,28,46
"102","2020-03-26",238,2,136,1043,6345,0.493617021276596,0,0,584,744,91,1350,27,508,17,27
"103","2020-03-27",261,2,135,1089,6345,0.493617021276596,0,0,584,744,81,1431,32,540,19,32
"104","2020-03-28",251,2,135,1113,6345,0.493617021276596,0,0,584,744,78,1509,33,573,20,33
"105","2020-03-29",258,2,122,1136,6345,0.493617021276596,0,0,584,744,73,1582,29,602,21,29
"106","2020-03-30",261,2,128,1145,6345,0.493617021276596,0,0,584,744,78,1660,29,631,22,29
"107","2020-03-31",259,2,140,1158,6345,0.493617021276596,0,0,584,744,107,1767,47,678,30,47
"108","2020-04-01",259,2,156,1208,6345,0.493617021276596,0,0,584,744,103,1870,34,712,21,34
"109","2020-04-02",275,2,190,1256,6345,0.493617021276596,0,0,584,744,88,1958,31,743,21,31
"110","2020-04-03",294,2,216,1258,6345,0.493617021276596,0,0,584,744,90,2048,43,786,16,43
"111","2020-04-04",318,2,241,1263,6345,0.493617021276596,0,0,584,744,74,2122,66,852,18,66
"112","2020-04-05",333,2,225,1253,6345,0.493617021276596,0,0,584,744,104,2226,40,892,21,40
"113","2020-04-06",350,2,207,1234,6345,0.493617021276596,0,0,584,744,73,2299,43,935,18,43
"114","2020-04-07",365,2,223,1236,6345,0.493617021276596,0,0,584,744,89,2388,52,987,18,52
"115","2020-04-08",383,2,255,1223,6345,0.493617021276596,0,0,584,744,90,2478,42,1029,22,42
"116","2020-04-09",375,2,262,1209,6345,0.493617021276596,0,0,584,744,88,2566,30,1059,17,30
"117","2020-04-10",357,2,289,1193,6345,0.493617021276596,0,0,584,744,79,2645,21,1080,22,21
"118","2020-04-11",342,2,263,1177,6345,0.493617021276596,0,0,584,744,75,2720,27,1107,14,27
"119","2020-04-12",338,2,252,1157,6345,0.493617021276596,0,0,584,744,94,2814,26,1133,29,26
"120","2020-04-13",335,2,227,1138,6345,0.493617021276596,0,0,584,744,88,2902,31,1164,19,31
"121","2020-04-14",322,2,202,1115,6345,0.493617021276596,0,0,584,744,108,3010,50,1214,18,50
"122","2020-04-15",307,2,180,1085,6345,0.493617021276596,0,0,584,744,81,3091,39,1253,23,39
"123","2020-04-16",317,2,180,1049,6345,0.493617021276596,0,0,584,744,89,3180,31,1284,24,31
"124","2020-04-17",323,2,229,1063,6345,0.493617021276596,0,0,584,744,82,3262,25,1309,24,25
"125","2020-04-18",325,2,239,1040,6345,0.493617021276596,0,0,584,744,79,3341,29,1338,15,29
"126","2020-04-19",326,2,223,1017,6345,0.493617021276596,0,0,584,744,80,3421,31,1369,21,31
"127","2020-04-20",303,2,192,991,6345,0.493617021276596,0,0,584,744,84,3505,47,1416,16,47
"128","2020-04-21",306,2,194,1006,6345,0.493617021276596,0,0,584,744,88,3593,28,1444,18,28
"129","2020-04-22",293,2,155,1013,6345,0.493617021276596,0,0,584,744,72,3665,24,1468,13,24
"130","2020-04-23",290,2,156,971,6345,0.493617021276596,0,0,584,744,101,3766,37,1505,22,37
"131","2020-04-24",275,2,142,969,6345,0.493617021276596,0,0,584,744,73,3839,46,1551,18,46
"132","2020-04-25",263,2,126,955,6345,0.493617021276596,0,0,584,744,71,3910,36,1587,14,36
"133","2020-04-26",265,2,137,943,6345,0.493617021276596,0,0,584,744,73,3983,43,1630,16,43
"134","2020-04-27",270,2,189,915,6345,0.493617021276596,0,0,584,744,85,4068,51,1681,28,51
"135","2020-04-28",260,2,216,897,6345,0.493617021276596,0,0,584,744,79,4147,28,1709,16,28
"136","2020-04-29",272,2,224,898,6345,0.493617021276596,0,0,584,744,81,4228,36,1745,17,36
"137","2020-04-30",255,2,242,857,6345,0.493617021276596,0,0,584,744,77,4305,53,1798,22,53
"138","2020-05-01",253,2,252,838,6345,0.493617021276596,0,0,584,744,66,4371,54,1852,19,54
"139","2020-05-02",257,2,261,817,6345,0.493617021276596,0,0,584,744,62,4433,28,1880,11,28
"140","2020-05-03",235,2,273,778,6345,0.493617021276596,0,0,584,744,55,4488,26,1906,12,26
"141","2020-05-04",227,2,264,767,6345,0.493617021276596,0,0,584,744,66,4554,36,1942,15,36
"142","2020-05-05",220,2,267,733,6345,0.493617021276596,0,0,584,744,66,4620,53,1995,11,53
"143","2020-05-06",218,2,264,711,6345,0.493617021276596,0,0,584,744,63,4683,26,2021,10,26
"144","2020-05-07",222,2,278,700,6345,0.493617021276596,0,0,584,744,60,4743,19,2040,11,19
"145","2020-05-08",224,2,263,663,6345,0.493617021276596,0,0,584,744,53,4796,36,2076,10,36
"146","2020-05-09",217,2,229,643,6345,0.493617021276596,0,0,584,744,65,4861,19,2095,12,19
"147","2020-05-10",206,2,205,610,6345,0.493617021276596,0,0,584,744,47,4908,32,2127,2,32
"148","2020-05-11",212,2,201,585,6345,0.493617021276596,0,0,584,744,48,4956,42,2169,8,42
"149","2020-05-12",208,2,236,536,6345,0.493617021276596,0,0,584,744,53,5009,31,2200,11,31
"150","2020-05-13",183,2,226,520,6345,0.493617021276596,0,0,584,744,37,5046,55,2255,10,55
"151","2020-05-14",164,2,205,498,6345,0.493617021276596,0,0,584,744,49,5095,63,2318,17,63
"152","2020-05-15",148,2,193,471,6345,0.493617021276596,0,0,584,744,37,5132,43,2361,5,43
"153","2020-05-16",140,2,176,472,6345,0.493617021276596,0,0,584,744,45,5177,20,2381,12,20
"154","2020-05-17",136,2,167,459,6345,0.493617021276596,0,0,584,744,42,5219,24,2405,9,24
"155","2020-05-18",120,2,168,441,6345,0.493617021276596,0,0,584,744,40,5259,31,2436,9,31
"156","2020-05-19",114,2,145,427,6345,0.493617021276596,0,0,584,744,28,5287,21,2457,12,21
"157","2020-05-20",121,2,130,419,6345,0.493617021276596,0,0,584,744,36,5323,19,2476,8,19
"158","2020-05-21",132,2,121,401,6345,0.493617021276596,0,0,584,744,29,5352,29,2505,10,29
"159","2020-05-22",130,2,114,390,6345,0.493617021276596,0,0,584,744,35,5387,11,2516,4,11
"160","2020-05-23",126,2,113,375,6345,0.493617021276596,0,0,584,744,34,5421,21,2537,6,21
"161","2020-05-24",121,2,117,354,6345,0.493617021276596,0,0,584,744,30,5451,32,2569,5,32
"162","2020-05-25",115,2,119,352,6345,0.493617021276596,0,0,584,744,32,5483,33,2602,7,33
"163","2020-05-26",110,2,106,343,6345,0.493617021276596,0,0,584,744,33,5516,27,2629,5,27
"164","2020-05-27",107,2,103,337,6345,0.493617021276596,0,0,584,744,28,5544,25,2654,8,25
"165","2020-05-28",91,2,106,331,6345,0.493617021276596,0,0,584,744,22,5566,30,2684,4,30
"166","2020-05-29",85,2,112,309,6345,0.493617021276596,0,0,584,744,19,5585,30,2714,4,30
"167","2020-05-30",86,2,142,282,6345,0.493617021276596,0,0,584,744,30,5615,44,2758,7,44
"168","2020-05-31",88,2,161,267,6345,0.493617021276596,0,0,584,744,17,5632,34,2792,4,34
"169","2020-06-01",87,2,184,258,6345,0.493617021276596,0,0,584,744,21,5653,28,2820,5,28
"170","2020-06-02",86,2,179,257,6345,0.493617021276596,0,0,584,744,21,5674,32,2852,5,32
"171","2020-06-03",78,2,211,239,6345,0.493617021276596,0,0,584,744,17,5691,26,2878,2,26
"172","2020-06-04",76,2,232,249,6345,0.493617021276596,0,0,584,744,13,5704,43,2921,NA,43
"173","2020-06-05",80,2,227,248,6345,0.493617021276596,0,0,584,744,11,5715,36,2957,1,36
"174","2020-06-06",76,2,232,230,6345,0.493617021276596,0,0,584,744,13,5728,20,2977,NA,20
"175","2020-06-07",72,2,211,212,6345,0.493617021276596,0,0,584,744,17,5745,35,3012,4,35
"176","2020-03-12",3,3,173,147,7543,0.287021079146228,0,0,586,1672,32,68,46,81,10,46
"177","2020-03-13",6,3,246,240,7543,0.287021079146228,0,0,586,1672,49,117,28,109,22,28
"178","2020-03-14",14,3,249,333,7543,0.287021079146228,0,0,586,1672,51,168,27,136,35,27
"179","2020-03-15",27,3,244,438,7543,0.287021079146228,0,0,586,1672,68,236,34,170,44,34
"180","2020-03-16",44,3,305,553,7543,0.287021079146228,0,0,586,1672,79,315,42,212,62,42
"181","2020-03-17",59,3,343,659,7543,0.287021079146228,0,0,586,1672,84,399,52,264,59,52
"182","2020-03-18",90,3,336,745,7543,0.287021079146228,0,0,586,1672,98,497,63,327,79,63
"183","2020-03-19",111,3,327,820,7543,0.287021079146228,0,0,586,1672,99,596,40,367,84,40
"184","2020-03-20",136,3,358,889,7543,0.287021079146228,0,0,586,1672,120,716,37,404,104,37
"185","2020-03-21",157,3,379,958,7543,0.287021079146228,0,0,586,1672,124,840,36,440,105,36
"186","2020-03-22",187,3,389,1023,7543,0.287021079146228,0,0,586,1672,156,996,30,470,141,30
"187","2020-03-23",207,3,369,1082,7543,0.287021079146228,0,0,586,1672,197,1193,51,521,169,51
"188","2020-03-24",219,3,342,1144,7543,0.287021079146228,0,0,586,1672,156,1349,45,566,141,45
"189","2020-03-25",230,3,307,1201,7543,0.287021079146228,0,0,586,1672,181,1530,45,611,157,45
"190","2020-03-26",248,3,296,1227,7543,0.287021079146228,0,0,586,1672,213,1743,40,651,187,40
"191","2020-03-27",271,3,307,1276,7543,0.287021079146228,0,0,586,1672,222,1965,27,678,209,27
"192","2020-03-28",299,3,304,1284,7543,0.287021079146228,0,0,586,1672,239,2204,23,701,216,23
"193","2020-03-29",303,3,287,1307,7543,0.287021079146228,0,0,586,1672,166,2370,30,731,148,30
"194","2020-03-30",322,3,311,1325,7543,0.287021079146228,0,0,586,1672,214,2584,32,763,195,32
"195","2020-03-31",336,3,304,1335,7543,0.287021079146228,0,0,586,1672,171,2755,44,807,158,44
"196","2020-04-01",342,3,321,1357,7543,0.287021079146228,0,0,586,1672,232,2987,33,840,216,33
"197","2020-04-02",350,3,354,1355,7543,0.287021079146228,0,0,586,1672,211,3198,20,860,188,20
"198","2020-04-03",355,3,339,1367,7543,0.287021079146228,0,0,586,1672,222,3420,30,890,208,30
"199","2020-04-04",352,3,373,1370,7543,0.287021079146228,0,0,586,1672,208,3628,52,942,196,52
"200","2020-04-05",359,3,377,1359,7543,0.287021079146228,0,0,586,1672,188,3816,52,994,170,52
"201","2020-04-06",351,3,392,1348,7543,0.287021079146228,0,0,586,1672,194,4010,37,1031,179,37
"202","2020-04-07",370,3,383,1359,7543,0.287021079146228,0,0,586,1672,182,4192,18,1049,162,18
"203","2020-04-08",378,3,346,1324,7543,0.287021079146228,0,0,586,1672,201,4393,19,1068,186,19
"204","2020-04-09",384,3,364,1326,7543,0.287021079146228,0,0,586,1672,152,4545,23,1091,140,23
"205","2020-04-10",366,3,350,1310,7543,0.287021079146228,0,0,586,1672,144,4689,23,1114,130,23
"206","2020-04-11",362,3,342,1297,7543,0.287021079146228,0,0,586,1672,117,4806,21,1135,110,21
"207","2020-04-12",374,3,357,1272,7543,0.287021079146228,0,0,586,1672,125,4931,25,1160,111,25
"208","2020-04-13",384,3,344,1261,7543,0.287021079146228,0,0,586,1672,105,5036,24,1184,96,24
"209","2020-04-14",366,3,322,1250,7543,0.287021079146228,0,0,586,1672,111,5147,22,1206,104,22
"210","2020-04-15",349,3,318,1223,7543,0.287021079146228,0,0,586,1672,90,5237,12,1218,75,12
"211","2020-04-16",334,3,312,1202,7543,0.287021079146228,0,0,586,1672,90,5327,21,1239,73,21
"212","2020-04-17",339,3,310,1178,7543,0.287021079146228,0,0,586,1672,84,5411,16,1255,74,16
"213","2020-04-18",342,3,319,1128,7543,0.287021079146228,0,0,586,1672,81,5492,28,1283,65,28
"214","2020-04-19",323,3,313,1110,7543,0.287021079146228,0,0,586,1672,76,5568,19,1302,59,19
"215","2020-04-20",301,3,312,1073,7543,0.287021079146228,0,0,586,1672,71,5639,26,1328,56,26
"216","2020-04-21",304,3,331,1058,7543,0.287021079146228,0,0,586,1672,65,5704,21,1349,54,21
"217","2020-04-22",311,3,336,1056,7543,0.287021079146228,0,0,586,1672,66,5770,50,1399,56,50
"218","2020-04-23",303,3,332,1053,7543,0.287021079146228,0,0,586,1672,68,5838,42,1441,56,42
"219","2020-04-24",297,3,336,1044,7543,0.287021079146228,0,0,586,1672,46,5884,41,1482,37,41
"220","2020-04-25",281,3,325,1031,7543,0.287021079146228,0,0,586,1672,42,5926,29,1511,37,29
"221","2020-04-26",275,3,323,994,7543,0.287021079146228,0,0,586,1672,40,5966,22,1533,31,22
"222","2020-04-27",280,3,334,978,7543,0.287021079146228,0,0,586,1672,49,6015,26,1559,40,26
"223","2020-04-28",263,3,320,964,7543,0.287021079146228,0,0,586,1672,36,6051,32,1591,26,32
"224","2020-04-29",258,3,330,946,7543,0.287021079146228,0,0,586,1672,38,6089,30,1621,29,30
"225","2020-04-30",258,3,334,917,7543,0.287021079146228,0,0,586,1672,28,6117,20,1641,24,20
"226","2020-05-01",253,3,359,902,7543,0.287021079146228,0,0,586,1672,30,6147,22,1663,20,22
"227","2020-05-02",254,3,356,869,7543,0.287021079146228,0,0,586,1672,39,6186,27,1690,27,27
"228","2020-05-03",257,3,343,846,7543,0.287021079146228,0,0,586,1672,30,6216,32,1722,19,32
"229","2020-05-04",245,3,346,824,7543,0.287021079146228,0,0,586,1672,36,6252,27,1749,25,27
"230","2020-05-05",246,3,358,794,7543,0.287021079146228,0,0,586,1672,28,6280,16,1765,19,16
"231","2020-05-06",223,3,354,767,7543,0.287021079146228,0,0,586,1672,28,6308,32,1797,20,32
"232","2020-05-07",228,3,364,758,7543,0.287021079146228,0,0,586,1672,20,6328,19,1816,10,19
"233","2020-05-08",227,3,349,754,7543,0.287021079146228,0,0,586,1672,25,6353,24,1840,22,24
"234","2020-05-09",219,3,362,751,7543,0.287021079146228,0,0,586,1672,19,6372,20,1860,15,20
"235","2020-05-10",201,3,362,729,7543,0.287021079146228,0,0,586,1672,25,6397,47,1907,14,47
"236","2020-05-11",203,3,346,700,7543,0.287021079146228,0,0,586,1672,18,6415,41,1948,11,41
"237","2020-05-12",203,3,344,682,7543,0.287021079146228,0,0,586,1672,14,6429,40,1988,12,40
"238","2020-05-13",223,3,337,662,7543,0.287021079146228,0,0,586,1672,15,6444,47,2035,11,47
"239","2020-05-14",211,3,326,644,7543,0.287021079146228,0,0,586,1672,23,6467,37,2072,13,37
"240","2020-05-15",197,3,343,643,7543,0.287021079146228,0,0,586,1672,14,6481,42,2114,7,42
"241","2020-05-16",186,3,335,602,7543,0.287021079146228,0,0,586,1672,28,6509,30,2144,17,30
"242","2020-05-17",176,3,317,582,7543,0.287021079146228,0,0,586,1672,18,6527,22,2166,13,22
"243","2020-05-18",170,3,331,542,7543,0.287021079146228,0,0,586,1672,12,6539,18,2184,6,18
"244","2020-05-19",161,3,332,522,7543,0.287021079146228,0,0,586,1672,12,6551,40,2224,8,40
"245","2020-05-20",138,3,334,504,7543,0.287021079146228,0,0,586,1672,12,6563,44,2268,10,44
"246","2020-05-21",142,3,332,481,7543,0.287021079146228,0,0,586,1672,12,6575,38,2306,7,38
"247","2020-05-22",145,3,330,459,7543,0.287021079146228,0,0,586,1672,9,6584,35,2341,7,35
"248","2020-05-23",142,3,330,444,7543,0.287021079146228,0,0,586,1672,9,6593,24,2365,6,24
"249","2020-05-24",146,3,331,425,7543,0.287021079146228,0,0,586,1672,14,6607,30,2395,11,30
"250","2020-05-25",130,3,340,400,7543,0.287021079146228,0,0,586,1672,18,6625,27,2422,10,27
"251","2020-05-26",132,3,339,379,7543,0.287021079146228,0,0,586,1672,15,6640,21,2443,12,21
"252","2020-05-27",127,3,338,364,7543,0.287021079146228,0,0,586,1672,11,6651,27,2470,7,27
"253","2020-05-28",109,3,348,349,7543,0.287021079146228,0,0,586,1672,7,6658,33,2503,6,33
"254","2020-05-29",101,3,359,325,7543,0.287021079146228,0,0,586,1672,15,6673,32,2535,8,32
"255","2020-05-30",93,3,352,314,7543,0.287021079146228,0,0,586,1672,10,6683,32,2567,6,32
"256","2020-05-31",90,3,333,303,7543,0.287021079146228,0,0,586,1672,12,6695,37,2604,6,37
"257","2020-06-01",91,3,346,279,7543,0.287021079146228,0,0,586,1672,9,6704,59,2663,7,59
"258","2020-06-02",78,3,324,256,7543,0.287021079146228,0,0,586,1672,12,6716,53,2716,12,53
"259","2020-06-03",82,3,346,257,7543,0.287021079146228,0,0,586,1672,9,6725,35,2751,7,35
"260","2020-06-04",77,3,338,239,7543,0.287021079146228,0,0,586,1672,4,6729,27,2778,1,27
"261","2020-06-05",75,3,355,216,7543,0.287021079146228,0,0,586,1672,8,6737,20,2798,4,20
"262","2020-06-06",79,3,357,206,7543,0.287021079146228,0,0,586,1672,14,6751,16,2814,7,16
"263","2020-06-07",74,3,378,192,7543,0.287021079146228,0,0,586,1672,3,6754,46,2860,2,46
"264","2020-03-13",3,4,137,116,6064,0.565468337730871,0,0,502,1048,165,375,27,162,75,27
"265","2020-03-14",7,4,152,173,6064,0.565468337730871,0,0,502,1048,202,577,13,175,117,13
"266","2020-03-15",10,4,189,230,6064,0.565468337730871,0,0,502,1048,246,823,17,192,179,17
"267","2020-03-16",16,4,211,295,6064,0.565468337730871,0,0,502,1048,335,1158,12,204,256,12
"268","2020-03-17",26,4,218,354,6064,0.565468337730871,0,0,502,1048,374,1532,35,239,294,35
"269","2020-03-18",46,4,223,429,6064,0.565468337730871,0,0,502,1048,495,2027,73,312,421,73
"270","2020-03-19",63,4,206,501,6064,0.565468337730871,0,0,502,1048,481,2508,42,354,428,42
"271","2020-03-20",81,4,176,568,6064,0.565468337730871,0,0,502,1048,659,3167,35,389,605,35
"272","2020-03-21",98,4,182,638,6064,0.565468337730871,0,0,502,1048,582,3749,29,418,537,29
"273","2020-03-22",120,4,159,710,6064,0.565468337730871,0,0,502,1048,638,4387,27,445,598,27
"274","2020-03-23",140,4,150,777,6064,0.565468337730871,0,0,502,1048,555,4942,39,484,507,39
"275","2020-03-24",165,4,184,841,6064,0.565468337730871,0,0,502,1048,593,5535,73,557,553,73
"276","2020-03-25",188,4,187,886,6064,0.565468337730871,0,0,502,1048,461,5996,39,596,428,39
"277","2020-03-26",199,4,180,926,6064,0.565468337730871,0,0,502,1048,430,6426,11,607,407,11
"278","2020-03-27",212,4,158,992,6064,0.565468337730871,0,0,502,1048,297,6723,27,634,274,27
"279","2020-03-28",242,4,145,1025,6064,0.565468337730871,0,0,502,1048,232,6955,67,701,211,67
"280","2020-03-29",243,4,129,1080,6064,0.565468337730871,0,0,502,1048,236,7191,19,720,223,19
"281","2020-03-30",253,4,119,1104,6064,0.565468337730871,0,0,502,1048,150,7341,20,740,149,20
"282","2020-03-31",258,4,106,1145,6064,0.565468337730871,0,0,502,1048,142,7483,19,759,133,19
"283","2020-04-01",273,4,115,1155,6064,0.565468337730871,0,0,502,1048,102,7585,5,764,91,5
"284","2020-04-02",287,4,181,1167,6064,0.565468337730871,0,0,502,1048,59,7644,14,778,52,14
"285","2020-04-03",298,4,244,1196,6064,0.565468337730871,0,0,502,1048,43,7687,19,797,39,19
"286","2020-04-04",290,4,244,1197,6064,0.565468337730871,0,0,502,1048,40,7727,46,843,35,46
"287","2020-04-05",332,4,213,1197,6064,0.565468337730871,0,0,502,1048,29,7756,25,868,27,25
"288","2020-04-06",344,4,199,1201,6064,0.565468337730871,0,0,502,1048,15,7771,18,886,13,18
"289","2020-04-07",357,4,189,1188,6064,0.565468337730871,0,0,502,1048,14,7785,49,935,9,49
"290","2020-04-08",348,4,230,1166,6064,0.565468337730871,0,0,502,1048,13,7798,61,996,9,61
"291","2020-04-09",361,4,275,1145,6064,0.565468337730871,0,0,502,1048,13,7811,28,1024,9,28
"292","2020-04-10",375,4,255,1159,6064,0.565468337730871,0,0,502,1048,7,7818,31,1055,2,31
"293","2020-04-11",373,4,211,1168,6064,0.565468337730871,0,0,502,1048,6,7824,34,1089,4,34
"294","2020-04-12",358,4,202,1153,6064,0.565468337730871,0,0,502,1048,10,7834,19,1108,7,19
"295","2020-04-13",353,4,251,1150,6064,0.565468337730871,0,0,502,1048,6,7840,14,1122,5,14
"296","2020-04-14",342,4,266,1148,6064,0.565468337730871,0,0,502,1048,5,7845,6,1128,2,6
"297","2020-04-15",342,4,319,1125,6064,0.565468337730871,0,0,502,1048,6,7851,3,1131,5,3
"298","2020-04-16",320,4,350,1084,6064,0.565468337730871,0,0,502,1048,3,7854,13,1144,3,13
"299","2020-04-17",297,4,342,1063,6064,0.565468337730871,0,0,502,1048,4,7858,13,1157,2,13
"300","2020-04-18",295,4,327,1031,6064,0.565468337730871,0,0,502,1048,5,7863,31,1188,1,31
"301","2020-04-19",287,4,319,1013,6064,0.565468337730871,0,0,502,1048,3,7866,30,1218,1,30
"302","2020-04-20",274,4,288,974,6064,0.565468337730871,0,0,502,1048,NA,NA,34,1252,NA,34
"303","2020-04-21",271,4,260,938,6064,0.565468337730871,0,0,502,1048,3,7869,20,1272,1,20
"304","2020-04-22",263,4,243,935,6064,0.565468337730871,0,0,502,1048,2,7871,17,1289,NA,17
"305","2020-04-23",264,4,215,899,6064,0.565468337730871,0,0,502,1048,5,7876,19,1308,2,19
"306","2020-04-24",266,4,241,885,6064,0.565468337730871,0,0,502,1048,3,7879,63,1371,1,63
"307","2020-04-25",266,4,231,850,6064,0.565468337730871,0,0,502,1048,3,7882,49,1420,NA,49
"308","2020-04-26",250,4,218,843,6064,0.565468337730871,0,0,502,1048,5,7887,19,1439,1,19
"309","2020-04-27",249,4,214,809,6064,0.565468337730871,0,0,502,1048,2,7889,11,1450,NA,11
"310","2020-04-28",244,4,206,809,6064,0.565468337730871,0,0,502,1048,4,7893,5,1455,1,5
"311","2020-04-29",242,4,228,784,6064,0.565468337730871,0,0,502,1048,5,7898,13,1468,1,13
"312","2020-04-30",238,4,264,770,6064,0.565468337730871,0,0,502,1048,4,7902,15,1483,1,15
"313","2020-05-01",224,4,256,752,6064,0.565468337730871,0,0,502,1048,2,7904,8,1491,NA,8
"314","2020-05-02",211,4,240,744,6064,0.565468337730871,0,0,502,1048,2,7906,23,1514,NA,23
"315","2020-05-03",214,4,225,739,6064,0.565468337730871,0,0,502,1048,2,7908,31,1545,1,31
"316","2020-05-04",212,4,189,721,6064,0.565468337730871,0,0,502,1048,2,7910,17,1562,2,17
"317","2020-05-05",208,4,169,680,6064,0.565468337730871,0,0,502,1048,2,7912,36,1598,2,36
"318","2020-05-06",194,4,184,675,6064,0.565468337730871,0,0,502,1048,4,7916,30,1628,1,30
"319","2020-05-07",196,4,225,679,6064,0.565468337730871,0,0,502,1048,1,7917,24,1652,NA,24
"320","2020-05-08",206,4,213,652,6064,0.565468337730871,0,0,502,1048,1,7918,25,1677,NA,25
"321","2020-05-09",208,4,205,648,6064,0.565468337730871,0,0,502,1048,1,7919,11,1688,NA,11
"322","2020-05-10",204,4,250,629,6064,0.565468337730871,0,0,502,1048,5,7924,18,1706,NA,18
"323","2020-05-11",205,4,249,612,6064,0.565468337730871,0,0,502,1048,1,7925,7,1713,NA,7
"324","2020-05-12",199,4,261,588,6064,0.565468337730871,0,0,502,1048,1,7926,8,1721,1,8
"325","2020-05-13",192,4,231,570,6064,0.565468337730871,0,0,502,1048,3,7929,10,1731,1,10
"326","2020-05-14",184,4,227,551,6064,0.565468337730871,0,0,502,1048,2,7931,39,1770,NA,39
"327","2020-05-15",174,4,203,521,6064,0.565468337730871,0,0,502,1048,1,7932,23,1793,1,23
"328","2020-05-16",173,4,209,510,6064,0.565468337730871,0,0,502,1048,2,7934,12,1805,NA,12
"329","2020-05-17",162,4,263,491,6064,0.565468337730871,0,0,502,1048,2,7936,16,1821,NA,16
"330","2020-05-18",156,4,252,472,6064,0.565468337730871,0,0,502,1048,NA,NA,30,1851,NA,30
"331","2020-05-19",145,4,291,452,6064,0.565468337730871,0,0,502,1048,5,7941,38,1889,NA,38
"332","2020-05-20",147,4,288,445,6064,0.565468337730871,0,0,502,1048,1,7942,21,1910,NA,21
"333","2020-05-21",141,4,271,424,6064,0.565468337730871,0,0,502,1048,1,7943,35,1945,NA,35
"334","2020-05-22",131,4,239,398,6064,0.565468337730871,0,0,502,1048,NA,NA,32,1977,NA,32
"335","2020-05-23",123,4,218,385,6064,0.565468337730871,0,0,502,1048,NA,NA,34,2011,NA,34
"336","2020-05-24",123,4,193,364,6064,0.565468337730871,0,0,502,1048,3,7946,24,2035,NA,24
"337","2020-05-25",109,4,181,343,6064,0.565468337730871,0,0,502,1048,2,7948,26,2061,1,26
"338","2020-05-26",107,4,170,339,6064,0.565468337730871,0,0,502,1048,NA,NA,32,2093,NA,32
"339","2020-05-27",102,4,151,321,6064,0.565468337730871,0,0,502,1048,2,7950,27,2120,1,27
"340","2020-05-28",94,4,150,310,6064,0.565468337730871,0,0,502,1048,NA,NA,89,2209,NA,89
"341","2020-05-29",96,4,148,299,6064,0.565468337730871,0,0,502,1048,NA,NA,73,2282,NA,73
"342","2020-05-30",87,4,212,281,6064,0.565468337730871,0,0,502,1048,1,7951,33,2315,NA,33
"343","2020-05-31",86,4,252,263,6064,0.565468337730871,0,0,502,1048,NA,NA,15,2330,NA,15
"344","2020-06-01",85,4,300,249,6064,0.565468337730871,0,0,502,1048,NA,NA,39,2369,NA,39
"345","2020-06-02",85,4,282,245,6064,0.565468337730871,0,0,502,1048,2,7953,56,2425,NA,56
"346","2020-06-03",75,4,264,233,6064,0.565468337730871,0,0,502,1048,2,7955,76,2501,1,76
"347","2020-06-04",78,4,296,224,6064,0.565468337730871,0,0,502,1048,NA,NA,64,2565,NA,64
"348","2020-06-05",68,4,289,214,6064,0.565468337730871,0,0,502,1048,NA,NA,51,2616,NA,51
"349","2020-06-06",65,4,267,213,6064,0.565468337730871,0,0,502,1048,NA,NA,22,2638,NA,22
"350","2020-06-07",59,4,271,204,6064,0.565468337730871,0,0,502,1048,1,7956,24,2662,NA,24
"351","2020-03-13",2,5,82,163,5442,0.251378169790518,0,0,459,684,31,82,40,84,6,40
"352","2020-03-14",7,5,104,226,5442,0.251378169790518,0,0,459,684,27,109,25,109,9,25
"353","2020-03-15",14,5,123,271,5442,0.251378169790518,0,0,459,684,34,143,43,152,8,43
"354","2020-03-16",26,5,124,343,5442,0.251378169790518,0,0,459,684,36,179,26,178,12,26
"355","2020-03-17",38,5,124,405,5442,0.251378169790518,0,0,459,684,41,220,50,228,19,50
"356","2020-03-18",48,5,120,457,5442,0.251378169790518,0,0,459,684,45,265,46,274,25,46
"357","2020-03-19",66,5,137,502,5442,0.251378169790518,0,0,459,684,45,310,31,305,20,31
"358","2020-03-20",83,5,139,542,5442,0.251378169790518,0,0,459,684,47,357,25,330,22,25
"359","2020-03-21",102,5,163,591,5442,0.251378169790518,0,0,459,684,50,407,22,352,26,22
"360","2020-03-22",118,5,156,637,5442,0.251378169790518,0,0,459,684,54,461,46,398,30,46
"361","2020-03-23",132,5,185,666,5442,0.251378169790518,0,0,459,684,49,510,36,434,24,36
"362","2020-03-24",148,5,204,676,5442,0.251378169790518,0,0,459,684,48,558,25,459,25,25
"363","2020-03-25",166,5,211,711,5442,0.251378169790518,0,0,459,684,54,612,44,503,25,44
"364","2020-03-26",169,5,195,723,5442,0.251378169790518,0,0,459,684,58,670,46,549,33,46
"365","2020-03-27",178,5,191,737,5442,0.251378169790518,0,0,459,684,51,721,44,593,27,44
"366","2020-03-28",178,5,208,738,5442,0.251378169790518,0,0,459,684,46,767,34,627,23,34
"367","2020-03-29",194,5,218,778,5442,0.251378169790518,0,0,459,684,65,832,64,691,36,64
"368","2020-03-30",194,5,219,774,5442,0.251378169790518,0,0,459,684,59,891,40,731,31,40
"369","2020-03-31",199,5,215,792,5442,0.251378169790518,0,0,459,684,56,947,25,756,22,25
"370","2020-04-01",197,5,190,791,5442,0.251378169790518,0,0,459,684,51,998,27,783,20,27
"371","2020-04-02",215,5,203,800,5442,0.251378169790518,0,0,459,684,47,1045,34,817,17,34
"372","2020-04-03",215,5,202,801,5442,0.251378169790518,0,0,459,684,61,1106,28,845,32,28
"373","2020-04-04",222,5,192,807,5442,0.251378169790518,0,0,459,684,61,1167,22,867,26,22
"374","2020-04-05",217,5,193,804,5442,0.251378169790518,0,0,459,684,63,1230,29,896,36,29
"375","2020-04-06",236,5,187,808,5442,0.251378169790518,0,0,459,684,53,1283,18,914,22,18
"376","2020-04-07",234,5,188,815,5442,0.251378169790518,0,0,459,684,47,1330,32,946,20,32
"377","2020-04-08",237,5,207,832,5442,0.251378169790518,0,0,459,684,62,1392,28,974,29,28
"378","2020-04-09",225,5,191,852,5442,0.251378169790518,0,0,459,684,63,1455,31,1005,29,31
"379","2020-04-10",222,5,177,855,5442,0.251378169790518,0,0,459,684,52,1507,46,1051,24,46
"380","2020-04-11",237,5,201,852,5442,0.251378169790518,0,0,459,684,64,1571,36,1087,30,36
"381","2020-04-12",235,5,230,853,5442,0.251378169790518,0,0,459,684,65,1636,32,1119,30,32
"382","2020-04-13",225,5,232,824,5442,0.251378169790518,0,0,459,684,63,1699,20,1139,38,20
"383","2020-04-14",221,5,256,820,5442,0.251378169790518,0,0,459,684,65,1764,46,1185,40,46
"384","2020-04-15",225,5,260,814,5442,0.251378169790518,0,0,459,684,60,1824,27,1212,38,27
"385","2020-04-16",236,5,255,820,5442,0.251378169790518,0,0,459,684,50,1874,28,1240,26,28
"386","2020-04-17",246,5,234,825,5442,0.251378169790518,0,0,459,684,68,1942,29,1269,34,29
"387","2020-04-18",230,5,214,850,5442,0.251378169790518,0,0,459,684,63,2005,32,1301,26,32
"388","2020-04-19",224,5,238,832,5442,0.251378169790518,0,0,459,684,36,2041,28,1329,11,28
"389","2020-04-20",227,5,224,801,5442,0.251378169790518,0,0,459,684,56,2097,18,1347,23,18
"390","2020-04-21",229,5,208,819,5442,0.251378169790518,0,0,459,684,46,2143,35,1382,15,35
"391","2020-04-22",234,5,192,804,5442,0.251378169790518,0,0,459,684,58,2201,25,1407,27,25
"392","2020-04-23",222,5,192,811,5442,0.251378169790518,0,0,459,684,42,2243,32,1439,20,32
"393","2020-04-24",224,5,203,817,5442,0.251378169790518,0,0,459,684,43,2286,34,1473,11,34
"394","2020-04-25",223,5,196,797,5442,0.251378169790518,0,0,459,684,39,2325,21,1494,18,21
"395","2020-04-26",226,5,220,785,5442,0.251378169790518,0,0,459,684,45,2370,44,1538,20,44
"396","2020-04-27",220,5,234,765,5442,0.251378169790518,0,0,459,684,43,2413,33,1571,12,33
"397","2020-04-28",220,5,226,741,5442,0.251378169790518,0,0,459,684,49,2462,23,1594,19,23
"398","2020-04-29",212,5,242,714,5442,0.251378169790518,0,0,459,684,49,2511,42,1636,21,42
"399","2020-04-30",212,5,246,696,5442,0.251378169790518,0,0,459,684,53,2564,38,1674,17,38
"400","2020-05-01",200,5,228,701,5442,0.251378169790518,0,0,459,684,38,2602,40,1714,13,40
"401","2020-05-02",193,5,211,695,5442,0.251378169790518,0,0,459,684,42,2644,19,1733,12,19
"402","2020-05-03",191,5,230,680,5442,0.251378169790518,0,0,459,684,48,2692,29,1762,15,29
"403","2020-05-04",195,5,259,682,5442,0.251378169790518,0,0,459,684,52,2744,25,1787,12,25
"404","2020-05-05",197,5,239,677,5442,0.251378169790518,0,0,459,684,42,2786,12,1799,11,12
"405","2020-05-06",189,5,197,653,5442,0.251378169790518,0,0,459,684,43,2829,23,1822,20,23
"406","2020-05-07",186,5,183,655,5442,0.251378169790518,0,0,459,684,45,2874,14,1836,22,14
"407","2020-05-08",194,5,160,660,5442,0.251378169790518,0,0,459,684,38,2912,13,1849,7,13
"408","2020-05-09",193,5,153,652,5442,0.251378169790518,0,0,459,684,40,2952,47,1896,14,47
"409","2020-05-10",198,5,151,647,5442,0.251378169790518,0,0,459,684,43,2995,36,1932,19,36
"410","2020-05-11",181,5,138,626,5442,0.251378169790518,0,0,459,684,29,3024,44,1976,15,44
"411","2020-05-12",168,5,144,628,5442,0.251378169790518,0,0,459,684,32,3056,28,2004,16,28
"412","2020-05-13",168,5,131,632,5442,0.251378169790518,0,0,459,684,40,3096,18,2022,19,18
"413","2020-05-14",174,5,119,628,5442,0.251378169790518,0,0,459,684,35,3131,37,2059,17,37
"414","2020-05-15",169,5,116,607,5442,0.251378169790518,0,0,459,684,34,3165,26,2085,12,26
"415","2020-05-16",162,5,112,601,5442,0.251378169790518,0,0,459,684,36,3201,18,2103,17,18
"416","2020-05-17",163,5,131,596,5442,0.251378169790518,0,0,459,684,33,3234,44,2147,16,44
"417","2020-05-18",171,5,153,585,5442,0.251378169790518,0,0,459,684,38,3272,25,2172,13,25
"418","2020-05-19",176,5,148,582,5442,0.251378169790518,0,0,459,684,41,3313,22,2194,20,22
"419","2020-05-20",185,5,150,581,5442,0.251378169790518,0,0,459,684,43,3356,19,2213,21,19
"420","2020-05-21",182,5,165,553,5442,0.251378169790518,0,0,459,684,19,3375,20,2233,9,20
"421","2020-05-22",168,5,206,548,5442,0.251378169790518,0,0,459,684,21,3396,17,2250,8,17
"422","2020-05-23",178,5,225,514,5442,0.251378169790518,0,0,459,684,23,3419,27,2277,10,27
"423","2020-05-24",164,5,265,488,5442,0.251378169790518,0,0,459,684,21,3440,21,2298,10,21
"424","2020-05-25",164,5,246,469,5442,0.251378169790518,0,0,459,684,36,3476,15,2313,15,15
"425","2020-05-26",162,5,226,429,5442,0.251378169790518,0,0,459,684,26,3502,20,2333,10,20
"426","2020-05-27",145,5,227,399,5442,0.251378169790518,0,0,459,684,22,3524,12,2345,9,12
"427","2020-05-28",134,5,199,385,5442,0.251378169790518,0,0,459,684,18,3542,48,2393,8,48
"428","2020-05-29",137,5,195,358,5442,0.251378169790518,0,0,459,684,25,3567,32,2425,16,32
"429","2020-05-30",120,5,173,339,5442,0.251378169790518,0,0,459,684,32,3599,39,2464,19,39
"430","2020-05-31",113,5,145,328,5442,0.251378169790518,0,0,459,684,16,3615,38,2502,10,38
"431","2020-06-01",100,5,139,306,5442,0.251378169790518,0,0,459,684,26,3641,35,2537,9,35
"432","2020-06-02",91,5,154,284,5442,0.251378169790518,0,0,459,684,21,3662,32,2569,11,32
"433","2020-06-03",84,5,156,274,5442,0.251378169790518,0,0,459,684,16,3678,30,2599,5,30
"434","2020-06-04",79,5,157,265,5442,0.251378169790518,0,0,459,684,20,3698,23,2622,6,23
"435","2020-06-05",76,5,145,244,5442,0.251378169790518,0,0,459,684,13,3711,40,2662,3,40
"436","2020-06-06",81,5,133,239,5442,0.251378169790518,0,0,459,684,14,3725,24,2686,8,24
"437","2020-06-07",78,5,146,230,5442,0.251378169790518,0,0,459,684,15,3740,19,2705,8,19
"438","2020-03-13",1,6,203,171,8656,0.856746765249538,0,0,743,1682,44,128,20,99,5,20
"439","2020-03-14",2,6,223,258,8656,0.856746765249538,0,0,743,1682,54,182,16,115,3,16
"440","2020-03-15",11,6,292,396,8656,0.856746765249538,0,0,743,1682,60,242,50,165,8,50
"441","2020-03-16",24,6,276,557,8656,0.856746765249538,0,0,743,1682,63,305,22,187,15,22
"442","2020-03-17",38,6,256,791,8656,0.856746765249538,0,0,743,1682,68,373,11,198,9,11
"443","2020-03-18",66,6,252,1082,8656,0.856746765249538,0,0,743,1682,72,445,13,211,29,13
"444","2020-03-19",103,6,224,1412,8656,0.856746765249538,0,0,743,1682,47,492,9,220,8,9
"445","2020-03-20",147,6,190,1741,8656,0.856746765249538,0,0,743,1682,67,559,46,266,29,46
"446","2020-03-21",204,6,177,2226,8656,0.856746765249538,0,0,743,1682,69,628,31,297,26,31
"447","2020-03-22",271,6,207,2576,8656,0.856746765249538,0,0,743,1682,69,697,19,316,19,19
"448","2020-03-23",342,6,202,3056,8656,0.856746765249538,0,0,743,1682,91,788,21,337,23,21
"449","2020-03-24",447,6,192,3459,8656,0.856746765249538,0,0,743,1682,77,865,59,396,25,59
"450","2020-03-25",552,6,189,4002,8656,0.856746765249538,0,0,743,1682,61,926,66,462,11,66
"451","2020-03-26",690,6,218,4318,8656,0.856746765249538,0,0,743,1682,58,984,30,492,14,30
"452","2020-03-27",813,6,208,4638,8656,0.856746765249538,0,0,743,1682,62,1046,23,515,14,23
"453","2020-03-28",946,6,212,4838,8656,0.856746765249538,0,0,743,1682,64,1110,21,536,14,21
"454","2020-03-29",1071,6,208,5036,8656,0.856746765249538,0,0,743,1682,80,1190,15,551,28,15
"455","2020-03-30",1194,6,208,4954,8656,0.856746765249538,0,0,743,1682,78,1268,9,560,21,9
"456","2020-03-31",1255,6,213,4862,8656,0.856746765249538,0,0,743,1682,70,1338,9,569,16,9
"457","2020-04-01",1319,6,197,4614,8656,0.856746765249538,0,0,743,1682,83,1421,9,578,34,9
"458","2020-04-02",1334,6,214,4278,8656,0.856746765249538,0,0,743,1682,85,1506,43,621,28,43
"459","2020-04-03",1383,6,191,3915,8656,0.856746765249538,0,0,743,1682,73,1579,74,695,18,74
"460","2020-04-04",1389,6,165,3571,8656,0.856746765249538,0,0,743,1682,70,1649,39,734,9,39
"461","2020-04-05",1336,6,235,3214,8656,0.856746765249538,0,0,743,1682,75,1724,30,764,16,30
"462","2020-04-06",1274,6,279,2842,8656,0.856746765249538,0,0,743,1682,62,1786,18,782,19,18
"463","2020-04-07",1198,6,276,2448,8656,0.856746765249538,0,0,743,1682,82,1868,21,803,21,21
"464","2020-04-08",1105,6,241,2076,8656,0.856746765249538,0,0,743,1682,69,1937,10,813,15,10
"465","2020-04-09",1010,6,205,1731,8656,0.856746765249538,0,0,743,1682,76,2013,12,825,17,12
"466","2020-04-10",842,6,215,1417,8656,0.856746765249538,0,0,743,1682,83,2096,10,835,26,10
"467","2020-04-11",687,6,224,1202,8656,0.856746765249538,0,0,743,1682,85,2181,11,846,27,11
"468","2020-04-12",587,6,248,982,8656,0.856746765249538,0,0,743,1682,48,2229,20,866,12,20
"469","2020-04-13",486,6,249,792,8656,0.856746765249538,0,0,743,1682,78,2307,18,884,25,18
"470","2020-04-14",410,6,232,659,8656,0.856746765249538,0,0,743,1682,66,2373,69,953,14,69
"471","2020-04-15",322,6,230,551,8656,0.856746765249538,0,0,743,1682,76,2449,37,990,16,37
"472","2020-04-16",243,6,201,463,8656,0.856746765249538,0,0,743,1682,65,2514,46,1036,9,46
"473","2020-04-17",202,6,196,372,8656,0.856746765249538,0,0,743,1682,65,2579,40,1076,9,40
"474","2020-04-18",175,6,200,310,8656,0.856746765249538,0,0,743,1682,72,2651,46,1122,18,46
"475","2020-04-19",133,6,217,261,8656,0.856746765249538,0,0,743,1682,44,2695,20,1142,12,20
"476","2020-04-20",99,6,205,230,8656,0.856746765249538,0,0,743,1682,66,2761,33,1175,18,33
"477","2020-04-21",74,6,224,195,8656,0.856746765249538,0,0,743,1682,64,2825,34,1209,10,34
"478","2020-04-22",62,6,249,152,8656,0.856746765249538,0,0,743,1682,76,2901,41,1250,10,41
"479","2020-04-23",51,6,232,128,8656,0.856746765249538,0,0,743,1682,57,2958,22,1272,17,22
"480","2020-04-24",48,6,209,113,8656,0.856746765249538,0,0,743,1682,63,3021,18,1290,7,18
"481","2020-04-25",35,6,209,107,8656,0.856746765249538,0,0,743,1682,47,3068,17,1307,6,17
"482","2020-04-26",33,6,195,95,8656,0.856746765249538,0,0,743,1682,44,3112,7,1314,9,7
"483","2020-04-27",28,6,178,85,8656,0.856746765249538,0,0,743,1682,60,3172,9,1323,13,9
"484","2020-04-28",31,6,187,81,8656,0.856746765249538,0,0,743,1682,52,3224,17,1340,9,17
"485","2020-04-29",30,6,183,72,8656,0.856746765249538,0,0,743,1682,61,3285,31,1371,11,31
"486","2020-04-30",26,6,186,65,8656,0.856746765249538,0,0,743,1682,54,3339,12,1383,8,12
"487","2020-05-01",25,6,252,59,8656,0.856746765249538,0,0,743,1682,53,3392,11,1394,7,11
"488","2020-05-02",26,6,264,49,8656,0.856746765249538,0,0,743,1682,50,3442,14,1408,5,14
"489","2020-05-03",22,6,268,45,8656,0.856746765249538,0,0,743,1682,45,3487,23,1431,2,23
"490","2020-05-04",20,6,247,39,8656,0.856746765249538,0,0,743,1682,60,3547,19,1450,10,19
"491","2020-05-05",14,6,222,36,8656,0.856746765249538,0,0,743,1682,58,3605,53,1503,12,53
"492","2020-05-06",12,6,201,30,8656,0.856746765249538,0,0,743,1682,52,3657,55,1558,11,55
"493","2020-05-07",12,6,203,26,8656,0.856746765249538,0,0,743,1682,43,3700,46,1604,4,46
"494","2020-05-08",8,6,197,23,8656,0.856746765249538,0,0,743,1682,59,3759,54,1658,13,54
"495","2020-05-09",5,6,182,22,8656,0.856746765249538,0,0,743,1682,53,3812,36,1694,9,36
"496","2020-05-10",6,6,182,20,8656,0.856746765249538,0,0,743,1682,36,3848,46,1740,7,46
"497","2020-05-11",4,6,218,22,8656,0.856746765249538,0,0,743,1682,40,3888,27,1767,8,27
"498","2020-05-12",5,6,232,21,8656,0.856746765249538,0,0,743,1682,46,3934,22,1789,3,22
"499","2020-05-13",6,6,216,21,8656,0.856746765249538,0,0,743,1682,46,3980,22,1811,4,22
"500","2020-05-14",5,6,199,24,8656,0.856746765249538,0,0,743,1682,42,4022,36,1847,7,36
"501","2020-05-15",5,6,176,28,8656,0.856746765249538,0,0,743,1682,40,4062,35,1882,8,35
"502","2020-05-16",5,6,180,26,8656,0.856746765249538,0,0,743,1682,45,4107,35,1917,11,35
"503","2020-05-17",7,6,180,27,8656,0.856746765249538,0,0,743,1682,31,4138,45,1962,1,45
"504","2020-05-18",7,6,158,26,8656,0.856746765249538,0,0,743,1682,33,4171,22,1984,4,22
"505","2020-05-19",6,6,154,30,8656,0.856746765249538,0,0,743,1682,43,4214,14,1998,1,14
"506","2020-05-20",4,6,166,33,8656,0.856746765249538,0,0,743,1682,44,4258,14,2012,9,14
"507","2020-05-21",5,6,196,32,8656,0.856746765249538,0,0,743,1682,28,4286,19,2031,4,19
"508","2020-05-22",5,6,225,29,8656,0.856746765249538,0,0,743,1682,39,4325,17,2048,10,17
"509","2020-05-23",7,6,245,29,8656,0.856746765249538,0,0,743,1682,27,4352,43,2091,4,43
"510","2020-05-24",5,6,226,30,8656,0.856746765249538,0,0,743,1682,32,4384,11,2102,6,11
"511","2020-05-25",6,6,197,28,8656,0.856746765249538,0,0,743,1682,26,4410,30,2132,4,30
"512","2020-05-26",9,6,208,27,8656,0.856746765249538,0,0,743,1682,28,4438,28,2160,6,28
"513","2020-05-27",9,6,255,24,8656,0.856746765249538,0,0,743,1682,36,4474,44,2204,3,44
"514","2020-05-28",8,6,243,21,8656,0.856746765249538,0,0,743,1682,26,4500,24,2228,2,24
"515","2020-05-29",9,6,217,20,8656,0.856746765249538,0,0,743,1682,27,4527,28,2256,4,28
"516","2020-05-30",7,6,239,20,8656,0.856746765249538,0,0,743,1682,21,4548,31,2287,5,31
"517","2020-05-31",6,6,233,19,8656,0.856746765249538,0,0,743,1682,34,4582,54,2341,10,54
"518","2020-06-01",7,6,251,17,8656,0.856746765249538,0,0,743,1682,29,4611,61,2402,4,61
"519","2020-06-02",4,6,236,15,8656,0.856746765249538,0,0,743,1682,23,4634,30,2432,3,30
"520","2020-06-03",5,6,239,14,8656,0.856746765249538,0,0,743,1682,23,4657,17,2449,6,17
"521","2020-06-04",7,6,220,15,8656,0.856746765249538,0,0,743,1682,23,4680,14,2463,4,14
"522","2020-06-05",6,6,179,14,8656,0.856746765249538,0,0,743,1682,19,4699,49,2512,4,49
"523","2020-06-06",6,6,160,11,8656,0.856746765249538,0,0,743,1682,22,4721,27,2539,3,27
"524","2020-06-07",6,6,167,9,8656,0.856746765249538,0,0,743,1682,14,4735,54,2593,2,54
"525","2020-03-12",1,7,40,160,7679,0.205235056648001,0,0,641,782,29,59,21,53,3,21
"526","2020-03-13",4,7,73,245,7679,0.205235056648001,0,0,641,782,31,90,58,111,11,58
"527","2020-03-14",14,7,93,322,7679,0.205235056648001,0,0,641,782,36,126,63,174,8,63
"528","2020-03-15",25,7,81,423,7679,0.205235056648001,0,0,641,782,40,166,52,226,21,52
"529","2020-03-16",42,7,83,539,7679,0.205235056648001,0,0,641,782,34,200,80,306,15,80
"530","2020-03-17",56,7,105,650,7679,0.205235056648001,0,0,641,782,39,239,78,384,19,78
"531","2020-03-18",81,7,104,767,7679,0.205235056648001,0,0,641,782,49,288,28,412,26,28
"532","2020-03-19",116,7,103,873,7679,0.205235056648001,0,0,641,782,42,330,17,429,18,17
"533","2020-03-20",146,7,98,952,7679,0.205235056648001,0,0,641,782,62,392,22,451,25,22
"534","2020-03-21",174,7,99,1055,7679,0.205235056648001,0,0,641,782,54,446,20,471,25,20
"535","2020-03-22",196,7,98,1132,7679,0.205235056648001,0,0,641,782,58,504,11,482,26,11
"536","2020-03-23",224,7,122,1186,7679,0.205235056648001,0,0,641,782,58,562,44,526,32,44
"537","2020-03-24",253,7,143,1242,7679,0.205235056648001,0,0,641,782,58,620,32,558,35,32
"538","2020-03-25",292,7,184,1262,7679,0.205235056648001,0,0,641,782,68,688,29,587,40,29
"539","2020-03-26",307,7,213,1298,7679,0.205235056648001,0,0,641,782,67,755,30,617,38,30
"540","2020-03-27",336,7,242,1340,7679,0.205235056648001,0,0,641,782,62,817,21,638,36,21
"541","2020-03-28",364,7,232,1347,7679,0.205235056648001,0,0,641,782,51,868,29,667,23,29
"542","2020-03-29",390,7,232,1334,7679,0.205235056648001,0,0,641,782,67,935,16,683,29,16
"543","2020-03-30",404,7,232,1342,7679,0.205235056648001,0,0,641,782,68,1003,40,723,47,40
"544","2020-03-31",417,7,238,1339,7679,0.205235056648001,0,0,641,782,59,1062,26,749,29,26
"545","2020-04-01",402,7,257,1340,7679,0.205235056648001,0,0,641,782,63,1125,8,757,33,8
"546","2020-04-02",410,7,267,1321,7679,0.205235056648001,0,0,641,782,59,1184,25,782,34,25
"547","2020-04-03",400,7,280,1283,7679,0.205235056648001,0,0,641,782,64,1248,20,802,32,20
"548","2020-04-04",387,7,261,1262,7679,0.205235056648001,0,0,641,782,54,1302,13,815,27,13
"549","2020-04-05",379,7,233,1261,7679,0.205235056648001,0,0,641,782,65,1367,7,822,31,7
"550","2020-04-06",372,7,211,1263,7679,0.205235056648001,0,0,641,782,72,1439,4,826,46,4
"551","2020-04-07",368,7,201,1255,7679,0.205235056648001,0,0,641,782,71,1510,6,832,27,6
"552","2020-04-08",364,7,202,1256,7679,0.205235056648001,0,0,641,782,49,1559,3,835,26,3
"553","2020-04-09",357,7,230,1247,7679,0.205235056648001,0,0,641,782,62,1621,4,839,31,4
"554","2020-04-10",360,7,228,1225,7679,0.205235056648001,0,0,641,782,78,1699,4,843,46,4
"555","2020-04-11",351,7,216,1212,7679,0.205235056648001,0,0,641,782,65,1764,12,855,33,12
"556","2020-04-12",332,7,175,1182,7679,0.205235056648001,0,0,641,782,79,1843,58,913,46,58
"557","2020-04-13",329,7,164,1179,7679,0.205235056648001,0,0,641,782,66,1909,25,938,35,25
"558","2020-04-14",318,7,190,1193,7679,0.205235056648001,0,0,641,782,62,1971,18,956,21,18
"559","2020-04-15",321,7,206,1191,7679,0.205235056648001,0,0,641,782,69,2040,20,976,39,20
"560","2020-04-16",308,7,201,1191,7679,0.205235056648001,0,0,641,782,71,2111,71,1047,43,71
"561","2020-04-17",306,7,193,1173,7679,0.205235056648001,0,0,641,782,59,2170,45,1092,31,45
"562","2020-04-18",301,7,179,1171,7679,0.205235056648001,0,0,641,782,63,2233,18,1110,25,18
"563","2020-04-19",298,7,177,1162,7679,0.205235056648001,0,0,641,782,63,2296,12,1122,25,12
"564","2020-04-20",286,7,188,1153,7679,0.205235056648001,0,0,641,782,62,2358,22,1144,40,22
"565","2020-04-21",301,7,200,1138,7679,0.205235056648001,0,0,641,782,64,2422,14,1158,37,14
"566","2020-04-22",300,7,172,1130,7679,0.205235056648001,0,0,641,782,61,2483,7,1165,31,7
"567","2020-04-23",317,7,155,1118,7679,0.205235056648001,0,0,641,782,53,2536,12,1177,30,12
"568","2020-04-24",307,7,151,1109,7679,0.205235056648001,0,0,641,782,59,2595,25,1202,29,25
"569","2020-04-25",303,7,142,1096,7679,0.205235056648001,0,0,641,782,62,2657,18,1220,22,18
"570","2020-04-26",316,7,139,1085,7679,0.205235056648001,0,0,641,782,50,2707,26,1246,28,26
"571","2020-04-27",312,7,171,1077,7679,0.205235056648001,0,0,641,782,63,2770,20,1266,36,20
"572","2020-04-28",294,7,183,1049,7679,0.205235056648001,0,0,641,782,64,2834,19,1285,34,19
"573","2020-04-29",292,7,187,1003,7679,0.205235056648001,0,0,641,782,49,2883,31,1316,19,31
"574","2020-04-30",275,7,176,988,7679,0.205235056648001,0,0,641,782,69,2952,33,1349,40,33
"575","2020-05-01",260,7,161,946,7679,0.205235056648001,0,0,641,782,41,2993,18,1367,23,18
"576","2020-05-02",255,7,189,918,7679,0.205235056648001,0,0,641,782,40,3033,5,1372,20,5
"577","2020-05-03",251,7,190,884,7679,0.205235056648001,0,0,641,782,41,3074,12,1384,17,12
"578","2020-05-04",246,7,173,856,7679,0.205235056648001,0,0,641,782,44,3118,11,1395,20,11
"579","2020-05-05",244,7,164,835,7679,0.205235056648001,0,0,641,782,55,3173,9,1404,26,9
"580","2020-05-06",232,7,160,826,7679,0.205235056648001,0,0,641,782,53,3226,22,1426,31,22
"581","2020-05-07",219,7,175,808,7679,0.205235056648001,0,0,641,782,53,3279,18,1444,26,18
"582","2020-05-08",221,7,177,798,7679,0.205235056648001,0,0,641,782,47,3326,13,1457,21,13
"583","2020-05-09",223,7,184,769,7679,0.205235056648001,0,0,641,782,59,3385,9,1466,27,9
"584","2020-05-10",215,7,230,747,7679,0.205235056648001,0,0,641,782,46,3431,3,1469,22,3
"585","2020-05-11",209,7,237,716,7679,0.205235056648001,0,0,641,782,36,3467,4,1473,21,4
"586","2020-05-12",199,7,262,684,7679,0.205235056648001,0,0,641,782,56,3523,6,1479,31,6
"587","2020-05-13",188,7,257,656,7679,0.205235056648001,0,0,641,782,34,3557,5,1484,19,5
"588","2020-05-14",185,7,235,625,7679,0.205235056648001,0,0,641,782,44,3601,9,1493,22,9
"589","2020-05-15",181,7,229,613,7679,0.205235056648001,0,0,641,782,36,3637,60,1553,18,60
"590","2020-05-16",168,7,216,597,7679,0.205235056648001,0,0,641,782,25,3662,44,1597,8,44
"591","2020-05-17",166,7,203,558,7679,0.205235056648001,0,0,641,782,34,3696,21,1618,17,21
"592","2020-05-18",171,7,191,522,7679,0.205235056648001,0,0,641,782,30,3726,11,1629,16,11
"593","2020-05-19",163,7,167,508,7679,0.205235056648001,0,0,641,782,25,3751,37,1666,16,37
"594","2020-05-20",153,7,151,480,7679,0.205235056648001,0,0,641,782,32,3783,41,1707,15,41
"595","2020-05-21",146,7,145,465,7679,0.205235056648001,0,0,641,782,27,3810,57,1764,12,57
"596","2020-05-22",139,7,121,433,7679,0.205235056648001,0,0,641,782,30,3840,31,1795,17,31
"597","2020-05-23",136,7,105,419,7679,0.205235056648001,0,0,641,782,26,3866,24,1819,10,24
"598","2020-05-24",117,7,99,395,7679,0.205235056648001,0,0,641,782,31,3897,52,1871,10,52
"599","2020-05-25",103,7,80,383,7679,0.205235056648001,0,0,641,782,27,3924,33,1904,15,33
"600","2020-05-26",93,7,105,363,7679,0.205235056648001,0,0,641,782,28,3952,23,1927,19,23
"601","2020-05-27",96,7,130,348,7679,0.205235056648001,0,0,641,782,15,3967,24,1951,5,24
"602","2020-05-28",99,7,133,345,7679,0.205235056648001,0,0,641,782,26,3993,25,1976,13,25
"603","2020-05-29",96,7,141,332,7679,0.205235056648001,0,0,641,782,27,4020,33,2009,9,33
"604","2020-05-30",90,7,167,321,7679,0.205235056648001,0,0,641,782,23,4043,20,2029,8,20
"605","2020-05-31",93,7,159,304,7679,0.205235056648001,0,0,641,782,23,4066,30,2059,11,30
"606","2020-06-01",94,7,139,296,7679,0.205235056648001,0,0,641,782,21,4087,35,2094,9,35
"607","2020-06-02",97,7,133,291,7679,0.205235056648001,0,0,641,782,24,4111,60,2154,13,60
"608","2020-06-03",93,7,131,278,7679,0.205235056648001,0,0,641,782,14,4125,61,2215,8,61
"609","2020-06-04",85,7,141,270,7679,0.205235056648001,0,0,641,782,18,4143,39,2254,6,39
"610","2020-06-05",80,7,156,264,7679,0.205235056648001,0,0,641,782,20,4163,17,2271,11,17
"611","2020-06-06",76,7,181,252,7679,0.205235056648001,0,0,641,782,17,4180,14,2285,5,14
"612","2020-06-07",70,7,193,244,7679,0.205235056648001,0,0,641,782,19,4199,35,2320,12,35
"613","2020-03-13",4,8,97,204,6717,0.315319338990621,0,0,599,1687,63,153,25,46,8,25
"614","2020-03-14",8,8,99,280,6717,0.315319338990621,0,0,599,1687,52,205,31,77,5,31
"615","2020-03-15",20,8,143,372,6717,0.315319338990621,0,0,599,1687,53,258,33,110,15,33
"616","2020-03-16",31,8,192,466,6717,0.315319338990621,0,0,599,1687,65,323,19,129,10,19
"617","2020-03-17",48,8,212,574,6717,0.315319338990621,0,0,599,1687,64,387,17,146,13,17
"618","2020-03-18",69,8,216,660,6717,0.315319338990621,0,0,599,1687,47,434,39,185,13,39
"619","2020-03-19",85,8,205,739,6717,0.315319338990621,0,0,599,1687,54,488,17,202,16,17
"620","2020-03-20",106,8,197,809,6717,0.315319338990621,0,0,599,1687,62,550,23,225,10,23
"621","2020-03-21",138,8,198,896,6717,0.315319338990621,0,0,599,1687,60,610,22,247,8,22
"622","2020-03-22",165,8,256,963,6717,0.315319338990621,0,0,599,1687,56,666,13,260,13,13
"623","2020-03-23",193,8,304,1010,6717,0.315319338990621,0,0,599,1687,70,736,50,310,17,50
"624","2020-03-24",216,8,306,1060,6717,0.315319338990621,0,0,599,1687,57,793,29,339,17,29
"625","2020-03-25",239,8,290,1096,6717,0.315319338990621,0,0,599,1687,52,845,17,356,15,17
"626","2020-03-26",269,8,299,1114,6717,0.315319338990621,0,0,599,1687,71,916,25,381,19,25
"627","2020-03-27",297,8,290,1134,6717,0.315319338990621,0,0,599,1687,69,985,47,428,22,47
"628","2020-03-28",315,8,305,1143,6717,0.315319338990621,0,0,599,1687,62,1047,22,450,16,22
"629","2020-03-29",327,8,314,1177,6717,0.315319338990621,0,0,599,1687,76,1123,35,485,21,35
"630","2020-03-30",343,8,279,1203,6717,0.315319338990621,0,0,599,1687,50,1173,19,504,12,19
"631","2020-03-31",342,8,245,1205,6717,0.315319338990621,0,0,599,1687,56,1229,52,556,23,52
"632","2020-04-01",348,8,252,1194,6717,0.315319338990621,0,0,599,1687,86,1315,54,610,23,54
"633","2020-04-02",336,8,240,1215,6717,0.315319338990621,0,0,599,1687,63,1378,29,639,11,29
"634","2020-04-03",325,8,251,1237,6717,0.315319338990621,0,0,599,1687,62,1440,20,659,11,20
"635","2020-04-04",324,8,261,1226,6717,0.315319338990621,0,0,599,1687,67,1507,25,684,12,25
"636","2020-04-05",329,8,255,1223,6717,0.315319338990621,0,0,599,1687,73,1580,14,698,16,14
"637","2020-04-06",333,8,264,1213,6717,0.315319338990621,0,0,599,1687,74,1654,28,726,19,28
"638","2020-04-07",334,8,266,1182,6717,0.315319338990621,0,0,599,1687,81,1735,57,783,15,57
"639","2020-04-08",329,8,262,1195,6717,0.315319338990621,0,0,599,1687,61,1796,30,813,6,30
"640","2020-04-09",338,8,277,1189,6717,0.315319338990621,0,0,599,1687,67,1863,26,839,17,26
"641","2020-04-10",342,8,304,1170,6717,0.315319338990621,0,0,599,1687,65,1928,45,884,14,45
"642","2020-04-11",332,8,313,1175,6717,0.315319338990621,0,0,599,1687,79,2007,54,938,10,54
"643","2020-04-12",311,8,329,1165,6717,0.315319338990621,0,0,599,1687,65,2072,54,992,11,54
"644","2020-04-13",307,8,342,1121,6717,0.315319338990621,0,0,599,1687,72,2144,36,1028,17,36
"645","2020-04-14",305,8,342,1101,6717,0.315319338990621,0,0,599,1687,63,2207,74,1102,14,74
"646","2020-04-15",301,8,334,1084,6717,0.315319338990621,0,0,599,1687,54,2261,55,1157,7,55
"647","2020-04-16",288,8,319,1065,6717,0.315319338990621,0,0,599,1687,69,2330,23,1180,8,23
"648","2020-04-17",286,8,303,1055,6717,0.315319338990621,0,0,599,1687,62,2392,22,1202,8,22
"649","2020-04-18",284,8,286,1039,6717,0.315319338990621,0,0,599,1687,58,2450,39,1241,7,39
"650","2020-04-19",284,8,307,1008,6717,0.315319338990621,0,0,599,1687,76,2526,40,1281,10,40
"651","2020-04-20",268,8,315,983,6717,0.315319338990621,0,0,599,1687,63,2589,33,1314,9,33
"652","2020-04-21",267,8,330,960,6717,0.315319338990621,0,0,599,1687,68,2657,14,1328,7,14
"653","2020-04-22",266,8,324,928,6717,0.315319338990621,0,0,599,1687,71,2728,23,1351,13,23
"654","2020-04-23",272,8,320,909,6717,0.315319338990621,0,0,599,1687,55,2783,50,1401,13,50
"655","2020-04-24",260,8,375,898,6717,0.315319338990621,0,0,599,1687,66,2849,28,1429,11,28
"656","2020-04-25",246,8,357,891,6717,0.315319338990621,0,0,599,1687,53,2902,54,1483,6,54
"657","2020-04-26",243,8,354,873,6717,0.315319338990621,0,0,599,1687,57,2959,37,1520,1,37
"658","2020-04-27",231,8,334,846,6717,0.315319338990621,0,0,599,1687,50,3009,66,1586,11,66
"659","2020-04-28",217,8,332,842,6717,0.315319338990621,0,0,599,1687,60,3069,40,1626,10,40
"660","2020-04-29",205,8,311,820,6717,0.315319338990621,0,0,599,1687,67,3136,24,1650,9,24
"661","2020-04-30",211,8,295,784,6717,0.315319338990621,0,0,599,1687,47,3183,19,1669,6,19
"662","2020-05-01",216,8,310,774,6717,0.315319338990621,0,0,599,1687,58,3241,15,1684,10,15
"663","2020-05-02",212,8,310,777,6717,0.315319338990621,0,0,599,1687,62,3303,17,1701,7,17
"664","2020-05-03",200,8,317,765,6717,0.315319338990621,0,0,599,1687,61,3364,57,1758,13,57
"665","2020-05-04",201,8,365,745,6717,0.315319338990621,0,0,599,1687,53,3417,47,1805,11,47
"666","2020-05-05",212,8,377,733,6717,0.315319338990621,0,0,599,1687,54,3471,22,1827,9,22
"667","2020-05-06",217,8,361,713,6717,0.315319338990621,0,0,599,1687,48,3519,67,1894,6,67
"668","2020-05-07",202,8,334,699,6717,0.315319338990621,0,0,599,1687,73,3592,41,1935,9,41
"669","2020-05-08",190,8,310,701,6717,0.315319338990621,0,0,599,1687,51,3643,24,1959,11,24
"670","2020-05-09",206,8,314,696,6717,0.315319338990621,0,0,599,1687,50,3693,10,1969,7,10
"671","2020-05-10",208,8,323,685,6717,0.315319338990621,0,0,599,1687,55,3748,41,2010,9,41
"672","2020-05-11",197,8,306,663,6717,0.315319338990621,0,0,599,1687,43,3791,51,2061,6,51
"673","2020-05-12",185,8,314,634,6717,0.315319338990621,0,0,599,1687,55,3846,29,2090,10,29
"674","2020-05-13",183,8,298,615,6717,0.315319338990621,0,0,599,1687,45,3891,43,2133,6,43
"675","2020-05-14",174,8,311,602,6717,0.315319338990621,0,0,599,1687,37,3928,32,2165,3,32
"676","2020-05-15",173,8,329,596,6717,0.315319338990621,0,0,599,1687,38,3966,44,2209,3,44
"677","2020-05-16",157,8,353,583,6717,0.315319338990621,0,0,599,1687,36,4002,31,2240,6,31
"678","2020-05-17",156,8,358,583,6717,0.315319338990621,0,0,599,1687,36,4038,23,2263,2,23
"679","2020-05-18",164,8,363,561,6717,0.315319338990621,0,0,599,1687,45,4083,31,2294,8,31
"680","2020-05-19",165,8,366,544,6717,0.315319338990621,0,0,599,1687,33,4116,37,2331,8,37
"681","2020-05-20",158,8,389,512,6717,0.315319338990621,0,0,599,1687,38,4154,35,2366,9,35
"682","2020-05-21",155,8,375,493,6717,0.315319338990621,0,0,599,1687,36,4190,19,2385,9,19
"683","2020-05-22",151,8,381,450,6717,0.315319338990621,0,0,599,1687,31,4221,14,2399,6,14
"684","2020-05-23",141,8,368,422,6717,0.315319338990621,0,0,599,1687,37,4258,47,2446,6,47
"685","2020-05-24",136,8,350,407,6717,0.315319338990621,0,0,599,1687,22,4280,41,2487,5,41
"686","2020-05-25",128,8,345,380,6717,0.315319338990621,0,0,599,1687,25,4305,28,2515,6,28
"687","2020-05-26",125,8,326,361,6717,0.315319338990621,0,0,599,1687,17,4322,14,2529,NA,14
"688","2020-05-27",111,8,317,346,6717,0.315319338990621,0,0,599,1687,21,4343,15,2544,NA,15
"689","2020-05-28",107,8,316,335,6717,0.315319338990621,0,0,599,1687,29,4372,27,2571,6,27
"690","2020-05-29",98,8,313,322,6717,0.315319338990621,0,0,599,1687,28,4400,17,2588,5,17
"691","2020-05-30",99,8,307,305,6717,0.315319338990621,0,0,599,1687,20,4420,11,2599,NA,11
"692","2020-05-31",90,8,307,284,6717,0.315319338990621,0,0,599,1687,22,4442,8,2607,5,8
"693","2020-06-01",82,8,336,277,6717,0.315319338990621,0,0,599,1687,23,4465,51,2658,6,51
"694","2020-06-02",73,8,314,271,6717,0.315319338990621,0,0,599,1687,23,4488,50,2708,1,50
"695","2020-06-03",72,8,332,242,6717,0.315319338990621,0,0,599,1687,28,4516,39,2747,6,39
"696","2020-06-04",77,8,326,232,6717,0.315319338990621,0,0,599,1687,20,4536,45,2792,4,45
"697","2020-06-05",73,8,331,238,6717,0.315319338990621,0,0,599,1687,20,4556,24,2816,3,24
"698","2020-06-06",63,8,318,230,6717,0.315319338990621,0,0,599,1687,17,4573,25,2841,5,25
"699","2020-06-07",62,8,315,215,6717,0.315319338990621,0,0,599,1687,22,4595,24,2865,6,24
"700","2020-03-13",1,9,149,75,7805,0.939910313901345,0,0,779,1212,17,44,22,134,12,22
"701","2020-03-14",2,9,160,115,7805,0.939910313901345,0,0,779,1212,18,62,9,143,9,9
"702","2020-03-15",7,9,142,154,7805,0.939910313901345,0,0,779,1212,23,85,6,149,17,6
"703","2020-03-16",10,9,122,208,7805,0.939910313901345,0,0,779,1212,33,118,9,158,22,9
"704","2020-03-17",14,9,126,291,7805,0.939910313901345,0,0,779,1212,25,143,16,174,14,16
"705","2020-03-18",26,9,128,378,7805,0.939910313901345,0,0,779,1212,32,175,78,252,24,78
"706","2020-03-19",32,9,191,469,7805,0.939910313901345,0,0,779,1212,45,220,74,326,37,74
"707","2020-03-20",38,9,211,616,7805,0.939910313901345,0,0,779,1212,42,262,33,359,31,33
"708","2020-03-21",61,9,220,777,7805,0.939910313901345,0,0,779,1212,46,308,13,372,34,13
"709","2020-03-22",82,9,230,955,7805,0.939910313901345,0,0,779,1212,59,367,14,386,46,14
"710","2020-03-23",115,9,211,1157,7805,0.939910313901345,0,0,779,1212,62,429,12,398,45,12
"711","2020-03-24",146,9,183,1433,7805,0.939910313901345,0,0,779,1212,70,499,14,412,62,14
"712","2020-03-25",183,9,173,1698,7805,0.939910313901345,0,0,779,1212,70,569,13,425,59,13
"713","2020-03-26",254,9,190,2026,7805,0.939910313901345,0,0,779,1212,63,632,15,440,49,15
"714","2020-03-27",312,9,206,2305,7805,0.939910313901345,0,0,779,1212,94,726,62,502,86,62
"715","2020-03-28",392,9,190,2733,7805,0.939910313901345,0,0,779,1212,88,814,66,568,78,66
"716","2020-03-29",461,9,186,2978,7805,0.939910313901345,0,0,779,1212,58,872,16,584,49,16
"717","2020-03-30",537,9,166,3272,7805,0.939910313901345,0,0,779,1212,96,968,19,603,80,19
"718","2020-03-31",640,9,208,3507,7805,0.939910313901345,0,0,779,1212,107,1075,31,634,90,31
"719","2020-04-01",732,9,210,3785,7805,0.939910313901345,0,0,779,1212,118,1193,31,665,110,31
"720","2020-04-02",799,9,246,3918,7805,0.939910313901345,0,0,779,1212,113,1306,19,684,98,19
"721","2020-04-03",911,9,243,3962,7805,0.939910313901345,0,0,779,1212,95,1401,16,700,83,16
"722","2020-04-04",979,9,211,3985,7805,0.939910313901345,0,0,779,1212,95,1496,9,709,89,9
"723","2020-04-05",1062,9,186,3901,7805,0.939910313901345,0,0,779,1212,108,1604,12,721,91,12
"724","2020-04-06",1103,9,184,3815,7805,0.939910313901345,0,0,779,1212,96,1700,17,738,86,17
"725","2020-04-07",1108,9,219,3681,7805,0.939910313901345,0,0,779,1212,117,1817,14,752,107,14
"726","2020-04-08",1103,9,255,3491,7805,0.939910313901345,0,0,779,1212,104,1921,88,840,98,88
"727","2020-04-09",1090,9,242,3261,7805,0.939910313901345,0,0,779,1212,116,2037,76,916,109,76
"728","2020-04-10",1072,9,205,2983,7805,0.939910313901345,0,0,779,1212,115,2152,42,958,104,42
"729","2020-04-11",1010,9,192,2676,7805,0.939910313901345,0,0,779,1212,96,2248,38,996,80,38
"730","2020-04-12",948,9,184,2411,7805,0.939910313901345,0,0,779,1212,71,2319,18,1014,63,18
"731","2020-04-13",898,9,183,2100,7805,0.939910313901345,0,0,779,1212,95,2414,22,1036,84,22
"732","2020-04-14",835,9,174,1808,7805,0.939910313901345,0,0,779,1212,80,2494,20,1056,70,20
"733","2020-04-15",770,9,163,1574,7805,0.939910313901345,0,0,779,1212,115,2609,10,1066,100,10
"734","2020-04-16",700,9,158,1346,7805,0.939910313901345,0,0,779,1212,106,2715,14,1080,93,14
"735","2020-04-17",606,9,148,1125,7805,0.939910313901345,0,0,779,1212,111,2826,9,1089,99,9
"736","2020-04-18",546,9,151,969,7805,0.939910313901345,0,0,779,1212,97,2923,33,1122,85,33
"737","2020-04-19",472,9,187,822,7805,0.939910313901345,0,0,779,1212,80,3003,80,1202,71,80
"738","2020-04-20",397,9,204,667,7805,0.939910313901345,0,0,779,1212,84,3087,56,1258,72,56
"739","2020-04-21",348,9,207,552,7805,0.939910313901345,0,0,779,1212,84,3171,70,1328,76,70
"740","2020-04-22",291,9,188,436,7805,0.939910313901345,0,0,779,1212,91,3262,33,1361,81,33
"741","2020-04-23",240,9,186,355,7805,0.939910313901345,0,0,779,1212,83,3345,52,1413,70,52
"742","2020-04-24",189,9,261,298,7805,0.939910313901345,0,0,779,1212,106,3451,31,1444,90,31
"743","2020-04-25",153,9,257,253,7805,0.939910313901345,0,0,779,1212,92,3543,26,1470,77,26
"744","2020-04-26",118,9,279,205,7805,0.939910313901345,0,0,779,1212,72,3615,29,1499,63,29
"745","2020-04-27",98,9,277,173,7805,0.939910313901345,0,0,779,1212,76,3691,21,1520,67,21
"746","2020-04-28",69,9,260,153,7805,0.939910313901345,0,0,779,1212,64,3755,18,1538,53,18
"747","2020-04-29",61,9,236,133,7805,0.939910313901345,0,0,779,1212,65,3820,15,1553,52,15
"748","2020-04-30",58,9,231,113,7805,0.939910313901345,0,0,779,1212,42,3862,14,1567,39,14
"749","2020-05-01",50,9,196,104,7805,0.939910313901345,0,0,779,1212,58,3920,9,1576,46,9
"750","2020-05-02",38,9,182,99,7805,0.939910313901345,0,0,779,1212,60,3980,14,1590,54,14
"751","2020-05-03",36,9,191,96,7805,0.939910313901345,0,0,779,1212,51,4031,7,1597,46,7
"752","2020-05-04",31,9,208,88,7805,0.939910313901345,0,0,779,1212,53,4084,9,1606,50,9
"753","2020-05-05",33,9,278,80,7805,0.939910313901345,0,0,779,1212,44,4128,16,1622,35,16
"754","2020-05-06",32,9,265,80,7805,0.939910313901345,0,0,779,1212,51,4179,42,1664,43,42
"755","2020-05-07",26,9,227,71,7805,0.939910313901345,0,0,779,1212,50,4229,29,1693,42,29
"756","2020-05-08",21,9,222,65,7805,0.939910313901345,0,0,779,1212,48,4277,25,1718,40,25
"757","2020-05-09",23,9,202,68,7805,0.939910313901345,0,0,779,1212,47,4324,21,1739,37,21
"758","2020-05-10",21,9,210,67,7805,0.939910313901345,0,0,779,1212,42,4366,13,1752,31,13
"759","2020-05-11",18,9,237,63,7805,0.939910313901345,0,0,779,1212,45,4411,14,1766,38,14
"760","2020-05-12",18,9,234,65,7805,0.939910313901345,0,0,779,1212,35,4446,15,1781,31,15
"761","2020-05-13",16,9,239,66,7805,0.939910313901345,0,0,779,1212,25,4471,13,1794,17,13
"762","2020-05-14",20,9,270,56,7805,0.939910313901345,0,0,779,1212,33,4504,21,1815,20,21
"763","2020-05-15",21,9,257,57,7805,0.939910313901345,0,0,779,1212,21,4525,37,1852,19,37
"764","2020-05-16",20,9,258,59,7805,0.939910313901345,0,0,779,1212,30,4555,24,1876,22,24
"765","2020-05-17",17,9,273,55,7805,0.939910313901345,0,0,779,1212,21,4576,33,1909,17,33
"766","2020-05-18",20,9,289,52,7805,0.939910313901345,0,0,779,1212,25,4601,60,1969,19,60
"767","2020-05-19",19,9,290,50,7805,0.939910313901345,0,0,779,1212,34,4635,17,1986,28,17
"768","2020-05-20",19,9,320,49,7805,0.939910313901345,0,0,779,1212,28,4663,8,1994,20,8
"769","2020-05-21",17,9,288,46,7805,0.939910313901345,0,0,779,1212,27,4690,12,2006,22,12
"770","2020-05-22",17,9,268,45,7805,0.939910313901345,0,0,779,1212,25,4715,46,2052,17,46
"771","2020-05-23",16,9,251,44,7805,0.939910313901345,0,0,779,1212,29,4744,45,2097,23,45
"772","2020-05-24",16,9,232,43,7805,0.939910313901345,0,0,779,1212,18,4762,31,2128,14,31
"773","2020-05-25",17,9,223,39,7805,0.939910313901345,0,0,779,1212,27,4789,22,2150,17,22
"774","2020-05-26",15,9,225,36,7805,0.939910313901345,0,0,779,1212,28,4817,35,2185,19,35
"775","2020-05-27",15,9,254,34,7805,0.939910313901345,0,0,779,1212,19,4836,20,2205,16,20
"776","2020-05-28",14,9,227,36,7805,0.939910313901345,0,0,779,1212,18,4854,12,2217,16,12
"777","2020-05-29",12,9,204,35,7805,0.939910313901345,0,0,779,1212,21,4875,14,2231,17,14
"778","2020-05-30",11,9,190,36,7805,0.939910313901345,0,0,779,1212,20,4895,48,2279,15,48
"779","2020-05-31",11,9,187,33,7805,0.939910313901345,0,0,779,1212,23,4918,28,2307,18,28
"780","2020-06-01",8,9,209,32,7805,0.939910313901345,0,0,779,1212,19,4937,17,2324,13,17
"781","2020-06-02",8,9,229,29,7805,0.939910313901345,0,0,779,1212,24,4961,24,2348,21,24
"782","2020-06-03",7,9,213,28,7805,0.939910313901345,0,0,779,1212,15,4976,23,2371,14,23
"783","2020-06-04",5,9,199,26,7805,0.939910313901345,0,0,779,1212,13,4989,42,2413,8,42
"784","2020-06-05",6,9,186,27,7805,0.939910313901345,0,0,779,1212,24,5013,22,2435,20,22
"785","2020-06-06",6,9,182,23,7805,0.939910313901345,0,0,779,1212,17,5030,27,2462,13,27
"786","2020-06-07",7,9,195,20,7805,0.939910313901345,0,0,779,1212,15,5045,18,2480,12,18
"787","2020-03-15",5,10,173,83,2591,0.43921265920494,0,0,269,1463,67,257,7,26,27,7
"788","2020-03-16",9,10,190,109,2591,0.43921265920494,0,0,269,1463,70,327,23,49,30,23
"789","2020-03-17",13,10,187,126,2591,0.43921265920494,0,0,269,1463,85,412,10,59,43,10
"790","2020-03-18",17,10,215,155,2591,0.43921265920494,0,0,269,1463,83,495,42,101,41,42
"791","2020-03-19",22,10,211,172,2591,0.43921265920494,0,0,269,1463,100,595,44,145,51,44
"792","2020-03-20",32,10,188,191,2591,0.43921265920494,0,0,269,1463,91,686,22,167,56,22
"793","2020-03-21",38,10,185,207,2591,0.43921265920494,0,0,269,1463,125,811,40,207,85,40
"794","2020-03-22",44,10,190,217,2591,0.43921265920494,0,0,269,1463,118,929,44,251,75,44
"795","2020-03-23",46,10,177,224,2591,0.43921265920494,0,0,269,1463,100,1029,26,277,49,26
"796","2020-03-24",49,10,145,228,2591,0.43921265920494,0,0,269,1463,97,1126,12,289,54,12
"797","2020-03-25",57,10,147,237,2591,0.43921265920494,0,0,269,1463,96,1222,22,311,56,22
"798","2020-03-26",61,10,164,250,2591,0.43921265920494,0,0,269,1463,111,1333,18,329,67,18
"799","2020-03-27",59,10,191,261,2591,0.43921265920494,0,0,269,1463,117,1450,16,345,78,16
"800","2020-03-28",62,10,218,277,2591,0.43921265920494,0,0,269,1463,104,1554,22,367,65,22
"801","2020-03-29",60,10,259,289,2591,0.43921265920494,0,0,269,1463,100,1654,18,385,60,18
"802","2020-03-30",68,10,242,304,2591,0.43921265920494,0,0,269,1463,107,1761,22,407,68,22
"803","2020-03-31",72,10,221,317,2591,0.43921265920494,0,0,269,1463,121,1882,20,427,68,20
"804","2020-04-01",73,10,195,329,2591,0.43921265920494,0,0,269,1463,138,2020,43,470,101,43
"805","2020-04-02",75,10,183,333,2591,0.43921265920494,0,0,269,1463,144,2164,53,523,93,53
"806","2020-04-03",79,10,168,344,2591,0.43921265920494,0,0,269,1463,101,2265,53,576,63,53
"807","2020-04-04",87,10,206,360,2591,0.43921265920494,0,0,269,1463,110,2375,61,637,65,61
"808","2020-04-05",91,10,246,370,2591,0.43921265920494,0,0,269,1463,105,2480,27,664,65,27
"809","2020-04-06",94,10,249,380,2591,0.43921265920494,0,0,269,1463,98,2578,19,683,70,19
"810","2020-04-07",101,10,243,377,2591,0.43921265920494,0,0,269,1463,100,2678,49,732,71,49
"811","2020-04-08",101,10,234,364,2591,0.43921265920494,0,0,269,1463,93,2771,65,797,52,65
"812","2020-04-09",101,10,217,371,2591,0.43921265920494,0,0,269,1463,88,2859,55,852,53,55
"813","2020-04-10",111,10,210,369,2591,0.43921265920494,0,0,269,1463,94,2953,54,906,54,54
"814","2020-04-11",114,10,254,386,2591,0.43921265920494,0,0,269,1463,94,3047,34,940,61,34
"815","2020-04-12",114,10,254,366,2591,0.43921265920494,0,0,269,1463,84,3131,24,964,51,24
"816","2020-04-13",113,10,220,378,2591,0.43921265920494,0,0,269,1463,89,3220,26,990,54,26
"817","2020-04-14",114,10,259,371,2591,0.43921265920494,0,0,269,1463,90,3310,16,1006,57,16
"818","2020-04-15",118,10,240,370,2591,0.43921265920494,0,0,269,1463,92,3402,16,1022,50,16
"819","2020-04-16",116,10,213,365,2591,0.43921265920494,0,0,269,1463,87,3489,14,1036,51,14
"820","2020-04-17",106,10,200,354,2591,0.43921265920494,0,0,269,1463,109,3598,72,1108,53,72
"821","2020-04-18",99,10,185,355,2591,0.43921265920494,0,0,269,1463,75,3673,40,1148,39,40
"822","2020-04-19",101,10,170,358,2591,0.43921265920494,0,0,269,1463,68,3741,22,1170,36,22
"823","2020-04-20",94,10,211,359,2591,0.43921265920494,0,0,269,1463,94,3835,11,1181,46,11
"824","2020-04-21",90,10,224,357,2591,0.43921265920494,0,0,269,1463,90,3925,21,1202,52,21
"825","2020-04-22",90,10,205,362,2591,0.43921265920494,0,0,269,1463,79,4004,10,1212,43,10
"826","2020-04-23",97,10,198,360,2591,0.43921265920494,0,0,269,1463,59,4063,7,1219,35,7
"827","2020-04-24",98,10,184,356,2591,0.43921265920494,0,0,269,1463,85,4148,9,1228,52,9
"828","2020-04-25",107,10,171,356,2591,0.43921265920494,0,0,269,1463,84,4232,9,1237,46,9
"829","2020-04-26",113,10,230,363,2591,0.43921265920494,0,0,269,1463,68,4300,17,1254,32,17
"830","2020-04-27",118,10,236,365,2591,0.43921265920494,0,0,269,1463,59,4359,56,1310,34,56
"831","2020-04-28",114,10,225,368,2591,0.43921265920494,0,0,269,1463,69,4428,51,1361,32,51
"832","2020-04-29",115,10,236,372,2591,0.43921265920494,0,0,269,1463,84,4512,38,1399,47,38
"833","2020-04-30",112,10,265,380,2591,0.43921265920494,0,0,269,1463,55,4567,55,1454,27,55
"834","2020-05-01",112,10,268,378,2591,0.43921265920494,0,0,269,1463,51,4618,59,1513,28,59
"835","2020-05-02",105,10,271,376,2591,0.43921265920494,0,0,269,1463,63,4681,49,1562,28,49
"836","2020-05-03",99,10,251,367,2591,0.43921265920494,0,0,269,1463,46,4727,39,1601,22,39
"837","2020-05-04",105,10,236,365,2591,0.43921265920494,0,0,269,1463,59,4786,29,1630,16,29
"838","2020-05-05",104,10,216,355,2591,0.43921265920494,0,0,269,1463,58,4844,26,1656,26,26
"839","2020-05-06",100,10,198,360,2591,0.43921265920494,0,0,269,1463,53,4897,36,1692,17,36
"840","2020-05-07",98,10,198,371,2591,0.43921265920494,0,0,269,1463,50,4947,50,1742,29,50
"841","2020-05-08",96,10,191,359,2591,0.43921265920494,0,0,269,1463,37,4984,32,1774,18,32
"842","2020-05-09",99,10,173,367,2591,0.43921265920494,0,0,269,1463,35,5019,15,1789,13,15
"843","2020-05-10",99,10,229,375,2591,0.43921265920494,0,0,269,1463,39,5058,18,1807,14,18
"844","2020-05-11",92,10,232,379,2591,0.43921265920494,0,0,269,1463,45,5103,17,1824,22,17
"845","2020-05-12",103,10,264,364,2591,0.43921265920494,0,0,269,1463,27,5130,60,1884,8,60
"846","2020-05-13",101,10,290,363,2591,0.43921265920494,0,0,269,1463,39,5169,22,1906,15,22
"847","2020-05-14",107,10,260,354,2591,0.43921265920494,0,0,269,1463,27,5196,15,1921,14,15
"848","2020-05-15",107,10,237,350,2591,0.43921265920494,0,0,269,1463,35,5231,11,1932,15,11
"849","2020-05-16",105,10,258,348,2591,0.43921265920494,0,0,269,1463,40,5271,19,1951,19,19
"850","2020-05-17",105,10,299,343,2591,0.43921265920494,0,0,269,1463,40,5311,9,1960,19,9
"851","2020-05-18",103,10,272,330,2591,0.43921265920494,0,0,269,1463,31,5342,12,1972,9,12
"852","2020-05-19",102,10,242,326,2591,0.43921265920494,0,0,269,1463,31,5373,5,1977,12,5
"853","2020-05-20",104,10,202,321,2591,0.43921265920494,0,0,269,1463,30,5403,2,1979,13,2
"854","2020-05-21",97,10,199,299,2591,0.43921265920494,0,0,269,1463,28,5431,4,1983,13,4
"855","2020-05-22",95,10,187,280,2591,0.43921265920494,0,0,269,1463,26,5457,8,1991,10,8
"856","2020-05-23",93,10,204,262,2591,0.43921265920494,0,0,269,1463,25,5482,4,1995,11,4
"857","2020-05-24",88,10,215,255,2591,0.43921265920494,0,0,269,1463,23,5505,6,2001,10,6
"858","2020-05-25",85,10,217,233,2591,0.43921265920494,0,0,269,1463,27,5532,11,2012,10,11
"859","2020-05-26",76,10,236,241,2591,0.43921265920494,0,0,269,1463,23,5555,7,2019,9,7
"860","2020-05-27",72,10,256,241,2591,0.43921265920494,0,0,269,1463,22,5577,3,2022,12,3
"861","2020-05-28",71,10,249,236,2591,0.43921265920494,0,0,269,1463,26,5603,10,2032,14,10
"862","2020-05-29",71,10,212,243,2591,0.43921265920494,0,0,269,1463,24,5627,9,2041,12,9
"863","2020-05-30",69,10,184,246,2591,0.43921265920494,0,0,269,1463,16,5643,40,2081,8,40
"864","2020-05-31",73,10,163,238,2591,0.43921265920494,0,0,269,1463,19,5662,35,2116,5,35
"865","2020-06-01",79,10,167,236,2591,0.43921265920494,0,0,269,1463,18,5680,46,2162,9,46
"866","2020-06-02",77,10,167,247,2591,0.43921265920494,0,0,269,1463,25,5705,20,2182,13,20
"867","2020-06-03",76,10,186,260,2591,0.43921265920494,0,0,269,1463,17,5722,41,2223,7,41
"868","2020-06-04",84,10,159,261,2591,0.43921265920494,0,0,269,1463,25,5747,53,2276,12,53
"869","2020-06-05",88,10,191,266,2591,0.43921265920494,0,0,269,1463,14,5761,28,2304,3,28
"870","2020-06-06",82,10,174,265,2591,0.43921265920494,0,0,269,1463,7,5768,34,2338,2,34
"871","2020-06-07",83,10,173,264,2591,0.43921265920494,0,0,269,1463,9,5777,23,2361,2,23
"872","2020-03-13",2,11,153,182,5950,0.218319327731092,0,0,498,1151,93,240,74,180,11,74
"873","2020-03-14",4,11,154,236,5950,0.218319327731092,0,0,498,1151,93,333,51,231,20,51
"874","2020-03-15",10,11,146,305,5950,0.218319327731092,0,0,498,1151,105,438,35,266,25,35
"875","2020-03-16",23,11,147,374,5950,0.218319327731092,0,0,498,1151,116,554,65,331,35,65
"876","2020-03-17",39,11,191,435,5950,0.218319327731092,0,0,498,1151,107,661,80,411,41,80
"877","2020-03-18",58,11,190,502,5950,0.218319327731092,0,0,498,1151,99,760,54,465,40,54
"878","2020-03-19",77,11,181,553,5950,0.218319327731092,0,0,498,1151,98,858,42,507,36,42
"879","2020-03-20",95,11,181,592,5950,0.218319327731092,0,0,498,1151,99,957,79,586,34,79
"880","2020-03-21",117,11,222,650,5950,0.218319327731092,0,0,498,1151,112,1069,58,644,52,58
"881","2020-03-22",136,11,247,706,5950,0.218319327731092,0,0,498,1151,108,1177,72,716,49,72
"882","2020-03-23",143,11,261,759,5950,0.218319327731092,0,0,498,1151,111,1288,52,768,48,52
"883","2020-03-24",164,11,245,793,5950,0.218319327731092,0,0,498,1151,114,1402,48,816,45,48
"884","2020-03-25",177,11,228,798,5950,0.218319327731092,0,0,498,1151,148,1550,43,859,75,43
"885","2020-03-26",195,11,281,810,5950,0.218319327731092,0,0,498,1151,122,1672,33,892,51,33
"886","2020-03-27",207,11,314,810,5950,0.218319327731092,0,0,498,1151,138,1810,53,945,61,53
"887","2020-03-28",209,11,289,821,5950,0.218319327731092,0,0,498,1151,110,1920,51,996,47,51
"888","2020-03-29",221,11,266,833,5950,0.218319327731092,0,0,498,1151,128,2048,36,1032,57,36
"889","2020-03-30",234,11,278,843,5950,0.218319327731092,0,0,498,1151,109,2157,55,1087,54,55
"890","2020-03-31",225,11,277,842,5950,0.218319327731092,0,0,498,1151,117,2274,38,1125,53,38
"891","2020-04-01",232,11,298,849,5950,0.218319327731092,0,0,498,1151,131,2405,57,1182,51,57
"892","2020-04-02",224,11,316,852,5950,0.218319327731092,0,0,498,1151,123,2528,54,1236,48,54
"893","2020-04-03",222,11,278,859,5950,0.218319327731092,0,0,498,1151,111,2639,36,1272,42,36
"894","2020-04-04",223,11,258,869,5950,0.218319327731092,0,0,498,1151,127,2766,57,1329,49,57
"895","2020-04-05",213,11,233,857,5950,0.218319327731092,0,0,498,1151,105,2871,59,1388,40,59
"896","2020-04-06",214,11,220,878,5950,0.218319327731092,0,0,498,1151,120,2991,66,1454,54,66
"897","2020-04-07",212,11,203,885,5950,0.218319327731092,0,0,498,1151,104,3095,47,1501,46,47
"898","2020-04-08",214,11,200,913,5950,0.218319327731092,0,0,498,1151,96,3191,39,1540,33,39
"899","2020-04-09",219,11,195,932,5950,0.218319327731092,0,0,498,1151,112,3303,56,1596,35,56
"900","2020-04-10",236,11,201,911,5950,0.218319327731092,0,0,498,1151,103,3406,34,1630,39,34
"901","2020-04-11",244,11,205,918,5950,0.218319327731092,0,0,498,1151,107,3513,43,1673,34,43
"902","2020-04-12",253,11,231,913,5950,0.218319327731092,0,0,498,1151,95,3608,46,1719,34,46
"903","2020-04-13",252,11,235,923,5950,0.218319327731092,0,0,498,1151,92,3700,32,1751,32,32
"904","2020-04-14",262,11,267,918,5950,0.218319327731092,0,0,498,1151,98,3798,32,1783,29,32
"905","2020-04-15",254,11,278,932,5950,0.218319327731092,0,0,498,1151,90,3888,32,1815,28,32
"906","2020-04-16",244,11,297,925,5950,0.218319327731092,0,0,498,1151,83,3971,28,1843,33,28
"907","2020-04-17",236,11,280,929,5950,0.218319327731092,0,0,498,1151,99,4070,33,1876,36,33
"908","2020-04-18",240,11,250,931,5950,0.218319327731092,0,0,498,1151,66,4136,38,1914,18,38
"909","2020-04-19",246,11,281,911,5950,0.218319327731092,0,0,498,1151,98,4234,31,1945,35,31
"910","2020-04-20",244,11,293,904,5950,0.218319327731092,0,0,498,1151,72,4306,31,1976,26,31
"911","2020-04-21",250,11,273,916,5950,0.218319327731092,0,0,498,1151,91,4397,36,2012,23,36
"912","2020-04-22",248,11,271,919,5950,0.218319327731092,0,0,498,1151,88,4485,52,2064,30,52
"913","2020-04-23",259,11,281,915,5950,0.218319327731092,0,0,498,1151,82,4567,36,2100,21,36
"914","2020-04-24",264,11,262,918,5950,0.218319327731092,0,0,498,1151,76,4643,33,2133,18,33
"915","2020-04-25",253,11,246,921,5950,0.218319327731092,0,0,498,1151,70,4713,37,2170,24,37
"916","2020-04-26",248,11,239,921,5950,0.218319327731092,0,0,498,1151,75,4788,34,2204,27,34
"917","2020-04-27",257,11,281,904,5950,0.218319327731092,0,0,498,1151,78,4866,34,2238,21,34
"918","2020-04-28",242,11,249,892,5950,0.218319327731092,0,0,498,1151,66,4932,40,2278,18,40
"919","2020-04-29",244,11,215,858,5950,0.218319327731092,0,0,498,1151,71,5003,44,2322,16,44
"920","2020-04-30",242,11,211,837,5950,0.218319327731092,0,0,498,1151,63,5066,29,2351,21,29
"921","2020-05-01",230,11,219,820,5950,0.218319327731092,0,0,498,1151,55,5121,52,2403,21,52
"922","2020-05-02",225,11,215,806,5950,0.218319327731092,0,0,498,1151,53,5174,34,2437,18,34
"923","2020-05-03",225,11,212,797,5950,0.218319327731092,0,0,498,1151,53,5227,29,2466,12,29
"924","2020-05-04",218,11,210,781,5950,0.218319327731092,0,0,498,1151,67,5294,37,2503,19,37
"925","2020-05-05",225,11,197,758,5950,0.218319327731092,0,0,498,1151,61,5355,44,2547,18,44
"926","2020-05-06",229,11,176,738,5950,0.218319327731092,0,0,498,1151,56,5411,41,2588,9,41
"927","2020-05-07",228,11,165,711,5950,0.218319327731092,0,0,498,1151,62,5473,32,2620,14,32
"928","2020-05-08",223,11,192,705,5950,0.218319327731092,0,0,498,1151,60,5533,34,2654,13,34
"929","2020-05-09",233,11,260,702,5950,0.218319327731092,0,0,498,1151,47,5580,46,2700,13,46
"930","2020-05-10",233,11,287,689,5950,0.218319327731092,0,0,498,1151,41,5621,38,2738,9,38
"931","2020-05-11",229,11,270,670,5950,0.218319327731092,0,0,498,1151,49,5670,38,2776,12,38
"932","2020-05-12",216,11,242,659,5950,0.218319327731092,0,0,498,1151,36,5706,32,2808,10,32
"933","2020-05-13",203,11,217,626,5950,0.218319327731092,0,0,498,1151,50,5756,34,2842,7,34
"934","2020-05-14",189,11,266,591,5950,0.218319327731092,0,0,498,1151,46,5802,26,2868,11,26
"935","2020-05-15",180,11,290,575,5950,0.218319327731092,0,0,498,1151,43,5845,30,2898,11,30
"936","2020-05-16",167,11,288,548,5950,0.218319327731092,0,0,498,1151,23,5868,36,2934,5,36
"937","2020-05-17",155,11,290,537,5950,0.218319327731092,0,0,498,1151,45,5913,35,2969,12,35
"938","2020-05-18",142,11,309,515,5950,0.218319327731092,0,0,498,1151,34,5947,41,3010,10,41
"939","2020-05-19",140,11,291,487,5950,0.218319327731092,0,0,498,1151,40,5987,32,3042,7,32
"940","2020-05-20",139,11,292,482,5950,0.218319327731092,0,0,498,1151,39,6026,43,3085,9,43
"941","2020-05-21",142,11,287,477,5950,0.218319327731092,0,0,498,1151,30,6056,45,3130,13,45
"942","2020-05-22",144,11,279,466,5950,0.218319327731092,0,0,498,1151,27,6083,33,3163,7,33
"943","2020-05-23",147,11,258,455,5950,0.218319327731092,0,0,498,1151,21,6104,36,3199,4,36
"944","2020-05-24",135,11,244,441,5950,0.218319327731092,0,0,498,1151,28,6132,35,3234,4,35
"945","2020-05-25",139,11,231,419,5950,0.218319327731092,0,0,498,1151,19,6151,44,3278,1,44
"946","2020-05-26",141,11,207,413,5950,0.218319327731092,0,0,498,1151,27,6178,30,3308,6,30
"947","2020-05-27",134,11,188,390,5950,0.218319327731092,0,0,498,1151,25,6203,42,3350,3,42
"948","2020-05-28",126,11,210,375,5950,0.218319327731092,0,0,498,1151,23,6226,44,3394,8,44
"949","2020-05-29",120,11,191,356,5950,0.218319327731092,0,0,498,1151,16,6242,42,3436,2,42
"950","2020-05-30",114,11,182,335,5950,0.218319327731092,0,0,498,1151,27,6269,44,3480,8,44
"951","2020-05-31",115,11,163,321,5950,0.218319327731092,0,0,498,1151,17,6286,30,3510,6,30
"952","2020-06-01",108,11,163,313,5950,0.218319327731092,0,0,498,1151,12,6298,47,3557,2,47
"953","2020-06-02",95,11,202,305,5950,0.218319327731092,0,0,498,1151,13,6311,36,3593,2,36
"954","2020-06-03",90,11,220,291,5950,0.218319327731092,0,0,498,1151,24,6335,44,3637,8,44
"955","2020-06-04",86,11,210,274,5950,0.218319327731092,0,0,498,1151,8,6343,41,3678,1,41
"956","2020-06-05",82,11,207,271,5950,0.218319327731092,0,0,498,1151,14,6357,52,3730,1,52
"957","2020-06-06",75,11,232,264,5950,0.218319327731092,0,0,498,1151,11,6368,41,3771,1,41
"958","2020-06-07",67,11,249,245,5950,0.218319327731092,0,0,498,1151,10,6378,56,3827,3,56
"959","2020-03-12",1,12,33,135,6656,0.192157451923077,0,0,590,1007,41,79,34,75,6,34
"960","2020-03-13",1,12,47,225,6656,0.192157451923077,0,0,590,1007,37,116,42,117,6,42
"961","2020-03-14",11,12,57,300,6656,0.192157451923077,0,0,590,1007,57,173,27,144,19,27
"962","2020-03-15",27,12,62,368,6656,0.192157451923077,0,0,590,1007,57,230,60,204,30,60
"963","2020-03-16",35,12,87,463,6656,0.192157451923077,0,0,590,1007,65,295,37,241,28,37
"964","2020-03-17",56,12,102,549,6656,0.192157451923077,0,0,590,1007,60,355,36,277,27,36
"965","2020-03-18",79,12,134,634,6656,0.192157451923077,0,0,590,1007,81,436,37,314,54,37
"966","2020-03-19",105,12,171,685,6656,0.192157451923077,0,0,590,1007,78,514,22,336,51,22
"967","2020-03-20",137,12,196,746,6656,0.192157451923077,0,0,590,1007,81,595,14,350,50,14
"968","2020-03-21",164,12,209,810,6656,0.192157451923077,0,0,590,1007,90,685,34,384,48,34
"969","2020-03-22",178,12,244,867,6656,0.192157451923077,0,0,590,1007,101,786,17,401,66,17
"970","2020-03-23",207,12,268,889,6656,0.192157451923077,0,0,590,1007,91,877,19,420,57,19
"971","2020-03-24",220,12,273,928,6656,0.192157451923077,0,0,590,1007,107,984,59,479,79,59
"972","2020-03-25",228,12,266,963,6656,0.192157451923077,0,0,590,1007,94,1078,25,504,64,25
"973","2020-03-26",248,12,243,962,6656,0.192157451923077,0,0,590,1007,101,1179,20,524,62,20
"974","2020-03-27",247,12,231,967,6656,0.192157451923077,0,0,590,1007,133,1312,18,542,88,18
"975","2020-03-28",261,12,223,973,6656,0.192157451923077,0,0,590,1007,113,1425,12,554,74,12
"976","2020-03-29",260,12,217,947,6656,0.192157451923077,0,0,590,1007,110,1535,6,560,76,6
"977","2020-03-30",268,12,219,938,6656,0.192157451923077,0,0,590,1007,101,1636,4,564,60,4
"978","2020-03-31",268,12,236,976,6656,0.192157451923077,0,0,590,1007,128,1764,6,570,82,6
"979","2020-04-01",279,12,229,995,6656,0.192157451923077,0,0,590,1007,103,1867,8,578,72,8
"980","2020-04-02",276,12,229,1003,6656,0.192157451923077,0,0,590,1007,94,1961,69,647,63,69
"981","2020-04-03",275,12,243,1001,6656,0.192157451923077,0,0,590,1007,118,2079,68,715,81,68
"982","2020-04-04",262,12,283,985,6656,0.192157451923077,0,0,590,1007,118,2197,36,751,84,36
"983","2020-04-05",276,12,273,1002,6656,0.192157451923077,0,0,590,1007,98,2295,21,772,61,21
"984","2020-04-06",281,12,283,986,6656,0.192157451923077,0,0,590,1007,105,2400,11,783,79,11
"985","2020-04-07",284,12,295,996,6656,0.192157451923077,0,0,590,1007,92,2492,17,800,70,17
"986","2020-04-08",276,12,289,1008,6656,0.192157451923077,0,0,590,1007,76,2568,53,853,54,53
"987","2020-04-09",261,12,264,1001,6656,0.192157451923077,0,0,590,1007,93,2661,67,920,64,67
"988","2020-04-10",273,12,252,1002,6656,0.192157451923077,0,0,590,1007,113,2774,32,952,76,32
"989","2020-04-11",278,12,244,996,6656,0.192157451923077,0,0,590,1007,107,2881,10,962,63,10
"990","2020-04-12",276,12,231,1005,6656,0.192157451923077,0,0,590,1007,95,2976,22,984,71,22
"991","2020-04-13",251,12,224,1013,6656,0.192157451923077,0,0,590,1007,102,3078,73,1057,70,73
"992","2020-04-14",254,12,262,1020,6656,0.192157451923077,0,0,590,1007,91,3169,46,1103,53,46
"993","2020-04-15",253,12,255,1011,6656,0.192157451923077,0,0,590,1007,82,3251,71,1174,57,71
"994","2020-04-16",254,12,237,1025,6656,0.192157451923077,0,0,590,1007,79,3330,69,1243,52,69
"995","2020-04-17",258,12,215,1006,6656,0.192157451923077,0,0,590,1007,86,3416,72,1315,59,72
"996","2020-04-18",253,12,207,1007,6656,0.192157451923077,0,0,590,1007,75,3491,39,1354,38,39
"997","2020-04-19",252,12,210,1012,6656,0.192157451923077,0,0,590,1007,80,3571,53,1407,53,53
"998","2020-04-20",260,12,238,1005,6656,0.192157451923077,0,0,590,1007,62,3633,28,1435,40,28
"999","2020-04-21",251,12,233,1005,6656,0.192157451923077,0,0,590,1007,62,3695,24,1459,44,24
"1000","2020-04-22",264,12,234,998,6656,0.192157451923077,0,0,590,1007,81,3776,18,1477,48,18
"1001","2020-04-23",266,12,236,1013,6656,0.192157451923077,0,0,590,1007,66,3842,17,1494,37,17
"1002","2020-04-24",260,12,252,998,6656,0.192157451923077,0,0,590,1007,58,3900,53,1547,32,53
"1003","2020-04-25",254,12,253,992,6656,0.192157451923077,0,0,590,1007,59,3959,25,1572,32,25
"1004","2020-04-26",256,12,253,980,6656,0.192157451923077,0,0,590,1007,79,4038,16,1588,52,16
"1005","2020-04-27",257,12,278,995,6656,0.192157451923077,0,0,590,1007,62,4100,15,1603,37,15
"1006","2020-04-28",259,12,265,988,6656,0.192157451923077,0,0,590,1007,76,4176,15,1618,45,15
"1007","2020-04-29",253,12,264,977,6656,0.192157451923077,0,0,590,1007,65,4241,38,1656,37,38
"1008","2020-04-30",254,12,288,962,6656,0.192157451923077,0,0,590,1007,64,4305,51,1707,38,51
"1009","2020-05-01",257,12,305,945,6656,0.192157451923077,0,0,590,1007,62,4367,38,1745,29,38
"1010","2020-05-02",252,12,295,923,6656,0.192157451923077,0,0,590,1007,58,4425,20,1765,33,20
"1011","2020-05-03",250,12,281,895,6656,0.192157451923077,0,0,590,1007,70,4495,13,1778,38,13
"1012","2020-05-04",253,12,269,890,6656,0.192157451923077,0,0,590,1007,48,4543,9,1787,26,9
"1013","2020-05-05",250,12,300,865,6656,0.192157451923077,0,0,590,1007,44,4587,12,1799,19,12
"1014","2020-05-06",239,12,273,844,6656,0.192157451923077,0,0,590,1007,52,4639,14,1813,31,14
"1015","2020-05-07",243,12,241,815,6656,0.192157451923077,0,0,590,1007,58,4697,58,1871,37,58
"1016","2020-05-08",230,12,246,799,6656,0.192157451923077,0,0,590,1007,47,4744,30,1901,29,30
"1017","2020-05-09",236,12,235,800,6656,0.192157451923077,0,0,590,1007,56,4800,18,1919,29,18
"1018","2020-05-10",233,12,231,771,6656,0.192157451923077,0,0,590,1007,44,4844,62,1981,16,62
"1019","2020-05-11",217,12,244,730,6656,0.192157451923077,0,0,590,1007,45,4889,30,2011,27,30
"1020","2020-05-12",206,12,245,706,6656,0.192157451923077,0,0,590,1007,40,4929,42,2053,20,42
"1021","2020-05-13",204,12,273,664,6656,0.192157451923077,0,0,590,1007,34,4963,18,2071,23,18
"1022","2020-05-14",189,12,289,649,6656,0.192157451923077,0,0,590,1007,41,5004,13,2084,23,13
"1023","2020-05-15",182,12,285,616,6656,0.192157451923077,0,0,590,1007,34,5038,26,2110,16,26
"1024","2020-05-16",173,12,253,609,6656,0.192157451923077,0,0,590,1007,38,5076,30,2140,19,30
"1025","2020-05-17",162,12,247,591,6656,0.192157451923077,0,0,590,1007,36,5112,60,2200,20,60
"1026","2020-05-18",177,12,240,559,6656,0.192157451923077,0,0,590,1007,34,5146,35,2235,17,35
"1027","2020-05-19",180,12,224,538,6656,0.192157451923077,0,0,590,1007,33,5179,63,2298,14,63
"1028","2020-05-20",171,12,211,522,6656,0.192157451923077,0,0,590,1007,32,5211,44,2342,18,44
"1029","2020-05-21",161,12,215,502,6656,0.192157451923077,0,0,590,1007,24,5235,32,2374,14,32
"1030","2020-05-22",149,12,187,479,6656,0.192157451923077,0,0,590,1007,25,5260,27,2401,14,27
"1031","2020-05-23",146,12,177,457,6656,0.192157451923077,0,0,590,1007,24,5284,16,2417,11,16
"1032","2020-05-24",147,12,186,441,6656,0.192157451923077,0,0,590,1007,20,5304,20,2437,14,20
"1033","2020-05-25",124,12,208,437,6656,0.192157451923077,0,0,590,1007,22,5326,18,2455,14,18
"1034","2020-05-26",119,12,206,415,6656,0.192157451923077,0,0,590,1007,26,5352,12,2467,9,12
"1035","2020-05-27",111,12,207,384,6656,0.192157451923077,0,0,590,1007,23,5375,13,2480,10,13
"1036","2020-05-28",112,12,222,365,6656,0.192157451923077,0,0,590,1007,25,5400,14,2494,11,14
"1037","2020-05-29",118,12,226,354,6656,0.192157451923077,0,0,590,1007,23,5423,19,2513,11,19
"1038","2020-05-30",114,12,247,354,6656,0.192157451923077,0,0,590,1007,17,5440,71,2584,8,71
"1039","2020-05-31",101,12,241,336,6656,0.192157451923077,0,0,590,1007,21,5461,58,2642,11,58
"1040","2020-06-01",97,12,252,327,6656,0.192157451923077,0,0,590,1007,19,5480,73,2715,11,73
"1041","2020-06-02",101,12,248,315,6656,0.192157451923077,0,0,590,1007,21,5501,33,2748,12,33
"1042","2020-06-03",105,12,227,291,6656,0.192157451923077,0,0,590,1007,14,5515,27,2775,6,27
"1043","2020-06-04",99,12,241,271,6656,0.192157451923077,0,0,590,1007,13,5528,69,2844,9,69
"1044","2020-06-05",92,12,238,254,6656,0.192157451923077,0,0,590,1007,17,5545,31,2875,8,31
"1045","2020-06-06",86,12,228,236,6656,0.192157451923077,0,0,590,1007,17,5562,29,2904,9,29
"1046","2020-06-07",84,12,226,227,6656,0.192157451923077,0,0,590,1007,14,5576,62,2966,6,62
"1047","2020-03-14",2,13,124,80,3204,0.355493133583021,0,0,252,944,63,226,35,100,14,35
"1048","2020-03-15",6,13,151,116,3204,0.355493133583021,0,0,252,944,45,271,25,125,8,25
"1049","2020-03-16",9,13,157,150,3204,0.355493133583021,0,0,252,944,73,344,27,152,25,27
"1050","2020-03-17",15,13,157,184,3204,0.355493133583021,0,0,252,944,64,408,20,172,11,20
"1051","2020-03-18",22,13,160,232,3204,0.355493133583021,0,0,252,944,59,467,14,186,15,14
"1052","2020-03-19",33,13,175,279,3204,0.355493133583021,0,0,252,944,64,531,28,214,22,28
"1053","2020-03-20",41,13,206,307,3204,0.355493133583021,0,0,252,944,68,599,24,238,26,24
"1054","2020-03-21",58,13,212,337,3204,0.355493133583021,0,0,252,944,77,676,41,279,21,41
"1055","2020-03-22",69,13,229,362,3204,0.355493133583021,0,0,252,944,70,746,37,316,13,37
"1056","2020-03-23",80,13,223,381,3204,0.355493133583021,0,0,252,944,65,811,46,362,22,46
"1057","2020-03-24",90,13,220,392,3204,0.355493133583021,0,0,252,944,66,877,41,403,23,41
"1058","2020-03-25",100,13,245,401,3204,0.355493133583021,0,0,252,944,80,957,43,446,34,43
"1059","2020-03-26",105,13,265,406,3204,0.355493133583021,0,0,252,944,59,1016,31,477,20,31
"1060","2020-03-27",111,13,279,409,3204,0.355493133583021,0,0,252,944,69,1085,28,505,18,28
"1061","2020-03-28",110,13,288,427,3204,0.355493133583021,0,0,252,944,74,1159,56,561,24,56
"1062","2020-03-29",106,13,289,434,3204,0.355493133583021,0,0,252,944,93,1252,43,604,36,43
"1063","2020-03-30",108,13,289,447,3204,0.355493133583021,0,0,252,944,68,1320,41,645,19,41
"1064","2020-03-31",109,13,276,466,3204,0.355493133583021,0,0,252,944,75,1395,33,678,22,33
"1065","2020-04-01",108,13,243,491,3204,0.355493133583021,0,0,252,944,73,1468,29,707,20,29
"1066","2020-04-02",120,13,264,496,3204,0.355493133583021,0,0,252,944,67,1535,41,748,20,41
"1067","2020-04-03",128,13,279,493,3204,0.355493133583021,0,0,252,944,81,1616,24,772,27,24
"1068","2020-04-04",130,13,261,488,3204,0.355493133583021,0,0,252,944,62,1678,25,797,22,25
"1069","2020-04-05",148,13,248,478,3204,0.355493133583021,0,0,252,944,76,1754,40,837,33,40
"1070","2020-04-06",150,13,220,475,3204,0.355493133583021,0,0,252,944,77,1831,23,860,22,23
"1071","2020-04-07",149,13,205,461,3204,0.355493133583021,0,0,252,944,78,1909,25,885,22,25
"1072","2020-04-08",149,13,221,477,3204,0.355493133583021,0,0,252,944,74,1983,47,932,21,47
"1073","2020-04-09",137,13,230,457,3204,0.355493133583021,0,0,252,944,89,2072,23,955,29,23
"1074","2020-04-10",131,13,260,445,3204,0.355493133583021,0,0,252,944,70,2142,23,978,18,23
"1075","2020-04-11",121,13,279,441,3204,0.355493133583021,0,0,252,944,72,2214,40,1018,28,40
"1076","2020-04-12",106,13,288,453,3204,0.355493133583021,0,0,252,944,63,2277,55,1073,12,55
"1077","2020-04-13",108,13,263,450,3204,0.355493133583021,0,0,252,944,69,2346,37,1110,22,37
"1078","2020-04-14",115,13,260,463,3204,0.355493133583021,0,0,252,944,74,2420,61,1171,28,61
"1079","2020-04-15",115,13,236,456,3204,0.355493133583021,0,0,252,944,64,2484,46,1217,17,46
"1080","2020-04-16",114,13,231,459,3204,0.355493133583021,0,0,252,944,76,2560,36,1253,22,36
"1081","2020-04-17",119,13,253,463,3204,0.355493133583021,0,0,252,944,79,2639,27,1280,19,27
"1082","2020-04-18",121,13,292,480,3204,0.355493133583021,0,0,252,944,94,2733,17,1297,24,17
"1083","2020-04-19",130,13,293,487,3204,0.355493133583021,0,0,252,944,57,2790,49,1346,14,49
"1084","2020-04-20",131,13,290,499,3204,0.355493133583021,0,0,252,944,59,2849,25,1371,12,25
"1085","2020-04-21",123,13,295,523,3204,0.355493133583021,0,0,252,944,75,2924,19,1390,20,19
"1086","2020-04-22",124,13,303,507,3204,0.355493133583021,0,0,252,944,57,2981,19,1409,19,19
"1087","2020-04-23",124,13,274,510,3204,0.355493133583021,0,0,252,944,70,3051,28,1437,15,28
"1088","2020-04-24",122,13,278,487,3204,0.355493133583021,0,0,252,944,69,3120,38,1475,18,38
"1089","2020-04-25",138,13,271,487,3204,0.355493133583021,0,0,252,944,57,3177,20,1495,20,20
"1090","2020-04-26",137,13,262,475,3204,0.355493133583021,0,0,252,944,70,3247,47,1542,26,47
"1091","2020-04-27",138,13,273,476,3204,0.355493133583021,0,0,252,944,53,3300,50,1592,12,50
"1092","2020-04-28",140,13,276,479,3204,0.355493133583021,0,0,252,944,61,3361,34,1626,17,34
"1093","2020-04-29",137,13,272,460,3204,0.355493133583021,0,0,252,944,55,3416,47,1673,6,47
"1094","2020-04-30",142,13,269,448,3204,0.355493133583021,0,0,252,944,43,3459,41,1714,9,41
"1095","2020-05-01",142,13,259,438,3204,0.355493133583021,0,0,252,944,64,3523,20,1734,15,20
"1096","2020-05-02",133,13,256,425,3204,0.355493133583021,0,0,252,944,63,3586,26,1760,9,26
"1097","2020-05-03",133,13,268,427,3204,0.355493133583021,0,0,252,944,50,3636,39,1799,12,39
"1098","2020-05-04",128,13,275,414,3204,0.355493133583021,0,0,252,944,64,3700,48,1847,23,48
"1099","2020-05-05",130,13,291,425,3204,0.355493133583021,0,0,252,944,62,3762,25,1872,12,25
"1100","2020-05-06",129,13,301,429,3204,0.355493133583021,0,0,252,944,48,3810,15,1887,13,15
"1101","2020-05-07",124,13,287,422,3204,0.355493133583021,0,0,252,944,65,3875,13,1900,14,13
"1102","2020-05-08",126,13,281,411,3204,0.355493133583021,0,0,252,944,60,3935,10,1910,12,10
"1103","2020-05-09",129,13,282,412,3204,0.355493133583021,0,0,252,944,59,3994,15,1925,13,15
"1104","2020-05-10",120,13,312,411,3204,0.355493133583021,0,0,252,944,50,4044,10,1935,11,10
"1105","2020-05-11",116,13,342,404,3204,0.355493133583021,0,0,252,944,42,4086,13,1948,14,13
"1106","2020-05-12",116,13,350,394,3204,0.355493133583021,0,0,252,944,57,4143,12,1960,20,12
"1107","2020-05-13",122,13,331,377,3204,0.355493133583021,0,0,252,944,55,4198,13,1973,13,13
"1108","2020-05-14",117,13,324,366,3204,0.355493133583021,0,0,252,944,51,4249,5,1978,18,5
"1109","2020-05-15",107,13,318,365,3204,0.355493133583021,0,0,252,944,43,4292,12,1990,14,12
"1110","2020-05-16",96,13,295,352,3204,0.355493133583021,0,0,252,944,57,4349,4,1994,13,4
"1111","2020-05-17",92,13,302,348,3204,0.355493133583021,0,0,252,944,48,4397,15,2009,12,15
"1112","2020-05-18",93,13,281,340,3204,0.355493133583021,0,0,252,944,45,4442,30,2039,15,30
"1113","2020-05-19",93,13,261,335,3204,0.355493133583021,0,0,252,944,43,4485,23,2062,15,23
"1114","2020-05-20",89,13,257,332,3204,0.355493133583021,0,0,252,944,49,4534,10,2072,20,10
"1115","2020-05-21",89,13,246,329,3204,0.355493133583021,0,0,252,944,40,4574,36,2108,8,36
"1116","2020-05-22",93,13,246,307,3204,0.355493133583021,0,0,252,944,40,4614,48,2156,16,48
"1117","2020-05-23",97,13,263,316,3204,0.355493133583021,0,0,252,944,23,4637,57,2213,7,57
"1118","2020-05-24",102,13,284,306,3204,0.355493133583021,0,0,252,944,32,4669,51,2264,8,51
"1119","2020-05-25",100,13,278,296,3204,0.355493133583021,0,0,252,944,25,4694,31,2295,5,31
"1120","2020-05-26",89,13,293,289,3204,0.355493133583021,0,0,252,944,18,4712,15,2310,2,15
"1121","2020-05-27",86,13,303,272,3204,0.355493133583021,0,0,252,944,21,4733,31,2341,6,31
"1122","2020-05-28",84,13,299,260,3204,0.355493133583021,0,0,252,944,23,4756,27,2368,6,27
"1123","2020-05-29",83,13,294,249,3204,0.355493133583021,0,0,252,944,22,4778,22,2390,1,22
"1124","2020-05-30",80,13,275,250,3204,0.355493133583021,0,0,252,944,26,4804,11,2401,6,11
"1125","2020-05-31",74,13,258,243,3204,0.355493133583021,0,0,252,944,27,4831,7,2408,8,7
"1126","2020-06-01",67,13,266,229,3204,0.355493133583021,0,0,252,944,15,4846,17,2425,6,17
"1127","2020-06-02",70,13,274,222,3204,0.355493133583021,0,0,252,944,16,4862,30,2455,2,30
"1128","2020-06-03",68,13,271,223,3204,0.355493133583021,0,0,252,944,22,4884,19,2474,5,19
"1129","2020-06-04",69,13,292,222,3204,0.355493133583021,0,0,252,944,16,4900,15,2489,5,15
"1130","2020-06-05",68,13,307,228,3204,0.355493133583021,0,0,252,944,17,4917,19,2508,4,19
"1131","2020-06-06",75,13,333,216,3204,0.355493133583021,0,0,252,944,24,4941,21,2529,3,21
"1132","2020-06-07",77,13,327,200,3204,0.355493133583021,0,0,252,944,20,4961,23,2552,5,23
"1133","2020-03-13",1,14,138,117,7243,0.814441529752865,0,0,667,1231,70,171,48,138,39,48
"1134","2020-03-14",1,14,161,168,7243,0.814441529752865,0,0,667,1231,87,258,45,183,62,45
"1135","2020-03-15",3,14,175,236,7243,0.814441529752865,0,0,667,1231,138,396,75,258,96,75
"1136","2020-03-16",9,14,197,315,7243,0.814441529752865,0,0,667,1231,161,557,40,298,137,40
"1137","2020-03-17",19,14,233,398,7243,0.814441529752865,0,0,667,1231,235,792,26,324,205,26
"1138","2020-03-18",29,14,258,493,7243,0.814441529752865,0,0,667,1231,294,1086,49,373,251,49
"1139","2020-03-19",49,14,259,579,7243,0.814441529752865,0,0,667,1231,345,1431,22,395,314,22
"1140","2020-03-20",63,14,254,679,7243,0.814441529752865,0,0,667,1231,351,1782,8,403,318,8
"1141","2020-03-21",86,14,253,780,7243,0.814441529752865,0,0,667,1231,519,2301,14,417,486,14
"1142","2020-03-22",118,14,248,908,7243,0.814441529752865,0,0,667,1231,404,2705,46,463,380,46
"1143","2020-03-23",151,14,259,1062,7243,0.814441529752865,0,0,667,1231,549,3254,35,498,527,35
"1144","2020-03-24",185,14,274,1180,7243,0.814441529752865,0,0,667,1231,498,3752,16,514,467,16
"1145","2020-03-25",220,14,264,1303,7243,0.814441529752865,0,0,667,1231,673,4425,20,534,654,20
"1146","2020-03-26",251,14,251,1443,7243,0.814441529752865,0,0,667,1231,480,4905,46,580,465,46
"1147","2020-03-27",297,14,239,1597,7243,0.814441529752865,0,0,667,1231,516,5421,25,605,503,25
"1148","2020-03-28",338,14,223,1760,7243,0.814441529752865,0,0,667,1231,438,5859,30,635,422,30
"1149","2020-03-29",371,14,231,1813,7243,0.814441529752865,0,0,667,1231,449,6308,16,651,438,16
"1150","2020-03-30",395,14,223,1911,7243,0.814441529752865,0,0,667,1231,252,6560,31,682,245,31
"1151","2020-03-31",436,14,253,1962,7243,0.814441529752865,0,0,667,1231,277,6837,24,706,273,24
"1152","2020-04-01",451,14,240,2064,7243,0.814441529752865,0,0,667,1231,215,7052,16,722,211,16
"1153","2020-04-02",480,14,219,2126,7243,0.814441529752865,0,0,667,1231,123,7175,17,739,121,17
"1154","2020-04-03",499,14,218,2163,7243,0.814441529752865,0,0,667,1231,123,7298,10,749,117,10
"1155","2020-04-04",501,14,270,2206,7243,0.814441529752865,0,0,667,1231,93,7391,2,751,92,2
"1156","2020-04-05",521,14,287,2221,7243,0.814441529752865,0,0,667,1231,75,7466,52,803,70,52
"1157","2020-04-06",554,14,283,2239,7243,0.814441529752865,0,0,667,1231,50,7516,58,861,48,58
"1158","2020-04-07",555,14,261,2245,7243,0.814441529752865,0,0,667,1231,31,7547,49,910,27,49
"1159","2020-04-08",576,14,227,2246,7243,0.814441529752865,0,0,667,1231,24,7571,16,926,23,16
"1160","2020-04-09",582,14,222,2215,7243,0.814441529752865,0,0,667,1231,29,7600,8,934,23,8
"1161","2020-04-10",585,14,231,2130,7243,0.814441529752865,0,0,667,1231,19,7619,16,950,16,16
"1162","2020-04-11",609,14,227,2024,7243,0.814441529752865,0,0,667,1231,16,7635,13,963,16,13
"1163","2020-04-12",606,14,227,1947,7243,0.814441529752865,0,0,667,1231,14,7649,40,1003,10,40
"1164","2020-04-13",597,14,213,1854,7243,0.814441529752865,0,0,667,1231,10,7659,30,1033,6,30
"1165","2020-04-14",609,14,215,1767,7243,0.814441529752865,0,0,667,1231,16,7675,23,1056,12,23
"1166","2020-04-15",603,14,190,1657,7243,0.814441529752865,0,0,667,1231,10,7685,17,1073,9,17
"1167","2020-04-16",570,14,196,1593,7243,0.814441529752865,0,0,667,1231,11,7696,7,1080,8,7
"1168","2020-04-17",548,14,202,1474,7243,0.814441529752865,0,0,667,1231,6,7702,11,1091,5,11
"1169","2020-04-18",514,14,206,1397,7243,0.814441529752865,0,0,667,1231,11,7713,19,1110,7,19
"1170","2020-04-19",477,14,218,1307,7243,0.814441529752865,0,0,667,1231,4,7717,23,1133,2,23
"1171","2020-04-20",437,14,222,1216,7243,0.814441529752865,0,0,667,1231,5,7722,14,1147,1,14
"1172","2020-04-21",391,14,220,1116,7243,0.814441529752865,0,0,667,1231,4,7726,36,1183,1,36
"1173","2020-04-22",347,14,241,1037,7243,0.814441529752865,0,0,667,1231,4,7730,33,1216,1,33
"1174","2020-04-23",343,14,274,986,7243,0.814441529752865,0,0,667,1231,6,7736,15,1231,3,15
"1175","2020-04-24",320,14,271,903,7243,0.814441529752865,0,0,667,1231,5,7741,5,1236,3,5
"1176","2020-04-25",304,14,259,828,7243,0.814441529752865,0,0,667,1231,9,7750,10,1246,6,10
"1177","2020-04-26",289,14,259,771,7243,0.814441529752865,0,0,667,1231,4,7754,11,1257,3,11
"1178","2020-04-27",273,14,267,736,7243,0.814441529752865,0,0,667,1231,3,7757,5,1262,1,5
"1179","2020-04-28",253,14,259,700,7243,0.814441529752865,0,0,667,1231,5,7762,19,1281,3,19
"1180","2020-04-29",249,14,266,660,7243,0.814441529752865,0,0,667,1231,1,7763,14,1295,1,14
"1181","2020-04-30",223,14,261,619,7243,0.814441529752865,0,0,667,1231,1,7764,27,1322,NA,27
"1182","2020-05-01",205,14,242,573,7243,0.814441529752865,0,0,667,1231,2,7766,46,1368,1,46
"1183","2020-05-02",193,14,239,534,7243,0.814441529752865,0,0,667,1231,1,7767,32,1400,1,32
"1184","2020-05-03",184,14,267,503,7243,0.814441529752865,0,0,667,1231,2,7769,26,1426,2,26
"1185","2020-05-04",176,14,249,486,7243,0.814441529752865,0,0,667,1231,1,7770,20,1446,1,20
"1186","2020-05-05",170,14,248,443,7243,0.814441529752865,0,0,667,1231,2,7772,22,1468,2,22
"1187","2020-05-06",159,14,253,424,7243,0.814441529752865,0,0,667,1231,1,7773,6,1474,1,6
"1188","2020-05-07",152,14,240,399,7243,0.814441529752865,0,0,667,1231,NA,NA,7,1481,NA,7
"1189","2020-05-08",141,14,239,375,7243,0.814441529752865,0,0,667,1231,1,7774,13,1494,NA,13
"1190","2020-05-09",129,14,228,346,7243,0.814441529752865,0,0,667,1231,3,7777,4,1498,2,4
"1191","2020-05-10",123,14,259,334,7243,0.814441529752865,0,0,667,1231,1,7778,9,1507,1,9
"1192","2020-05-11",114,14,269,314,7243,0.814441529752865,0,0,667,1231,3,7781,34,1541,1,34
"1193","2020-05-12",97,14,273,289,7243,0.814441529752865,0,0,667,1231,2,7783,35,1576,NA,35
"1194","2020-05-13",89,14,280,274,7243,0.814441529752865,0,0,667,1231,2,7785,13,1589,1,13
"1195","2020-05-14",78,14,297,257,7243,0.814441529752865,0,0,667,1231,3,7788,10,1599,3,10
"1196","2020-05-15",84,14,297,247,7243,0.814441529752865,0,0,667,1231,5,7793,10,1609,4,10
"1197","2020-05-16",83,14,300,240,7243,0.814441529752865,0,0,667,1231,NA,NA,8,1617,NA,8
"1198","2020-05-17",79,14,268,232,7243,0.814441529752865,0,0,667,1231,4,7797,4,1621,1,4
"1199","2020-05-18",70,14,246,210,7243,0.814441529752865,0,0,667,1231,1,7798,10,1631,1,10
"1200","2020-05-19",73,14,252,205,7243,0.814441529752865,0,0,667,1231,4,7802,7,1638,1,7
"1201","2020-05-20",74,14,285,206,7243,0.814441529752865,0,0,667,1231,3,7805,6,1644,NA,6
"1202","2020-05-21",80,14,263,198,7243,0.814441529752865,0,0,667,1231,2,7807,36,1680,NA,36
"1203","2020-05-22",72,14,269,183,7243,0.814441529752865,0,0,667,1231,1,7808,50,1730,1,50
"1204","2020-05-23",62,14,264,172,7243,0.814441529752865,0,0,667,1231,3,7811,34,1764,2,34
"1205","2020-05-24",57,14,247,166,7243,0.814441529752865,0,0,667,1231,2,7813,17,1781,NA,17
"1206","2020-05-25",57,14,240,168,7243,0.814441529752865,0,0,667,1231,3,7816,10,1791,1,10
"1207","2020-05-26",50,14,230,167,7243,0.814441529752865,0,0,667,1231,1,7817,15,1806,NA,15
"1208","2020-05-27",46,14,224,155,7243,0.814441529752865,0,0,667,1231,NA,NA,63,1869,NA,63
"1209","2020-05-28",43,14,216,149,7243,0.814441529752865,0,0,667,1231,1,7818,28,1897,NA,28
"1210","2020-05-29",43,14,232,143,7243,0.814441529752865,0,0,667,1231,1,7819,17,1914,1,17
"1211","2020-05-30",40,14,236,138,7243,0.814441529752865,0,0,667,1231,NA,NA,54,1968,NA,54
"1212","2020-05-31",42,14,250,141,7243,0.814441529752865,0,0,667,1231,1,7820,33,2001,NA,33
"1213","2020-06-01",42,14,278,136,7243,0.814441529752865,0,0,667,1231,2,7822,37,2038,1,37
"1214","2020-06-02",42,14,295,130,7243,0.814441529752865,0,0,667,1231,1,7823,19,2057,1,19
"1215","2020-06-03",39,14,289,125,7243,0.814441529752865,0,0,667,1231,1,7824,31,2088,1,31
"1216","2020-06-04",33,14,274,117,7243,0.814441529752865,0,0,667,1231,1,7825,24,2112,NA,24
"1217","2020-06-05",30,14,246,113,7243,0.814441529752865,0,0,667,1231,NA,NA,7,2119,NA,7
"1218","2020-06-06",32,14,228,116,7243,0.814441529752865,0,0,667,1231,NA,NA,9,2128,NA,9
"1219","2020-06-07",25,14,244,104,7243,0.814441529752865,0,0,667,1231,NA,NA,15,2143,NA,15
"1220","2020-03-13",9,15,207,375,9470,0.740865892291447,0,0,835,2080,85,245,21,43,12,21
"1221","2020-03-14",16,15,191,577,9470,0.740865892291447,0,0,835,2080,77,322,28,71,7,28
"1222","2020-03-15",37,15,182,822,9470,0.740865892291447,0,0,835,2080,101,423,12,83,25,12
"1223","2020-03-16",63,15,179,1157,9470,0.740865892291447,0,0,835,2080,119,542,11,94,30,11
"1224","2020-03-17",99,15,209,1527,9470,0.740865892291447,0,0,835,2080,114,656,30,124,14,30
"1225","2020-03-18",163,15,271,2001,9470,0.740865892291447,0,0,835,2080,123,779,13,137,45,13
"1226","2020-03-19",229,15,265,2455,9470,0.740865892291447,0,0,835,2080,130,909,19,156,56,19
"1227","2020-03-20",306,15,259,3058,9470,0.740865892291447,0,0,835,2080,113,1022,10,166,33,10
"1228","2020-03-21",420,15,230,3578,9470,0.740865892291447,0,0,835,2080,128,1150,15,181,41,15
"1229","2020-03-22",557,15,219,4133,9470,0.740865892291447,0,0,835,2080,120,1270,11,192,41,11
"1230","2020-03-23",705,15,221,4552,9470,0.740865892291447,0,0,835,2080,115,1385,36,228,43,36
"1231","2020-03-24",825,15,283,4984,9470,0.740865892291447,0,0,835,2080,115,1500,40,268,41,40
"1232","2020-03-25",956,15,280,5229,9470,0.740865892291447,0,0,835,2080,116,1616,58,326,32,58
"1233","2020-03-26",1117,15,250,5397,9470,0.740865892291447,0,0,835,2080,137,1753,46,372,57,46
"1234","2020-03-27",1252,15,252,5383,9470,0.740865892291447,0,0,835,2080,132,1885,60,432,39,60
"1235","2020-03-28",1346,15,290,5260,9470,0.740865892291447,0,0,835,2080,105,1990,41,473,37,41
"1236","2020-03-29",1397,15,281,5064,9470,0.740865892291447,0,0,835,2080,114,2104,49,522,41,49
"1237","2020-03-30",1411,15,281,4768,9470,0.740865892291447,0,0,835,2080,134,2238,37,559,41,37
"1238","2020-03-31",1464,15,246,4455,9470,0.740865892291447,0,0,835,2080,107,2345,40,599,36,40
"1239","2020-04-01",1469,15,211,4049,9470,0.740865892291447,0,0,835,2080,105,2450,57,656,35,57
"1240","2020-04-02",1395,15,188,3572,9470,0.740865892291447,0,0,835,2080,97,2547,56,712,18,56
"1241","2020-04-03",1318,15,200,3110,9470,0.740865892291447,0,0,835,2080,83,2630,53,765,21,53
"1242","2020-04-04",1248,15,237,2735,9470,0.740865892291447,0,0,835,2080,84,2714,46,811,23,46
"1243","2020-04-05",1128,15,228,2355,9470,0.740865892291447,0,0,835,2080,103,2817,28,839,37,28
"1244","2020-04-06",1033,15,228,1966,9470,0.740865892291447,0,0,835,2080,109,2926,24,863,24,24
"1245","2020-04-07",894,15,254,1665,9470,0.740865892291447,0,0,835,2080,109,3035,36,899,20,36
"1246","2020-04-08",741,15,323,1397,9470,0.740865892291447,0,0,835,2080,111,3146,19,918,35,19
"1247","2020-04-09",634,15,296,1171,9470,0.740865892291447,0,0,835,2080,105,3251,57,975,30,57
"1248","2020-04-10",520,15,316,966,9470,0.740865892291447,0,0,835,2080,97,3348,31,1006,25,31
"1249","2020-04-11",407,15,290,816,9470,0.740865892291447,0,0,835,2080,98,3446,18,1024,29,18
"1250","2020-04-12",345,15,274,663,9470,0.740865892291447,0,0,835,2080,73,3519,18,1042,18,18
"1251","2020-04-13",267,15,252,547,9470,0.740865892291447,0,0,835,2080,97,3616,14,1056,25,14
"1252","2020-04-14",208,15,220,462,9470,0.740865892291447,0,0,835,2080,121,3737,44,1100,39,44
"1253","2020-04-15",172,15,192,388,9470,0.740865892291447,0,0,835,2080,98,3835,47,1147,25,47
"1254","2020-04-16",133,15,196,325,9470,0.740865892291447,0,0,835,2080,100,3935,23,1170,26,23
"1255","2020-04-17",115,15,198,268,9470,0.740865892291447,0,0,835,2080,81,4016,22,1192,23,22
"1256","2020-04-18",91,15,209,241,9470,0.740865892291447,0,0,835,2080,93,4109,24,1216,23,24
"1257","2020-04-19",72,15,217,213,9470,0.740865892291447,0,0,835,2080,92,4201,18,1234,25,18
"1258","2020-04-20",64,15,231,189,9470,0.740865892291447,0,0,835,2080,76,4277,43,1277,22,43
"1259","2020-04-21",59,15,234,161,9470,0.740865892291447,0,0,835,2080,81,4358,33,1310,23,33
"1260","2020-04-22",54,15,234,138,9470,0.740865892291447,0,0,835,2080,83,4441,13,1323,22,13
"1261","2020-04-23",48,15,233,122,9470,0.740865892291447,0,0,835,2080,97,4538,12,1335,22,12
"1262","2020-04-24",38,15,297,104,9470,0.740865892291447,0,0,835,2080,82,4620,6,1341,24,6
"1263","2020-04-25",32,15,312,92,9470,0.740865892291447,0,0,835,2080,87,4707,13,1354,17,13
"1264","2020-04-26",27,15,288,87,9470,0.740865892291447,0,0,835,2080,77,4784,7,1361,20,7
"1265","2020-04-27",22,15,273,78,9470,0.740865892291447,0,0,835,2080,77,4861,44,1405,10,44
"1266","2020-04-28",17,15,247,74,9470,0.740865892291447,0,0,835,2080,83,4944,29,1434,16,29
"1267","2020-04-29",15,15,238,72,9470,0.740865892291447,0,0,835,2080,69,5013,27,1461,15,27
"1268","2020-04-30",14,15,226,66,9470,0.740865892291447,0,0,835,2080,67,5080,17,1478,14,17
"1269","2020-05-01",14,15,215,57,9470,0.740865892291447,0,0,835,2080,58,5138,18,1496,7,18
"1270","2020-05-02",14,15,234,55,9470,0.740865892291447,0,0,835,2080,66,5204,34,1530,12,34
"1271","2020-05-03",15,15,246,51,9470,0.740865892291447,0,0,835,2080,47,5251,26,1556,6,26
"1272","2020-05-04",14,15,236,50,9470,0.740865892291447,0,0,835,2080,62,5313,15,1571,10,15
"1273","2020-05-05",15,15,283,42,9470,0.740865892291447,0,0,835,2080,50,5363,12,1583,13,12
"1274","2020-05-06",12,15,288,42,9470,0.740865892291447,0,0,835,2080,67,5430,17,1600,8,17
"1275","2020-05-07",12,15,269,39,9470,0.740865892291447,0,0,835,2080,62,5492,33,1633,10,33
"1276","2020-05-08",13,15,266,36,9470,0.740865892291447,0,0,835,2080,59,5551,21,1654,12,21
"1277","2020-05-09",11,15,255,35,9470,0.740865892291447,0,0,835,2080,45,5596,26,1680,8,26
"1278","2020-05-10",8,15,234,40,9470,0.740865892291447,0,0,835,2080,43,5639,61,1741,5,61
"1279","2020-05-11",9,15,204,38,9470,0.740865892291447,0,0,835,2080,44,5683,53,1794,4,53
"1280","2020-05-12",9,15,195,36,9470,0.740865892291447,0,0,835,2080,44,5727,52,1846,6,52
"1281","2020-05-13",10,15,190,36,9470,0.740865892291447,0,0,835,2080,40,5767,34,1880,7,34
"1282","2020-05-14",10,15,221,36,9470,0.740865892291447,0,0,835,2080,33,5800,32,1912,4,32
"1283","2020-05-15",7,15,228,32,9470,0.740865892291447,0,0,835,2080,43,5843,25,1937,6,25
"1284","2020-05-16",9,15,217,30,9470,0.740865892291447,0,0,835,2080,35,5878,24,1961,8,24
"1285","2020-05-17",10,15,221,32,9470,0.740865892291447,0,0,835,2080,32,5910,22,1983,3,22
"1286","2020-05-18",10,15,239,29,9470,0.740865892291447,0,0,835,2080,24,5934,20,2003,2,20
"1287","2020-05-19",9,15,253,32,9470,0.740865892291447,0,0,835,2080,38,5972,9,2012,7,9
"1288","2020-05-20",8,15,260,28,9470,0.740865892291447,0,0,835,2080,35,6007,10,2022,3,10
"1289","2020-05-21",8,15,270,24,9470,0.740865892291447,0,0,835,2080,30,6037,10,2032,4,10
"1290","2020-05-22",9,15,279,21,9470,0.740865892291447,0,0,835,2080,27,6064,6,2038,4,6
"1291","2020-05-23",7,15,263,19,9470,0.740865892291447,0,0,835,2080,26,6090,4,2042,6,4
"1292","2020-05-24",6,15,244,17,9470,0.740865892291447,0,0,835,2080,22,6112,7,2049,1,7
"1293","2020-05-25",4,15,247,17,9470,0.740865892291447,0,0,835,2080,32,6144,NA,NA,1,NA
"1294","2020-05-26",4,15,245,15,9470,0.740865892291447,0,0,835,2080,24,6168,18,2067,4,18
"1295","2020-05-27",4,15,261,16,9470,0.740865892291447,0,0,835,2080,22,6190,35,2102,NA,35
"1296","2020-05-28",4,15,323,14,9470,0.740865892291447,0,0,835,2080,34,6224,20,2122,3,20
"1297","2020-05-29",3,15,363,14,9470,0.740865892291447,0,0,835,2080,24,6248,20,2142,NA,20
"1298","2020-05-30",4,15,323,13,9470,0.740865892291447,0,0,835,2080,17,6265,37,2179,NA,37
"1299","2020-05-31",3,15,278,12,9470,0.740865892291447,0,0,835,2080,18,6283,18,2197,5,18
"1300","2020-06-01",3,15,282,7,9470,0.740865892291447,0,0,835,2080,23,6306,9,2206,4,9
"1301","2020-06-02",2,15,306,9,9470,0.740865892291447,0,0,835,2080,19,6325,11,2217,2,11
"1302","2020-06-03",2,15,358,9,9470,0.740865892291447,0,0,835,2080,16,6341,15,2232,4,15
"1303","2020-06-04",3,15,361,8,9470,0.740865892291447,0,0,835,2080,15,6356,15,2247,2,15
"1304","2020-06-05",3,15,336,8,9470,0.740865892291447,0,0,835,2080,22,6378,36,2283,3,36
"1305","2020-06-06",2,15,300,7,9470,0.740865892291447,0,0,835,2080,13,6391,36,2319,2,36
"1306","2020-06-07",2,15,271,6,9470,0.740865892291447,0,0,835,2080,19,6410,46,2365,1,46
"1307","2020-03-13",2,16,139,82,3940,0.418274111675127,0,0,360,1623,68,204,12,62,8,12
"1308","2020-03-14",5,16,149,109,3940,0.418274111675127,0,0,360,1623,76,280,19,81,20,19
"1309","2020-03-15",10,16,164,143,3940,0.418274111675127,0,0,360,1623,93,373,39,120,27,39
"1310","2020-03-16",16,16,174,179,3940,0.418274111675127,0,0,360,1623,94,467,54,174,32,54
"1311","2020-03-17",20,16,223,218,3940,0.418274111675127,0,0,360,1623,112,579,35,209,45,35
"1312","2020-03-18",31,16,255,254,3940,0.418274111675127,0,0,360,1623,91,670,35,244,30,35
"1313","2020-03-19",42,16,225,291,3940,0.418274111675127,0,0,360,1623,102,772,29,273,55,29
"1314","2020-03-20",50,16,212,331,3940,0.418274111675127,0,0,360,1623,90,862,33,306,33,33
"1315","2020-03-21",60,16,206,371,3940,0.418274111675127,0,0,360,1623,115,977,32,338,54,32
"1316","2020-03-22",72,16,226,409,3940,0.418274111675127,0,0,360,1623,114,1091,64,402,62,64
"1317","2020-03-23",83,16,227,443,3940,0.418274111675127,0,0,360,1623,97,1188,68,470,46,68
"1318","2020-03-24",93,16,211,462,3940,0.418274111675127,0,0,360,1623,106,1294,54,524,50,54
"1319","2020-03-25",104,16,219,487,3940,0.418274111675127,0,0,360,1623,115,1409,45,569,55,45
"1320","2020-03-26",116,16,251,501,3940,0.418274111675127,0,0,360,1623,95,1504,47,616,43,47
"1321","2020-03-27",121,16,266,515,3940,0.418274111675127,0,0,360,1623,105,1609,39,655,56,39
"1322","2020-03-28",134,16,276,530,3940,0.418274111675127,0,0,360,1623,105,1714,50,705,40,50
"1323","2020-03-29",132,16,306,564,3940,0.418274111675127,0,0,360,1623,108,1822,42,747,48,42
"1324","2020-03-30",145,16,292,573,3940,0.418274111675127,0,0,360,1623,117,1939,30,777,49,30
"1325","2020-03-31",153,16,275,599,3940,0.418274111675127,0,0,360,1623,113,2052,22,799,47,22
"1326","2020-04-01",152,16,266,595,3940,0.418274111675127,0,0,360,1623,102,2154,30,829,46,30
"1327","2020-04-02",145,16,254,594,3940,0.418274111675127,0,0,360,1623,112,2266,24,853,58,24
"1328","2020-04-03",152,16,240,605,3940,0.418274111675127,0,0,360,1623,120,2386,41,894,51,41
"1329","2020-04-04",149,16,229,602,3940,0.418274111675127,0,0,360,1623,97,2483,39,933,36,39
"1330","2020-04-05",158,16,236,601,3940,0.418274111675127,0,0,360,1623,104,2587,33,966,37,33
"1331","2020-04-06",163,16,213,604,3940,0.418274111675127,0,0,360,1623,87,2674,38,1004,31,38
"1332","2020-04-07",158,16,218,610,3940,0.418274111675127,0,0,360,1623,92,2766,29,1033,43,29
"1333","2020-04-08",166,16,223,617,3940,0.418274111675127,0,0,360,1623,101,2867,22,1055,42,22
"1334","2020-04-09",168,16,234,630,3940,0.418274111675127,0,0,360,1623,104,2971,46,1101,41,46
"1335","2020-04-10",167,16,250,610,3940,0.418274111675127,0,0,360,1623,86,3057,48,1149,38,48
"1336","2020-04-11",180,16,245,615,3940,0.418274111675127,0,0,360,1623,99,3156,48,1197,43,48
"1337","2020-04-12",172,16,256,625,3940,0.418274111675127,0,0,360,1623,101,3257,40,1237,37,40
"1338","2020-04-13",163,16,251,646,3940,0.418274111675127,0,0,360,1623,72,3329,48,1285,31,48
"1339","2020-04-14",172,16,274,652,3940,0.418274111675127,0,0,360,1623,92,3421,42,1327,34,42
"1340","2020-04-15",168,16,264,642,3940,0.418274111675127,0,0,360,1623,79,3500,50,1377,31,50
"1341","2020-04-16",182,16,252,641,3940,0.418274111675127,0,0,360,1623,86,3586,33,1410,21,33
"1342","2020-04-17",189,16,262,652,3940,0.418274111675127,0,0,360,1623,90,3676,38,1448,38,38
"1343","2020-04-18",181,16,250,655,3940,0.418274111675127,0,0,360,1623,73,3749,41,1489,13,41
"1344","2020-04-19",189,16,264,630,3940,0.418274111675127,0,0,360,1623,67,3816,40,1529,22,40
"1345","2020-04-20",194,16,255,634,3940,0.418274111675127,0,0,360,1623,70,3886,39,1568,22,39
"1346","2020-04-21",199,16,264,623,3940,0.418274111675127,0,0,360,1623,74,3960,48,1616,16,48
"1347","2020-04-22",196,16,262,622,3940,0.418274111675127,0,0,360,1623,69,4029,35,1651,24,35
"1348","2020-04-23",189,16,248,609,3940,0.418274111675127,0,0,360,1623,74,4103,32,1683,28,32
"1349","2020-04-24",186,16,255,598,3940,0.418274111675127,0,0,360,1623,72,4175,53,1736,20,53
"1350","2020-04-25",185,16,252,575,3940,0.418274111675127,0,0,360,1623,75,4250,44,1780,28,44
"1351","2020-04-26",178,16,282,559,3940,0.418274111675127,0,0,360,1623,63,4313,36,1816,23,36
"1352","2020-04-27",173,16,267,535,3940,0.418274111675127,0,0,360,1623,61,4374,37,1853,23,37
"1353","2020-04-28",159,16,267,530,3940,0.418274111675127,0,0,360,1623,66,4440,31,1884,19,31
"1354","2020-04-29",166,16,287,532,3940,0.418274111675127,0,0,360,1623,61,4501,23,1907,17,23
"1355","2020-04-30",153,16,285,530,3940,0.418274111675127,0,0,360,1623,61,4562,31,1938,9,31
"1356","2020-05-01",155,16,288,508,3940,0.418274111675127,0,0,360,1623,55,4617,43,1981,14,43
"1357","2020-05-02",151,16,285,508,3940,0.418274111675127,0,0,360,1623,73,4690,33,2014,26,33
"1358","2020-05-03",152,16,274,499,3940,0.418274111675127,0,0,360,1623,59,4749,29,2043,15,29
"1359","2020-05-04",143,16,252,511,3940,0.418274111675127,0,0,360,1623,44,4793,72,2115,13,72
"1360","2020-05-05",145,16,217,511,3940,0.418274111675127,0,0,360,1623,61,4854,51,2166,22,51
"1361","2020-05-06",137,16,207,500,3940,0.418274111675127,0,0,360,1623,45,4899,37,2203,9,37
"1362","2020-05-07",139,16,202,508,3940,0.418274111675127,0,0,360,1623,59,4958,23,2226,17,23
"1363","2020-05-08",132,16,196,501,3940,0.418274111675127,0,0,360,1623,62,5020,24,2250,20,24
"1364","2020-05-09",134,16,226,498,3940,0.418274111675127,0,0,360,1623,54,5074,28,2278,14,28
"1365","2020-05-10",140,16,264,495,3940,0.418274111675127,0,0,360,1623,44,5118,32,2310,13,32
"1366","2020-05-11",140,16,282,477,3940,0.418274111675127,0,0,360,1623,42,5160,32,2342,17,32
"1367","2020-05-12",143,16,263,475,3940,0.418274111675127,0,0,360,1623,37,5197,24,2366,9,24
"1368","2020-05-13",150,16,236,462,3940,0.418274111675127,0,0,360,1623,38,5235,37,2403,9,37
"1369","2020-05-14",159,16,248,451,3940,0.418274111675127,0,0,360,1623,54,5289,37,2440,14,37
"1370","2020-05-15",155,16,257,439,3940,0.418274111675127,0,0,360,1623,58,5347,41,2481,20,41
"1371","2020-05-16",147,16,261,432,3940,0.418274111675127,0,0,360,1623,42,5389,63,2544,11,63
"1372","2020-05-17",132,16,277,424,3940,0.418274111675127,0,0,360,1623,42,5431,49,2593,12,49
"1373","2020-05-18",134,16,273,420,3940,0.418274111675127,0,0,360,1623,29,5460,50,2643,8,50
"1374","2020-05-19",133,16,256,423,3940,0.418274111675127,0,0,360,1623,33,5493,42,2685,6,42
"1375","2020-05-20",122,16,249,422,3940,0.418274111675127,0,0,360,1623,16,5509,59,2744,3,59
"1376","2020-05-21",119,16,234,396,3940,0.418274111675127,0,0,360,1623,30,5539,40,2784,4,40
"1377","2020-05-22",121,16,219,378,3940,0.418274111675127,0,0,360,1623,18,5557,48,2832,4,48
"1378","2020-05-23",120,16,217,360,3940,0.418274111675127,0,0,360,1623,26,5583,35,2867,6,35
"1379","2020-05-24",125,16,212,335,3940,0.418274111675127,0,0,360,1623,31,5614,33,2900,8,33
"1380","2020-05-25",120,16,207,332,3940,0.418274111675127,0,0,360,1623,22,5636,33,2933,6,33
"1381","2020-05-26",107,16,196,326,3940,0.418274111675127,0,0,360,1623,23,5659,29,2962,6,29
"1382","2020-05-27",104,16,199,312,3940,0.418274111675127,0,0,360,1623,25,5684,36,2998,5,36
"1383","2020-05-28",89,16,227,289,3940,0.418274111675127,0,0,360,1623,21,5705,31,3029,3,31
"1384","2020-05-29",80,16,238,281,3940,0.418274111675127,0,0,360,1623,31,5736,29,3058,8,29
"1385","2020-05-30",75,16,258,292,3940,0.418274111675127,0,0,360,1623,19,5755,29,3087,4,29
"1386","2020-05-31",74,16,250,270,3940,0.418274111675127,0,0,360,1623,16,5771,40,3127,4,40
"1387","2020-06-01",76,16,260,273,3940,0.418274111675127,0,0,360,1623,25,5796,52,3179,2,52
"1388","2020-06-02",81,16,262,259,3940,0.418274111675127,0,0,360,1623,22,5818,34,3213,7,34
"1389","2020-06-03",76,16,248,251,3940,0.418274111675127,0,0,360,1623,10,5828,42,3255,3,42
"1390","2020-06-04",79,16,243,247,3940,0.418274111675127,0,0,360,1623,15,5843,39,3294,2,39
"1391","2020-06-05",79,16,241,232,3940,0.418274111675127,0,0,360,1623,22,5865,50,3344,10,50
"1392","2020-06-06",75,16,235,220,3940,0.418274111675127,0,0,360,1623,16,5881,32,3376,5,32
"1393","2020-06-07",67,16,209,211,3940,0.418274111675127,0,0,360,1623,14,5895,38,3414,6,38
"1394","2020-03-13",2,17,136,128,5261,0.191218399543813,0,0,441,1616,36,75,26,111,24,26
"1395","2020-03-14",4,17,137,182,5261,0.191218399543813,0,0,441,1616,40,115,21,132,34,21
"1396","2020-03-15",12,17,182,242,5261,0.191218399543813,0,0,441,1616,39,154,17,149,33,17
"1397","2020-03-16",21,17,172,305,5261,0.191218399543813,0,0,441,1616,55,209,12,161,48,12
"1398","2020-03-17",31,17,152,369,5261,0.191218399543813,0,0,441,1616,83,292,11,172,75,11
"1399","2020-03-18",42,17,141,434,5261,0.191218399543813,0,0,441,1616,89,381,10,182,77,10
"1400","2020-03-19",51,17,137,474,5261,0.191218399543813,0,0,441,1616,98,479,77,259,85,77
"1401","2020-03-20",63,17,178,521,5261,0.191218399543813,0,0,441,1616,161,640,41,300,151,41
"1402","2020-03-21",88,17,190,570,5261,0.191218399543813,0,0,441,1616,178,818,33,333,168,33
"1403","2020-03-22",106,17,189,611,5261,0.191218399543813,0,0,441,1616,194,1012,46,379,186,46
"1404","2020-03-23",120,17,166,672,5261,0.191218399543813,0,0,441,1616,234,1246,24,403,229,24
"1405","2020-03-24",140,17,217,712,5261,0.191218399543813,0,0,441,1616,301,1547,15,418,289,15
"1406","2020-03-25",165,17,266,717,5261,0.191218399543813,0,0,441,1616,316,1863,16,434,305,16
"1407","2020-03-26",185,17,243,725,5261,0.191218399543813,0,0,441,1616,396,2259,34,468,390,34
"1408","2020-03-27",203,17,222,724,5261,0.191218399543813,0,0,441,1616,352,2611,51,519,344,51
"1409","2020-03-28",216,17,214,735,5261,0.191218399543813,0,0,441,1616,527,3138,20,539,516,20
"1410","2020-03-29",227,17,200,758,5261,0.191218399543813,0,0,441,1616,352,3490,19,558,348,19
"1411","2020-03-30",235,17,180,788,5261,0.191218399543813,0,0,441,1616,425,3915,11,569,418,11
"1412","2020-03-31",239,17,152,796,5261,0.191218399543813,0,0,441,1616,386,4301,53,622,378,53
"1413","2020-04-01",228,17,145,816,5261,0.191218399543813,0,0,441,1616,463,4764,31,653,459,31
"1414","2020-04-02",233,17,187,834,5261,0.191218399543813,0,0,441,1616,327,5091,61,714,323,61
"1415","2020-04-03",247,17,264,837,5261,0.191218399543813,0,0,441,1616,299,5390,37,751,297,37
"1416","2020-04-04",234,17,254,843,5261,0.191218399543813,0,0,441,1616,292,5682,15,766,288,15
"1417","2020-04-05",229,17,250,852,5261,0.191218399543813,0,0,441,1616,256,5938,9,775,250,9
"1418","2020-04-06",231,17,231,825,5261,0.191218399543813,0,0,441,1616,250,6188,14,789,246,14
"1419","2020-04-07",228,17,211,836,5261,0.191218399543813,0,0,441,1616,193,6381,57,846,193,57
"1420","2020-04-08",238,17,187,845,5261,0.191218399543813,0,0,441,1616,175,6556,55,901,172,55
"1421","2020-04-09",244,17,177,853,5261,0.191218399543813,0,0,441,1616,186,6742,28,929,181,28
"1422","2020-04-10",226,17,158,859,5261,0.191218399543813,0,0,441,1616,108,6850,11,940,107,11
"1423","2020-04-11",234,17,156,866,5261,0.191218399543813,0,0,441,1616,92,6942,12,952,90,12
"1424","2020-04-12",234,17,169,842,5261,0.191218399543813,0,0,441,1616,85,7027,9,961,81,9
"1425","2020-04-13",227,17,179,858,5261,0.191218399543813,0,0,441,1616,50,7077,20,981,49,20
"1426","2020-04-14",236,17,250,838,5261,0.191218399543813,0,0,441,1616,42,7119,13,994,38,13
"1427","2020-04-15",248,17,247,828,5261,0.191218399543813,0,0,441,1616,44,7163,10,1004,43,10
"1428","2020-04-16",236,17,285,821,5261,0.191218399543813,0,0,441,1616,35,7198,8,1012,34,8
"1429","2020-04-17",233,17,290,822,5261,0.191218399543813,0,0,441,1616,24,7222,12,1024,23,12
"1430","2020-04-18",234,17,304,817,5261,0.191218399543813,0,0,441,1616,25,7247,15,1039,24,15
"1431","2020-04-19",235,17,287,785,5261,0.191218399543813,0,0,441,1616,8,7255,38,1077,8,38
"1432","2020-04-20",242,17,293,784,5261,0.191218399543813,0,0,441,1616,14,7269,25,1102,12,25
"1433","2020-04-21",230,17,278,771,5261,0.191218399543813,0,0,441,1616,13,7282,28,1130,12,28
"1434","2020-04-22",218,17,276,770,5261,0.191218399543813,0,0,441,1616,8,7290,13,1143,7,13
"1435","2020-04-23",212,17,265,747,5261,0.191218399543813,0,0,441,1616,11,7301,14,1157,10,14
"1436","2020-04-24",216,17,251,754,5261,0.191218399543813,0,0,441,1616,9,7310,66,1223,7,66
"1437","2020-04-25",217,17,215,732,5261,0.191218399543813,0,0,441,1616,4,7314,38,1261,3,38
"1438","2020-04-26",207,17,202,711,5261,0.191218399543813,0,0,441,1616,9,7323,45,1306,7,45
"1439","2020-04-27",200,17,215,693,5261,0.191218399543813,0,0,441,1616,8,7331,44,1350,4,44
"1440","2020-04-28",199,17,221,678,5261,0.191218399543813,0,0,441,1616,7,7338,19,1369,6,19
"1441","2020-04-29",189,17,210,684,5261,0.191218399543813,0,0,441,1616,10,7348,23,1392,7,23
"1442","2020-04-30",197,17,212,668,5261,0.191218399543813,0,0,441,1616,4,7352,15,1407,3,15
"1443","2020-05-01",188,17,195,660,5261,0.191218399543813,0,0,441,1616,7,7359,10,1417,5,10
"1444","2020-05-02",177,17,173,656,5261,0.191218399543813,0,0,441,1616,5,7364,13,1430,2,13
"1445","2020-05-03",182,17,190,646,5261,0.191218399543813,0,0,441,1616,6,7370,14,1444,4,14
"1446","2020-05-04",180,17,196,637,5261,0.191218399543813,0,0,441,1616,7,7377,34,1478,4,34
"1447","2020-05-05",183,17,271,628,5261,0.191218399543813,0,0,441,1616,6,7383,68,1546,5,68
"1448","2020-05-06",181,17,292,623,5261,0.191218399543813,0,0,441,1616,7,7390,24,1570,3,24
"1449","2020-05-07",176,17,293,630,5261,0.191218399543813,0,0,441,1616,3,7393,14,1584,3,14
"1450","2020-05-08",181,17,300,639,5261,0.191218399543813,0,0,441,1616,2,7395,10,1594,1,10
"1451","2020-05-09",173,17,301,621,5261,0.191218399543813,0,0,441,1616,5,7400,17,1611,2,17
"1452","2020-05-10",177,17,300,603,5261,0.191218399543813,0,0,441,1616,6,7406,25,1636,5,25
"1453","2020-05-11",180,17,291,597,5261,0.191218399543813,0,0,441,1616,5,7411,41,1677,3,41
"1454","2020-05-12",174,17,287,572,5261,0.191218399543813,0,0,441,1616,6,7417,24,1701,3,24
"1455","2020-05-13",167,17,261,556,5261,0.191218399543813,0,0,441,1616,6,7423,35,1736,3,35
"1456","2020-05-14",165,17,273,551,5261,0.191218399543813,0,0,441,1616,2,7425,62,1798,2,62
"1457","2020-05-15",168,17,263,539,5261,0.191218399543813,0,0,441,1616,4,7429,25,1823,3,25
"1458","2020-05-16",170,17,266,533,5261,0.191218399543813,0,0,441,1616,6,7435,29,1852,5,29
"1459","2020-05-17",154,17,277,512,5261,0.191218399543813,0,0,441,1616,2,7437,56,1908,2,56
"1460","2020-05-18",145,17,265,490,5261,0.191218399543813,0,0,441,1616,4,7441,46,1954,2,46
"1461","2020-05-19",141,17,233,491,5261,0.191218399543813,0,0,441,1616,4,7445,42,1996,3,42
"1462","2020-05-20",145,17,211,483,5261,0.191218399543813,0,0,441,1616,4,7449,49,2045,2,49
"1463","2020-05-21",144,17,213,477,5261,0.191218399543813,0,0,441,1616,3,7452,34,2079,2,34
"1464","2020-05-22",135,17,217,463,5261,0.191218399543813,0,0,441,1616,3,7455,21,2100,3,21
"1465","2020-05-23",134,17,227,437,5261,0.191218399543813,0,0,441,1616,2,7457,28,2128,1,28
"1466","2020-05-24",127,17,213,425,5261,0.191218399543813,0,0,441,1616,3,7460,19,2147,2,19
"1467","2020-05-25",127,17,224,416,5261,0.191218399543813,0,0,441,1616,3,7463,21,2168,2,21
"1468","2020-05-26",123,17,223,402,5261,0.191218399543813,0,0,441,1616,2,7465,33,2201,2,33
"1469","2020-05-27",120,17,238,401,5261,0.191218399543813,0,0,441,1616,4,7469,51,2252,4,51
"1470","2020-05-28",113,17,230,377,5261,0.191218399543813,0,0,441,1616,2,7471,22,2274,1,22
"1471","2020-05-29",112,17,221,363,5261,0.191218399543813,0,0,441,1616,2,7473,8,2282,2,8
"1472","2020-05-30",104,17,221,346,5261,0.191218399543813,0,0,441,1616,4,7477,16,2298,4,16
"1473","2020-05-31",109,17,268,346,5261,0.191218399543813,0,0,441,1616,2,7479,17,2315,NA,17
"1474","2020-06-01",103,17,287,332,5261,0.191218399543813,0,0,441,1616,5,7484,43,2358,3,43
"1475","2020-06-02",102,17,269,319,5261,0.191218399543813,0,0,441,1616,1,7485,45,2403,1,45
"1476","2020-06-03",95,17,230,318,5261,0.191218399543813,0,0,441,1616,1,7486,24,2427,1,24
"1477","2020-06-04",91,17,214,305,5261,0.191218399543813,0,0,441,1616,2,7488,28,2455,2,28
"1478","2020-06-05",77,17,233,290,5261,0.191218399543813,0,0,441,1616,3,7491,15,2470,NA,15
"1479","2020-06-06",81,17,230,284,5261,0.191218399543813,0,0,441,1616,NA,NA,18,2488,NA,18
"1480","2020-06-07",76,17,244,273,5261,0.191218399543813,0,0,441,1616,1,7492,35,2523,NA,35
"1481","2020-03-13",2,18,163,90,4457,0.473636975544088,0,0,363,2433,23,44,32,107,3,32
"1482","2020-03-14",5,18,231,126,4457,0.473636975544088,0,0,363,2433,20,64,46,153,5,46
"1483","2020-03-15",8,18,259,166,4457,0.473636975544088,0,0,363,2433,19,83,23,176,8,23
"1484","2020-03-16",16,18,317,200,4457,0.473636975544088,0,0,363,2433,26,109,32,208,7,32
"1485","2020-03-17",20,18,354,238,4457,0.473636975544088,0,0,363,2433,17,126,28,236,4,28
"1486","2020-03-18",33,18,302,284,4457,0.473636975544088,0,0,363,2433,30,156,41,277,17,41
"1487","2020-03-19",47,18,272,317,4457,0.473636975544088,0,0,363,2433,21,177,28,305,11,28
"1488","2020-03-20",61,18,261,365,4457,0.473636975544088,0,0,363,2433,25,202,19,324,4,19
"1489","2020-03-21",73,18,235,411,4457,0.473636975544088,0,0,363,2433,22,224,16,340,10,16
"1490","2020-03-22",88,18,219,451,4457,0.473636975544088,0,0,363,2433,22,246,27,367,8,27
"1491","2020-03-23",94,18,234,490,4457,0.473636975544088,0,0,363,2433,22,268,22,389,8,22
"1492","2020-03-24",106,18,221,526,4457,0.473636975544088,0,0,363,2433,22,290,12,401,10,12
"1493","2020-03-25",114,18,229,557,4457,0.473636975544088,0,0,363,2433,26,316,20,421,12,20
"1494","2020-03-26",115,18,243,592,4457,0.473636975544088,0,0,363,2433,36,352,29,450,23,29
"1495","2020-03-27",119,18,236,601,4457,0.473636975544088,0,0,363,2433,26,378,33,483,12,33
"1496","2020-03-28",131,18,232,597,4457,0.473636975544088,0,0,363,2433,29,407,49,532,12,49
"1497","2020-03-29",138,18,217,618,4457,0.473636975544088,0,0,363,2433,35,442,56,588,18,56
"1498","2020-03-30",160,18,234,643,4457,0.473636975544088,0,0,363,2433,35,477,26,614,13,26
"1499","2020-03-31",169,18,221,643,4457,0.473636975544088,0,0,363,2433,36,513,13,627,19,13
"1500","2020-04-01",172,18,190,654,4457,0.473636975544088,0,0,363,2433,34,547,12,639,18,12
"1501","2020-04-02",169,18,197,658,4457,0.473636975544088,0,0,363,2433,37,584,13,652,25,13
"1502","2020-04-03",168,18,203,669,4457,0.473636975544088,0,0,363,2433,38,622,17,669,20,17
"1503","2020-04-04",166,18,194,660,4457,0.473636975544088,0,0,363,2433,44,666,33,702,24,33
"1504","2020-04-05",169,18,170,663,4457,0.473636975544088,0,0,363,2433,32,698,56,758,19,56
"1505","2020-04-06",158,18,155,674,4457,0.473636975544088,0,0,363,2433,41,739,44,802,13,44
"1506","2020-04-07",172,18,159,691,4457,0.473636975544088,0,0,363,2433,24,763,28,830,6,28
"1507","2020-04-08",171,18,146,672,4457,0.473636975544088,0,0,363,2433,22,785,22,852,4,22
"1508","2020-04-09",178,18,135,686,4457,0.473636975544088,0,0,363,2433,32,817,11,863,14,11
"1509","2020-04-10",191,18,143,713,4457,0.473636975544088,0,0,363,2433,29,846,15,878,12,15
"1510","2020-04-11",193,18,137,708,4457,0.473636975544088,0,0,363,2433,44,890,46,924,22,46
"1511","2020-04-12",189,18,208,729,4457,0.473636975544088,0,0,363,2433,29,919,31,955,11,31
"1512","2020-04-13",198,18,237,730,4457,0.473636975544088,0,0,363,2433,41,960,11,966,15,11
"1513","2020-04-14",189,18,207,725,4457,0.473636975544088,0,0,363,2433,29,989,36,1002,15,36
"1514","2020-04-15",202,18,209,729,4457,0.473636975544088,0,0,363,2433,34,1023,23,1025,11,23
"1515","2020-04-16",210,18,288,741,4457,0.473636975544088,0,0,363,2433,30,1053,15,1040,6,15
"1516","2020-04-17",202,18,299,737,4457,0.473636975544088,0,0,363,2433,25,1078,6,1046,12,6
"1517","2020-04-18",210,18,281,734,4457,0.473636975544088,0,0,363,2433,26,1104,10,1056,7,10
"1518","2020-04-19",218,18,263,726,4457,0.473636975544088,0,0,363,2433,33,1137,6,1062,17,6
"1519","2020-04-20",203,18,258,724,4457,0.473636975544088,0,0,363,2433,34,1171,31,1093,14,31
"1520","2020-04-21",198,18,249,732,4457,0.473636975544088,0,0,363,2433,30,1201,28,1121,16,28
"1521","2020-04-22",192,18,230,722,4457,0.473636975544088,0,0,363,2433,38,1239,25,1146,19,25
"1522","2020-04-23",195,18,231,705,4457,0.473636975544088,0,0,363,2433,35,1274,16,1162,7,16
"1523","2020-04-24",195,18,233,685,4457,0.473636975544088,0,0,363,2433,36,1310,9,1171,14,9
"1524","2020-04-25",182,18,239,679,4457,0.473636975544088,0,0,363,2433,40,1350,11,1182,15,11
"1525","2020-04-26",178,18,249,675,4457,0.473636975544088,0,0,363,2433,32,1382,48,1230,14,48
"1526","2020-04-27",185,18,220,666,4457,0.473636975544088,0,0,363,2433,30,1412,42,1272,12,42
"1527","2020-04-28",188,18,246,676,4457,0.473636975544088,0,0,363,2433,32,1444,20,1292,11,20
"1528","2020-04-29",186,18,240,651,4457,0.473636975544088,0,0,363,2433,41,1485,31,1323,16,31
"1529","2020-04-30",181,18,264,662,4457,0.473636975544088,0,0,363,2433,29,1514,41,1364,19,41
"1530","2020-05-01",173,18,259,639,4457,0.473636975544088,0,0,363,2433,34,1548,29,1393,14,29
"1531","2020-05-02",190,18,231,620,4457,0.473636975544088,0,0,363,2433,31,1579,31,1424,14,31
"1532","2020-05-03",181,18,213,605,4457,0.473636975544088,0,0,363,2433,31,1610,19,1443,14,19
"1533","2020-05-04",185,18,209,586,4457,0.473636975544088,0,0,363,2433,30,1640,14,1457,10,14
"1534","2020-05-05",175,18,203,589,4457,0.473636975544088,0,0,363,2433,32,1672,13,1470,7,13
"1535","2020-05-06",171,18,229,581,4457,0.473636975544088,0,0,363,2433,39,1711,10,1480,16,10
"1536","2020-05-07",177,18,217,567,4457,0.473636975544088,0,0,363,2433,40,1751,14,1494,21,14
"1537","2020-05-08",179,18,210,575,4457,0.473636975544088,0,0,363,2433,22,1773,20,1514,11,20
"1538","2020-05-09",161,18,201,580,4457,0.473636975544088,0,0,363,2433,47,1820,20,1534,27,20
"1539","2020-05-10",173,18,182,576,4457,0.473636975544088,0,0,363,2433,39,1859,49,1583,21,49
"1540","2020-05-11",168,18,177,546,4457,0.473636975544088,0,0,363,2433,27,1886,30,1613,16,30
"1541","2020-05-12",168,18,167,550,4457,0.473636975544088,0,0,363,2433,31,1917,62,1675,19,62
"1542","2020-05-13",157,18,168,535,4457,0.473636975544088,0,0,363,2433,32,1949,45,1720,17,45
"1543","2020-05-14",153,18,173,530,4457,0.473636975544088,0,0,363,2433,31,1980,20,1740,14,20
"1544","2020-05-15",155,18,236,516,4457,0.473636975544088,0,0,363,2433,25,2005,21,1761,10,21
"1545","2020-05-16",155,18,245,497,4457,0.473636975544088,0,0,363,2433,26,2031,41,1802,15,41
"1546","2020-05-17",139,18,240,475,4457,0.473636975544088,0,0,363,2433,28,2059,61,1863,13,61
"1547","2020-05-18",130,18,214,453,4457,0.473636975544088,0,0,363,2433,22,2081,28,1891,9,28
"1548","2020-05-19",140,18,252,418,4457,0.473636975544088,0,0,363,2433,27,2108,15,1906,8,15
"1549","2020-05-20",144,18,278,402,4457,0.473636975544088,0,0,363,2433,21,2129,19,1925,8,19
"1550","2020-05-21",133,18,317,397,4457,0.473636975544088,0,0,363,2433,12,2141,13,1938,7,13
"1551","2020-05-22",130,18,293,382,4457,0.473636975544088,0,0,363,2433,17,2158,13,1951,8,13
"1552","2020-05-23",127,18,269,362,4457,0.473636975544088,0,0,363,2433,24,2182,25,1976,7,25
"1553","2020-05-24",123,18,287,360,4457,0.473636975544088,0,0,363,2433,21,2203,33,2009,11,33
"1554","2020-05-25",119,18,280,347,4457,0.473636975544088,0,0,363,2433,11,2214,32,2041,6,32
"1555","2020-05-26",103,18,252,329,4457,0.473636975544088,0,0,363,2433,32,2246,38,2079,20,38
"1556","2020-05-27",99,18,240,313,4457,0.473636975544088,0,0,363,2433,30,2276,49,2128,18,49
"1557","2020-05-28",97,18,229,305,4457,0.473636975544088,0,0,363,2433,20,2296,37,2165,9,37
"1558","2020-05-29",94,18,244,300,4457,0.473636975544088,0,0,363,2433,30,2326,20,2185,14,20
"1559","2020-05-30",87,18,234,291,4457,0.473636975544088,0,0,363,2433,26,2352,8,2193,10,8
"1560","2020-05-31",88,18,229,279,4457,0.473636975544088,0,0,363,2433,21,2373,8,2201,11,8
"1561","2020-06-01",84,18,249,270,4457,0.473636975544088,0,0,363,2433,13,2386,13,2214,7,13
"1562","2020-06-02",82,18,287,271,4457,0.473636975544088,0,0,363,2433,28,2414,14,2228,15,14
"1563","2020-06-03",79,18,310,249,4457,0.473636975544088,0,0,363,2433,28,2442,43,2271,16,43
"1564","2020-06-04",78,18,295,243,4457,0.473636975544088,0,0,363,2433,21,2463,19,2290,14,19
"1565","2020-06-05",78,18,258,235,4457,0.473636975544088,0,0,363,2433,27,2490,48,2338,18,48
"1566","2020-06-06",72,18,232,222,4457,0.473636975544088,0,0,363,2433,19,2509,22,2360,12,22
"1567","2020-06-07",69,18,240,216,4457,0.473636975544088,0,0,363,2433,20,2529,18,2378,15,18
"1568","2020-03-12",1,19,44,90,5079,0.165189998031108,0,0,462,961,64,114,33,91,1,33
"1569","2020-03-13",3,19,82,153,5079,0.165189998031108,0,0,462,961,68,182,43,134,10,43
"1570","2020-03-14",7,19,112,205,5079,0.165189998031108,0,0,462,961,54,236,23,157,4,23
"1571","2020-03-15",13,19,131,258,5079,0.165189998031108,0,0,462,961,69,305,14,171,20,14
"1572","2020-03-16",26,19,132,323,5079,0.165189998031108,0,0,462,961,69,374,15,186,18,15
"1573","2020-03-17",37,19,131,387,5079,0.165189998031108,0,0,462,961,62,436,56,242,13,56
"1574","2020-03-18",54,19,152,428,5079,0.165189998031108,0,0,462,961,75,511,30,272,13,30
"1575","2020-03-19",75,19,147,471,5079,0.165189998031108,0,0,462,961,70,581,19,291,25,19
"1576","2020-03-20",92,19,148,518,5079,0.165189998031108,0,0,462,961,67,648,28,319,19,28
"1577","2020-03-21",113,19,144,552,5079,0.165189998031108,0,0,462,961,83,731,66,385,22,66
"1578","2020-03-22",130,19,124,572,5079,0.165189998031108,0,0,462,961,89,820,58,443,33,58
"1579","2020-03-23",136,19,165,612,5079,0.165189998031108,0,0,462,961,86,906,50,493,33,50
"1580","2020-03-24",150,19,173,637,5079,0.165189998031108,0,0,462,961,84,990,30,523,32,30
"1581","2020-03-25",164,19,155,641,5079,0.165189998031108,0,0,462,961,72,1062,36,559,19,36
"1582","2020-03-26",168,19,156,654,5079,0.165189998031108,0,0,462,961,68,1130,65,624,29,65
"1583","2020-03-27",187,19,184,684,5079,0.165189998031108,0,0,462,961,72,1202,79,703,21,79
"1584","2020-03-28",190,19,177,682,5079,0.165189998031108,0,0,462,961,69,1271,26,729,20,26
"1585","2020-03-29",192,19,181,695,5079,0.165189998031108,0,0,462,961,72,1343,23,752,22,23
"1586","2020-03-30",199,19,171,684,5079,0.165189998031108,0,0,462,961,89,1432,65,817,26,65
"1587","2020-03-31",206,19,208,681,5079,0.165189998031108,0,0,462,961,71,1503,37,854,24,37
"1588","2020-04-01",204,19,238,716,5079,0.165189998031108,0,0,462,961,80,1583,57,911,25,57
"1589","2020-04-02",201,19,223,725,5079,0.165189998031108,0,0,462,961,82,1665,52,963,25,52
"1590","2020-04-03",188,19,218,721,5079,0.165189998031108,0,0,462,961,81,1746,24,987,27,24
"1591","2020-04-04",188,19,211,735,5079,0.165189998031108,0,0,462,961,74,1820,34,1021,17,34
"1592","2020-04-05",200,19,189,746,5079,0.165189998031108,0,0,462,961,76,1896,35,1056,28,35
"1593","2020-04-06",198,19,191,757,5079,0.165189998031108,0,0,462,961,89,1985,18,1074,28,18
"1594","2020-04-07",199,19,223,775,5079,0.165189998031108,0,0,462,961,79,2064,12,1086,16,12
"1595","2020-04-08",210,19,226,780,5079,0.165189998031108,0,0,462,961,101,2165,37,1123,31,37
"1596","2020-04-09",221,19,200,779,5079,0.165189998031108,0,0,462,961,89,2254,21,1144,17,21
"1597","2020-04-10",235,19,224,777,5079,0.165189998031108,0,0,462,961,74,2328,27,1171,19,27
"1598","2020-04-11",232,19,250,798,5079,0.165189998031108,0,0,462,961,80,2408,22,1193,22,22
"1599","2020-04-12",217,19,261,793,5079,0.165189998031108,0,0,462,961,67,2475,37,1230,24,37
"1600","2020-04-13",228,19,261,807,5079,0.165189998031108,0,0,462,961,68,2543,40,1270,16,40
"1601","2020-04-14",229,19,311,796,5079,0.165189998031108,0,0,462,961,79,2622,52,1322,24,52
"1602","2020-04-15",218,19,304,779,5079,0.165189998031108,0,0,462,961,102,2724,30,1352,31,30
"1603","2020-04-16",209,19,266,767,5079,0.165189998031108,0,0,462,961,78,2802,59,1411,21,59
"1604","2020-04-17",209,19,240,755,5079,0.165189998031108,0,0,462,961,76,2878,30,1441,12,30
"1605","2020-04-18",210,19,236,741,5079,0.165189998031108,0,0,462,961,89,2967,16,1457,17,16
"1606","2020-04-19",216,19,238,757,5079,0.165189998031108,0,0,462,961,66,3033,52,1509,12,52
"1607","2020-04-20",205,19,242,751,5079,0.165189998031108,0,0,462,961,75,3108,34,1543,21,34
"1608","2020-04-21",196,19,220,762,5079,0.165189998031108,0,0,462,961,90,3198,46,1589,21,46
"1609","2020-04-22",188,19,218,767,5079,0.165189998031108,0,0,462,961,86,3284,30,1619,18,30
"1610","2020-04-23",195,19,240,749,5079,0.165189998031108,0,0,462,961,80,3364,49,1668,16,49
"1611","2020-04-24",187,19,236,741,5079,0.165189998031108,0,0,462,961,74,3438,26,1694,21,26
"1612","2020-04-25",205,19,258,733,5079,0.165189998031108,0,0,462,961,66,3504,19,1713,20,19
"1613","2020-04-26",202,19,257,718,5079,0.165189998031108,0,0,462,961,72,3576,28,1741,15,28
"1614","2020-04-27",202,19,286,708,5079,0.165189998031108,0,0,462,961,77,3653,63,1804,21,64
"1615","2020-04-28",207,19,285,712,5079,0.165189998031108,0,0,462,961,69,3722,19,1823,13,19
"1616","2020-04-29",218,19,265,711,5079,0.165189998031108,0,0,462,961,51,3773,10,1833,9,10
"1617","2020-04-30",219,19,228,693,5079,0.165189998031108,0,0,462,961,58,3831,19,1852,14,19
"1618","2020-05-01",229,19,209,690,5079,0.165189998031108,0,0,462,961,56,3887,33,1885,13,33
"1619","2020-05-02",204,19,203,693,5079,0.165189998031108,0,0,462,961,67,3954,26,1911,12,26
"1620","2020-05-03",209,19,250,689,5079,0.165189998031108,0,0,462,961,71,4025,25,1936,21,25
"1621","2020-05-04",212,19,262,666,5079,0.165189998031108,0,0,462,961,66,4091,20,1956,8,20
"1622","2020-05-05",209,19,237,672,5079,0.165189998031108,0,0,462,961,62,4153,16,1972,13,16
"1623","2020-05-06",215,19,274,658,5079,0.165189998031108,0,0,462,961,52,4205,5,1977,8,5
"1624","2020-05-07",202,19,273,682,5079,0.165189998031108,0,0,462,961,48,4253,7,1984,14,7
"1625","2020-05-08",189,19,247,671,5079,0.165189998031108,0,0,462,961,53,4306,31,2015,14,31
"1626","2020-05-09",193,19,227,668,5079,0.165189998031108,0,0,462,961,45,4351,73,2088,9,73
"1627","2020-05-10",190,19,250,658,5079,0.165189998031108,0,0,462,961,44,4395,65,2153,4,65
"1628","2020-05-11",184,19,266,619,5079,0.165189998031108,0,0,462,961,53,4448,25,2178,6,25
"1629","2020-05-12",183,19,251,608,5079,0.165189998031108,0,0,462,961,43,4491,16,2194,6,16
"1630","2020-05-13",173,19,258,607,5079,0.165189998031108,0,0,462,961,30,4521,12,2206,4,12
"1631","2020-05-14",171,19,243,580,5079,0.165189998031108,0,0,462,961,39,4560,65,2271,7,65
"1632","2020-05-15",169,19,244,566,5079,0.165189998031108,0,0,462,961,45,4605,59,2330,8,59
"1633","2020-05-16",166,19,233,551,5079,0.165189998031108,0,0,462,961,36,4641,36,2366,9,36
"1634","2020-05-17",161,19,232,538,5079,0.165189998031108,0,0,462,961,52,4693,38,2404,11,38
"1635","2020-05-18",166,19,225,533,5079,0.165189998031108,0,0,462,961,40,4733,66,2470,14,66
"1636","2020-05-19",156,19,226,506,5079,0.165189998031108,0,0,462,961,29,4762,42,2512,5,42
"1637","2020-05-20",150,19,216,487,5079,0.165189998031108,0,0,462,961,44,4806,38,2550,12,38
"1638","2020-05-21",144,19,205,467,5079,0.165189998031108,0,0,462,961,35,4841,44,2594,7,44
"1639","2020-05-22",139,19,196,451,5079,0.165189998031108,0,0,462,961,36,4877,32,2626,7,32
"1640","2020-05-23",138,19,216,456,5079,0.165189998031108,0,0,462,961,29,4906,44,2670,7,44
"1641","2020-05-24",124,19,221,428,5079,0.165189998031108,0,0,462,961,31,4937,31,2701,8,31
"1642","2020-05-25",113,19,219,403,5079,0.165189998031108,0,0,462,961,21,4958,29,2730,3,29
"1643","2020-05-26",116,19,195,375,5079,0.165189998031108,0,0,462,961,27,4985,21,2751,2,21
"1644","2020-05-27",114,19,177,363,5079,0.165189998031108,0,0,462,961,23,5008,18,2769,5,18
"1645","2020-05-28",115,19,176,348,5079,0.165189998031108,0,0,462,961,27,5035,37,2806,5,37
"1646","2020-05-29",110,19,163,330,5079,0.165189998031108,0,0,462,961,19,5054,24,2830,4,24
"1647","2020-05-30",106,19,147,307,5079,0.165189998031108,0,0,462,961,26,5080,14,2844,7,14
"1648","2020-05-31",109,19,119,295,5079,0.165189998031108,0,0,462,961,28,5108,13,2857,10,13
"1649","2020-06-01",113,19,166,286,5079,0.165189998031108,0,0,462,961,25,5133,23,2880,8,23
"1650","2020-06-02",98,19,200,275,5079,0.165189998031108,0,0,462,961,15,5148,53,2933,5,53
"1651","2020-06-03",88,19,212,278,5079,0.165189998031108,0,0,462,961,21,5169,42,2975,4,42
"1652","2020-06-04",87,19,221,269,5079,0.165189998031108,0,0,462,961,14,5183,31,3006,3,31
"1653","2020-06-05",83,19,212,259,5079,0.165189998031108,0,0,462,961,23,5206,27,3033,4,27
"1654","2020-06-06",82,19,201,254,5079,0.165189998031108,0,0,462,961,17,5223,55,3088,3,55
"1655","2020-06-07",80,19,187,247,5079,0.165189998031108,0,0,462,961,12,5235,50,3138,3,50
"1656","2020-03-13",2,20,163,44,5237,0.824517853733053,0,0,443,1278,16,54,37,75,3,37
"1657","2020-03-14",2,20,143,62,5237,0.824517853733053,0,0,443,1278,26,80,33,108,7,33
"1658","2020-03-15",3,20,130,85,5237,0.824517853733053,0,0,443,1278,36,116,34,142,14,34
"1659","2020-03-16",5,20,119,118,5237,0.824517853733053,0,0,443,1278,34,150,20,162,13,20
"1660","2020-03-17",9,20,122,141,5237,0.824517853733053,0,0,443,1278,34,184,30,192,13,30
"1661","2020-03-18",15,20,202,172,5237,0.824517853733053,0,0,443,1278,50,234,24,216,28,24
"1662","2020-03-19",21,20,257,215,5237,0.824517853733053,0,0,443,1278,49,283,35,251,24,35
"1663","2020-03-20",24,20,256,252,5237,0.824517853733053,0,0,443,1278,38,321,49,300,18,49
"1664","2020-03-21",35,20,207,291,5237,0.824517853733053,0,0,443,1278,38,359,41,341,16,41
"1665","2020-03-22",58,20,179,342,5237,0.824517853733053,0,0,443,1278,40,399,52,393,22,52
"1666","2020-03-23",74,20,164,388,5237,0.824517853733053,0,0,443,1278,40,439,32,425,18,32
"1667","2020-03-24",84,20,151,440,5237,0.824517853733053,0,0,443,1278,33,472,33,458,10,33
"1668","2020-03-25",94,20,149,492,5237,0.824517853733053,0,0,443,1278,37,509,51,509,21,51
"1669","2020-03-26",115,20,157,531,5237,0.824517853733053,0,0,443,1278,40,549,52,561,19,52
"1670","2020-03-27",126,20,207,598,5237,0.824517853733053,0,0,443,1278,44,593,55,616,17,55
"1671","2020-03-28",135,20,250,647,5237,0.824517853733053,0,0,443,1278,49,642,56,672,15,56
"1672","2020-03-29",136,20,219,677,5237,0.824517853733053,0,0,443,1278,37,679,57,729,21,57
"1673","2020-03-30",145,20,207,735,5237,0.824517853733053,0,0,443,1278,54,733,54,783,28,54
"1674","2020-03-31",162,20,221,789,5237,0.824517853733053,0,0,443,1278,51,784,35,818,17,35
"1675","2020-04-01",170,20,231,855,5237,0.824517853733053,0,0,443,1278,61,845,28,846,32,28
"1676","2020-04-02",180,20,206,911,5237,0.824517853733053,0,0,443,1278,50,895,73,919,22,73
"1677","2020-04-03",205,20,189,933,5237,0.824517853733053,0,0,443,1278,33,928,49,968,10,49
"1678","2020-04-04",220,20,179,965,5237,0.824517853733053,0,0,443,1278,40,968,31,999,15,31
"1679","2020-04-05",225,20,148,1006,5237,0.824517853733053,0,0,443,1278,31,999,29,1028,7,29
"1680","2020-04-06",242,20,156,1035,5237,0.824517853733053,0,0,443,1278,35,1034,26,1054,13,26
"1681","2020-04-07",257,20,164,1081,5237,0.824517853733053,0,0,443,1278,37,1071,35,1089,17,35
"1682","2020-04-08",279,20,261,1099,5237,0.824517853733053,0,0,443,1278,48,1119,36,1125,21,36
"1683","2020-04-09",294,20,310,1123,5237,0.824517853733053,0,0,443,1278,33,1152,45,1170,14,45
"1684","2020-04-10",291,20,291,1142,5237,0.824517853733053,0,0,443,1278,42,1194,50,1220,16,50
"1685","2020-04-11",302,20,274,1135,5237,0.824517853733053,0,0,443,1278,46,1240,59,1279,18,59
"1686","2020-04-12",318,20,251,1099,5237,0.824517853733053,0,0,443,1278,49,1289,51,1330,19,51
"1687","2020-04-13",320,20,239,1097,5237,0.824517853733053,0,0,443,1278,38,1327,31,1361,12,31
"1688","2020-04-14",327,20,218,1080,5237,0.824517853733053,0,0,443,1278,49,1376,43,1404,26,43
"1689","2020-04-15",328,20,217,1108,5237,0.824517853733053,0,0,443,1278,45,1421,28,1432,16,28
"1690","2020-04-16",313,20,200,1106,5237,0.824517853733053,0,0,443,1278,49,1470,30,1462,27,30
"1691","2020-04-17",314,20,182,1116,5237,0.824517853733053,0,0,443,1278,35,1505,55,1517,15,55
"1692","2020-04-18",308,20,199,1106,5237,0.824517853733053,0,0,443,1278,50,1555,69,1586,19,69
"1693","2020-04-19",308,20,263,1092,5237,0.824517853733053,0,0,443,1278,50,1605,52,1638,18,52
"1694","2020-04-20",309,20,300,1069,5237,0.824517853733053,0,0,443,1278,59,1664,42,1680,23,42
"1695","2020-04-21",313,20,329,1039,5237,0.824517853733053,0,0,443,1278,55,1719,49,1729,21,49
"1696","2020-04-22",314,20,302,1026,5237,0.824517853733053,0,0,443,1278,31,1750,46,1775,9,46
"1697","2020-04-23",311,20,324,1008,5237,0.824517853733053,0,0,443,1278,47,1797,33,1808,15,33
"1698","2020-04-24",314,20,322,1027,5237,0.824517853733053,0,0,443,1278,28,1825,43,1851,13,43
"1699","2020-04-25",315,20,277,1018,5237,0.824517853733053,0,0,443,1278,45,1870,39,1890,13,39
"1700","2020-04-26",318,20,277,999,5237,0.824517853733053,0,0,443,1278,33,1903,38,1928,9,38
"1701","2020-04-27",312,20,242,991,5237,0.824517853733053,0,0,443,1278,37,1940,49,1977,12,49
"1702","2020-04-28",299,20,237,956,5237,0.824517853733053,0,0,443,1278,42,1982,31,2008,20,31
"1703","2020-04-29",292,20,221,919,5237,0.824517853733053,0,0,443,1278,35,2017,36,2044,10,36
"1704","2020-04-30",294,20,213,861,5237,0.824517853733053,0,0,443,1278,44,2061,37,2081,9,37
"1705","2020-05-01",290,20,184,831,5237,0.824517853733053,0,0,443,1278,37,2098,30,2111,9,30
"1706","2020-05-02",279,20,186,802,5237,0.824517853733053,0,0,443,1278,35,2133,37,2148,8,37
"1707","2020-05-03",257,20,183,765,5237,0.824517853733053,0,0,443,1278,36,2169,44,2192,9,44
"1708","2020-05-04",247,20,186,720,5237,0.824517853733053,0,0,443,1278,43,2212,42,2234,17,42
"1709","2020-05-05",225,20,187,675,5237,0.824517853733053,0,0,443,1278,42,2254,57,2291,15,57
"1710","2020-05-06",205,20,225,660,5237,0.824517853733053,0,0,443,1278,30,2284,42,2333,9,42
"1711","2020-05-07",192,20,225,648,5237,0.824517853733053,0,0,443,1278,37,2321,39,2372,8,39
"1712","2020-05-08",182,20,227,621,5237,0.824517853733053,0,0,443,1278,27,2348,44,2416,11,44
"1713","2020-05-09",176,20,224,600,5237,0.824517853733053,0,0,443,1278,37,2385,39,2455,11,39
"1714","2020-05-10",174,20,213,570,5237,0.824517853733053,0,0,443,1278,36,2421,60,2515,14,60
"1715","2020-05-11",166,20,204,546,5237,0.824517853733053,0,0,443,1278,38,2459,72,2587,11,72
"1716","2020-05-12",168,20,215,524,5237,0.824517853733053,0,0,443,1278,32,2491,61,2648,7,61
"1717","2020-05-13",164,20,195,489,5237,0.824517853733053,0,0,443,1278,24,2515,36,2684,8,36
"1718","2020-05-14",163,20,203,469,5237,0.824517853733053,0,0,443,1278,26,2541,52,2736,6,52
"1719","2020-05-15",154,20,221,437,5237,0.824517853733053,0,0,443,1278,28,2569,44,2780,7,44
"1720","2020-05-16",139,20,235,430,5237,0.824517853733053,0,0,443,1278,22,2591,33,2813,6,33
"1721","2020-05-17",132,20,246,408,5237,0.824517853733053,0,0,443,1278,34,2625,59,2872,6,59
"1722","2020-05-18",127,20,282,376,5237,0.824517853733053,0,0,443,1278,27,2652,33,2905,5,33
"1723","2020-05-19",116,20,252,369,5237,0.824517853733053,0,0,443,1278,31,2683,34,2939,8,34
"1724","2020-05-20",118,20,216,354,5237,0.824517853733053,0,0,443,1278,30,2713,37,2976,6,37
"1725","2020-05-21",108,20,201,339,5237,0.824517853733053,0,0,443,1278,28,2741,31,3007,7,31
"1726","2020-05-22",102,20,228,329,5237,0.824517853733053,0,0,443,1278,20,2761,29,3036,6,29
"1727","2020-05-23",112,20,251,309,5237,0.824517853733053,0,0,443,1278,34,2795,55,3091,13,55
"1728","2020-05-24",103,20,244,300,5237,0.824517853733053,0,0,443,1278,25,2820,61,3152,11,61
"1729","2020-05-25",104,20,240,292,5237,0.824517853733053,0,0,443,1278,22,2842,37,3189,6,37
"1730","2020-05-26",103,20,233,289,5237,0.824517853733053,0,0,443,1278,16,2858,43,3232,7,43
"1731","2020-05-27",94,20,218,279,5237,0.824517853733053,0,0,443,1278,18,2876,43,3275,5,43
"1732","2020-05-28",94,20,201,268,5237,0.824517853733053,0,0,443,1278,13,2889,36,3311,4,36
"1733","2020-05-29",89,20,202,260,5237,0.824517853733053,0,0,443,1278,16,2905,35,3346,7,35
"1734","2020-05-30",91,20,211,248,5237,0.824517853733053,0,0,443,1278,23,2928,30,3376,8,30
"1735","2020-05-31",98,20,219,249,5237,0.824517853733053,0,0,443,1278,28,2956,29,3405,13,29
"1736","2020-06-01",87,20,207,252,5237,0.824517853733053,0,0,443,1278,18,2974,45,3450,7,45
"1737","2020-06-02",85,20,211,257,5237,0.824517853733053,0,0,443,1278,20,2994,46,3496,10,46
"1738","2020-06-03",81,20,215,249,5237,0.824517853733053,0,0,443,1278,20,3014,39,3535,9,39
"1739","2020-06-04",85,20,227,241,5237,0.824517853733053,0,0,443,1278,19,3033,45,3580,9,45
"1740","2020-06-05",89,20,223,238,5237,0.824517853733053,0,0,443,1278,22,3055,52,3632,13,52
"1741","2020-06-06",77,20,226,226,5237,0.824517853733053,0,0,443,1278,9,3064,68,3700,6,68
"1742","2020-06-07",68,20,206,219,5237,0.824517853733053,0,0,443,1278,6,3070,55,3755,NA,55
