"","Date","Absents","Paramset","Infections_or_Exposed_per_day_Patient","Infections_or_Exposed_per_day_HCW","total_infections","nosocomial_proportion","PCR_pooled","LFD_pooled","HCW_symp_test","patient_symp_test","new_hcw_infs","cumulative_hcw_infs","new_pat_infs","cumulative_pats_infs","new_nosocomial_hcw_infs","new_nosocomial_pat_infs"
"1","2020-03-12",1,1,26,108,5769,0.378401802738776,2085,8355,604,819,57,108,6,15,3,6
"2","2020-03-13",8,1,44,163,5769,0.378401802738776,2085,8355,604,819,55,163,12,27,9,12
"3","2020-03-14",22,1,54,212,5769,0.378401802738776,2085,8355,604,819,49,212,15,42,5,15
"4","2020-03-15",30,1,62,279,5769,0.378401802738776,2085,8355,604,819,67,279,11,53,22,11
"5","2020-03-16",36,1,65,332,5769,0.378401802738776,2085,8355,604,819,53,332,11,64,20,11
"6","2020-03-17",52,1,65,391,5769,0.378401802738776,2085,8355,604,819,60,392,8,72,20,8
"7","2020-03-18",66,1,82,466,5769,0.378401802738776,2085,8355,604,819,82,474,22,94,33,22
"8","2020-03-19",81,1,83,525,5769,0.378401802738776,2085,8355,604,819,82,556,9,103,40,9
"9","2020-03-20",113,1,79,577,5769,0.378401802738776,2085,8355,604,819,73,629,6,109,35,6
"10","2020-03-21",151,1,77,630,5769,0.378401802738776,2085,8355,604,819,76,705,14,123,35,14
"11","2020-03-22",190,1,76,693,5769,0.378401802738776,2085,8355,604,819,83,788,7,130,34,7
"12","2020-03-23",194,1,76,749,5769,0.378401802738776,2085,8355,604,819,89,877,9,139,37,9
"13","2020-03-24",197,1,98,807,5769,0.378401802738776,2085,8355,604,819,91,968,24,163,41,24
"14","2020-03-25",211,1,105,822,5769,0.378401802738776,2085,8355,604,819,68,1036,24,187,30,24
"15","2020-03-26",228,1,117,844,5769,0.378401802738776,2085,8355,604,819,81,1117,28,215,45,28
"16","2020-03-27",289,1,122,887,5769,0.378401802738776,2085,8355,604,819,95,1212,22,237,50,22
"17","2020-03-28",315,1,128,889,5769,0.378401802738776,2085,8355,604,819,91,1303,28,265,43,28
"18","2020-03-29",277,1,118,909,5769,0.378401802738776,2085,8355,604,819,91,1394,17,282,51,17
"19","2020-03-30",287,1,123,908,5769,0.378401802738776,2085,8355,604,819,83,1477,20,302,33,20
"20","2020-03-31",288,1,129,911,5769,0.378401802738776,2085,8355,604,819,88,1565,26,328,43,26
"21","2020-04-01",291,1,129,928,5769,0.378401802738776,2085,8355,604,819,98,1663,21,349,52,21
"22","2020-04-02",284,1,128,940,5769,0.378401802738776,2085,8355,604,819,87,1750,20,369,48,20
"23","2020-04-03",337,1,144,978,5769,0.378401802738776,2085,8355,604,819,96,1846,29,398,44,29
"24","2020-04-04",311,1,154,1001,5769,0.378401802738776,2085,8355,604,819,107,1953,22,420,44,22
"25","2020-04-05",333,1,134,989,5769,0.378401802738776,2085,8355,604,819,80,2033,10,430,41,10
"26","2020-04-06",332,1,131,989,5769,0.378401802738776,2085,8355,604,819,91,2124,16,446,45,16
"27","2020-04-07",332,1,142,1007,5769,0.378401802738776,2085,8355,604,819,89,2213,31,477,47,31
"28","2020-04-08",337,1,128,1016,5769,0.378401802738776,2085,8355,604,819,85,2298,14,491,36,14
"29","2020-04-09",340,1,102,1018,5769,0.378401802738776,2085,8355,604,819,89,2387,9,500,41,9
"30","2020-04-10",370,1,108,1025,5769,0.378401802738776,2085,8355,604,819,96,2483,9,509,46,9
"31","2020-04-11",385,1,119,1058,5769,0.378401802738776,2085,8355,604,819,107,2590,34,543,44,34
"32","2020-04-12",359,1,116,1053,5769,0.378401802738776,2085,8355,604,819,99,2689,19,562,57,19
"33","2020-04-13",350,1,114,1037,5769,0.378401802738776,2085,8355,604,819,68,2757,12,574,24,12
"34","2020-04-14",335,1,115,1025,5769,0.378401802738776,2085,8355,604,819,82,2839,14,588,33,14
"35","2020-04-15",332,1,113,1027,5769,0.378401802738776,2085,8355,604,819,88,2927,11,599,36,11
"36","2020-04-16",339,1,132,1049,5769,0.378401802738776,2085,8355,604,819,98,3025,40,639,44,40
"37","2020-04-17",334,1,165,1042,5769,0.378401802738776,2085,8355,604,819,86,3111,48,687,31,48
"38","2020-04-18",333,1,166,1011,5769,0.378401802738776,2085,8355,604,819,64,3175,30,717,20,30
"39","2020-04-19",300,1,173,989,5769,0.378401802738776,2085,8355,604,819,81,3256,31,748,38,31
"40","2020-04-20",302,1,183,962,5769,0.378401802738776,2085,8355,604,819,70,3326,40,788,26,40
"41","2020-04-21",299,1,175,952,5769,0.378401802738776,2085,8355,604,819,77,3403,27,815,35,27
"42","2020-04-22",300,1,162,943,5769,0.378401802738776,2085,8355,604,819,76,3479,23,838,34,23
"43","2020-04-23",299,1,165,931,5769,0.378401802738776,2085,8355,604,819,67,3546,32,870,25,32
"44","2020-04-24",326,1,155,889,5769,0.378401802738776,2085,8355,604,819,63,3609,24,894,25,24
"45","2020-04-25",351,1,145,856,5769,0.378401802738776,2085,8355,604,819,54,3663,14,908,29,14
"46","2020-04-26",329,1,163,851,5769,0.378401802738776,2085,8355,604,819,73,3736,44,952,35,44
"47","2020-04-27",304,1,162,848,5769,0.378401802738776,2085,8355,604,819,76,3812,29,981,27,29
"48","2020-04-28",307,1,172,840,5769,0.378401802738776,2085,8355,604,819,59,3871,39,1020,18,39
"49","2020-04-29",302,1,209,821,5769,0.378401802738776,2085,8355,604,819,58,3929,52,1072,23,52
"50","2020-04-30",293,1,222,797,5769,0.378401802738776,2085,8355,604,819,56,3985,51,1123,24,51
"51","2020-05-01",285,1,208,774,5769,0.378401802738776,2085,8355,604,819,47,4032,31,1154,26,31
"52","2020-05-02",289,1,203,764,5769,0.378401802738776,2085,8355,604,819,57,4089,37,1191,28,37
"53","2020-05-03",268,1,204,723,5769,0.378401802738776,2085,8355,604,819,41,4130,37,1228,17,37
"54","2020-05-04",280,1,182,711,5769,0.378401802738776,2085,8355,604,819,52,4182,23,1251,18,23
"55","2020-05-05",268,1,169,682,5769,0.378401802738776,2085,8355,604,819,51,4233,20,1271,15,20
"56","2020-05-06",266,1,193,664,5769,0.378401802738776,2085,8355,604,819,56,4289,39,1310,22,39
"57","2020-05-07",270,1,187,646,5769,0.378401802738776,2085,8355,604,819,40,4329,23,1333,6,23
"58","2020-05-08",240,1,174,633,5769,0.378401802738776,2085,8355,604,819,48,4377,27,1360,15,27
"59","2020-05-09",225,1,173,627,5769,0.378401802738776,2085,8355,604,819,55,4432,27,1387,20,27
"60","2020-05-10",233,1,161,603,5769,0.378401802738776,2085,8355,604,819,47,4479,14,1401,15,14
"61","2020-05-11",203,1,160,581,5769,0.378401802738776,2085,8355,604,819,36,4515,23,1424,15,23
"62","2020-05-12",200,1,168,562,5769,0.378401802738776,2085,8355,604,819,39,4554,18,1442,15,18
"63","2020-05-13",192,1,162,540,5769,0.378401802738776,2085,8355,604,819,41,4595,31,1473,18,31
"64","2020-05-14",185,1,149,521,5769,0.378401802738776,2085,8355,604,819,37,4632,19,1492,8,19
"65","2020-05-15",201,1,144,516,5769,0.378401802738776,2085,8355,604,819,37,4669,20,1512,13,20
"66","2020-05-16",193,1,124,491,5769,0.378401802738776,2085,8355,604,819,35,4704,14,1526,10,14
"67","2020-05-17",169,1,131,468,5769,0.378401802738776,2085,8355,604,819,33,4737,19,1545,12,19
"68","2020-05-18",164,1,139,452,5769,0.378401802738776,2085,8355,604,819,30,4767,33,1578,11,33
"69","2020-05-19",160,1,149,429,5769,0.378401802738776,2085,8355,604,819,29,4796,34,1612,12,34
"70","2020-05-20",165,1,162,422,5769,0.378401802738776,2085,8355,604,819,33,4829,22,1634,11,22
"71","2020-05-21",152,1,153,415,5769,0.378401802738776,2085,8355,604,819,36,4865,25,1659,14,25
"72","2020-05-22",143,1,156,407,5769,0.378401802738776,2085,8355,604,819,28,4893,24,1683,8,24
"73","2020-05-23",155,1,151,404,5769,0.378401802738776,2085,8355,604,819,24,4917,20,1703,10,20
"74","2020-05-24",145,1,144,389,5769,0.378401802738776,2085,8355,604,819,29,4946,19,1722,10,19
"75","2020-05-25",135,1,160,382,5769,0.378401802738776,2085,8355,604,819,23,4969,33,1755,8,33
"76","2020-05-26",132,1,174,377,5769,0.378401802738776,2085,8355,604,819,37,5006,30,1785,15,30
"77","2020-05-27",126,1,172,361,5769,0.378401802738776,2085,8355,604,819,25,5031,23,1808,7,23
"78","2020-05-28",126,1,187,354,5769,0.378401802738776,2085,8355,604,819,24,5055,36,1844,10,36
"79","2020-05-29",128,1,169,331,5769,0.378401802738776,2085,8355,604,819,16,5071,25,1869,6,25
"80","2020-05-30",111,1,156,303,5769,0.378401802738776,2085,8355,604,819,15,5086,17,1886,4,17
"81","2020-05-31",101,1,163,287,5769,0.378401802738776,2085,8355,604,819,15,5101,34,1920,6,34
"82","2020-06-01",101,1,158,280,5769,0.378401802738776,2085,8355,604,819,20,5121,30,1950,9,30
"83","2020-06-02",98,1,169,267,5769,0.378401802738776,2085,8355,604,819,13,5134,32,1982,5,32
"84","2020-06-03",88,1,172,254,5769,0.378401802738776,2085,8355,604,819,18,5152,31,2013,4,31
"85","2020-06-04",83,1,167,240,5769,0.378401802738776,2085,8355,604,819,17,5169,20,2033,11,20
"86","2020-06-05",76,1,176,232,5769,0.378401802738776,2085,8355,604,819,22,5191,36,2069,9,36
"87","2020-06-06",81,1,193,219,5769,0.378401802738776,2085,8355,604,819,20,5211,42,2111,8,42
"88","2020-06-07",80,1,178,211,5769,0.378401802738776,2085,8355,604,819,16,5227,15,2126,3,15
"89","2020-03-15",8,2,54,125,5740,0.702439024390244,2085,7531,591,618,48,205,23,92,7,23
"90","2020-03-16",9,2,55,159,5740,0.702439024390244,2085,7531,591,618,49,254,27,119,18,27
"91","2020-03-17",11,2,41,219,5740,0.702439024390244,2085,7531,591,618,57,311,14,133,33,14
"92","2020-03-18",21,2,55,258,5740,0.702439024390244,2085,7531,591,618,54,365,15,148,24,15
"93","2020-03-19",28,2,56,304,5740,0.702439024390244,2085,7531,591,618,64,429,19,167,30,19
"94","2020-03-20",45,2,54,364,5740,0.702439024390244,2085,7531,591,618,68,497,21,188,36,21
"95","2020-03-21",84,2,54,435,5740,0.702439024390244,2085,7531,591,618,82,579,24,212,40,24
"96","2020-03-22",99,2,58,483,5740,0.702439024390244,2085,7531,591,618,94,673,21,233,55,21
"97","2020-03-23",113,2,61,554,5740,0.702439024390244,2085,7531,591,618,91,764,31,264,50,31
"98","2020-03-24",129,2,60,617,5740,0.702439024390244,2085,7531,591,618,81,845,27,291,49,27
"99","2020-03-25",146,2,83,675,5740,0.702439024390244,2085,7531,591,618,92,937,30,321,56,30
"100","2020-03-26",166,2,101,739,5740,0.702439024390244,2085,7531,591,618,88,1025,23,344,58,23
"101","2020-03-27",207,2,90,792,5740,0.702439024390244,2085,7531,591,618,106,1131,14,358,73,14
"102","2020-03-28",232,2,95,867,5740,0.702439024390244,2085,7531,591,618,96,1227,15,373,57,15
"103","2020-03-29",244,2,88,919,5740,0.702439024390244,2085,7531,591,618,72,1299,36,409,45,36
"104","2020-03-30",253,2,75,978,5740,0.702439024390244,2085,7531,591,618,83,1382,38,447,58,38
"105","2020-03-31",259,2,70,1034,5740,0.702439024390244,2085,7531,591,618,100,1482,30,477,60,30
"106","2020-04-01",282,2,70,1096,5740,0.702439024390244,2085,7531,591,618,102,1584,38,515,67,38
"107","2020-04-02",300,2,71,1132,5740,0.702439024390244,2085,7531,591,618,97,1681,46,561,72,46
"108","2020-04-03",371,2,82,1153,5740,0.702439024390244,2085,7531,591,618,86,1767,34,595,53,34
"109","2020-04-04",407,2,98,1197,5740,0.702439024390244,2085,7531,591,618,97,1864,34,629,64,34
"110","2020-04-05",410,2,94,1270,5740,0.702439024390244,2085,7531,591,618,91,1955,39,668,55,39
"111","2020-04-06",411,2,91,1306,5740,0.702439024390244,2085,7531,591,618,92,2047,33,701,53,33
"112","2020-04-07",419,2,89,1308,5740,0.702439024390244,2085,7531,591,618,102,2149,43,744,73,43
"113","2020-04-08",415,2,98,1296,5740,0.702439024390244,2085,7531,591,618,86,2235,49,793,45,49
"114","2020-04-09",423,2,117,1315,5740,0.702439024390244,2085,7531,591,618,89,2324,20,813,57,20
"115","2020-04-10",495,2,127,1350,5740,0.702439024390244,2085,7531,591,618,73,2397,55,868,39,55
"116","2020-04-11",470,2,120,1360,5740,0.702439024390244,2085,7531,591,618,92,2489,52,920,52,52
"117","2020-04-12",453,2,126,1343,5740,0.702439024390244,2085,7531,591,618,92,2581,40,960,56,40
"118","2020-04-13",443,2,132,1340,5740,0.702439024390244,2085,7531,591,618,85,2666,37,997,34,37
"119","2020-04-14",436,2,123,1324,5740,0.702439024390244,2085,7531,591,618,91,2757,26,1023,50,26
"120","2020-04-15",434,2,130,1321,5740,0.702439024390244,2085,7531,591,618,71,2828,23,1046,44,23
"121","2020-04-16",434,2,117,1313,5740,0.702439024390244,2085,7531,591,618,88,2916,24,1070,47,24
"122","2020-04-17",446,2,120,1282,5740,0.702439024390244,2085,7531,591,618,89,3005,24,1094,53,24
"123","2020-04-18",452,2,121,1251,5740,0.702439024390244,2085,7531,591,618,72,3077,25,1119,35,25
"124","2020-04-19",430,2,112,1234,5740,0.702439024390244,2085,7531,591,618,82,3159,28,1147,46,28
"125","2020-04-20",437,2,126,1194,5740,0.702439024390244,2085,7531,591,618,61,3220,35,1182,32,35
"126","2020-04-21",435,2,127,1164,5740,0.702439024390244,2085,7531,591,618,69,3289,39,1221,35,39
"127","2020-04-22",439,2,161,1122,5740,0.702439024390244,2085,7531,591,618,78,3367,45,1266,32,45
"128","2020-04-23",432,2,174,1094,5740,0.702439024390244,2085,7531,591,618,92,3459,29,1295,42,29
"129","2020-04-24",415,2,179,1054,5740,0.702439024390244,2085,7531,591,618,70,3529,23,1318,34,23
"130","2020-04-25",420,2,188,1016,5740,0.702439024390244,2085,7531,591,618,77,3606,30,1348,40,30
"131","2020-04-26",373,2,171,966,5740,0.702439024390244,2085,7531,591,618,79,3685,39,1387,50,39
"132","2020-04-27",345,2,153,921,5740,0.702439024390244,2085,7531,591,618,69,3754,28,1415,30,28
"133","2020-04-28",321,2,160,888,5740,0.702439024390244,2085,7531,591,618,73,3827,19,1434,34,19
"134","2020-04-29",301,2,142,852,5740,0.702439024390244,2085,7531,591,618,72,3899,20,1454,39,20
"135","2020-04-30",282,2,125,809,5740,0.702439024390244,2085,7531,591,618,43,3942,21,1475,21,21
"136","2020-05-01",282,2,153,764,5740,0.702439024390244,2085,7531,591,618,74,4016,42,1517,43,42
"137","2020-05-02",270,2,154,741,5740,0.702439024390244,2085,7531,591,618,64,4080,38,1555,32,38
"138","2020-05-03",240,2,150,722,5740,0.702439024390244,2085,7531,591,618,55,4135,23,1578,26,23
"139","2020-05-04",236,2,130,698,5740,0.702439024390244,2085,7531,591,618,59,4194,23,1601,30,23
"140","2020-05-05",230,2,128,670,5740,0.702439024390244,2085,7531,591,618,52,4246,36,1637,23,36
"141","2020-05-06",226,2,146,640,5740,0.702439024390244,2085,7531,591,618,71,4317,36,1673,34,36
"142","2020-05-07",232,2,148,618,5740,0.702439024390244,2085,7531,591,618,34,4351,41,1714,17,41
"143","2020-05-08",210,2,137,587,5740,0.702439024390244,2085,7531,591,618,40,4391,26,1740,17,26
"144","2020-05-09",189,2,128,569,5740,0.702439024390244,2085,7531,591,618,47,4438,29,1769,32,29
"145","2020-05-10",208,2,124,543,5740,0.702439024390244,2085,7531,591,618,40,4478,23,1792,18,23
"146","2020-05-11",204,2,122,502,5740,0.702439024390244,2085,7531,591,618,49,4527,52,1844,22,52
"147","2020-05-12",198,2,113,483,5740,0.702439024390244,2085,7531,591,618,39,4566,39,1883,23,39
"148","2020-05-13",196,2,132,450,5740,0.702439024390244,2085,7531,591,618,48,4614,38,1921,25,38
"149","2020-05-14",181,2,136,427,5740,0.702439024390244,2085,7531,591,618,22,4636,27,1948,8,27
"150","2020-05-15",177,2,116,422,5740,0.702439024390244,2085,7531,591,618,31,4667,38,1986,12,38
"151","2020-05-16",179,2,117,393,5740,0.702439024390244,2085,7531,591,618,39,4706,28,2014,19,28
"152","2020-05-17",147,2,94,377,5740,0.702439024390244,2085,7531,591,618,27,4733,37,2051,16,37
"153","2020-05-18",136,2,102,349,5740,0.702439024390244,2085,7531,591,618,24,4757,41,2092,13,41
"154","2020-05-19",127,2,98,335,5740,0.702439024390244,2085,7531,591,618,26,4783,20,2112,6,20
"155","2020-05-20",113,2,116,312,5740,0.702439024390244,2085,7531,591,618,28,4811,25,2137,17,25
"156","2020-05-21",111,2,108,301,5740,0.702439024390244,2085,7531,591,618,32,4843,25,2162,22,25
"157","2020-05-22",100,2,95,287,5740,0.702439024390244,2085,7531,591,618,22,4865,16,2178,11,16
"158","2020-05-23",101,2,87,282,5740,0.702439024390244,2085,7531,591,618,28,4893,37,2215,10,37
"159","2020-05-24",102,2,89,277,5740,0.702439024390244,2085,7531,591,618,24,4917,36,2251,7,36
"160","2020-05-25",99,2,95,270,5740,0.702439024390244,2085,7531,591,618,19,4936,31,2282,9,31
"161","2020-05-26",95,2,90,256,5740,0.702439024390244,2085,7531,591,618,19,4955,42,2324,8,42
"162","2020-05-27",100,2,92,242,5740,0.702439024390244,2085,7531,591,618,18,4973,33,2357,8,33
"163","2020-05-28",93,2,74,226,5740,0.702439024390244,2085,7531,591,618,26,4999,16,2373,13,16
"164","2020-05-29",95,2,65,225,5740,0.702439024390244,2085,7531,591,618,13,5012,25,2398,6,25
"165","2020-05-30",87,2,66,220,5740,0.702439024390244,2085,7531,591,618,18,5030,31,2429,2,31
"166","2020-05-31",79,2,61,217,5740,0.702439024390244,2085,7531,591,618,18,5048,26,2455,10,26
"167","2020-06-01",72,2,76,207,5740,0.702439024390244,2085,7531,591,618,15,5063,32,2487,5,32
"168","2020-06-02",70,2,74,194,5740,0.702439024390244,2085,7531,591,618,26,5089,27,2514,14,27
"169","2020-06-03",65,2,72,180,5740,0.702439024390244,2085,7531,591,618,14,5103,33,2547,7,33
"170","2020-06-04",60,2,75,163,5740,0.702439024390244,2085,7531,591,618,18,5121,32,2579,12,32
"171","2020-06-05",63,2,68,156,5740,0.702439024390244,2085,7531,591,618,11,5132,26,2605,6,26
"172","2020-06-06",62,2,66,155,5740,0.702439024390244,2085,7531,591,618,16,5148,16,2621,8,16
"173","2020-06-07",55,2,60,146,5740,0.702439024390244,2085,7531,591,618,12,5160,29,2650,5,29
"174","2020-03-12",1,3,71,93,6399,0.570714174089701,1995,8357,693,1582,14,24,10,22,6,10
"175","2020-03-13",6,3,117,133,6399,0.570714174089701,1995,8357,693,1582,23,47,16,38,9,16
"176","2020-03-14",17,3,144,183,6399,0.570714174089701,1995,8357,693,1582,23,70,11,49,10,11
"177","2020-03-15",21,3,168,251,6399,0.570714174089701,1995,8357,693,1582,30,100,13,62,23,13
"178","2020-03-16",32,3,215,312,6399,0.570714174089701,1995,8357,693,1582,29,129,16,78,19,16
"179","2020-03-17",44,3,248,377,6399,0.570714174089701,1995,8357,693,1582,31,160,24,102,22,24
"180","2020-03-18",63,3,290,435,6399,0.570714174089701,1995,8357,693,1582,49,209,25,127,33,25
"181","2020-03-19",82,3,333,509,6399,0.570714174089701,1995,8357,693,1582,55,264,36,163,44,36
"182","2020-03-20",107,3,314,597,6399,0.570714174089701,1995,8357,693,1582,62,326,42,205,50,42
"183","2020-03-21",122,3,278,671,6399,0.570714174089701,1995,8357,693,1582,69,395,20,225,59,20
"184","2020-03-22",174,3,242,766,6399,0.570714174089701,1995,8357,693,1582,70,465,36,261,54,36
"185","2020-03-23",187,3,235,823,6399,0.570714174089701,1995,8357,693,1582,84,549,42,303,76,42
"186","2020-03-24",187,3,262,931,6399,0.570714174089701,1995,8357,693,1582,75,624,32,335,65,32
"187","2020-03-25",195,3,271,992,6399,0.570714174089701,1995,8357,693,1582,80,704,35,370,67,35
"188","2020-03-26",212,3,265,1085,6399,0.570714174089701,1995,8357,693,1582,97,801,45,415,81,45
"189","2020-03-27",305,3,250,1152,6399,0.570714174089701,1995,8357,693,1582,125,926,23,438,118,23
"190","2020-03-28",354,3,254,1220,6399,0.570714174089701,1995,8357,693,1582,132,1058,21,459,118,21
"191","2020-03-29",390,3,249,1262,6399,0.570714174089701,1995,8357,693,1582,117,1175,26,485,100,26
"192","2020-03-30",406,3,230,1292,6399,0.570714174089701,1995,8357,693,1582,131,1306,46,531,126,46
"193","2020-03-31",409,3,233,1303,6399,0.570714174089701,1995,8357,693,1582,127,1433,31,562,118,31
"194","2020-04-01",424,3,230,1328,6399,0.570714174089701,1995,8357,693,1582,136,1569,25,587,122,25
"195","2020-04-02",434,3,205,1364,6399,0.570714174089701,1995,8357,693,1582,148,1717,21,608,136,21
"196","2020-04-03",474,3,211,1365,6399,0.570714174089701,1995,8357,693,1582,146,1863,32,640,139,32
"197","2020-04-04",492,3,241,1405,6399,0.570714174089701,1995,8357,693,1582,135,1998,30,670,125,30
"198","2020-04-05",424,3,258,1408,6399,0.570714174089701,1995,8357,693,1582,145,2143,17,687,134,17
"199","2020-04-06",423,3,260,1432,6399,0.570714174089701,1995,8357,693,1582,121,2264,41,728,103,41
"200","2020-04-07",432,3,244,1420,6399,0.570714174089701,1995,8357,693,1582,150,2414,41,769,140,41
"201","2020-04-08",444,3,268,1378,6399,0.570714174089701,1995,8357,693,1582,178,2592,46,815,165,46
"202","2020-04-09",446,3,268,1362,6399,0.570714174089701,1995,8357,693,1582,130,2722,48,863,125,48
"203","2020-04-10",488,3,274,1368,6399,0.570714174089701,1995,8357,693,1582,137,2859,43,906,127,43
"204","2020-04-11",459,3,281,1352,6399,0.570714174089701,1995,8357,693,1582,144,3003,35,941,134,35
"205","2020-04-12",465,3,289,1343,6399,0.570714174089701,1995,8357,693,1582,181,3184,48,989,172,48
"206","2020-04-13",444,3,284,1307,6399,0.570714174089701,1995,8357,693,1582,140,3324,57,1046,135,57
"207","2020-04-14",434,3,292,1295,6399,0.570714174089701,1995,8357,693,1582,121,3445,30,1076,112,30
"208","2020-04-15",417,3,311,1263,6399,0.570714174089701,1995,8357,693,1582,131,3576,35,1111,122,35
"209","2020-04-16",414,3,311,1240,6399,0.570714174089701,1995,8357,693,1582,124,3700,31,1142,117,31
"210","2020-04-17",436,3,291,1189,6399,0.570714174089701,1995,8357,693,1582,115,3815,24,1166,107,24
"211","2020-04-18",453,3,302,1184,6399,0.570714174089701,1995,8357,693,1582,103,3918,39,1205,96,39
"212","2020-04-19",404,3,278,1156,6399,0.570714174089701,1995,8357,693,1582,108,4026,37,1242,98,37
"213","2020-04-20",401,3,261,1108,6399,0.570714174089701,1995,8357,693,1582,92,4118,34,1276,84,34
"214","2020-04-21",397,3,241,1080,6399,0.570714174089701,1995,8357,693,1582,91,4209,27,1303,84,27
"215","2020-04-22",398,3,229,1048,6399,0.570714174089701,1995,8357,693,1582,81,4290,46,1349,72,46
"216","2020-04-23",379,3,233,1025,6399,0.570714174089701,1995,8357,693,1582,84,4374,24,1373,75,24
"217","2020-04-24",376,3,264,980,6399,0.570714174089701,1995,8357,693,1582,78,4452,33,1406,72,33
"218","2020-04-25",380,3,286,953,6399,0.570714174089701,1995,8357,693,1582,83,4535,15,1421,71,15
"219","2020-04-26",348,3,304,944,6399,0.570714174089701,1995,8357,693,1582,63,4598,20,1441,50,20
"220","2020-04-27",313,3,288,877,6399,0.570714174089701,1995,8357,693,1582,58,4656,18,1459,49,18
"221","2020-04-28",307,3,280,847,6399,0.570714174089701,1995,8357,693,1582,77,4733,40,1499,72,40
"222","2020-04-29",303,3,275,823,6399,0.570714174089701,1995,8357,693,1582,55,4788,40,1539,46,40
"223","2020-04-30",303,3,273,801,6399,0.570714174089701,1995,8357,693,1582,66,4854,38,1577,58,38
"224","2020-05-01",306,3,279,759,6399,0.570714174089701,1995,8357,693,1582,59,4913,37,1614,55,37
"225","2020-05-02",284,3,285,753,6399,0.570714174089701,1995,8357,693,1582,40,4953,30,1644,35,30
"226","2020-05-03",251,3,294,723,6399,0.570714174089701,1995,8357,693,1582,40,4993,26,1670,36,26
"227","2020-05-04",249,3,297,722,6399,0.570714174089701,1995,8357,693,1582,33,5026,30,1700,29,30
"228","2020-05-05",237,3,302,690,6399,0.570714174089701,1995,8357,693,1582,36,5062,30,1730,32,30
"229","2020-05-06",223,3,285,652,6399,0.570714174089701,1995,8357,693,1582,42,5104,45,1775,32,45
"230","2020-05-07",219,3,294,638,6399,0.570714174089701,1995,8357,693,1582,37,5141,32,1807,31,32
"231","2020-05-08",206,3,292,602,6399,0.570714174089701,1995,8357,693,1582,28,5169,42,1849,21,42
"232","2020-05-09",213,3,296,587,6399,0.570714174089701,1995,8357,693,1582,30,5199,32,1881,23,32
"233","2020-05-10",190,3,289,557,6399,0.570714174089701,1995,8357,693,1582,33,5232,40,1921,25,40
"234","2020-05-11",179,3,299,529,6399,0.570714174089701,1995,8357,693,1582,39,5271,28,1949,32,28
"235","2020-05-12",169,3,293,502,6399,0.570714174089701,1995,8357,693,1582,33,5304,31,1980,26,31
"236","2020-05-13",165,3,296,489,6399,0.570714174089701,1995,8357,693,1582,28,5332,37,2017,26,37
"237","2020-05-14",167,3,289,478,6399,0.570714174089701,1995,8357,693,1582,32,5364,48,2065,30,48
"238","2020-05-15",167,3,316,442,6399,0.570714174089701,1995,8357,693,1582,15,5379,35,2100,11,35
"239","2020-05-16",169,3,303,418,6399,0.570714174089701,1995,8357,693,1582,24,5403,40,2140,19,40
"240","2020-05-17",152,3,315,398,6399,0.570714174089701,1995,8357,693,1582,27,5430,23,2163,23,23
"241","2020-05-18",156,3,327,376,6399,0.570714174089701,1995,8357,693,1582,28,5458,24,2187,23,24
"242","2020-05-19",154,3,336,365,6399,0.570714174089701,1995,8357,693,1582,22,5480,29,2216,20,29
"243","2020-05-20",150,3,369,350,6399,0.570714174089701,1995,8357,693,1582,21,5501,14,2230,13,14
"244","2020-05-21",140,3,364,332,6399,0.570714174089701,1995,8357,693,1582,26,5527,25,2255,18,25
"245","2020-05-22",128,3,350,319,6399,0.570714174089701,1995,8357,693,1582,15,5542,24,2279,14,24
"246","2020-05-23",112,3,362,302,6399,0.570714174089701,1995,8357,693,1582,14,5556,19,2298,10,19
"247","2020-05-24",100,3,339,279,6399,0.570714174089701,1995,8357,693,1582,20,5576,25,2323,15,25
"248","2020-05-25",94,3,317,266,6399,0.570714174089701,1995,8357,693,1582,14,5590,36,2359,12,36
"249","2020-05-26",81,3,298,255,6399,0.570714174089701,1995,8357,693,1582,11,5601,54,2413,4,54
"250","2020-05-27",79,3,276,247,6399,0.570714174089701,1995,8357,693,1582,17,5618,23,2436,13,23
"251","2020-05-28",73,3,251,236,6399,0.570714174089701,1995,8357,693,1582,20,5638,31,2467,13,31
"252","2020-05-29",69,3,251,215,6399,0.570714174089701,1995,8357,693,1582,19,5657,28,2495,16,28
"253","2020-05-30",79,3,240,213,6399,0.570714174089701,1995,8357,693,1582,15,5672,22,2517,12,22
"254","2020-05-31",78,3,252,203,6399,0.570714174089701,1995,8357,693,1582,18,5690,20,2537,15,20
"255","2020-06-01",69,3,252,192,6399,0.570714174089701,1995,8357,693,1582,14,5704,16,2553,11,16
"256","2020-06-02",71,3,255,193,6399,0.570714174089701,1995,8357,693,1582,13,5717,20,2573,10,20
"257","2020-06-03",71,3,257,182,6399,0.570714174089701,1995,8357,693,1582,10,5727,28,2601,5,28
"258","2020-06-04",71,3,283,187,6399,0.570714174089701,1995,8357,693,1582,8,5735,21,2622,6,21
"259","2020-06-05",74,3,278,184,6399,0.570714174089701,1995,8357,693,1582,10,5745,25,2647,9,25
"260","2020-06-06",72,3,266,168,6399,0.570714174089701,1995,8357,693,1582,11,5756,27,2674,7,27
"261","2020-06-07",65,3,268,156,6399,0.570714174089701,1995,8357,693,1582,12,5768,19,2693,12,19
"262","2020-03-13",2,4,113,62,5112,0.729655712050078,2055,7370,530,762,61,140,43,97,15,43
"263","2020-03-14",3,4,116,82,5112,0.729655712050078,2055,7370,530,762,64,204,32,129,22,32
"264","2020-03-15",12,4,141,119,5112,0.729655712050078,2055,7370,530,762,70,274,83,212,24,83
"265","2020-03-16",19,4,126,151,5112,0.729655712050078,2055,7370,530,762,59,333,66,278,36,66
"266","2020-03-17",19,4,125,195,5112,0.729655712050078,2055,7370,530,762,113,446,24,302,68,24
"267","2020-03-18",23,4,125,230,5112,0.729655712050078,2055,7370,530,762,84,530,16,318,36,16
"268","2020-03-19",31,4,146,255,5112,0.729655712050078,2055,7370,530,762,84,614,19,337,50,19
"269","2020-03-20",47,4,163,295,5112,0.729655712050078,2055,7370,530,762,90,704,65,402,51,65
"270","2020-03-21",78,4,174,352,5112,0.729655712050078,2055,7370,530,762,122,826,66,468,68,66
"271","2020-03-22",95,4,158,402,5112,0.729655712050078,2055,7370,530,762,101,927,57,525,65,57
"272","2020-03-23",101,4,151,445,5112,0.729655712050078,2055,7370,530,762,94,1021,43,568,58,43
"273","2020-03-24",103,4,160,478,5112,0.729655712050078,2055,7370,530,762,108,1129,27,595,75,27
"274","2020-03-25",116,4,153,531,5112,0.729655712050078,2055,7370,530,762,109,1238,18,613,69,18
"275","2020-03-26",128,4,144,585,5112,0.729655712050078,2055,7370,530,762,124,1362,15,628,73,15
"276","2020-03-27",152,4,120,631,5112,0.729655712050078,2055,7370,530,762,113,1475,13,641,71,13
"277","2020-03-28",169,4,114,667,5112,0.729655712050078,2055,7370,530,762,105,1580,13,654,64,13
"278","2020-03-29",189,4,126,723,5112,0.729655712050078,2055,7370,530,762,112,1692,6,660,72,6
"279","2020-03-30",187,4,146,760,5112,0.729655712050078,2055,7370,530,762,114,1806,35,695,69,35
"280","2020-03-31",201,4,171,798,5112,0.729655712050078,2055,7370,530,762,98,1904,35,730,60,35
"281","2020-04-01",211,4,176,834,5112,0.729655712050078,2055,7370,530,762,98,2002,64,794,56,64
"282","2020-04-02",223,4,184,873,5112,0.729655712050078,2055,7370,530,762,93,2095,69,863,58,69
"283","2020-04-03",273,4,183,895,5112,0.729655712050078,2055,7370,530,762,109,2204,40,903,76,40
"284","2020-04-04",282,4,164,957,5112,0.729655712050078,2055,7370,530,762,99,2303,66,969,58,66
"285","2020-04-05",287,4,169,999,5112,0.729655712050078,2055,7370,530,762,92,2395,51,1020,57,51
"286","2020-04-06",292,4,205,1032,5112,0.729655712050078,2055,7370,530,762,93,2488,27,1047,55,27
"287","2020-04-07",281,4,190,1044,5112,0.729655712050078,2055,7370,530,762,101,2589,25,1072,60,25
"288","2020-04-08",297,4,182,1102,5112,0.729655712050078,2055,7370,530,762,100,2689,48,1120,56,48
"289","2020-04-09",305,4,183,1122,5112,0.729655712050078,2055,7370,530,762,105,2794,49,1169,53,49
"290","2020-04-10",345,4,199,1129,5112,0.729655712050078,2055,7370,530,762,121,2915,63,1232,80,63
"291","2020-04-11",377,4,179,1148,5112,0.729655712050078,2055,7370,530,762,95,3010,60,1292,61,60
"292","2020-04-12",374,4,208,1169,5112,0.729655712050078,2055,7370,530,762,103,3113,50,1342,65,50
"293","2020-04-13",392,4,184,1174,5112,0.729655712050078,2055,7370,530,762,102,3215,43,1385,65,43
"294","2020-04-14",402,4,186,1180,5112,0.729655712050078,2055,7370,530,762,95,3310,29,1414,55,29
"295","2020-04-15",400,4,206,1162,5112,0.729655712050078,2055,7370,530,762,96,3406,51,1465,65,51
"296","2020-04-16",403,4,223,1144,5112,0.729655712050078,2055,7370,530,762,79,3485,45,1510,52,45
"297","2020-04-17",414,4,217,1144,5112,0.729655712050078,2055,7370,530,762,88,3573,29,1539,50,29
"298","2020-04-18",390,4,194,1139,5112,0.729655712050078,2055,7370,530,762,99,3672,14,1553,60,14
"299","2020-04-19",397,4,215,1117,5112,0.729655712050078,2055,7370,530,762,81,3753,13,1566,42,13
"300","2020-04-20",384,4,182,1099,5112,0.729655712050078,2055,7370,530,762,68,3821,12,1578,37,12
"301","2020-04-21",375,4,166,1050,5112,0.729655712050078,2055,7370,530,762,79,3900,31,1609,42,31
"302","2020-04-22",378,4,155,1022,5112,0.729655712050078,2055,7370,530,762,63,3963,42,1651,31,42
"303","2020-04-23",362,4,137,984,5112,0.729655712050078,2055,7370,530,762,76,4039,28,1679,43,28
"304","2020-04-24",375,4,140,939,5112,0.729655712050078,2055,7370,530,762,78,4117,11,1690,34,11
"305","2020-04-25",380,4,134,899,5112,0.729655712050078,2055,7370,530,762,67,4184,30,1720,41,30
"306","2020-04-26",341,4,150,858,5112,0.729655712050078,2055,7370,530,762,55,4239,39,1759,34,39
"307","2020-04-27",321,4,201,814,5112,0.729655712050078,2055,7370,530,762,71,4310,55,1814,34,55
"308","2020-04-28",303,4,190,781,5112,0.729655712050078,2055,7370,530,762,73,4383,34,1848,33,34
"309","2020-04-29",287,4,175,764,5112,0.729655712050078,2055,7370,530,762,66,4449,19,1867,34,19
"310","2020-04-30",286,4,194,756,5112,0.729655712050078,2055,7370,530,762,49,4498,34,1901,21,34
"311","2020-05-01",280,4,212,729,5112,0.729655712050078,2055,7370,530,762,64,4562,78,1979,32,78
"312","2020-05-02",278,4,195,704,5112,0.729655712050078,2055,7370,530,762,46,4608,43,2022,27,43
"313","2020-05-03",246,4,196,653,5112,0.729655712050078,2055,7370,530,762,51,4659,49,2071,19,49
"314","2020-05-04",243,4,205,658,5112,0.729655712050078,2055,7370,530,762,53,4712,30,2101,30,30
"315","2020-05-05",243,4,220,636,5112,0.729655712050078,2055,7370,530,762,68,4780,23,2124,38,23
"316","2020-05-06",238,4,222,601,5112,0.729655712050078,2055,7370,530,762,49,4829,23,2147,29,23
"317","2020-05-07",227,4,237,579,5112,0.729655712050078,2055,7370,530,762,35,4864,19,2166,13,19
"318","2020-05-08",214,4,226,551,5112,0.729655712050078,2055,7370,530,762,45,4909,13,2179,21,13
"319","2020-05-09",216,4,203,520,5112,0.729655712050078,2055,7370,530,762,44,4953,9,2188,24,9
"320","2020-05-10",185,4,212,488,5112,0.729655712050078,2055,7370,530,762,42,4995,16,2204,21,16
"321","2020-05-11",174,4,208,466,5112,0.729655712050078,2055,7370,530,762,39,5034,9,2213,20,9
"322","2020-05-12",174,4,189,433,5112,0.729655712050078,2055,7370,530,762,35,5069,12,2225,10,12
"323","2020-05-13",166,4,177,417,5112,0.729655712050078,2055,7370,530,762,50,5119,43,2268,23,43
"324","2020-05-14",171,4,166,387,5112,0.729655712050078,2055,7370,530,762,36,5155,39,2307,16,39
"325","2020-05-15",160,4,147,381,5112,0.729655712050078,2055,7370,530,762,31,5186,69,2376,14,69
"326","2020-05-16",135,4,160,378,5112,0.729655712050078,2055,7370,530,762,37,5223,67,2443,19,67
"327","2020-05-17",139,4,178,372,5112,0.729655712050078,2055,7370,530,762,36,5259,78,2521,22,78
"328","2020-05-18",135,4,193,356,5112,0.729655712050078,2055,7370,530,762,37,5296,26,2547,21,26
"329","2020-05-19",124,4,175,342,5112,0.729655712050078,2055,7370,530,762,32,5328,21,2568,9,21
"330","2020-05-20",117,4,159,332,5112,0.729655712050078,2055,7370,530,762,36,5364,26,2594,20,26
"331","2020-05-21",106,4,175,325,5112,0.729655712050078,2055,7370,530,762,30,5394,27,2621,16,27
"332","2020-05-22",109,4,183,328,5112,0.729655712050078,2055,7370,530,762,32,5426,61,2682,19,61
"333","2020-05-23",110,4,192,310,5112,0.729655712050078,2055,7370,530,762,30,5456,42,2724,20,42
"334","2020-05-24",106,4,195,292,5112,0.729655712050078,2055,7370,530,762,30,5486,52,2776,13,52
"335","2020-05-25",102,4,202,288,5112,0.729655712050078,2055,7370,530,762,25,5511,57,2833,14,57
"336","2020-05-26",92,4,178,287,5112,0.729655712050078,2055,7370,530,762,38,5549,54,2887,25,54
"337","2020-05-27",94,4,177,289,5112,0.729655712050078,2055,7370,530,762,33,5582,48,2935,18,48
"338","2020-05-28",93,4,195,286,5112,0.729655712050078,2055,7370,530,762,26,5608,75,3010,19,75
"339","2020-05-29",89,4,165,270,5112,0.729655712050078,2055,7370,530,762,28,5636,72,3082,15,72
"340","2020-05-30",103,4,163,260,5112,0.729655712050078,2055,7370,530,762,29,5665,61,3143,16,61
"341","2020-05-31",94,4,152,248,5112,0.729655712050078,2055,7370,530,762,26,5691,36,3179,18,36
"342","2020-06-01",84,4,171,247,5112,0.729655712050078,2055,7370,530,762,24,5715,30,3209,14,30
"343","2020-06-02",86,4,170,243,5112,0.729655712050078,2055,7370,530,762,19,5734,18,3227,11,18
"344","2020-06-03",80,4,164,233,5112,0.729655712050078,2055,7370,530,762,22,5756,25,3252,12,25
"345","2020-06-04",83,4,153,218,5112,0.729655712050078,2055,7370,530,762,18,5774,19,3271,9,19
"346","2020-06-05",79,4,139,203,5112,0.729655712050078,2055,7370,530,762,20,5794,13,3284,10,13
"347","2020-06-06",61,4,130,192,5112,0.729655712050078,2055,7370,530,762,16,5810,12,3296,9,12
"348","2020-06-07",58,4,127,181,5112,0.729655712050078,2055,7370,530,762,14,5824,21,3317,8,21
"349","2020-03-12",1,5,14,43,5469,0.650941671237886,2115,7425,483,529,13,28,29,48,1,29
"350","2020-03-13",2,5,15,72,5469,0.650941671237886,2115,7425,483,529,19,47,26,74,4,26
"351","2020-03-14",4,5,25,106,5469,0.650941671237886,2115,7425,483,529,19,66,28,102,4,28
"352","2020-03-15",7,5,43,139,5469,0.650941671237886,2115,7425,483,529,25,91,30,132,10,30
"353","2020-03-16",11,5,45,197,5469,0.650941671237886,2115,7425,483,529,27,118,19,151,16,19
"354","2020-03-17",12,5,46,264,5469,0.650941671237886,2115,7425,483,529,28,146,32,183,16,32
"355","2020-03-18",22,5,45,310,5469,0.650941671237886,2115,7425,483,529,30,176,23,206,16,23
"356","2020-03-19",31,5,51,382,5469,0.650941671237886,2115,7425,483,529,36,212,20,226,25,20
"357","2020-03-20",52,5,65,431,5469,0.650941671237886,2115,7425,483,529,39,251,34,260,28,34
"358","2020-03-21",92,5,61,488,5469,0.650941671237886,2115,7425,483,529,61,312,23,283,48,23
"359","2020-03-22",126,5,72,564,5469,0.650941671237886,2115,7425,483,529,68,380,48,331,55,48
"360","2020-03-23",121,5,85,601,5469,0.650941671237886,2115,7425,483,529,78,458,32,363,57,32
"361","2020-03-24",146,5,102,656,5469,0.650941671237886,2115,7425,483,529,64,522,44,407,47,44
"362","2020-03-25",166,5,104,726,5469,0.650941671237886,2115,7425,483,529,69,591,34,441,60,34
"363","2020-03-26",186,5,101,770,5469,0.650941671237886,2115,7425,483,529,113,704,34,475,103,34
"364","2020-03-27",261,5,113,808,5469,0.650941671237886,2115,7425,483,529,76,780,21,496,69,21
"365","2020-03-28",279,5,130,833,5469,0.650941671237886,2115,7425,483,529,104,884,27,523,95,27
"366","2020-03-29",269,5,150,865,5469,0.650941671237886,2115,7425,483,529,124,1008,18,541,109,18
"367","2020-03-30",293,5,141,890,5469,0.650941671237886,2115,7425,483,529,117,1125,17,558,108,17
"368","2020-03-31",294,5,136,947,5469,0.650941671237886,2115,7425,483,529,130,1255,17,575,115,17
"369","2020-04-01",304,5,132,977,5469,0.650941671237886,2115,7425,483,529,120,1375,12,587,107,12
"370","2020-04-02",308,5,131,1024,5469,0.650941671237886,2115,7425,483,529,172,1547,15,602,155,15
"371","2020-04-03",335,5,114,1051,5469,0.650941671237886,2115,7425,483,529,133,1680,22,624,114,22
"372","2020-04-04",340,5,106,1099,5469,0.650941671237886,2115,7425,483,529,170,1850,41,665,154,41
"373","2020-04-05",339,5,91,1114,5469,0.650941671237886,2115,7425,483,529,198,2048,35,700,182,35
"374","2020-04-06",341,5,88,1153,5469,0.650941671237886,2115,7425,483,529,192,2240,32,732,177,32
"375","2020-04-07",344,5,87,1170,5469,0.650941671237886,2115,7425,483,529,159,2399,46,778,145,46
"376","2020-04-08",351,5,83,1205,5469,0.650941671237886,2115,7425,483,529,198,2597,35,813,184,35
"377","2020-04-09",358,5,77,1219,5469,0.650941671237886,2115,7425,483,529,168,2765,34,847,154,34
"378","2020-04-10",413,5,81,1198,5469,0.650941671237886,2115,7425,483,529,205,2970,44,891,192,44
"379","2020-04-11",429,5,80,1212,5469,0.650941671237886,2115,7425,483,529,163,3133,55,946,155,55
"380","2020-04-12",412,5,73,1218,5469,0.650941671237886,2115,7425,483,529,205,3338,32,978,192,32
"381","2020-04-13",398,5,77,1201,5469,0.650941671237886,2115,7425,483,529,183,3521,37,1015,167,37
"382","2020-04-14",388,5,92,1199,5469,0.650941671237886,2115,7425,483,529,138,3659,22,1037,126,22
"383","2020-04-15",397,5,97,1184,5469,0.650941671237886,2115,7425,483,529,157,3816,20,1057,149,20
"384","2020-04-16",393,5,89,1143,5469,0.650941671237886,2115,7425,483,529,133,3949,25,1082,125,25
"385","2020-04-17",393,5,75,1116,5469,0.650941671237886,2115,7425,483,529,137,4086,19,1101,129,19
"386","2020-04-18",437,5,75,1094,5469,0.650941671237886,2115,7425,483,529,145,4231,35,1136,133,35
"387","2020-04-19",388,5,79,1064,5469,0.650941671237886,2115,7425,483,529,138,4369,40,1176,124,40
"388","2020-04-20",377,5,86,1045,5469,0.650941671237886,2115,7425,483,529,117,4486,27,1203,107,27
"389","2020-04-21",372,5,92,1040,5469,0.650941671237886,2115,7425,483,529,124,4610,50,1253,110,50
"390","2020-04-22",352,5,87,1034,5469,0.650941671237886,2115,7425,483,529,86,4696,20,1273,80,20
"391","2020-04-23",350,5,87,1007,5469,0.650941671237886,2115,7425,483,529,114,4810,26,1299,104,26
"392","2020-04-24",391,5,103,986,5469,0.650941671237886,2115,7425,483,529,102,4912,23,1322,91,23
"393","2020-04-25",344,5,112,940,5469,0.650941671237886,2115,7425,483,529,71,4983,22,1344,64,22
"394","2020-04-26",322,5,114,910,5469,0.650941671237886,2115,7425,483,529,74,5057,40,1384,64,40
"395","2020-04-27",303,5,114,874,5469,0.650941671237886,2115,7425,483,529,82,5139,50,1434,76,50
"396","2020-04-28",296,5,113,836,5469,0.650941671237886,2115,7425,483,529,60,5199,32,1466,49,32
"397","2020-04-29",287,5,123,825,5469,0.650941671237886,2115,7425,483,529,78,5277,22,1488,68,22
"398","2020-04-30",285,5,121,805,5469,0.650941671237886,2115,7425,483,529,41,5318,21,1509,35,21
"399","2020-05-01",246,5,125,773,5469,0.650941671237886,2115,7425,483,529,42,5360,24,1533,34,24
"400","2020-05-02",256,5,126,754,5469,0.650941671237886,2115,7425,483,529,48,5408,31,1564,39,31
"401","2020-05-03",237,5,124,705,5469,0.650941671237886,2115,7425,483,529,65,5473,36,1600,59,36
"402","2020-05-04",226,5,142,665,5469,0.650941671237886,2115,7425,483,529,32,5505,39,1639,27,39
"403","2020-05-05",219,5,151,615,5469,0.650941671237886,2115,7425,483,529,36,5541,20,1659,34,20
"404","2020-05-06",222,5,142,590,5469,0.650941671237886,2115,7425,483,529,41,5582,22,1681,34,22
"405","2020-05-07",216,5,129,577,5469,0.650941671237886,2115,7425,483,529,36,5618,29,1710,30,29
"406","2020-05-08",220,5,136,563,5469,0.650941671237886,2115,7425,483,529,33,5651,23,1733,23,23
"407","2020-05-09",209,5,124,524,5469,0.650941671237886,2115,7425,483,529,23,5674,20,1753,14,20
"408","2020-05-10",197,5,120,510,5469,0.650941671237886,2115,7425,483,529,27,5701,28,1781,19,28
"409","2020-05-11",194,5,128,486,5469,0.650941671237886,2115,7425,483,529,23,5724,25,1806,17,25
"410","2020-05-12",188,5,131,477,5469,0.650941671237886,2115,7425,483,529,16,5740,22,1828,11,22
"411","2020-05-13",173,5,123,456,5469,0.650941671237886,2115,7425,483,529,29,5769,39,1867,21,39
"412","2020-05-14",168,5,115,438,5469,0.650941671237886,2115,7425,483,529,24,5793,28,1895,17,28
"413","2020-05-15",152,5,101,426,5469,0.650941671237886,2115,7425,483,529,9,5802,34,1929,7,34
"414","2020-05-16",149,5,78,394,5469,0.650941671237886,2115,7425,483,529,17,5819,40,1969,13,40
"415","2020-05-17",144,5,84,386,5469,0.650941671237886,2115,7425,483,529,14,5833,35,2004,12,35
"416","2020-05-18",143,5,77,380,5469,0.650941671237886,2115,7425,483,529,8,5841,39,2043,7,39
"417","2020-05-19",142,5,72,370,5469,0.650941671237886,2115,7425,483,529,19,5860,36,2079,16,36
"418","2020-05-20",144,5,71,344,5469,0.650941671237886,2115,7425,483,529,17,5877,35,2114,13,35
"419","2020-05-21",131,5,87,331,5469,0.650941671237886,2115,7425,483,529,14,5891,38,2152,9,38
"420","2020-05-22",130,5,99,321,5469,0.650941671237886,2115,7425,483,529,16,5907,27,2179,9,27
"421","2020-05-23",117,5,109,315,5469,0.650941671237886,2115,7425,483,529,8,5915,26,2205,4,26
"422","2020-05-24",111,5,114,308,5469,0.650941671237886,2115,7425,483,529,3,5918,43,2248,3,43
"423","2020-05-25",115,5,113,290,5469,0.650941671237886,2115,7425,483,529,11,5929,28,2276,9,28
"424","2020-05-26",101,5,115,272,5469,0.650941671237886,2115,7425,483,529,11,5940,37,2313,7,37
"425","2020-05-27",94,5,120,264,5469,0.650941671237886,2115,7425,483,529,8,5948,32,2345,3,32
"426","2020-05-28",93,5,129,249,5469,0.650941671237886,2115,7425,483,529,13,5961,39,2384,11,39
"427","2020-05-29",93,5,124,237,5469,0.650941671237886,2115,7425,483,529,10,5971,42,2426,5,42
"428","2020-05-30",91,5,110,230,5469,0.650941671237886,2115,7425,483,529,11,5982,30,2456,7,30
"429","2020-05-31",78,5,93,214,5469,0.650941671237886,2115,7425,483,529,3,5985,33,2489,2,33
"430","2020-06-01",69,5,92,200,5469,0.650941671237886,2115,7425,483,529,4,5989,19,2508,3,19
"431","2020-06-02",65,5,87,186,5469,0.650941671237886,2115,7425,483,529,7,5996,7,2515,6,7
"432","2020-06-03",69,5,90,177,5469,0.650941671237886,2115,7425,483,529,9,6005,15,2530,5,15
"433","2020-06-04",67,5,78,161,5469,0.650941671237886,2115,7425,483,529,6,6011,13,2543,2,13
"434","2020-06-05",61,5,72,156,5469,0.650941671237886,2115,7425,483,529,9,6020,14,2557,7,14
"435","2020-06-06",69,5,64,144,5469,0.650941671237886,2115,7425,483,529,5,6025,27,2584,3,27
"436","2020-06-07",63,5,56,142,5469,0.650941671237886,2115,7425,483,529,7,6032,34,2618,5,34
"437","2020-03-07",2,6,0,0,5593,0.720007151796889,2055,7841,624,1059,NA,NA,NA,NA,NA,NA
"438","2020-03-08",2,6,0,0,5593,0.720007151796889,2055,7841,624,1059,NA,NA,NA,NA,NA,NA
"439","2020-03-09",0,6,0,0,5593,0.720007151796889,2055,7841,624,1059,NA,NA,NA,NA,NA,NA
"440","2020-03-10",0,6,0,0,5593,0.720007151796889,2055,7841,624,1059,NA,NA,1,1,NA,1
"441","2020-03-11",0,6,0,0,5593,0.720007151796889,2055,7841,624,1059,26,26,11,12,NA,11
"442","2020-03-12",0,6,0,0,5593,0.720007151796889,2055,7841,624,1059,23,49,10,22,1,10
"443","2020-03-13",3,6,92,78,5593,0.720007151796889,2055,7841,624,1059,21,70,1,23,5,1
"444","2020-03-14",7,6,139,106,5593,0.720007151796889,2055,7841,624,1059,27,97,6,29,6,6
"445","2020-03-15",15,6,147,157,5593,0.720007151796889,2055,7841,624,1059,32,129,15,44,12,15
"446","2020-03-16",18,6,131,193,5593,0.720007151796889,2055,7841,624,1059,34,163,16,60,16,16
"447","2020-03-17",21,6,113,243,5593,0.720007151796889,2055,7841,624,1059,57,220,11,71,34,11
"448","2020-03-18",29,6,108,289,5593,0.720007151796889,2055,7841,624,1059,55,275,30,101,34,30
"449","2020-03-19",40,6,143,347,5593,0.720007151796889,2055,7841,624,1059,61,336,20,121,27,20
"450","2020-03-20",65,6,134,400,5593,0.720007151796889,2055,7841,624,1059,62,398,33,154,33,33
"451","2020-03-21",103,6,127,449,5593,0.720007151796889,2055,7841,624,1059,65,463,17,171,45,17
"452","2020-03-22",115,6,162,510,5593,0.720007151796889,2055,7841,624,1059,86,549,22,193,56,22
"453","2020-03-23",119,6,166,562,5593,0.720007151796889,2055,7841,624,1059,72,621,25,218,55,25
"454","2020-03-24",131,6,172,604,5593,0.720007151796889,2055,7841,624,1059,88,709,24,242,63,24
"455","2020-03-25",138,6,166,655,5593,0.720007151796889,2055,7841,624,1059,85,794,37,279,54,37
"456","2020-03-26",151,6,185,713,5593,0.720007151796889,2055,7841,624,1059,103,897,26,305,73,26
"457","2020-03-27",207,6,186,748,5593,0.720007151796889,2055,7841,624,1059,78,975,19,324,59,19
"458","2020-03-28",208,6,171,763,5593,0.720007151796889,2055,7841,624,1059,91,1066,25,349,68,25
"459","2020-03-29",237,6,163,789,5593,0.720007151796889,2055,7841,624,1059,99,1165,15,364,74,15
"460","2020-03-30",248,6,143,809,5593,0.720007151796889,2055,7841,624,1059,134,1299,32,396,98,32
"461","2020-03-31",239,6,126,857,5593,0.720007151796889,2055,7841,624,1059,103,1402,22,418,77,22
"462","2020-04-01",256,6,147,881,5593,0.720007151796889,2055,7841,624,1059,127,1529,38,456,92,38
"463","2020-04-02",261,6,157,906,5593,0.720007151796889,2055,7841,624,1059,106,1635,30,486,82,30
"464","2020-04-03",300,6,162,927,5593,0.720007151796889,2055,7841,624,1059,132,1767,43,529,109,43
"465","2020-04-04",302,6,184,966,5593,0.720007151796889,2055,7841,624,1059,140,1907,47,576,116,47
"466","2020-04-05",310,6,216,984,5593,0.720007151796889,2055,7841,624,1059,113,2020,28,604,92,28
"467","2020-04-06",313,6,246,1030,5593,0.720007151796889,2055,7841,624,1059,144,2164,18,622,117,18
"468","2020-04-07",320,6,267,1046,5593,0.720007151796889,2055,7841,624,1059,121,2285,20,642,93,20
"469","2020-04-08",335,6,279,1068,5593,0.720007151796889,2055,7841,624,1059,110,2395,43,685,85,43
"470","2020-04-09",349,6,268,1069,5593,0.720007151796889,2055,7841,624,1059,112,2507,26,711,91,26
"471","2020-04-10",396,6,253,1094,5593,0.720007151796889,2055,7841,624,1059,142,2649,20,731,113,20
"472","2020-04-11",406,6,244,1101,5593,0.720007151796889,2055,7841,624,1059,120,2769,43,774,102,43
"473","2020-04-12",367,6,224,1091,5593,0.720007151796889,2055,7841,624,1059,108,2877,62,836,81,62
"474","2020-04-13",358,6,210,1097,5593,0.720007151796889,2055,7841,624,1059,158,3035,56,892,127,56
"475","2020-04-14",348,6,188,1109,5593,0.720007151796889,2055,7841,624,1059,94,3129,37,929,69,37
"476","2020-04-15",333,6,209,1100,5593,0.720007151796889,2055,7841,624,1059,113,3242,31,960,86,31
"477","2020-04-16",336,6,179,1101,5593,0.720007151796889,2055,7841,624,1059,124,3366,27,987,102,27
"478","2020-04-17",368,6,178,1076,5593,0.720007151796889,2055,7841,624,1059,116,3482,28,1015,88,28
"479","2020-04-18",386,6,225,1072,5593,0.720007151796889,2055,7841,624,1059,85,3567,54,1069,64,54
"480","2020-04-19",353,6,240,1066,5593,0.720007151796889,2055,7841,624,1059,99,3666,47,1116,68,47
"481","2020-04-20",361,6,235,1036,5593,0.720007151796889,2055,7841,624,1059,92,3758,33,1149,65,33
"482","2020-04-21",359,6,223,1046,5593,0.720007151796889,2055,7841,624,1059,103,3861,28,1177,68,28
"483","2020-04-22",353,6,256,1012,5593,0.720007151796889,2055,7841,624,1059,69,3930,46,1223,48,46
"484","2020-04-23",347,6,249,990,5593,0.720007151796889,2055,7841,624,1059,76,4006,21,1244,54,21
"485","2020-04-24",357,6,223,975,5593,0.720007151796889,2055,7841,624,1059,80,4086,18,1262,60,18
"486","2020-04-25",335,6,187,976,5593,0.720007151796889,2055,7841,624,1059,61,4147,20,1282,45,20
"487","2020-04-26",308,6,177,934,5593,0.720007151796889,2055,7841,624,1059,82,4229,11,1293,60,11
"488","2020-04-27",299,6,158,912,5593,0.720007151796889,2055,7841,624,1059,73,4302,14,1307,56,14
"489","2020-04-28",292,6,145,888,5593,0.720007151796889,2055,7841,624,1059,62,4364,12,1319,40,12
"490","2020-04-29",298,6,179,856,5593,0.720007151796889,2055,7841,624,1059,63,4427,53,1372,40,53
"491","2020-04-30",282,6,180,819,5593,0.720007151796889,2055,7841,624,1059,62,4489,35,1407,45,35
"492","2020-05-01",264,6,216,795,5593,0.720007151796889,2055,7841,624,1059,48,4537,15,1422,25,15
"493","2020-05-02",281,6,244,775,5593,0.720007151796889,2055,7841,624,1059,78,4615,24,1446,47,24
"494","2020-05-03",271,6,250,761,5593,0.720007151796889,2055,7841,624,1059,52,4667,55,1501,30,55
"495","2020-05-04",260,6,272,740,5593,0.720007151796889,2055,7841,624,1059,50,4717,41,1542,32,41
"496","2020-05-05",251,6,243,703,5593,0.720007151796889,2055,7841,624,1059,35,4752,52,1594,23,52
"497","2020-05-06",247,6,213,680,5593,0.720007151796889,2055,7841,624,1059,43,4795,42,1636,33,42
"498","2020-05-07",257,6,178,658,5593,0.720007151796889,2055,7841,624,1059,39,4834,27,1663,23,27
"499","2020-05-08",249,6,158,652,5593,0.720007151796889,2055,7841,624,1059,32,4866,34,1697,15,34
"500","2020-05-09",224,6,140,640,5593,0.720007151796889,2055,7841,624,1059,38,4904,26,1723,21,26
"501","2020-05-10",220,6,136,613,5593,0.720007151796889,2055,7841,624,1059,28,4932,42,1765,14,42
"502","2020-05-11",221,6,180,601,5593,0.720007151796889,2055,7841,624,1059,29,4961,28,1793,13,28
"503","2020-05-12",209,6,227,590,5593,0.720007151796889,2055,7841,624,1059,38,4999,29,1822,25,29
"504","2020-05-13",199,6,259,571,5593,0.720007151796889,2055,7841,624,1059,30,5029,25,1847,21,25
"505","2020-05-14",182,6,277,551,5593,0.720007151796889,2055,7841,624,1059,34,5063,12,1859,20,12
"506","2020-05-15",189,6,257,537,5593,0.720007151796889,2055,7841,624,1059,34,5097,9,1868,18,9
"507","2020-05-16",205,6,237,511,5593,0.720007151796889,2055,7841,624,1059,19,5116,11,1879,10,11
"508","2020-05-17",178,6,208,501,5593,0.720007151796889,2055,7841,624,1059,22,5138,4,1883,12,4
"509","2020-05-18",167,6,199,487,5593,0.720007151796889,2055,7841,624,1059,26,5164,47,1930,15,47
"510","2020-05-19",165,6,214,476,5593,0.720007151796889,2055,7841,624,1059,28,5192,53,1983,11,53
"511","2020-05-20",169,6,201,472,5593,0.720007151796889,2055,7841,624,1059,19,5211,29,2012,10,29
"512","2020-05-21",174,6,184,460,5593,0.720007151796889,2055,7841,624,1059,18,5229,20,2032,11,20
"513","2020-05-22",164,6,156,442,5593,0.720007151796889,2055,7841,624,1059,23,5252,50,2082,5,50
"514","2020-05-23",153,6,122,409,5593,0.720007151796889,2055,7841,624,1059,17,5269,49,2131,14,49
"515","2020-05-24",153,6,116,390,5593,0.720007151796889,2055,7841,624,1059,24,5293,63,2194,14,63
"516","2020-05-25",150,6,111,378,5593,0.720007151796889,2055,7841,624,1059,13,5306,28,2222,5,28
"517","2020-05-26",144,6,127,350,5593,0.720007151796889,2055,7841,624,1059,17,5323,17,2239,9,17
"518","2020-05-27",132,6,147,331,5593,0.720007151796889,2055,7841,624,1059,17,5340,17,2256,7,17
"519","2020-05-28",126,6,186,307,5593,0.720007151796889,2055,7841,624,1059,14,5354,14,2270,8,14
"520","2020-05-29",121,6,190,295,5593,0.720007151796889,2055,7841,624,1059,19,5373,40,2310,10,40
"521","2020-05-30",121,6,236,281,5593,0.720007151796889,2055,7841,624,1059,15,5388,31,2341,4,31
"522","2020-05-31",97,6,228,253,5593,0.720007151796889,2055,7841,624,1059,14,5402,10,2351,6,10
"523","2020-06-01",93,6,234,245,5593,0.720007151796889,2055,7841,624,1059,15,5417,14,2365,10,14
"524","2020-06-02",85,6,216,225,5593,0.720007151796889,2055,7841,624,1059,16,5433,27,2392,9,27
"525","2020-06-03",81,6,216,224,5593,0.720007151796889,2055,7841,624,1059,8,5441,17,2409,2,17
"526","2020-06-04",74,6,191,224,5593,0.720007151796889,2055,7841,624,1059,7,5448,40,2449,4,40
"527","2020-06-05",69,6,186,216,5593,0.720007151796889,2055,7841,624,1059,10,5458,41,2490,9,41
"528","2020-06-06",62,6,194,210,5593,0.720007151796889,2055,7841,624,1059,14,5472,19,2509,6,19
"529","2020-06-07",67,6,204,202,5593,0.720007151796889,2055,7841,624,1059,13,5485,13,2522,5,13
"530","2020-03-13",3,7,32,147,5866,0.394306171155813,2070,8339,579,518,27,60,18,83,8,18
"531","2020-03-14",7,7,33,203,5866,0.394306171155813,2070,8339,579,518,32,92,25,108,17,25
"532","2020-03-15",30,7,46,273,5866,0.394306171155813,2070,8339,579,518,28,120,37,145,16,37
"533","2020-03-16",40,7,64,339,5866,0.394306171155813,2070,8339,579,518,40,160,35,180,20,35
"534","2020-03-17",43,7,61,401,5866,0.394306171155813,2070,8339,579,518,46,206,47,227,36,47
"535","2020-03-18",56,7,57,454,5866,0.394306171155813,2070,8339,579,518,38,244,38,265,32,38
"536","2020-03-19",68,7,70,512,5866,0.394306171155813,2070,8339,579,518,34,278,32,297,25,32
"537","2020-03-20",104,7,66,568,5866,0.394306171155813,2070,8339,579,518,58,336,29,326,46,29
"538","2020-03-21",138,7,69,604,5866,0.394306171155813,2070,8339,579,518,60,396,13,339,44,13
"539","2020-03-22",149,7,83,678,5866,0.394306171155813,2070,8339,579,518,73,469,39,378,55,39
"540","2020-03-23",170,7,90,740,5866,0.394306171155813,2070,8339,579,518,65,534,24,402,50,24
"541","2020-03-24",177,7,113,768,5866,0.394306171155813,2070,8339,579,518,84,618,43,445,68,43
"542","2020-03-25",198,7,115,806,5866,0.394306171155813,2070,8339,579,518,87,705,23,468,80,23
"543","2020-03-26",212,7,121,847,5866,0.394306171155813,2070,8339,579,518,95,800,18,486,82,18
"544","2020-03-27",290,7,123,881,5866,0.394306171155813,2070,8339,579,518,78,878,13,499,69,13
"545","2020-03-28",306,7,142,887,5866,0.394306171155813,2070,8339,579,518,88,966,9,508,77,9
"546","2020-03-29",302,7,159,921,5866,0.394306171155813,2070,8339,579,518,93,1059,28,536,82,28
"547","2020-03-30",299,7,168,935,5866,0.394306171155813,2070,8339,579,518,106,1165,48,584,86,48
"548","2020-03-31",297,7,175,966,5866,0.394306171155813,2070,8339,579,518,110,1275,58,642,97,58
"549","2020-04-01",293,7,166,1002,5866,0.394306171155813,2070,8339,579,518,109,1384,44,686,100,44
"550","2020-04-02",298,7,153,1010,5866,0.394306171155813,2070,8339,579,518,109,1493,33,719,94,33
"551","2020-04-03",323,7,168,1026,5866,0.394306171155813,2070,8339,579,518,135,1628,32,751,121,32
"552","2020-04-04",344,7,164,1027,5866,0.394306171155813,2070,8339,579,518,130,1758,23,774,113,23
"553","2020-04-05",327,7,171,1026,5866,0.394306171155813,2070,8339,579,518,132,1890,38,812,118,38
"554","2020-04-06",309,7,163,1017,5866,0.394306171155813,2070,8339,579,518,136,2026,22,834,130,22
"555","2020-04-07",320,7,155,1021,5866,0.394306171155813,2070,8339,579,518,121,2147,26,860,110,26
"556","2020-04-08",325,7,157,1045,5866,0.394306171155813,2070,8339,579,518,157,2304,25,885,143,25
"557","2020-04-09",317,7,150,1021,5866,0.394306171155813,2070,8339,579,518,136,2440,22,907,119,22
"558","2020-04-10",353,7,146,1050,5866,0.394306171155813,2070,8339,579,518,158,2598,40,947,137,40
"559","2020-04-11",348,7,145,1058,5866,0.394306171155813,2070,8339,579,518,168,2766,28,975,148,28
"560","2020-04-12",328,7,138,1046,5866,0.394306171155813,2070,8339,579,518,165,2931,31,1006,151,31
"561","2020-04-13",335,7,131,1045,5866,0.394306171155813,2070,8339,579,518,131,3062,28,1034,115,28
"562","2020-04-14",323,7,141,1050,5866,0.394306171155813,2070,8339,579,518,130,3192,23,1057,112,23
"563","2020-04-15",326,7,133,1030,5866,0.394306171155813,2070,8339,579,518,114,3306,14,1071,108,14
"564","2020-04-16",349,7,139,1021,5866,0.394306171155813,2070,8339,579,518,131,3437,10,1081,117,10
"565","2020-04-17",361,7,139,1019,5866,0.394306171155813,2070,8339,579,518,146,3583,7,1088,135,7
"566","2020-04-18",359,7,127,990,5866,0.394306171155813,2070,8339,579,518,107,3690,13,1101,92,13
"567","2020-04-19",336,7,122,1007,5866,0.394306171155813,2070,8339,579,518,128,3818,7,1108,107,7
"568","2020-04-20",325,7,114,990,5866,0.394306171155813,2070,8339,579,518,129,3947,9,1117,118,9
"569","2020-04-21",334,7,114,979,5866,0.394306171155813,2070,8339,579,518,111,4058,48,1165,99,48
"570","2020-04-22",325,7,120,964,5866,0.394306171155813,2070,8339,579,518,108,4166,56,1221,98,56
"571","2020-04-23",310,7,104,948,5866,0.394306171155813,2070,8339,579,518,99,4265,24,1245,85,24
"572","2020-04-24",310,7,101,928,5866,0.394306171155813,2070,8339,579,518,99,4364,14,1259,85,14
"573","2020-04-25",292,7,92,894,5866,0.394306171155813,2070,8339,579,518,75,4439,8,1267,65,8
"574","2020-04-26",297,7,112,849,5866,0.394306171155813,2070,8339,579,518,92,4531,7,1274,77,7
"575","2020-04-27",293,7,107,843,5866,0.394306171155813,2070,8339,579,518,91,4622,46,1320,81,46
"576","2020-04-28",286,7,122,807,5866,0.394306171155813,2070,8339,579,518,63,4685,27,1347,53,27
"577","2020-04-29",288,7,121,790,5866,0.394306171155813,2070,8339,579,518,57,4742,31,1378,50,31
"578","2020-04-30",284,7,116,767,5866,0.394306171155813,2070,8339,579,518,69,4811,57,1435,57,57
"579","2020-05-01",275,7,122,757,5866,0.394306171155813,2070,8339,579,518,62,4873,61,1496,52,61
"580","2020-05-02",295,7,109,750,5866,0.394306171155813,2070,8339,579,518,57,4930,31,1527,50,31
"581","2020-05-03",256,7,106,749,5866,0.394306171155813,2070,8339,579,518,31,4961,13,1540,27,13
"582","2020-05-04",248,7,92,731,5866,0.394306171155813,2070,8339,579,518,50,5011,13,1553,44,13
"583","2020-05-05",235,7,91,723,5866,0.394306171155813,2070,8339,579,518,42,5053,41,1594,34,41
"584","2020-05-06",231,7,88,713,5866,0.394306171155813,2070,8339,579,518,33,5086,18,1612,28,18
"585","2020-05-07",224,7,114,688,5866,0.394306171155813,2070,8339,579,518,38,5124,10,1622,33,10
"586","2020-05-08",248,7,113,674,5866,0.394306171155813,2070,8339,579,518,31,5155,8,1630,25,8
"587","2020-05-09",255,7,136,654,5866,0.394306171155813,2070,8339,579,518,34,5189,5,1635,27,5
"588","2020-05-10",239,7,142,664,5866,0.394306171155813,2070,8339,579,518,36,5225,8,1643,33,8
"589","2020-05-11",226,7,149,635,5866,0.394306171155813,2070,8339,579,518,19,5244,8,1651,16,8
"590","2020-05-12",222,7,168,590,5866,0.394306171155813,2070,8339,579,518,29,5273,22,1673,20,22
"591","2020-05-13",219,7,152,573,5866,0.394306171155813,2070,8339,579,518,29,5302,8,1681,21,8
"592","2020-05-14",222,7,142,548,5866,0.394306171155813,2070,8339,579,518,27,5329,8,1689,24,8
"593","2020-05-15",229,7,136,556,5866,0.394306171155813,2070,8339,579,518,21,5350,13,1702,14,13
"594","2020-05-16",221,7,128,529,5866,0.394306171155813,2070,8339,579,518,21,5371,8,1710,16,8
"595","2020-05-17",195,7,131,496,5866,0.394306171155813,2070,8339,579,518,18,5389,5,1715,14,5
"596","2020-05-18",189,7,136,475,5866,0.394306171155813,2070,8339,579,518,18,5407,8,1723,9,8
"597","2020-05-19",186,7,129,461,5866,0.394306171155813,2070,8339,579,518,15,5422,3,1726,11,3
"598","2020-05-20",174,7,135,449,5866,0.394306171155813,2070,8339,579,518,14,5436,44,1770,7,44
"599","2020-05-21",174,7,127,445,5866,0.394306171155813,2070,8339,579,518,18,5454,44,1814,13,44
"600","2020-05-22",161,7,139,437,5866,0.394306171155813,2070,8339,579,518,13,5467,55,1869,12,55
"601","2020-05-23",170,7,134,413,5866,0.394306171155813,2070,8339,579,518,15,5482,25,1894,9,25
"602","2020-05-24",160,7,147,370,5866,0.394306171155813,2070,8339,579,518,13,5495,10,1904,8,10
"603","2020-05-25",147,7,143,356,5866,0.394306171155813,2070,8339,579,518,14,5509,32,1936,13,32
"604","2020-05-26",146,7,138,344,5866,0.394306171155813,2070,8339,579,518,17,5526,31,1967,8,31
"605","2020-05-27",146,7,137,334,5866,0.394306171155813,2070,8339,579,518,7,5533,22,1989,5,22
"606","2020-05-28",126,7,134,322,5866,0.394306171155813,2070,8339,579,518,12,5545,40,2029,7,40
"607","2020-05-29",122,7,135,310,5866,0.394306171155813,2070,8339,579,518,14,5559,57,2086,10,57
"608","2020-05-30",116,7,118,282,5866,0.394306171155813,2070,8339,579,518,11,5570,28,2114,6,28
"609","2020-05-31",106,7,118,264,5866,0.394306171155813,2070,8339,579,518,12,5582,35,2149,8,35
"610","2020-06-01",99,7,127,254,5866,0.394306171155813,2070,8339,579,518,13,5595,30,2179,8,30
"611","2020-06-02",88,7,131,242,5866,0.394306171155813,2070,8339,579,518,7,5602,19,2198,3,19
"612","2020-06-03",85,7,117,225,5866,0.394306171155813,2070,8339,579,518,4,5606,11,2209,4,11
"613","2020-06-04",88,7,110,213,5866,0.394306171155813,2070,8339,579,518,9,5615,16,2225,6,16
"614","2020-06-05",73,7,92,205,5866,0.394306171155813,2070,8339,579,518,10,5625,4,2229,6,4
"615","2020-06-06",58,7,86,195,5866,0.394306171155813,2070,8339,579,518,4,5629,7,2236,2,7
"616","2020-06-07",58,7,77,182,5866,0.394306171155813,2070,8339,579,518,7,5636,30,2266,5,30
"617","2020-03-12",1,8,66,50,5811,0.578041645155739,1950,7566,693,1283,25,56,9,19,1,9
"618","2020-03-13",5,8,125,73,5811,0.578041645155739,1950,7566,693,1283,37,93,23,42,9,23
"619","2020-03-14",9,8,130,100,5811,0.578041645155739,1950,7566,693,1283,34,127,24,66,6,24
"620","2020-03-15",12,8,131,128,5811,0.578041645155739,1950,7566,693,1283,33,160,40,106,12,40
"621","2020-03-16",13,8,160,181,5811,0.578041645155739,1950,7566,693,1283,34,194,13,119,13,13
"622","2020-03-17",20,8,162,243,5811,0.578041645155739,1950,7566,693,1283,40,234,25,144,15,25
"623","2020-03-18",29,8,177,298,5811,0.578041645155739,1950,7566,693,1283,43,277,31,175,20,31
"624","2020-03-19",32,8,202,354,5811,0.578041645155739,1950,7566,693,1283,52,329,38,213,15,38
"625","2020-03-20",53,8,212,403,5811,0.578041645155739,1950,7566,693,1283,52,381,40,253,24,40
"626","2020-03-21",72,8,225,468,5811,0.578041645155739,1950,7566,693,1283,40,421,28,281,21,28
"627","2020-03-22",117,8,241,536,5811,0.578041645155739,1950,7566,693,1283,49,470,17,298,24,17
"628","2020-03-23",126,8,247,595,5811,0.578041645155739,1950,7566,693,1283,63,533,16,314,39,16
"629","2020-03-24",132,8,244,646,5811,0.578041645155739,1950,7566,693,1283,52,585,28,342,28,28
"630","2020-03-25",139,8,218,697,5811,0.578041645155739,1950,7566,693,1283,71,656,38,380,36,38
"631","2020-03-26",167,8,214,781,5811,0.578041645155739,1950,7566,693,1283,76,732,31,411,51,31
"632","2020-03-27",223,8,197,820,5811,0.578041645155739,1950,7566,693,1283,77,809,24,435,42,24
"633","2020-03-28",245,8,186,847,5811,0.578041645155739,1950,7566,693,1283,67,876,13,448,44,13
"634","2020-03-29",266,8,187,889,5811,0.578041645155739,1950,7566,693,1283,65,941,13,461,45,13
"635","2020-03-30",270,8,178,942,5811,0.578041645155739,1950,7566,693,1283,60,1001,13,474,40,13
"636","2020-03-31",269,8,195,965,5811,0.578041645155739,1950,7566,693,1283,62,1063,21,495,41,21
"637","2020-04-01",278,8,180,1020,5811,0.578041645155739,1950,7566,693,1283,74,1137,21,516,50,21
"638","2020-04-02",277,8,175,1041,5811,0.578041645155739,1950,7566,693,1283,64,1201,18,534,40,18
"639","2020-04-03",335,8,169,1112,5811,0.578041645155739,1950,7566,693,1283,81,1282,30,564,52,30
"640","2020-04-04",360,8,186,1158,5811,0.578041645155739,1950,7566,693,1283,88,1370,40,604,60,40
"641","2020-04-05",324,8,243,1187,5811,0.578041645155739,1950,7566,693,1283,84,1454,23,627,48,23
"642","2020-04-06",331,8,275,1199,5811,0.578041645155739,1950,7566,693,1283,63,1517,23,650,30,23
"643","2020-04-07",328,8,283,1229,5811,0.578041645155739,1950,7566,693,1283,89,1606,13,663,59,13
"644","2020-04-08",356,8,276,1261,5811,0.578041645155739,1950,7566,693,1283,78,1684,35,698,55,35
"645","2020-04-09",376,8,296,1261,5811,0.578041645155739,1950,7566,693,1283,78,1762,19,717,55,19
"646","2020-04-10",425,8,273,1255,5811,0.578041645155739,1950,7566,693,1283,79,1841,14,731,55,14
"647","2020-04-11",418,8,259,1242,5811,0.578041645155739,1950,7566,693,1283,88,1929,9,740,59,9
"648","2020-04-12",408,8,245,1260,5811,0.578041645155739,1950,7566,693,1283,87,2016,19,759,56,19
"649","2020-04-13",420,8,229,1290,5811,0.578041645155739,1950,7566,693,1283,90,2106,21,780,59,21
"650","2020-04-14",430,8,241,1283,5811,0.578041645155739,1950,7566,693,1283,79,2185,25,805,38,25
"651","2020-04-15",420,8,229,1266,5811,0.578041645155739,1950,7566,693,1283,88,2273,22,827,61,22
"652","2020-04-16",422,8,222,1265,5811,0.578041645155739,1950,7566,693,1283,81,2354,30,857,51,30
"653","2020-04-17",421,8,236,1230,5811,0.578041645155739,1950,7566,693,1283,85,2439,34,891,54,34
"654","2020-04-18",456,8,257,1213,5811,0.578041645155739,1950,7566,693,1283,88,2527,25,916,56,25
"655","2020-04-19",423,8,257,1201,5811,0.578041645155739,1950,7566,693,1283,95,2622,16,932,64,16
"656","2020-04-20",409,8,295,1160,5811,0.578041645155739,1950,7566,693,1283,73,2695,24,956,51,24
"657","2020-04-21",398,8,293,1122,5811,0.578041645155739,1950,7566,693,1283,68,2763,27,983,35,27
"658","2020-04-22",392,8,280,1103,5811,0.578041645155739,1950,7566,693,1283,96,2859,10,993,55,10
"659","2020-04-23",380,8,267,1069,5811,0.578041645155739,1950,7566,693,1283,64,2923,9,1002,44,9
"660","2020-04-24",388,8,299,1040,5811,0.578041645155739,1950,7566,693,1283,83,3006,9,1011,53,9
"661","2020-04-25",362,8,297,995,5811,0.578041645155739,1950,7566,693,1283,58,3064,16,1027,34,16
"662","2020-04-26",349,8,304,956,5811,0.578041645155739,1950,7566,693,1283,67,3131,20,1047,38,20
"663","2020-04-27",334,8,299,935,5811,0.578041645155739,1950,7566,693,1283,60,3191,50,1097,35,50
"664","2020-04-28",316,8,298,912,5811,0.578041645155739,1950,7566,693,1283,66,3257,41,1138,43,41
"665","2020-04-29",318,8,276,881,5811,0.578041645155739,1950,7566,693,1283,70,3327,37,1175,47,37
"666","2020-04-30",306,8,270,868,5811,0.578041645155739,1950,7566,693,1283,63,3390,26,1201,36,26
"667","2020-05-01",312,8,261,839,5811,0.578041645155739,1950,7566,693,1283,63,3453,25,1226,45,25
"668","2020-05-02",322,8,260,811,5811,0.578041645155739,1950,7566,693,1283,53,3506,38,1264,32,38
"669","2020-05-03",286,8,257,775,5811,0.578041645155739,1950,7566,693,1283,41,3547,26,1290,22,26
"670","2020-05-04",277,8,250,745,5811,0.578041645155739,1950,7566,693,1283,61,3608,48,1338,38,48
"671","2020-05-05",283,8,275,717,5811,0.578041645155739,1950,7566,693,1283,55,3663,51,1389,24,51
"672","2020-05-06",270,8,296,684,5811,0.578041645155739,1950,7566,693,1283,52,3715,41,1430,26,41
"673","2020-05-07",256,8,327,654,5811,0.578041645155739,1950,7566,693,1283,48,3763,37,1467,30,37
"674","2020-05-08",240,8,331,626,5811,0.578041645155739,1950,7566,693,1283,47,3810,34,1501,31,34
"675","2020-05-09",227,8,302,605,5811,0.578041645155739,1950,7566,693,1283,41,3851,49,1550,24,49
"676","2020-05-10",209,8,281,573,5811,0.578041645155739,1950,7566,693,1283,40,3891,41,1591,22,41
"677","2020-05-11",197,8,274,548,5811,0.578041645155739,1950,7566,693,1283,45,3936,46,1637,22,46
"678","2020-05-12",180,8,259,518,5811,0.578041645155739,1950,7566,693,1283,51,3987,29,1666,31,29
"679","2020-05-13",171,8,260,499,5811,0.578041645155739,1950,7566,693,1283,33,4020,40,1706,18,40
"680","2020-05-14",174,8,229,495,5811,0.578041645155739,1950,7566,693,1283,38,4058,13,1719,23,13
"681","2020-05-15",164,8,220,459,5811,0.578041645155739,1950,7566,693,1283,32,4090,47,1766,16,47
"682","2020-05-16",161,8,234,452,5811,0.578041645155739,1950,7566,693,1283,31,4121,50,1816,17,50
"683","2020-05-17",162,8,261,441,5811,0.578041645155739,1950,7566,693,1283,31,4152,22,1838,19,22
"684","2020-05-18",151,8,285,418,5811,0.578041645155739,1950,7566,693,1283,37,4189,14,1852,19,14
"685","2020-05-19",148,8,299,400,5811,0.578041645155739,1950,7566,693,1283,26,4215,19,1871,10,19
"686","2020-05-20",145,8,316,377,5811,0.578041645155739,1950,7566,693,1283,33,4248,30,1901,19,30
"687","2020-05-21",138,8,309,370,5811,0.578041645155739,1950,7566,693,1283,38,4286,33,1934,18,33
"688","2020-05-22",138,8,309,356,5811,0.578041645155739,1950,7566,693,1283,27,4313,35,1969,15,35
"689","2020-05-23",125,8,292,339,5811,0.578041645155739,1950,7566,693,1283,24,4337,37,2006,13,37
"690","2020-05-24",113,8,276,322,5811,0.578041645155739,1950,7566,693,1283,25,4362,23,2029,11,23
"691","2020-05-25",114,8,275,300,5811,0.578041645155739,1950,7566,693,1283,16,4378,30,2059,7,30
"692","2020-05-26",107,8,253,282,5811,0.578041645155739,1950,7566,693,1283,30,4408,19,2078,13,19
"693","2020-05-27",105,8,255,265,5811,0.578041645155739,1950,7566,693,1283,16,4424,15,2093,8,15
"694","2020-05-28",106,8,232,261,5811,0.578041645155739,1950,7566,693,1283,16,4440,32,2125,11,32
"695","2020-05-29",98,8,245,250,5811,0.578041645155739,1950,7566,693,1283,27,4467,49,2174,9,49
"696","2020-05-30",94,8,241,232,5811,0.578041645155739,1950,7566,693,1283,19,4486,32,2206,6,32
"697","2020-05-31",88,8,226,222,5811,0.578041645155739,1950,7566,693,1283,21,4507,24,2230,14,24
"698","2020-06-01",84,8,209,216,5811,0.578041645155739,1950,7566,693,1283,17,4524,34,2264,8,34
"699","2020-06-02",72,8,211,206,5811,0.578041645155739,1950,7566,693,1283,24,4548,19,2283,10,19
"700","2020-06-03",72,8,218,190,5811,0.578041645155739,1950,7566,693,1283,21,4569,13,2296,13,13
"701","2020-06-04",64,8,211,181,5811,0.578041645155739,1950,7566,693,1283,9,4578,20,2316,5,20
"702","2020-06-05",60,8,214,180,5811,0.578041645155739,1950,7566,693,1283,13,4591,15,2331,7,15
"703","2020-06-06",65,8,206,176,5811,0.578041645155739,1950,7566,693,1283,17,4608,17,2348,9,17
"704","2020-06-07",55,8,200,165,5811,0.578041645155739,1950,7566,693,1283,15,4623,7,2355,6,7
"705","2020-03-13",1,9,31,35,5974,0.929527954469367,2055,7320,728,864,13,30,30,74,12,30
"706","2020-03-14",1,9,37,55,5974,0.929527954469367,2055,7320,728,864,17,47,42,116,9,42
"707","2020-03-15",3,9,40,72,5974,0.929527954469367,2055,7320,728,864,15,62,17,133,10,17
"708","2020-03-16",6,9,54,93,5974,0.929527954469367,2055,7320,728,864,23,85,18,151,18,18
"709","2020-03-17",9,9,62,115,5974,0.929527954469367,2055,7320,728,864,25,110,11,162,22,11
"710","2020-03-18",10,9,61,141,5974,0.929527954469367,2055,7320,728,864,13,123,8,170,9,8
"711","2020-03-19",18,9,60,169,5974,0.929527954469367,2055,7320,728,864,28,151,4,174,25,4
"712","2020-03-20",23,9,60,206,5974,0.929527954469367,2055,7320,728,864,28,179,11,185,22,11
"713","2020-03-21",54,9,67,247,5974,0.929527954469367,2055,7320,728,864,39,218,39,224,35,39
"714","2020-03-22",60,9,67,275,5974,0.929527954469367,2055,7320,728,864,43,261,19,243,38,19
"715","2020-03-23",57,9,55,328,5974,0.929527954469367,2055,7320,728,864,39,300,20,263,33,20
"716","2020-03-24",63,9,94,373,5974,0.929527954469367,2055,7320,728,864,53,353,17,280,48,17
"717","2020-03-25",77,9,95,416,5974,0.929527954469367,2055,7320,728,864,64,417,60,340,58,60
"718","2020-03-26",86,9,88,485,5974,0.929527954469367,2055,7320,728,864,56,473,44,384,50,44
"719","2020-03-27",125,9,85,543,5974,0.929527954469367,2055,7320,728,864,74,547,43,427,63,43
"720","2020-03-28",147,9,83,593,5974,0.929527954469367,2055,7320,728,864,64,611,33,460,61,33
"721","2020-03-29",161,9,77,685,5974,0.929527954469367,2055,7320,728,864,74,685,44,504,68,44
"722","2020-03-30",173,9,73,742,5974,0.929527954469367,2055,7320,728,864,91,776,45,549,85,45
"723","2020-03-31",178,9,71,805,5974,0.929527954469367,2055,7320,728,864,82,858,33,582,78,33
"724","2020-04-01",194,9,74,877,5974,0.929527954469367,2055,7320,728,864,95,953,50,632,88,50
"725","2020-04-02",207,9,109,945,5974,0.929527954469367,2055,7320,728,864,106,1059,21,653,99,21
"726","2020-04-03",255,9,119,1010,5974,0.929527954469367,2055,7320,728,864,97,1156,11,664,93,11
"727","2020-04-04",273,9,110,1097,5974,0.929527954469367,2055,7320,728,864,121,1277,6,670,115,6
"728","2020-04-05",310,9,104,1167,5974,0.929527954469367,2055,7320,728,864,126,1403,6,676,119,6
"729","2020-04-06",325,9,122,1254,5974,0.929527954469367,2055,7320,728,864,120,1523,11,687,117,11
"730","2020-04-07",344,9,141,1392,5974,0.929527954469367,2055,7320,728,864,136,1659,19,706,129,19
"731","2020-04-08",361,9,159,1482,5974,0.929527954469367,2055,7320,728,864,143,1802,39,745,141,39
"732","2020-04-09",383,9,153,1547,5974,0.929527954469367,2055,7320,728,864,127,1929,46,791,118,46
"733","2020-04-10",482,9,149,1624,5974,0.929527954469367,2055,7320,728,864,132,2061,31,822,128,31
"734","2020-04-11",512,9,124,1662,5974,0.929527954469367,2055,7320,728,864,159,2220,43,865,158,43
"735","2020-04-12",522,9,118,1706,5974,0.929527954469367,2055,7320,728,864,127,2347,22,887,123,22
"736","2020-04-13",517,9,152,1736,5974,0.929527954469367,2055,7320,728,864,147,2494,25,912,139,25
"737","2020-04-14",521,9,134,1764,5974,0.929527954469367,2055,7320,728,864,148,2642,59,971,143,59
"738","2020-04-15",534,9,127,1737,5974,0.929527954469367,2055,7320,728,864,159,2801,69,1040,152,69
"739","2020-04-16",544,9,122,1741,5974,0.929527954469367,2055,7320,728,864,151,2952,32,1072,144,32
"740","2020-04-17",636,9,146,1737,5974,0.929527954469367,2055,7320,728,864,141,3093,51,1123,134,51
"741","2020-04-18",627,9,137,1702,5974,0.929527954469367,2055,7320,728,864,119,3212,50,1173,112,50
"742","2020-04-19",574,9,169,1646,5974,0.929527954469367,2055,7320,728,864,123,3335,24,1197,119,24
"743","2020-04-20",595,9,194,1619,5974,0.929527954469367,2055,7320,728,864,157,3492,43,1240,146,43
"744","2020-04-21",576,9,240,1567,5974,0.929527954469367,2055,7320,728,864,115,3607,32,1272,114,32
"745","2020-04-22",574,9,262,1553,5974,0.929527954469367,2055,7320,728,864,118,3725,55,1327,116,55
"746","2020-04-23",572,9,249,1511,5974,0.929527954469367,2055,7320,728,864,132,3857,36,1363,126,36
"747","2020-04-24",576,9,234,1437,5974,0.929527954469367,2055,7320,728,864,114,3971,30,1393,107,30
"748","2020-04-25",568,9,226,1380,5974,0.929527954469367,2055,7320,728,864,79,4050,11,1404,73,11
"749","2020-04-26",524,9,226,1318,5974,0.929527954469367,2055,7320,728,864,88,4138,18,1422,85,18
"750","2020-04-27",499,9,225,1273,5974,0.929527954469367,2055,7320,728,864,106,4244,35,1457,104,35
"751","2020-04-28",476,9,202,1236,5974,0.929527954469367,2055,7320,728,864,81,4325,16,1473,78,16
"752","2020-04-29",460,9,222,1174,5974,0.929527954469367,2055,7320,728,864,85,4410,14,1487,81,14
"753","2020-04-30",449,9,211,1127,5974,0.929527954469367,2055,7320,728,864,66,4476,42,1529,62,42
"754","2020-05-01",401,9,196,1062,5974,0.929527954469367,2055,7320,728,864,72,4548,20,1549,71,20
"755","2020-05-02",393,9,185,979,5974,0.929527954469367,2055,7320,728,864,73,4621,19,1568,69,19
"756","2020-05-03",359,9,165,901,5974,0.929527954469367,2055,7320,728,864,55,4676,15,1583,51,15
"757","2020-05-04",340,9,153,845,5974,0.929527954469367,2055,7320,728,864,56,4732,8,1591,52,8
"758","2020-05-05",331,9,182,777,5974,0.929527954469367,2055,7320,728,864,60,4792,26,1617,54,26
"759","2020-05-06",318,9,168,715,5974,0.929527954469367,2055,7320,728,864,47,4839,28,1645,42,28
"760","2020-05-07",297,9,155,678,5974,0.929527954469367,2055,7320,728,864,49,4888,47,1692,47,47
"761","2020-05-08",279,9,156,633,5974,0.929527954469367,2055,7320,728,864,32,4920,23,1715,26,23
"762","2020-05-09",258,9,187,577,5974,0.929527954469367,2055,7320,728,864,51,4971,58,1773,44,58
"763","2020-05-10",235,9,203,547,5974,0.929527954469367,2055,7320,728,864,46,5017,53,1826,45,53
"764","2020-05-11",223,9,216,512,5974,0.929527954469367,2055,7320,728,864,45,5062,23,1849,43,23
"765","2020-05-12",211,9,225,453,5974,0.929527954469367,2055,7320,728,864,23,5085,15,1864,22,15
"766","2020-05-13",191,9,206,420,5974,0.929527954469367,2055,7320,728,864,35,5120,10,1874,34,10
"767","2020-05-14",178,9,183,382,5974,0.929527954469367,2055,7320,728,864,28,5148,35,1909,27,35
"768","2020-05-15",145,9,199,345,5974,0.929527954469367,2055,7320,728,864,32,5180,57,1966,31,57
"769","2020-05-16",142,9,210,317,5974,0.929527954469367,2055,7320,728,864,20,5200,28,1994,17,28
"770","2020-05-17",125,9,201,276,5974,0.929527954469367,2055,7320,728,864,22,5222,38,2032,21,38
"771","2020-05-18",116,9,183,265,5974,0.929527954469367,2055,7320,728,864,25,5247,27,2059,25,27
"772","2020-05-19",102,9,183,238,5974,0.929527954469367,2055,7320,728,864,25,5272,23,2082,25,23
"773","2020-05-20",100,9,178,224,5974,0.929527954469367,2055,7320,728,864,21,5293,21,2103,19,21
"774","2020-05-21",96,9,181,215,5974,0.929527954469367,2055,7320,728,864,15,5308,50,2153,15,50
"775","2020-05-22",101,9,207,200,5974,0.929527954469367,2055,7320,728,864,17,5325,45,2198,16,45
"776","2020-05-23",88,9,199,186,5974,0.929527954469367,2055,7320,728,864,13,5338,47,2245,12,47
"777","2020-05-24",67,9,180,180,5974,0.929527954469367,2055,7320,728,864,13,5351,26,2271,13,26
"778","2020-05-25",60,9,201,164,5974,0.929527954469367,2055,7320,728,864,8,5359,34,2305,5,34
"779","2020-05-26",55,9,208,159,5974,0.929527954469367,2055,7320,728,864,15,5374,16,2321,10,16
"780","2020-05-27",52,9,187,151,5974,0.929527954469367,2055,7320,728,864,17,5391,10,2331,13,10
"781","2020-05-28",50,9,166,144,5974,0.929527954469367,2055,7320,728,864,11,5402,9,2340,11,9
"782","2020-05-29",40,9,152,131,5974,0.929527954469367,2055,7320,728,864,5,5407,32,2372,4,32
"783","2020-05-30",42,9,138,133,5974,0.929527954469367,2055,7320,728,864,11,5418,56,2428,9,56
"784","2020-05-31",40,9,121,127,5974,0.929527954469367,2055,7320,728,864,11,5429,40,2468,10,40
"785","2020-06-01",43,9,115,123,5974,0.929527954469367,2055,7320,728,864,14,5443,28,2496,11,28
"786","2020-06-02",44,9,126,115,5974,0.929527954469367,2055,7320,728,864,6,5449,20,2516,5,20
"787","2020-06-03",45,9,145,109,5974,0.929527954469367,2055,7320,728,864,14,5463,11,2527,8,11
"788","2020-06-04",37,9,151,103,5974,0.929527954469367,2055,7320,728,864,6,5469,17,2544,6,17
"789","2020-06-05",40,9,135,99,5974,0.929527954469367,2055,7320,728,864,11,5480,23,2567,10,23
"790","2020-06-06",35,9,125,95,5974,0.929527954469367,2055,7320,728,864,9,5489,19,2586,6,19
"791","2020-06-07",32,9,127,91,5974,0.929527954469367,2055,7320,728,864,9,5498,26,2612,9,26
"792","2020-03-08",2,10,0,0,6013,0.909196740395809,1980,6887,563,960,NA,NA,NA,NA,NA,NA
"793","2020-03-09",2,10,0,0,6013,0.909196740395809,1980,6887,563,960,NA,NA,NA,NA,NA,NA
"794","2020-03-10",0,10,0,0,6013,0.909196740395809,1980,6887,563,960,NA,NA,2,2,NA,2
"795","2020-03-11",0,10,0,0,6013,0.909196740395809,1980,6887,563,960,15,15,3,5,NA,3
"796","2020-03-12",0,10,0,0,6013,0.909196740395809,1980,6887,563,960,27,42,11,16,1,11
"797","2020-03-13",1,10,81,28,6013,0.909196740395809,1980,6887,563,960,30,72,7,23,2,7
"798","2020-03-14",2,10,92,42,6013,0.909196740395809,1980,6887,563,960,21,93,14,37,7,14
"799","2020-03-15",7,10,100,53,6013,0.909196740395809,1980,6887,563,960,32,125,14,51,11,14
"800","2020-03-16",9,10,121,71,6013,0.909196740395809,1980,6887,563,960,35,160,8,59,15,8
"801","2020-03-17",9,10,138,90,6013,0.909196740395809,1980,6887,563,960,60,220,3,62,35,3
"802","2020-03-18",10,10,121,107,6013,0.909196740395809,1980,6887,563,960,42,262,15,77,25,15
"803","2020-03-19",18,10,128,140,6013,0.909196740395809,1980,6887,563,960,55,317,10,87,38,10
"804","2020-03-20",24,10,144,183,6013,0.909196740395809,1980,6887,563,960,69,386,10,97,49,10
"805","2020-03-21",35,10,141,220,6013,0.909196740395809,1980,6887,563,960,77,463,7,104,58,7
"806","2020-03-22",45,10,157,271,6013,0.909196740395809,1980,6887,563,960,65,528,15,119,53,15
"807","2020-03-23",54,10,154,322,6013,0.909196740395809,1980,6887,563,960,81,609,11,130,52,11
"808","2020-03-24",59,10,147,367,6013,0.909196740395809,1980,6887,563,960,89,698,9,139,74,9
"809","2020-03-25",67,10,161,425,6013,0.909196740395809,1980,6887,563,960,91,789,28,167,63,28
"810","2020-03-26",78,10,191,477,6013,0.909196740395809,1980,6887,563,960,98,887,28,195,73,28
"811","2020-03-27",108,10,190,553,6013,0.909196740395809,1980,6887,563,960,93,980,17,212,74,17
"812","2020-03-28",119,10,189,615,6013,0.909196740395809,1980,6887,563,960,122,1102,17,229,97,17
"813","2020-03-29",159,10,187,675,6013,0.909196740395809,1980,6887,563,960,104,1206,14,243,83,14
"814","2020-03-30",161,10,166,752,6013,0.909196740395809,1980,6887,563,960,108,1314,12,255,90,12
"815","2020-03-31",166,10,163,870,6013,0.909196740395809,1980,6887,563,960,129,1443,5,260,106,5
"816","2020-04-01",200,10,160,945,6013,0.909196740395809,1980,6887,563,960,121,1564,7,267,96,7
"817","2020-04-02",221,10,190,1048,6013,0.909196740395809,1980,6887,563,960,113,1677,10,277,94,10
"818","2020-04-03",315,10,216,1137,6013,0.909196740395809,1980,6887,563,960,115,1792,23,300,87,23
"819","2020-04-04",381,10,200,1220,6013,0.909196740395809,1980,6887,563,960,123,1915,32,332,98,32
"820","2020-04-05",366,10,182,1342,6013,0.909196740395809,1980,6887,563,960,146,2061,13,345,120,13
"821","2020-04-06",402,10,156,1434,6013,0.909196740395809,1980,6887,563,960,120,2181,11,356,89,11
"822","2020-04-07",424,10,140,1535,6013,0.909196740395809,1980,6887,563,960,110,2291,14,370,93,14
"823","2020-04-08",423,10,143,1623,6013,0.909196740395809,1980,6887,563,960,102,2393,19,389,84,19
"824","2020-04-09",448,10,163,1679,6013,0.909196740395809,1980,6887,563,960,128,2521,30,419,105,30
"825","2020-04-10",585,10,177,1748,6013,0.909196740395809,1980,6887,563,960,138,2659,26,445,99,26
"826","2020-04-11",619,10,188,1815,6013,0.909196740395809,1980,6887,563,960,125,2784,18,463,104,18
"827","2020-04-12",569,10,204,1904,6013,0.909196740395809,1980,6887,563,960,109,2893,15,478,84,15
"828","2020-04-13",565,10,214,1914,6013,0.909196740395809,1980,6887,563,960,127,3020,30,508,96,30
"829","2020-04-14",568,10,226,1913,6013,0.909196740395809,1980,6887,563,960,112,3132,16,524,88,16
"830","2020-04-15",600,10,251,1899,6013,0.909196740395809,1980,6887,563,960,119,3251,17,541,103,17
"831","2020-04-16",617,10,232,1900,6013,0.909196740395809,1980,6887,563,960,104,3355,14,555,87,14
"832","2020-04-17",685,10,235,1928,6013,0.909196740395809,1980,6887,563,960,92,3447,28,583,76,28
"833","2020-04-18",687,10,224,1887,6013,0.909196740395809,1980,6887,563,960,85,3532,16,599,72,16
"834","2020-04-19",680,10,205,1868,6013,0.909196740395809,1980,6887,563,960,103,3635,13,612,87,13
"835","2020-04-20",660,10,192,1814,6013,0.909196740395809,1980,6887,563,960,76,3711,32,644,57,32
"836","2020-04-21",659,10,213,1753,6013,0.909196740395809,1980,6887,563,960,90,3801,19,663,78,19
"837","2020-04-22",648,10,197,1695,6013,0.909196740395809,1980,6887,563,960,73,3874,51,714,52,51
"838","2020-04-23",637,10,218,1614,6013,0.909196740395809,1980,6887,563,960,85,3959,30,744,66,30
"839","2020-04-24",618,10,204,1529,6013,0.909196740395809,1980,6887,563,960,72,4031,38,782,58,38
"840","2020-04-25",586,10,191,1441,6013,0.909196740395809,1980,6887,563,960,71,4102,36,818,56,36
"841","2020-04-26",538,10,173,1382,6013,0.909196740395809,1980,6887,563,960,65,4167,19,837,49,19
"842","2020-04-27",519,10,157,1318,6013,0.909196740395809,1980,6887,563,960,58,4225,19,856,42,19
"843","2020-04-28",516,10,162,1205,6013,0.909196740395809,1980,6887,563,960,73,4298,35,891,54,35
"844","2020-04-29",494,10,189,1133,6013,0.909196740395809,1980,6887,563,960,61,4359,17,908,44,17
"845","2020-04-30",477,10,225,1040,6013,0.909196740395809,1980,6887,563,960,64,4423,9,917,48,9
"846","2020-05-01",439,10,271,957,6013,0.909196740395809,1980,6887,563,960,52,4475,35,952,36,35
"847","2020-05-02",417,10,250,893,6013,0.909196740395809,1980,6887,563,960,57,4532,44,996,34,44
"848","2020-05-03",365,10,239,802,6013,0.909196740395809,1980,6887,563,960,55,4587,21,1017,48,21
"849","2020-05-04",354,10,207,741,6013,0.909196740395809,1980,6887,563,960,53,4640,10,1027,35,10
"850","2020-05-05",310,10,220,678,6013,0.909196740395809,1980,6887,563,960,49,4689,16,1043,32,16
"851","2020-05-06",288,10,233,606,6013,0.909196740395809,1980,6887,563,960,44,4733,34,1077,29,34
"852","2020-05-07",251,10,225,556,6013,0.909196740395809,1980,6887,563,960,33,4766,20,1097,24,20
"853","2020-05-08",209,10,228,494,6013,0.909196740395809,1980,6887,563,960,33,4799,17,1114,26,17
"854","2020-05-09",198,10,199,440,6013,0.909196740395809,1980,6887,563,960,46,4845,20,1134,33,20
"855","2020-05-10",166,10,194,389,6013,0.909196740395809,1980,6887,563,960,40,4885,16,1150,30,16
"856","2020-05-11",147,10,197,354,6013,0.909196740395809,1980,6887,563,960,21,4906,19,1169,16,19
"857","2020-05-12",144,10,163,325,6013,0.909196740395809,1980,6887,563,960,30,4936,15,1184,22,15
"858","2020-05-13",141,10,151,309,6013,0.909196740395809,1980,6887,563,960,30,4966,30,1214,24,30
"859","2020-05-14",135,10,155,296,6013,0.909196740395809,1980,6887,563,960,31,4997,23,1237,19,23
"860","2020-05-15",106,10,143,277,6013,0.909196740395809,1980,6887,563,960,38,5035,8,1245,24,8
"861","2020-05-16",99,10,137,247,6013,0.909196740395809,1980,6887,563,960,17,5052,15,1260,12,15
"862","2020-05-17",104,10,158,230,6013,0.909196740395809,1980,6887,563,960,24,5076,8,1268,10,8
"863","2020-05-18",96,10,170,218,6013,0.909196740395809,1980,6887,563,960,24,5100,19,1287,11,19
"864","2020-05-19",85,10,198,202,6013,0.909196740395809,1980,6887,563,960,28,5128,16,1303,17,16
"865","2020-05-20",72,10,213,190,6013,0.909196740395809,1980,6887,563,960,21,5149,25,1328,10,25
"866","2020-05-21",68,10,205,172,6013,0.909196740395809,1980,6887,563,960,23,5172,15,1343,11,15
"867","2020-05-22",66,10,179,155,6013,0.909196740395809,1980,6887,563,960,24,5196,7,1350,13,7
"868","2020-05-23",61,10,166,148,6013,0.909196740395809,1980,6887,563,960,24,5220,8,1358,15,8
"869","2020-05-24",53,10,150,139,6013,0.909196740395809,1980,6887,563,960,21,5241,12,1370,11,12
"870","2020-05-25",54,10,167,128,6013,0.909196740395809,1980,6887,563,960,23,5264,21,1391,14,21
"871","2020-05-26",55,10,154,121,6013,0.909196740395809,1980,6887,563,960,10,5274,7,1398,7,7
"872","2020-05-27",58,10,144,111,6013,0.909196740395809,1980,6887,563,960,13,5287,12,1410,6,12
"873","2020-05-28",56,10,129,101,6013,0.909196740395809,1980,6887,563,960,14,5301,6,1416,5,6
"874","2020-05-29",46,10,139,91,6013,0.909196740395809,1980,6887,563,960,20,5321,4,1420,11,4
"875","2020-05-30",44,10,158,83,6013,0.909196740395809,1980,6887,563,960,15,5336,10,1430,6,10
"876","2020-05-31",39,10,149,73,6013,0.909196740395809,1980,6887,563,960,17,5353,9,1439,11,9
"877","2020-06-01",35,10,160,68,6013,0.909196740395809,1980,6887,563,960,12,5365,19,1458,7,19
"878","2020-06-02",28,10,165,64,6013,0.909196740395809,1980,6887,563,960,8,5373,12,1470,3,12
"879","2020-06-03",23,10,158,64,6013,0.909196740395809,1980,6887,563,960,16,5389,12,1482,9,12
"880","2020-06-04",20,10,146,54,6013,0.909196740395809,1980,6887,563,960,7,5396,12,1494,2,12
"881","2020-06-05",22,10,140,47,6013,0.909196740395809,1980,6887,563,960,9,5405,7,1501,7,7
"882","2020-06-06",18,10,127,39,6013,0.909196740395809,1980,6887,563,960,18,5423,6,1507,7,6
"883","2020-06-07",17,10,115,33,6013,0.909196740395809,1980,6887,563,960,11,5434,10,1517,6,10
"884","2020-03-08",1,11,0,0,6639,0.704021690013556,1995,7422,687,820,NA,NA,NA,NA,NA,NA
"885","2020-03-09",1,11,0,0,6639,0.704021690013556,1995,7422,687,820,NA,NA,NA,NA,NA,NA
"886","2020-03-10",0,11,0,0,6639,0.704021690013556,1995,7422,687,820,NA,NA,1,1,NA,1
"887","2020-03-11",0,11,0,0,6639,0.704021690013556,1995,7422,687,820,43,43,14,15,2,14
"888","2020-03-12",0,11,0,0,6639,0.704021690013556,1995,7422,687,820,50,93,22,37,6,22
"889","2020-03-13",1,11,109,92,6639,0.704021690013556,1995,7422,687,820,40,133,45,82,4,45
"890","2020-03-14",7,11,137,135,6639,0.704021690013556,1995,7422,687,820,51,184,37,119,17,37
"891","2020-03-15",12,11,133,193,6639,0.704021690013556,1995,7422,687,820,68,252,44,163,20,44
"892","2020-03-16",17,11,123,259,6639,0.704021690013556,1995,7422,687,820,61,313,55,218,31,55
"893","2020-03-17",19,11,95,335,6639,0.704021690013556,1995,7422,687,820,65,378,49,267,33,49
"894","2020-03-18",33,11,93,397,6639,0.704021690013556,1995,7422,687,820,65,443,84,351,34,84
"895","2020-03-19",45,11,83,464,6639,0.704021690013556,1995,7422,687,820,88,531,83,434,47,83
"896","2020-03-20",68,11,80,563,6639,0.704021690013556,1995,7422,687,820,111,642,56,490,63,56
"897","2020-03-21",122,11,75,664,6639,0.704021690013556,1995,7422,687,820,95,737,38,528,60,38
"898","2020-03-22",164,11,108,757,6639,0.704021690013556,1995,7422,687,820,115,852,25,553,77,25
"899","2020-03-23",168,11,112,859,6639,0.704021690013556,1995,7422,687,820,90,942,35,588,56,35
"900","2020-03-24",182,11,121,951,6639,0.704021690013556,1995,7422,687,820,146,1088,52,640,111,52
"901","2020-03-25",204,11,129,1038,6639,0.704021690013556,1995,7422,687,820,121,1209,50,690,82,50
"902","2020-03-26",241,11,127,1118,6639,0.704021690013556,1995,7422,687,820,136,1345,28,718,96,28
"903","2020-03-27",338,11,177,1203,6639,0.704021690013556,1995,7422,687,820,128,1473,35,753,91,35
"904","2020-03-28",360,11,218,1301,6639,0.704021690013556,1995,7422,687,820,137,1610,41,794,101,41
"905","2020-03-29",413,11,235,1337,6639,0.704021690013556,1995,7422,687,820,131,1741,37,831,87,37
"906","2020-03-30",436,11,194,1385,6639,0.704021690013556,1995,7422,687,820,132,1873,36,867,98,36
"907","2020-03-31",442,11,172,1422,6639,0.704021690013556,1995,7422,687,820,106,1979,35,902,78,35
"908","2020-04-01",455,11,153,1464,6639,0.704021690013556,1995,7422,687,820,134,2113,25,927,93,25
"909","2020-04-02",453,11,177,1494,6639,0.704021690013556,1995,7422,687,820,126,2239,27,954,97,27
"910","2020-04-03",571,11,201,1530,6639,0.704021690013556,1995,7422,687,820,131,2370,26,980,96,26
"911","2020-04-04",575,11,223,1565,6639,0.704021690013556,1995,7422,687,820,146,2516,53,1033,103,53
"912","2020-04-05",483,11,242,1617,6639,0.704021690013556,1995,7422,687,820,129,2645,39,1072,93,39
"913","2020-04-06",491,11,227,1647,6639,0.704021690013556,1995,7422,687,820,135,2780,54,1126,104,54
"914","2020-04-07",499,11,214,1669,6639,0.704021690013556,1995,7422,687,820,118,2898,28,1154,85,28
"915","2020-04-08",510,11,197,1651,6639,0.704021690013556,1995,7422,687,820,90,2988,60,1214,67,60
"916","2020-04-09",526,11,171,1670,6639,0.704021690013556,1995,7422,687,820,119,3107,40,1254,78,40
"917","2020-04-10",553,11,156,1671,6639,0.704021690013556,1995,7422,687,820,117,3224,46,1300,81,46
"918","2020-04-11",538,11,145,1664,6639,0.704021690013556,1995,7422,687,820,99,3323,47,1347,73,47
"919","2020-04-12",534,11,171,1678,6639,0.704021690013556,1995,7422,687,820,105,3428,45,1392,77,45
"920","2020-04-13",523,11,180,1655,6639,0.704021690013556,1995,7422,687,820,96,3524,48,1440,73,48
"921","2020-04-14",518,11,217,1658,6639,0.704021690013556,1995,7422,687,820,108,3632,48,1488,72,48
"922","2020-04-15",513,11,259,1642,6639,0.704021690013556,1995,7422,687,820,96,3728,56,1544,71,56
"923","2020-04-16",526,11,287,1610,6639,0.704021690013556,1995,7422,687,820,105,3833,53,1597,72,53
"924","2020-04-17",539,11,288,1549,6639,0.704021690013556,1995,7422,687,820,80,3913,39,1636,51,39
"925","2020-04-18",574,11,307,1495,6639,0.704021690013556,1995,7422,687,820,105,4018,39,1675,74,39
"926","2020-04-19",545,11,265,1470,6639,0.704021690013556,1995,7422,687,820,93,4111,28,1703,58,28
"927","2020-04-20",552,11,235,1392,6639,0.704021690013556,1995,7422,687,820,74,4185,27,1730,50,27
"928","2020-04-21",540,11,232,1330,6639,0.704021690013556,1995,7422,687,820,73,4258,31,1761,51,31
"929","2020-04-22",539,11,244,1281,6639,0.704021690013556,1995,7422,687,820,72,4330,19,1780,39,19
"930","2020-04-23",508,11,221,1215,6639,0.704021690013556,1995,7422,687,820,71,4401,32,1812,42,32
"931","2020-04-24",492,11,209,1156,6639,0.704021690013556,1995,7422,687,820,57,4458,47,1859,31,47
"932","2020-04-25",468,11,203,1096,6639,0.704021690013556,1995,7422,687,820,62,4520,49,1908,44,49
"933","2020-04-26",408,11,200,1035,6639,0.704021690013556,1995,7422,687,820,80,4600,49,1957,49,49
"934","2020-04-27",381,11,193,978,6639,0.704021690013556,1995,7422,687,820,60,4660,34,1991,32,34
"935","2020-04-28",359,11,218,913,6639,0.704021690013556,1995,7422,687,820,55,4715,34,2025,32,34
"936","2020-04-29",339,11,211,859,6639,0.704021690013556,1995,7422,687,820,62,4777,41,2066,34,41
"937","2020-04-30",334,11,212,789,6639,0.704021690013556,1995,7422,687,820,67,4844,31,2097,35,31
"938","2020-05-01",290,11,227,720,6639,0.704021690013556,1995,7422,687,820,40,4884,43,2140,17,43
"939","2020-05-02",270,11,245,685,6639,0.704021690013556,1995,7422,687,820,62,4946,46,2186,28,46
"940","2020-05-03",268,11,230,652,6639,0.704021690013556,1995,7422,687,820,53,4999,35,2221,32,35
"941","2020-05-04",251,11,190,625,6639,0.704021690013556,1995,7422,687,820,62,5061,46,2267,34,46
"942","2020-05-05",249,11,188,589,6639,0.704021690013556,1995,7422,687,820,39,5100,45,2312,14,45
"943","2020-05-06",231,11,186,545,6639,0.704021690013556,1995,7422,687,820,45,5145,34,2346,20,34
"944","2020-05-07",204,11,175,526,6639,0.704021690013556,1995,7422,687,820,47,5192,39,2385,26,39
"945","2020-05-08",200,11,147,485,6639,0.704021690013556,1995,7422,687,820,38,5230,43,2428,24,43
"946","2020-05-09",192,11,129,449,6639,0.704021690013556,1995,7422,687,820,38,5268,52,2480,19,52
"947","2020-05-10",168,11,113,428,6639,0.704021690013556,1995,7422,687,820,44,5312,33,2513,17,33
"948","2020-05-11",162,11,102,395,6639,0.704021690013556,1995,7422,687,820,32,5344,35,2548,14,35
"949","2020-05-12",152,11,95,376,6639,0.704021690013556,1995,7422,687,820,27,5371,40,2588,12,40
"950","2020-05-13",156,11,101,372,6639,0.704021690013556,1995,7422,687,820,34,5405,38,2626,18,38
"951","2020-05-14",157,11,147,352,6639,0.704021690013556,1995,7422,687,820,42,5447,40,2666,19,40
"952","2020-05-15",143,11,174,321,6639,0.704021690013556,1995,7422,687,820,23,5470,56,2722,9,56
"953","2020-05-16",129,11,220,309,6639,0.704021690013556,1995,7422,687,820,24,5494,41,2763,7,41
"954","2020-05-17",122,11,208,289,6639,0.704021690013556,1995,7422,687,820,30,5524,43,2806,11,43
"955","2020-05-18",115,11,225,270,6639,0.704021690013556,1995,7422,687,820,19,5543,56,2862,7,56
"956","2020-05-19",102,11,211,251,6639,0.704021690013556,1995,7422,687,820,27,5570,51,2913,13,51
"957","2020-05-20",87,11,197,237,6639,0.704021690013556,1995,7422,687,820,14,5584,63,2976,3,63
"958","2020-05-21",79,11,173,220,6639,0.704021690013556,1995,7422,687,820,15,5599,74,3050,9,74
"959","2020-05-22",71,11,168,212,6639,0.704021690013556,1995,7422,687,820,24,5623,38,3088,13,38
"960","2020-05-23",72,11,184,203,6639,0.704021690013556,1995,7422,687,820,20,5643,48,3136,9,48
"961","2020-05-24",63,11,206,207,6639,0.704021690013556,1995,7422,687,820,18,5661,55,3191,8,55
"962","2020-05-25",57,11,224,193,6639,0.704021690013556,1995,7422,687,820,19,5680,27,3218,9,27
"963","2020-05-26",51,11,214,182,6639,0.704021690013556,1995,7422,687,820,17,5697,36,3254,4,36
"964","2020-05-27",58,11,212,172,6639,0.704021690013556,1995,7422,687,820,19,5716,29,3283,11,29
"965","2020-05-28",57,11,193,160,6639,0.704021690013556,1995,7422,687,820,23,5739,28,3311,12,28
"966","2020-05-29",49,11,166,161,6639,0.704021690013556,1995,7422,687,820,14,5753,36,3347,5,36
"967","2020-05-30",52,11,150,145,6639,0.704021690013556,1995,7422,687,820,17,5770,34,3381,7,34
"968","2020-05-31",50,11,127,139,6639,0.704021690013556,1995,7422,687,820,12,5782,48,3429,3,48
"969","2020-06-01",48,11,108,137,6639,0.704021690013556,1995,7422,687,820,9,5791,45,3474,2,45
"970","2020-06-02",53,11,112,134,6639,0.704021690013556,1995,7422,687,820,19,5810,38,3512,6,38
"971","2020-06-03",44,11,108,130,6639,0.704021690013556,1995,7422,687,820,10,5820,30,3542,6,30
"972","2020-06-04",43,11,121,123,6639,0.704021690013556,1995,7422,687,820,23,5843,56,3598,11,56
"973","2020-06-05",45,11,115,123,6639,0.704021690013556,1995,7422,687,820,13,5856,44,3642,5,44
"974","2020-06-06",45,11,114,120,6639,0.704021690013556,1995,7422,687,820,4,5860,35,3677,2,35
"975","2020-06-07",40,11,126,113,6639,0.704021690013556,1995,7422,687,820,8,5868,40,3717,2,40
"976","2020-03-07",1,12,0,0,5563,0.494517346755348,2055,7785,614,862,NA,NA,NA,NA,NA,NA
"977","2020-03-08",1,12,0,0,5563,0.494517346755348,2055,7785,614,862,NA,NA,NA,NA,NA,NA
"978","2020-03-09",0,12,0,0,5563,0.494517346755348,2055,7785,614,862,NA,NA,NA,NA,NA,NA
"979","2020-03-10",0,12,0,0,5563,0.494517346755348,2055,7785,614,862,NA,NA,2,2,NA,2
"980","2020-03-11",0,12,0,0,5563,0.494517346755348,2055,7785,614,862,18,18,19,21,1,19
"981","2020-03-12",1,12,46,65,5563,0.494517346755348,2055,7785,614,862,24,42,23,44,6,23
"982","2020-03-13",4,12,59,116,5563,0.494517346755348,2055,7785,614,862,20,62,52,96,6,52
"983","2020-03-14",6,12,72,157,5563,0.494517346755348,2055,7785,614,862,20,82,22,118,9,22
"984","2020-03-15",16,12,87,205,5563,0.494517346755348,2055,7785,614,862,37,119,39,157,22,39
"985","2020-03-16",20,12,99,254,5563,0.494517346755348,2055,7785,614,862,32,151,22,179,13,22
"986","2020-03-17",27,12,92,311,5563,0.494517346755348,2055,7785,614,862,45,196,16,195,27,16
"987","2020-03-18",39,12,91,360,5563,0.494517346755348,2055,7785,614,862,39,235,19,214,27,19
"988","2020-03-19",47,12,96,413,5563,0.494517346755348,2055,7785,614,862,32,267,34,248,20,34
"989","2020-03-20",74,12,114,468,5563,0.494517346755348,2055,7785,614,862,49,316,44,292,28,44
"990","2020-03-21",119,12,126,529,5563,0.494517346755348,2055,7785,614,862,69,385,34,326,51,34
"991","2020-03-22",125,12,120,597,5563,0.494517346755348,2055,7785,614,862,60,445,27,353,46,27
"992","2020-03-23",131,12,123,660,5563,0.494517346755348,2055,7785,614,862,55,500,22,375,39,22
"993","2020-03-24",153,12,135,705,5563,0.494517346755348,2055,7785,614,862,57,557,40,415,46,40
"994","2020-03-25",166,12,141,753,5563,0.494517346755348,2055,7785,614,862,84,641,24,439,62,24
"995","2020-03-26",184,12,134,796,5563,0.494517346755348,2055,7785,614,862,81,722,21,460,71,21
"996","2020-03-27",227,12,112,856,5563,0.494517346755348,2055,7785,614,862,80,802,8,468,65,8
"997","2020-03-28",243,12,104,879,5563,0.494517346755348,2055,7785,614,862,78,880,9,477,59,9
"998","2020-03-29",274,12,126,888,5563,0.494517346755348,2055,7785,614,862,92,972,32,509,72,32
"999","2020-03-30",281,12,150,914,5563,0.494517346755348,2055,7785,614,862,89,1061,39,548,70,39
"1000","2020-03-31",273,12,153,945,5563,0.494517346755348,2055,7785,614,862,81,1142,47,595,66,47
"1001","2020-04-01",282,12,168,977,5563,0.494517346755348,2055,7785,614,862,96,1238,41,636,77,41
"1002","2020-04-02",297,12,186,1009,5563,0.494517346755348,2055,7785,614,862,102,1340,33,669,78,33
"1003","2020-04-03",349,12,182,1012,5563,0.494517346755348,2055,7785,614,862,100,1440,43,712,80,43
"1004","2020-04-04",351,12,194,1026,5563,0.494517346755348,2055,7785,614,862,134,1574,20,732,111,20
"1005","2020-04-05",334,12,196,1035,5563,0.494517346755348,2055,7785,614,862,99,1673,27,759,91,27
"1006","2020-04-06",332,12,195,1026,5563,0.494517346755348,2055,7785,614,862,105,1778,54,813,84,54
"1007","2020-04-07",335,12,204,1035,5563,0.494517346755348,2055,7785,614,862,97,1875,29,842,74,29
"1008","2020-04-08",341,12,212,1029,5563,0.494517346755348,2055,7785,614,862,127,2002,22,864,105,22
"1009","2020-04-09",339,12,188,1030,5563,0.494517346755348,2055,7785,614,862,107,2109,50,914,85,50
"1010","2020-04-10",361,12,207,1025,5563,0.494517346755348,2055,7785,614,862,97,2206,44,958,86,44
"1011","2020-04-11",386,12,240,1023,5563,0.494517346755348,2055,7785,614,862,119,2325,26,984,92,26
"1012","2020-04-12",356,12,236,1014,5563,0.494517346755348,2055,7785,614,862,116,2441,41,1025,96,41
"1013","2020-04-13",350,12,223,995,5563,0.494517346755348,2055,7785,614,862,103,2544,26,1051,83,26
"1014","2020-04-14",341,12,219,984,5563,0.494517346755348,2055,7785,614,862,97,2641,32,1083,82,32
"1015","2020-04-15",337,12,195,974,5563,0.494517346755348,2055,7785,614,862,91,2732,36,1119,74,36
"1016","2020-04-16",326,12,167,963,5563,0.494517346755348,2055,7785,614,862,89,2821,53,1172,65,53
"1017","2020-04-17",337,12,165,973,5563,0.494517346755348,2055,7785,614,862,113,2934,24,1196,95,24
"1018","2020-04-18",333,12,180,960,5563,0.494517346755348,2055,7785,614,862,97,3031,19,1215,82,19
"1019","2020-04-19",313,12,169,953,5563,0.494517346755348,2055,7785,614,862,70,3101,46,1261,53,46
"1020","2020-04-20",315,12,183,933,5563,0.494517346755348,2055,7785,614,862,86,3187,11,1272,72,11
"1021","2020-04-21",314,12,198,920,5563,0.494517346755348,2055,7785,614,862,65,3252,14,1286,49,14
"1022","2020-04-22",311,12,202,918,5563,0.494517346755348,2055,7785,614,862,77,3329,8,1294,65,8
"1023","2020-04-23",308,12,193,915,5563,0.494517346755348,2055,7785,614,862,68,3397,12,1306,55,12
"1024","2020-04-24",314,12,172,911,5563,0.494517346755348,2055,7785,614,862,59,3456,14,1320,47,14
"1025","2020-04-25",313,12,179,900,5563,0.494517346755348,2055,7785,614,862,75,3531,15,1335,62,15
"1026","2020-04-26",294,12,193,901,5563,0.494517346755348,2055,7785,614,862,69,3600,23,1358,50,23
"1027","2020-04-27",277,12,189,886,5563,0.494517346755348,2055,7785,614,862,58,3658,63,1421,49,63
"1028","2020-04-28",278,12,179,874,5563,0.494517346755348,2055,7785,614,862,48,3706,26,1447,34,26
"1029","2020-04-29",269,12,172,868,5563,0.494517346755348,2055,7785,614,862,57,3763,20,1467,44,20
"1030","2020-04-30",277,12,166,828,5563,0.494517346755348,2055,7785,614,862,71,3834,39,1506,53,39
"1031","2020-05-01",277,12,185,829,5563,0.494517346755348,2055,7785,614,862,57,3891,59,1565,43,59
"1032","2020-05-02",260,12,201,813,5563,0.494517346755348,2055,7785,614,862,44,3935,24,1589,31,24
"1033","2020-05-03",264,12,188,788,5563,0.494517346755348,2055,7785,614,862,32,3967,29,1618,27,29
"1034","2020-05-04",254,12,169,770,5563,0.494517346755348,2055,7785,614,862,62,4029,46,1664,41,46
"1035","2020-05-05",239,12,182,751,5563,0.494517346755348,2055,7785,614,862,41,4070,46,1710,26,46
"1036","2020-05-06",246,12,188,744,5563,0.494517346755348,2055,7785,614,862,36,4106,40,1750,23,40
"1037","2020-05-07",236,12,201,704,5563,0.494517346755348,2055,7785,614,862,48,4154,39,1789,35,39
"1038","2020-05-08",251,12,185,674,5563,0.494517346755348,2055,7785,614,862,28,4182,38,1827,18,38
"1039","2020-05-09",255,12,187,641,5563,0.494517346755348,2055,7785,614,862,32,4214,25,1852,17,25
"1040","2020-05-10",232,12,175,617,5563,0.494517346755348,2055,7785,614,862,33,4247,46,1898,25,46
"1041","2020-05-11",229,12,205,591,5563,0.494517346755348,2055,7785,614,862,39,4286,29,1927,24,29
"1042","2020-05-12",223,12,204,565,5563,0.494517346755348,2055,7785,614,862,24,4310,27,1954,16,27
"1043","2020-05-13",211,12,203,554,5563,0.494517346755348,2055,7785,614,862,29,4339,18,1972,21,18
"1044","2020-05-14",203,12,204,532,5563,0.494517346755348,2055,7785,614,862,28,4367,20,1992,14,20
"1045","2020-05-15",190,12,193,512,5563,0.494517346755348,2055,7785,614,862,36,4403,8,2000,23,8
"1046","2020-05-16",195,12,193,497,5563,0.494517346755348,2055,7785,614,862,38,4441,33,2033,31,33
"1047","2020-05-17",188,12,213,467,5563,0.494517346755348,2055,7785,614,862,28,4469,47,2080,16,47
"1048","2020-05-18",183,12,209,433,5563,0.494517346755348,2055,7785,614,862,26,4495,42,2122,18,42
"1049","2020-05-19",170,12,202,418,5563,0.494517346755348,2055,7785,614,862,23,4518,19,2141,14,19
"1050","2020-05-20",161,12,181,398,5563,0.494517346755348,2055,7785,614,862,25,4543,19,2160,16,19
"1051","2020-05-21",157,12,179,386,5563,0.494517346755348,2055,7785,614,862,36,4579,41,2201,22,41
"1052","2020-05-22",152,12,156,352,5563,0.494517346755348,2055,7785,614,862,27,4606,41,2242,17,41
"1053","2020-05-23",145,12,175,349,5563,0.494517346755348,2055,7785,614,862,23,4629,41,2283,17,41
"1054","2020-05-24",125,12,181,329,5563,0.494517346755348,2055,7785,614,862,18,4647,34,2317,10,34
"1055","2020-05-25",114,12,191,306,5563,0.494517346755348,2055,7785,614,862,25,4672,41,2358,16,41
"1056","2020-05-26",112,12,195,295,5563,0.494517346755348,2055,7785,614,862,25,4697,18,2376,21,18
"1057","2020-05-27",111,12,180,278,5563,0.494517346755348,2055,7785,614,862,21,4718,17,2393,18,17
"1058","2020-05-28",112,12,158,283,5563,0.494517346755348,2055,7785,614,862,22,4740,39,2432,12,39
"1059","2020-05-29",96,12,156,272,5563,0.494517346755348,2055,7785,614,862,17,4757,18,2450,11,18
"1060","2020-05-30",86,12,174,263,5563,0.494517346755348,2055,7785,614,862,22,4779,33,2483,14,33
"1061","2020-05-31",85,12,177,254,5563,0.494517346755348,2055,7785,614,862,18,4797,21,2504,15,21
"1062","2020-06-01",86,12,178,248,5563,0.494517346755348,2055,7785,614,862,18,4815,44,2548,10,44
"1063","2020-06-02",81,12,173,250,5563,0.494517346755348,2055,7785,614,862,19,4834,27,2575,12,27
"1064","2020-06-03",84,12,179,233,5563,0.494517346755348,2055,7785,614,862,14,4848,32,2607,9,32
"1065","2020-06-04",77,12,177,225,5563,0.494517346755348,2055,7785,614,862,9,4857,22,2629,8,22
"1066","2020-06-05",86,12,173,205,5563,0.494517346755348,2055,7785,614,862,11,4868,14,2643,11,14
"1067","2020-06-06",100,12,154,198,5563,0.494517346755348,2055,7785,614,862,15,4883,13,2656,12,13
"1068","2020-06-07",90,12,158,196,5563,0.494517346755348,2055,7785,614,862,10,4893,19,2675,5,19
"1069","2020-03-08",1,13,0,0,6089,0.874856298242733,2130,7156,565,709,NA,NA,NA,NA,NA,NA
"1070","2020-03-09",1,13,0,0,6089,0.874856298242733,2130,7156,565,709,NA,NA,NA,NA,NA,NA
"1071","2020-03-10",0,13,0,0,6089,0.874856298242733,2130,7156,565,709,NA,NA,NA,NA,NA,NA
"1072","2020-03-11",0,13,0,0,6089,0.874856298242733,2130,7156,565,709,17,17,4,4,NA,4
"1073","2020-03-12",0,13,0,0,6089,0.874856298242733,2130,7156,565,709,26,43,1,5,2,1
"1074","2020-03-13",1,13,27,44,6089,0.874856298242733,2130,7156,565,709,29,72,NA,NA,2,NA
"1075","2020-03-14",5,13,45,76,6089,0.874856298242733,2130,7156,565,709,34,106,6,11,10,6
"1076","2020-03-15",11,13,59,94,6089,0.874856298242733,2130,7156,565,709,33,139,16,27,11,16
"1077","2020-03-16",15,13,58,125,6089,0.874856298242733,2130,7156,565,709,59,198,6,33,31,6
"1078","2020-03-17",15,13,70,155,6089,0.874856298242733,2130,7156,565,709,68,266,7,40,42,7
"1079","2020-03-18",24,13,88,186,6089,0.874856298242733,2130,7156,565,709,48,314,5,45,31,5
"1080","2020-03-19",30,13,106,233,6089,0.874856298242733,2130,7156,565,709,74,388,15,60,50,15
"1081","2020-03-20",42,13,100,296,6089,0.874856298242733,2130,7156,565,709,59,447,21,81,39,21
"1082","2020-03-21",59,13,93,352,6089,0.874856298242733,2130,7156,565,709,77,524,9,90,50,9
"1083","2020-03-22",70,13,104,411,6089,0.874856298242733,2130,7156,565,709,96,620,18,108,77,18
"1084","2020-03-23",76,13,121,487,6089,0.874856298242733,2130,7156,565,709,65,685,19,127,42,19
"1085","2020-03-24",87,13,132,558,6089,0.874856298242733,2130,7156,565,709,78,763,28,155,60,28
"1086","2020-03-25",98,13,126,632,6089,0.874856298242733,2130,7156,565,709,107,870,18,173,88,18
"1087","2020-03-26",115,13,125,715,6089,0.874856298242733,2130,7156,565,709,90,960,15,188,70,15
"1088","2020-03-27",163,13,133,825,6089,0.874856298242733,2130,7156,565,709,89,1049,25,213,62,25
"1089","2020-03-28",197,13,128,906,6089,0.874856298242733,2130,7156,565,709,78,1127,31,244,53,31
"1090","2020-03-29",251,13,138,996,6089,0.874856298242733,2130,7156,565,709,90,1217,35,279,57,35
"1091","2020-03-30",264,13,128,1096,6089,0.874856298242733,2130,7156,565,709,85,1302,24,303,61,24
"1092","2020-03-31",259,13,144,1179,6089,0.874856298242733,2130,7156,565,709,114,1416,25,328,89,25
"1093","2020-04-01",275,13,156,1280,6089,0.874856298242733,2130,7156,565,709,106,1522,25,353,82,25
"1094","2020-04-02",295,13,156,1361,6089,0.874856298242733,2130,7156,565,709,114,1636,26,379,88,26
"1095","2020-04-03",392,13,185,1430,6089,0.874856298242733,2130,7156,565,709,109,1745,16,395,78,16
"1096","2020-04-04",415,13,205,1513,6089,0.874856298242733,2130,7156,565,709,125,1870,16,411,98,16
"1097","2020-04-05",455,13,205,1597,6089,0.874856298242733,2130,7156,565,709,101,1971,9,420,76,9
"1098","2020-04-06",470,13,224,1654,6089,0.874856298242733,2130,7156,565,709,121,2092,5,425,96,5
"1099","2020-04-07",470,13,220,1713,6089,0.874856298242733,2130,7156,565,709,103,2195,6,431,74,6
"1100","2020-04-08",489,13,212,1774,6089,0.874856298242733,2130,7156,565,709,123,2318,12,443,98,12
"1101","2020-04-09",521,13,205,1862,6089,0.874856298242733,2130,7156,565,709,130,2448,11,454,101,11
"1102","2020-04-10",680,13,202,1932,6089,0.874856298242733,2130,7156,565,709,89,2537,10,464,71,10
"1103","2020-04-11",700,13,213,1910,6089,0.874856298242733,2130,7156,565,709,104,2641,8,472,82,8
"1104","2020-04-12",611,13,211,1930,6089,0.874856298242733,2130,7156,565,709,108,2749,7,479,89,7
"1105","2020-04-13",624,13,209,1972,6089,0.874856298242733,2130,7156,565,709,87,2836,10,489,63,10
"1106","2020-04-14",644,13,202,1942,6089,0.874856298242733,2130,7156,565,709,112,2948,19,508,91,19
"1107","2020-04-15",658,13,198,1898,6089,0.874856298242733,2130,7156,565,709,87,3035,19,527,63,19
"1108","2020-04-16",655,13,192,1867,6089,0.874856298242733,2130,7156,565,709,82,3117,15,542,57,15
"1109","2020-04-17",666,13,189,1813,6089,0.874856298242733,2130,7156,565,709,94,3211,5,547,77,5
"1110","2020-04-18",686,13,195,1740,6089,0.874856298242733,2130,7156,565,709,84,3295,10,557,65,10
"1111","2020-04-19",625,13,178,1670,6089,0.874856298242733,2130,7156,565,709,85,3380,11,568,63,11
"1112","2020-04-20",596,13,181,1568,6089,0.874856298242733,2130,7156,565,709,91,3471,15,583,70,15
"1113","2020-04-21",578,13,194,1466,6089,0.874856298242733,2130,7156,565,709,77,3548,13,596,59,13
"1114","2020-04-22",556,13,194,1408,6089,0.874856298242733,2130,7156,565,709,95,3643,13,609,69,13
"1115","2020-04-23",517,13,194,1322,6089,0.874856298242733,2130,7156,565,709,79,3722,13,622,47,13
"1116","2020-04-24",486,13,199,1235,6089,0.874856298242733,2130,7156,565,709,70,3792,20,642,47,20
"1117","2020-04-25",444,13,191,1201,6089,0.874856298242733,2130,7156,565,709,62,3854,21,663,44,21
"1118","2020-04-26",415,13,194,1133,6089,0.874856298242733,2130,7156,565,709,61,3915,23,686,40,23
"1119","2020-04-27",397,13,188,1070,6089,0.874856298242733,2130,7156,565,709,56,3971,21,707,36,21
"1120","2020-04-28",373,13,200,1007,6089,0.874856298242733,2130,7156,565,709,54,4025,15,722,37,15
"1121","2020-04-29",364,13,218,939,6089,0.874856298242733,2130,7156,565,709,75,4100,24,746,55,24
"1122","2020-04-30",356,13,214,865,6089,0.874856298242733,2130,7156,565,709,59,4159,22,768,35,22
"1123","2020-05-01",319,13,219,805,6089,0.874856298242733,2130,7156,565,709,59,4218,27,795,38,27
"1124","2020-05-02",310,13,206,755,6089,0.874856298242733,2130,7156,565,709,61,4279,19,814,41,19
"1125","2020-05-03",268,13,207,698,6089,0.874856298242733,2130,7156,565,709,44,4323,16,830,25,16
"1126","2020-05-04",276,13,200,649,6089,0.874856298242733,2130,7156,565,709,39,4362,26,856,18,26
"1127","2020-05-05",260,13,211,586,6089,0.874856298242733,2130,7156,565,709,39,4401,36,892,26,36
"1128","2020-05-06",236,13,197,538,6089,0.874856298242733,2130,7156,565,709,47,4448,18,910,29,18
"1129","2020-05-07",235,13,197,491,6089,0.874856298242733,2130,7156,565,709,46,4494,12,922,23,12
"1130","2020-05-08",199,13,196,420,6089,0.874856298242733,2130,7156,565,709,35,4529,20,942,17,20
"1131","2020-05-09",189,13,179,384,6089,0.874856298242733,2130,7156,565,709,31,4560,12,954,21,12
"1132","2020-05-10",174,13,177,335,6089,0.874856298242733,2130,7156,565,709,36,4596,14,968,25,14
"1133","2020-05-11",142,13,171,296,6089,0.874856298242733,2130,7156,565,709,29,4625,19,987,18,19
"1134","2020-05-12",128,13,170,270,6089,0.874856298242733,2130,7156,565,709,32,4657,16,1003,21,16
"1135","2020-05-13",126,13,163,235,6089,0.874856298242733,2130,7156,565,709,37,4694,14,1017,20,14
"1136","2020-05-14",111,13,172,215,6089,0.874856298242733,2130,7156,565,709,43,4737,8,1025,19,8
"1137","2020-05-15",98,13,147,195,6089,0.874856298242733,2130,7156,565,709,26,4763,5,1030,16,5
"1138","2020-05-16",82,13,143,180,6089,0.874856298242733,2130,7156,565,709,23,4786,3,1033,13,3
"1139","2020-05-17",70,13,138,163,6089,0.874856298242733,2130,7156,565,709,32,4818,9,1042,17,9
"1140","2020-05-18",61,13,152,147,6089,0.874856298242733,2130,7156,565,709,32,4850,6,1048,21,6
"1141","2020-05-19",59,13,160,137,6089,0.874856298242733,2130,7156,565,709,33,4883,4,1052,17,4
"1142","2020-05-20",52,13,162,128,6089,0.874856298242733,2130,7156,565,709,15,4898,6,1058,9,6
"1143","2020-05-21",49,13,175,119,6089,0.874856298242733,2130,7156,565,709,20,4918,23,1081,11,23
"1144","2020-05-22",47,13,161,106,6089,0.874856298242733,2130,7156,565,709,19,4937,26,1107,11,26
"1145","2020-05-23",44,13,157,97,6089,0.874856298242733,2130,7156,565,709,29,4966,20,1127,19,20
"1146","2020-05-24",38,13,179,93,6089,0.874856298242733,2130,7156,565,709,27,4993,22,1149,15,22
"1147","2020-05-25",37,13,175,86,6089,0.874856298242733,2130,7156,565,709,16,5009,15,1164,7,15
"1148","2020-05-26",32,13,178,81,6089,0.874856298242733,2130,7156,565,709,17,5026,15,1179,7,15
"1149","2020-05-27",28,13,158,78,6089,0.874856298242733,2130,7156,565,709,23,5049,23,1202,10,23
"1150","2020-05-28",27,13,154,75,6089,0.874856298242733,2130,7156,565,709,18,5067,27,1229,9,27
"1151","2020-05-29",25,13,142,66,6089,0.874856298242733,2130,7156,565,709,11,5078,12,1241,8,12
"1152","2020-05-30",27,13,144,60,6089,0.874856298242733,2130,7156,565,709,19,5097,17,1258,12,17
"1153","2020-05-31",27,13,162,57,6089,0.874856298242733,2130,7156,565,709,13,5110,10,1268,4,10
"1154","2020-06-01",30,13,154,52,6089,0.874856298242733,2130,7156,565,709,11,5121,12,1280,6,12
"1155","2020-06-02",27,13,166,53,6089,0.874856298242733,2130,7156,565,709,10,5131,7,1287,4,7
"1156","2020-06-03",30,13,171,54,6089,0.874856298242733,2130,7156,565,709,9,5140,5,1292,3,5
"1157","2020-06-04",25,13,172,55,6089,0.874856298242733,2130,7156,565,709,11,5151,3,1295,5,3
"1158","2020-06-05",28,13,181,55,6089,0.874856298242733,2130,7156,565,709,12,5163,6,1301,2,6
"1159","2020-06-06",25,13,174,54,6089,0.874856298242733,2130,7156,565,709,9,5172,3,1304,6,3
"1160","2020-06-07",21,13,171,47,6089,0.874856298242733,2130,7156,565,709,14,5186,2,1306,9,2
"1161","2020-03-14",5,14,69,70,5975,0.863933054393305,1965,7567,627,999,28,106,44,99,22,44
"1162","2020-03-15",14,14,74,100,5975,0.863933054393305,1965,7567,627,999,51,157,23,122,29,23
"1163","2020-03-16",15,14,82,129,5975,0.863933054393305,1965,7567,627,999,37,194,17,139,20,17
"1164","2020-03-17",21,14,97,160,5975,0.863933054393305,1965,7567,627,999,51,245,4,143,26,4
"1165","2020-03-18",24,14,110,206,5975,0.863933054393305,1965,7567,627,999,50,295,11,154,29,11
"1166","2020-03-19",29,14,133,259,5975,0.863933054393305,1965,7567,627,999,66,361,39,193,48,39
"1167","2020-03-20",42,14,152,314,5975,0.863933054393305,1965,7567,627,999,61,422,19,212,38,19
"1168","2020-03-21",77,14,153,380,5975,0.863933054393305,1965,7567,627,999,61,483,15,227,43,15
"1169","2020-03-22",83,14,163,443,5975,0.863933054393305,1965,7567,627,999,77,560,46,273,56,46
"1170","2020-03-23",84,14,186,506,5975,0.863933054393305,1965,7567,627,999,72,632,29,302,54,29
"1171","2020-03-24",89,14,172,559,5975,0.863933054393305,1965,7567,627,999,72,704,36,338,54,36
"1172","2020-03-25",110,14,180,615,5975,0.863933054393305,1965,7567,627,999,76,780,21,359,53,21
"1173","2020-03-26",132,14,195,680,5975,0.863933054393305,1965,7567,627,999,99,879,40,399,79,40
"1174","2020-03-27",190,14,179,770,5975,0.863933054393305,1965,7567,627,999,79,958,35,434,61,35
"1175","2020-03-28",205,14,165,863,5975,0.863933054393305,1965,7567,627,999,70,1028,18,452,58,18
"1176","2020-03-29",229,14,160,939,5975,0.863933054393305,1965,7567,627,999,89,1117,13,465,72,13
"1177","2020-03-30",237,14,195,1014,5975,0.863933054393305,1965,7567,627,999,87,1204,9,474,65,9
"1178","2020-03-31",245,14,194,1088,5975,0.863933054393305,1965,7567,627,999,105,1309,4,478,79,4
"1179","2020-04-01",262,14,178,1160,5975,0.863933054393305,1965,7567,627,999,94,1403,41,519,72,41
"1180","2020-04-02",277,14,171,1241,5975,0.863933054393305,1965,7567,627,999,77,1480,18,537,58,18
"1181","2020-04-03",338,14,171,1291,5975,0.863933054393305,1965,7567,627,999,104,1584,42,579,80,42
"1182","2020-04-04",364,14,164,1346,5975,0.863933054393305,1965,7567,627,999,104,1688,23,602,80,23
"1183","2020-04-05",404,14,141,1372,5975,0.863933054393305,1965,7567,627,999,87,1775,56,658,66,56
"1184","2020-04-06",413,14,159,1389,5975,0.863933054393305,1965,7567,627,999,116,1891,50,708,98,50
"1185","2020-04-07",411,14,180,1434,5975,0.863933054393305,1965,7567,627,999,102,1993,51,759,83,51
"1186","2020-04-08",427,14,200,1498,5975,0.863933054393305,1965,7567,627,999,96,2089,52,811,79,52
"1187","2020-04-09",433,14,222,1499,5975,0.863933054393305,1965,7567,627,999,85,2174,37,848,67,37
"1188","2020-04-10",526,14,224,1510,5975,0.863933054393305,1965,7567,627,999,128,2302,24,872,104,24
"1189","2020-04-11",531,14,219,1545,5975,0.863933054393305,1965,7567,627,999,93,2395,29,901,73,29
"1190","2020-04-12",473,14,228,1600,5975,0.863933054393305,1965,7567,627,999,98,2493,25,926,76,25
"1191","2020-04-13",489,14,248,1607,5975,0.863933054393305,1965,7567,627,999,95,2588,15,941,81,15
"1192","2020-04-14",498,14,236,1600,5975,0.863933054393305,1965,7567,627,999,110,2698,14,955,94,14
"1193","2020-04-15",499,14,229,1585,5975,0.863933054393305,1965,7567,627,999,87,2785,41,996,60,41
"1194","2020-04-16",508,14,219,1572,5975,0.863933054393305,1965,7567,627,999,89,2874,14,1010,78,14
"1195","2020-04-17",523,14,197,1542,5975,0.863933054393305,1965,7567,627,999,79,2953,22,1032,55,22
"1196","2020-04-18",544,14,218,1473,5975,0.863933054393305,1965,7567,627,999,92,3045,58,1090,74,58
"1197","2020-04-19",534,14,214,1423,5975,0.863933054393305,1965,7567,627,999,100,3145,49,1139,85,49
"1198","2020-04-20",517,14,212,1375,5975,0.863933054393305,1965,7567,627,999,77,3222,27,1166,65,27
"1199","2020-04-21",505,14,202,1316,5975,0.863933054393305,1965,7567,627,999,89,3311,41,1207,74,41
"1200","2020-04-22",486,14,213,1258,5975,0.863933054393305,1965,7567,627,999,81,3392,63,1270,57,63
"1201","2020-04-23",466,14,198,1212,5975,0.863933054393305,1965,7567,627,999,92,3484,39,1309,72,39
"1202","2020-04-24",446,14,195,1171,5975,0.863933054393305,1965,7567,627,999,70,3554,14,1323,52,14
"1203","2020-04-25",407,14,182,1118,5975,0.863933054393305,1965,7567,627,999,81,3635,13,1336,53,13
"1204","2020-04-26",381,14,171,1052,5975,0.863933054393305,1965,7567,627,999,52,3687,12,1348,40,12
"1205","2020-04-27",365,14,181,982,5975,0.863933054393305,1965,7567,627,999,75,3762,6,1354,56,6
"1206","2020-04-28",357,14,200,934,5975,0.863933054393305,1965,7567,627,999,63,3825,11,1365,47,11
"1207","2020-04-29",353,14,225,878,5975,0.863933054393305,1965,7567,627,999,56,3881,45,1410,41,45
"1208","2020-04-30",347,14,241,838,5975,0.863933054393305,1965,7567,627,999,54,3935,26,1436,45,26
"1209","2020-05-01",326,14,236,800,5975,0.863933054393305,1965,7567,627,999,57,3992,46,1482,39,46
"1210","2020-05-02",352,14,236,754,5975,0.863933054393305,1965,7567,627,999,61,4053,46,1528,49,46
"1211","2020-05-03",310,14,220,711,5975,0.863933054393305,1965,7567,627,999,73,4126,43,1571,56,43
"1212","2020-05-04",300,14,229,667,5975,0.863933054393305,1965,7567,627,999,54,4180,51,1622,44,51
"1213","2020-05-05",273,14,215,630,5975,0.863933054393305,1965,7567,627,999,50,4230,27,1649,33,27
"1214","2020-05-06",254,14,230,596,5975,0.863933054393305,1965,7567,627,999,46,4276,24,1673,26,24
"1215","2020-05-07",244,14,224,555,5975,0.863933054393305,1965,7567,627,999,56,4332,12,1685,44,12
"1216","2020-05-08",227,14,239,505,5975,0.863933054393305,1965,7567,627,999,58,4390,4,1689,50,4
"1217","2020-05-09",189,14,232,469,5975,0.863933054393305,1965,7567,627,999,49,4439,7,1696,31,7
"1218","2020-05-10",169,14,245,446,5975,0.863933054393305,1965,7567,627,999,39,4478,12,1708,25,12
"1219","2020-05-11",161,14,229,423,5975,0.863933054393305,1965,7567,627,999,51,4529,48,1756,39,48
"1220","2020-05-12",152,14,241,400,5975,0.863933054393305,1965,7567,627,999,43,4572,59,1815,29,59
"1221","2020-05-13",148,14,234,375,5975,0.863933054393305,1965,7567,627,999,41,4613,57,1872,26,57
"1222","2020-05-14",138,14,242,363,5975,0.863933054393305,1965,7567,627,999,39,4652,57,1929,29,57
"1223","2020-05-15",129,14,230,349,5975,0.863933054393305,1965,7567,627,999,33,4685,33,1962,24,33
"1224","2020-05-16",125,14,243,344,5975,0.863933054393305,1965,7567,627,999,45,4730,16,1978,34,16
"1225","2020-05-17",122,14,228,338,5975,0.863933054393305,1965,7567,627,999,38,4768,16,1994,27,16
"1226","2020-05-18",110,14,213,329,5975,0.863933054393305,1965,7567,627,999,37,4805,13,2007,23,13
"1227","2020-05-19",108,14,197,314,5975,0.863933054393305,1965,7567,627,999,37,4842,39,2046,28,39
"1228","2020-05-20",109,14,179,301,5975,0.863933054393305,1965,7567,627,999,41,4883,18,2064,27,18
"1229","2020-05-21",107,14,179,291,5975,0.863933054393305,1965,7567,627,999,31,4914,11,2075,26,11
"1230","2020-05-22",108,14,176,270,5975,0.863933054393305,1965,7567,627,999,33,4947,10,2085,24,10
"1231","2020-05-23",109,14,171,258,5975,0.863933054393305,1965,7567,627,999,20,4967,2,2087,17,2
"1232","2020-05-24",105,14,170,253,5975,0.863933054393305,1965,7567,627,999,26,4993,3,2090,18,3
"1233","2020-05-25",109,14,190,235,5975,0.863933054393305,1965,7567,627,999,28,5021,12,2102,17,12
"1234","2020-05-26",107,14,209,216,5975,0.863933054393305,1965,7567,627,999,13,5034,21,2123,8,21
"1235","2020-05-27",96,14,200,213,5975,0.863933054393305,1965,7567,627,999,17,5051,32,2155,12,32
"1236","2020-05-28",94,14,208,203,5975,0.863933054393305,1965,7567,627,999,21,5072,53,2208,15,53
"1237","2020-05-29",86,14,193,203,5975,0.863933054393305,1965,7567,627,999,19,5091,41,2249,16,41
"1238","2020-05-30",85,14,193,194,5975,0.863933054393305,1965,7567,627,999,18,5109,62,2311,14,62
"1239","2020-05-31",66,14,176,190,5975,0.863933054393305,1965,7567,627,999,15,5124,29,2340,12,29
"1240","2020-06-01",57,14,166,188,5975,0.863933054393305,1965,7567,627,999,24,5148,53,2393,16,53
"1241","2020-06-02",53,14,162,181,5975,0.863933054393305,1965,7567,627,999,17,5165,25,2418,12,25
"1242","2020-06-03",58,14,172,179,5975,0.863933054393305,1965,7567,627,999,20,5185,28,2446,14,28
"1243","2020-06-04",61,14,166,168,5975,0.863933054393305,1965,7567,627,999,26,5211,24,2470,22,24
"1244","2020-06-05",59,14,166,158,5975,0.863933054393305,1965,7567,627,999,18,5229,30,2500,10,30
"1245","2020-06-06",55,14,170,154,5975,0.863933054393305,1965,7567,627,999,18,5247,42,2542,14,42
"1246","2020-06-07",62,14,157,144,5975,0.863933054393305,1965,7567,627,999,14,5261,32,2574,10,32
"1247","2020-03-12",1,15,81,79,6494,0.521558361564521,2040,8111,575,1142,45,94,8,20,NA,8
"1248","2020-03-13",6,15,128,140,6494,0.521558361564521,2040,8111,575,1142,53,147,3,23,7,3
"1249","2020-03-14",10,15,143,204,6494,0.521558361564521,2040,8111,575,1142,56,203,3,26,10,3
"1250","2020-03-15",24,15,210,274,6494,0.521558361564521,2040,8111,575,1142,70,273,17,43,23,17
"1251","2020-03-16",26,15,247,332,6494,0.521558361564521,2040,8111,575,1142,66,339,18,61,23,18
"1252","2020-03-17",40,15,229,444,6494,0.521558361564521,2040,8111,575,1142,64,403,9,70,14,9
"1253","2020-03-18",55,15,194,518,6494,0.521558361564521,2040,8111,575,1142,57,460,12,82,25,12
"1254","2020-03-19",69,15,180,591,6494,0.521558361564521,2040,8111,575,1142,72,532,18,100,24,18
"1255","2020-03-20",98,15,224,665,6494,0.521558361564521,2040,8111,575,1142,83,615,10,110,37,10
"1256","2020-03-21",157,15,251,763,6494,0.521558361564521,2040,8111,575,1142,63,678,14,124,28,14
"1257","2020-03-22",188,15,278,827,6494,0.521558361564521,2040,8111,575,1142,102,780,20,144,47,20
"1258","2020-03-23",201,15,271,888,6494,0.521558361564521,2040,8111,575,1142,94,874,23,167,47,23
"1259","2020-03-24",217,15,233,942,6494,0.521558361564521,2040,8111,575,1142,71,945,37,204,42,37
"1260","2020-03-25",238,15,202,994,6494,0.521558361564521,2040,8111,575,1142,89,1034,16,220,36,16
"1261","2020-03-26",266,15,175,1049,6494,0.521558361564521,2040,8111,575,1142,96,1130,22,242,46,22
"1262","2020-03-27",344,15,164,1094,6494,0.521558361564521,2040,8111,575,1142,84,1214,16,258,40,16
"1263","2020-03-28",342,15,145,1104,6494,0.521558361564521,2040,8111,575,1142,78,1292,36,294,42,36
"1264","2020-03-29",385,15,146,1124,6494,0.521558361564521,2040,8111,575,1142,97,1389,39,333,47,39
"1265","2020-03-30",409,15,153,1155,6494,0.521558361564521,2040,8111,575,1142,92,1481,34,367,46,34
"1266","2020-03-31",401,15,165,1181,6494,0.521558361564521,2040,8111,575,1142,87,1568,34,401,38,34
"1267","2020-04-01",403,15,217,1189,6494,0.521558361564521,2040,8111,575,1142,109,1677,23,424,51,23
"1268","2020-04-02",406,15,261,1192,6494,0.521558361564521,2040,8111,575,1142,86,1763,16,440,52,16
"1269","2020-04-03",457,15,250,1222,6494,0.521558361564521,2040,8111,575,1142,102,1865,40,480,56,40
"1270","2020-04-04",476,15,280,1208,6494,0.521558361564521,2040,8111,575,1142,78,1943,29,509,41,29
"1271","2020-04-05",412,15,287,1181,6494,0.521558361564521,2040,8111,575,1142,94,2037,32,541,51,32
"1272","2020-04-06",396,15,265,1162,6494,0.521558361564521,2040,8111,575,1142,86,2123,22,563,45,22
"1273","2020-04-07",384,15,237,1147,6494,0.521558361564521,2040,8111,575,1142,97,2220,32,595,40,32
"1274","2020-04-08",390,15,248,1143,6494,0.521558361564521,2040,8111,575,1142,101,2321,26,621,46,26
"1275","2020-04-09",382,15,278,1140,6494,0.521558361564521,2040,8111,575,1142,74,2395,24,645,33,24
"1276","2020-04-10",393,15,274,1161,6494,0.521558361564521,2040,8111,575,1142,122,2517,22,667,66,22
"1277","2020-04-11",390,15,304,1159,6494,0.521558361564521,2040,8111,575,1142,86,2603,28,695,46,28
"1278","2020-04-12",352,15,300,1169,6494,0.521558361564521,2040,8111,575,1142,83,2686,15,710,44,15
"1279","2020-04-13",340,15,291,1183,6494,0.521558361564521,2040,8111,575,1142,95,2781,24,734,61,24
"1280","2020-04-14",323,15,274,1178,6494,0.521558361564521,2040,8111,575,1142,104,2885,28,762,55,28
"1281","2020-04-15",323,15,282,1178,6494,0.521558361564521,2040,8111,575,1142,73,2958,20,782,36,20
"1282","2020-04-16",322,15,286,1147,6494,0.521558361564521,2040,8111,575,1142,89,3047,23,805,39,23
"1283","2020-04-17",343,15,261,1120,6494,0.521558361564521,2040,8111,575,1142,78,3125,26,831,36,26
"1284","2020-04-18",356,15,231,1095,6494,0.521558361564521,2040,8111,575,1142,81,3206,19,850,33,19
"1285","2020-04-19",353,15,210,1088,6494,0.521558361564521,2040,8111,575,1142,93,3299,14,864,43,14
"1286","2020-04-20",349,15,186,1063,6494,0.521558361564521,2040,8111,575,1142,76,3375,18,882,30,18
"1287","2020-04-21",376,15,195,1044,6494,0.521558361564521,2040,8111,575,1142,72,3447,20,902,37,20
"1288","2020-04-22",367,15,204,1000,6494,0.521558361564521,2040,8111,575,1142,64,3511,16,918,28,16
"1289","2020-04-23",370,15,199,997,6494,0.521558361564521,2040,8111,575,1142,79,3590,14,932,40,14
"1290","2020-04-24",385,15,181,958,6494,0.521558361564521,2040,8111,575,1142,69,3659,13,945,35,13
"1291","2020-04-25",379,15,189,938,6494,0.521558361564521,2040,8111,575,1142,52,3711,13,958,15,13
"1292","2020-04-26",349,15,201,903,6494,0.521558361564521,2040,8111,575,1142,55,3766,30,988,24,30
"1293","2020-04-27",334,15,237,885,6494,0.521558361564521,2040,8111,575,1142,80,3846,11,999,43,11
"1294","2020-04-28",310,15,240,865,6494,0.521558361564521,2040,8111,575,1142,57,3903,26,1025,22,26
"1295","2020-04-29",306,15,201,839,6494,0.521558361564521,2040,8111,575,1142,64,3967,26,1051,31,26
"1296","2020-04-30",304,15,206,810,6494,0.521558361564521,2040,8111,575,1142,51,4018,15,1066,22,15
"1297","2020-05-01",289,15,267,791,6494,0.521558361564521,2040,8111,575,1142,64,4082,19,1085,30,19
"1298","2020-05-02",275,15,279,749,6494,0.521558361564521,2040,8111,575,1142,51,4133,8,1093,21,8
"1299","2020-05-03",273,15,284,731,6494,0.521558361564521,2040,8111,575,1142,69,4202,9,1102,28,9
"1300","2020-05-04",265,15,257,714,6494,0.521558361564521,2040,8111,575,1142,53,4255,3,1105,21,3
"1301","2020-05-05",261,15,233,721,6494,0.521558361564521,2040,8111,575,1142,53,4308,11,1116,27,11
"1302","2020-05-06",261,15,213,692,6494,0.521558361564521,2040,8111,575,1142,58,4366,11,1127,22,11
"1303","2020-05-07",241,15,204,650,6494,0.521558361564521,2040,8111,575,1142,46,4412,32,1159,22,32
"1304","2020-05-08",236,15,183,623,6494,0.521558361564521,2040,8111,575,1142,45,4457,17,1176,24,17
"1305","2020-05-09",227,15,167,603,6494,0.521558361564521,2040,8111,575,1142,54,4511,32,1208,21,32
"1306","2020-05-10",197,15,159,590,6494,0.521558361564521,2040,8111,575,1142,59,4570,27,1235,24,27
"1307","2020-05-11",186,15,155,575,6494,0.521558361564521,2040,8111,575,1142,52,4622,24,1259,24,24
"1308","2020-05-12",181,15,152,551,6494,0.521558361564521,2040,8111,575,1142,36,4658,45,1304,11,45
"1309","2020-05-13",173,15,178,542,6494,0.521558361564521,2040,8111,575,1142,42,4700,12,1316,10,12
"1310","2020-05-14",178,15,189,536,6494,0.521558361564521,2040,8111,575,1142,32,4732,21,1337,13,21
"1311","2020-05-15",176,15,251,517,6494,0.521558361564521,2040,8111,575,1142,46,4778,19,1356,15,19
"1312","2020-05-16",192,15,277,498,6494,0.521558361564521,2040,8111,575,1142,31,4809,13,1369,9,13
"1313","2020-05-17",197,15,330,487,6494,0.521558361564521,2040,8111,575,1142,35,4844,24,1393,17,24
"1314","2020-05-18",195,15,299,469,6494,0.521558361564521,2040,8111,575,1142,27,4871,30,1423,7,30
"1315","2020-05-19",190,15,268,451,6494,0.521558361564521,2040,8111,575,1142,36,4907,18,1441,10,18
"1316","2020-05-20",177,15,248,441,6494,0.521558361564521,2040,8111,575,1142,36,4943,23,1464,7,23
"1317","2020-05-21",170,15,248,432,6494,0.521558361564521,2040,8111,575,1142,36,4979,18,1482,14,18
"1318","2020-05-22",158,15,269,427,6494,0.521558361564521,2040,8111,575,1142,28,5007,28,1510,11,28
"1319","2020-05-23",154,15,272,424,6494,0.521558361564521,2040,8111,575,1142,28,5035,17,1527,10,17
"1320","2020-05-24",142,15,279,402,6494,0.521558361564521,2040,8111,575,1142,19,5054,28,1555,4,28
"1321","2020-05-25",133,15,283,387,6494,0.521558361564521,2040,8111,575,1142,19,5073,25,1580,6,25
"1322","2020-05-26",123,15,297,393,6494,0.521558361564521,2040,8111,575,1142,26,5099,23,1603,10,23
"1323","2020-05-27",125,15,309,383,6494,0.521558361564521,2040,8111,575,1142,30,5129,18,1621,6,18
"1324","2020-05-28",119,15,331,373,6494,0.521558361564521,2040,8111,575,1142,20,5149,22,1643,7,22
"1325","2020-05-29",132,15,346,358,6494,0.521558361564521,2040,8111,575,1142,22,5171,22,1665,7,22
"1326","2020-05-30",130,15,345,354,6494,0.521558361564521,2040,8111,575,1142,11,5182,15,1680,1,15
"1327","2020-05-31",118,15,304,338,6494,0.521558361564521,2040,8111,575,1142,15,5197,19,1699,5,19
"1328","2020-06-01",124,15,273,326,6494,0.521558361564521,2040,8111,575,1142,14,5211,26,1725,6,26
"1329","2020-06-02",124,15,226,310,6494,0.521558361564521,2040,8111,575,1142,24,5235,26,1751,10,26
"1330","2020-06-03",121,15,203,296,6494,0.521558361564521,2040,8111,575,1142,12,5247,8,1759,2,8
"1331","2020-06-04",116,15,184,278,6494,0.521558361564521,2040,8111,575,1142,21,5268,14,1773,6,14
"1332","2020-06-05",109,15,155,282,6494,0.521558361564521,2040,8111,575,1142,14,5282,8,1781,6,8
"1333","2020-06-06",106,15,141,272,6494,0.521558361564521,2040,8111,575,1142,11,5293,2,1783,4,2
"1334","2020-06-07",96,15,150,255,6494,0.521558361564521,2040,8111,575,1142,7,5300,11,1794,4,11
"1335","2020-03-15",4,16,128,91,6207,0.845980344772032,2055,7065,588,882,28,129,27,144,7,27
"1336","2020-03-16",9,16,135,118,6207,0.845980344772032,2055,7065,588,882,53,182,43,187,23,43
"1337","2020-03-17",14,16,147,146,6207,0.845980344772032,2055,7065,588,882,63,245,32,219,26,32
"1338","2020-03-18",16,16,143,173,6207,0.845980344772032,2055,7065,588,882,57,302,26,245,21,26
"1339","2020-03-19",22,16,140,205,6207,0.845980344772032,2055,7065,588,882,66,368,55,300,30,55
"1340","2020-03-20",28,16,156,240,6207,0.845980344772032,2055,7065,588,882,64,432,33,333,32,33
"1341","2020-03-21",39,16,154,287,6207,0.845980344772032,2055,7065,588,882,78,510,52,385,49,52
"1342","2020-03-22",64,16,183,348,6207,0.845980344772032,2055,7065,588,882,84,594,55,440,47,55
"1343","2020-03-23",78,16,179,408,6207,0.845980344772032,2055,7065,588,882,79,673,46,486,52,46
"1344","2020-03-24",78,16,197,453,6207,0.845980344772032,2055,7065,588,882,73,746,42,528,50,42
"1345","2020-03-25",98,16,196,499,6207,0.845980344772032,2055,7065,588,882,90,836,33,561,60,33
"1346","2020-03-26",112,16,196,593,6207,0.845980344772032,2055,7065,588,882,111,947,33,594,76,33
"1347","2020-03-27",149,16,175,644,6207,0.845980344772032,2055,7065,588,882,88,1035,26,620,60,26
"1348","2020-03-28",184,16,178,720,6207,0.845980344772032,2055,7065,588,882,74,1109,23,643,50,23
"1349","2020-03-29",203,16,165,808,6207,0.845980344772032,2055,7065,588,882,112,1221,34,677,73,34
"1350","2020-03-30",193,16,158,872,6207,0.845980344772032,2055,7065,588,882,115,1336,24,701,71,24
"1351","2020-03-31",203,16,143,956,6207,0.845980344772032,2055,7065,588,882,93,1429,50,751,60,50
"1352","2020-04-01",217,16,134,1028,6207,0.845980344772032,2055,7065,588,882,120,1549,32,783,90,32
"1353","2020-04-02",237,16,131,1129,6207,0.845980344772032,2055,7065,588,882,87,1636,24,807,53,24
"1354","2020-04-03",320,16,142,1199,6207,0.845980344772032,2055,7065,588,882,149,1785,23,830,106,23
"1355","2020-04-04",386,16,164,1290,6207,0.845980344772032,2055,7065,588,882,116,1901,32,862,88,32
"1356","2020-04-05",361,16,170,1413,6207,0.845980344772032,2055,7065,588,882,110,2011,69,931,80,69
"1357","2020-04-06",362,16,176,1499,6207,0.845980344772032,2055,7065,588,882,114,2125,62,993,89,62
"1358","2020-04-07",387,16,185,1573,6207,0.845980344772032,2055,7065,588,882,116,2241,50,1043,79,50
"1359","2020-04-08",409,16,193,1657,6207,0.845980344772032,2055,7065,588,882,121,2362,42,1085,83,42
"1360","2020-04-09",435,16,196,1720,6207,0.845980344772032,2055,7065,588,882,118,2480,59,1144,87,59
"1361","2020-04-10",613,16,207,1798,6207,0.845980344772032,2055,7065,588,882,107,2587,31,1175,70,31
"1362","2020-04-11",632,16,232,1836,6207,0.845980344772032,2055,7065,588,882,106,2693,34,1209,80,34
"1363","2020-04-12",605,16,225,1893,6207,0.845980344772032,2055,7065,588,882,123,2816,29,1238,91,29
"1364","2020-04-13",613,16,229,1916,6207,0.845980344772032,2055,7065,588,882,116,2932,39,1277,76,39
"1365","2020-04-14",611,16,213,1900,6207,0.845980344772032,2055,7065,588,882,104,3036,34,1311,73,34
"1366","2020-04-15",615,16,181,1892,6207,0.845980344772032,2055,7065,588,882,93,3129,32,1343,64,32
"1367","2020-04-16",629,16,180,1872,6207,0.845980344772032,2055,7065,588,882,106,3235,23,1366,74,23
"1368","2020-04-17",635,16,185,1830,6207,0.845980344772032,2055,7065,588,882,88,3323,36,1402,62,36
"1369","2020-04-18",632,16,201,1798,6207,0.845980344772032,2055,7065,588,882,96,3419,54,1456,70,54
"1370","2020-04-19",618,16,210,1737,6207,0.845980344772032,2055,7065,588,882,102,3521,38,1494,71,38
"1371","2020-04-20",605,16,196,1690,6207,0.845980344772032,2055,7065,588,882,77,3598,67,1561,44,67
"1372","2020-04-21",588,16,225,1657,6207,0.845980344772032,2055,7065,588,882,65,3663,53,1614,46,53
"1373","2020-04-22",591,16,194,1560,6207,0.845980344772032,2055,7065,588,882,88,3751,36,1650,59,36
"1374","2020-04-23",566,16,197,1484,6207,0.845980344772032,2055,7065,588,882,72,3823,34,1684,49,34
"1375","2020-04-24",539,16,194,1421,6207,0.845980344772032,2055,7065,588,882,78,3901,65,1749,54,65
"1376","2020-04-25",516,16,195,1342,6207,0.845980344772032,2055,7065,588,882,54,3955,39,1788,38,39
"1377","2020-04-26",463,16,217,1255,6207,0.845980344772032,2055,7065,588,882,62,4017,54,1842,32,54
"1378","2020-04-27",451,16,239,1179,6207,0.845980344772032,2055,7065,588,882,85,4102,35,1877,54,35
"1379","2020-04-28",439,16,219,1125,6207,0.845980344772032,2055,7065,588,882,69,4171,51,1928,45,51
"1380","2020-04-29",420,16,217,1060,6207,0.845980344772032,2055,7065,588,882,69,4240,35,1963,39,35
"1381","2020-04-30",409,16,211,974,6207,0.845980344772032,2055,7065,588,882,66,4306,45,2008,33,45
"1382","2020-05-01",387,16,198,900,6207,0.845980344772032,2055,7065,588,882,66,4372,35,2043,39,35
"1383","2020-05-02",377,16,208,849,6207,0.845980344772032,2055,7065,588,882,52,4424,35,2078,31,35
"1384","2020-05-03",330,16,219,816,6207,0.845980344772032,2055,7065,588,882,48,4472,35,2113,23,35
"1385","2020-05-04",314,16,235,751,6207,0.845980344772032,2055,7065,588,882,50,4522,40,2153,27,40
"1386","2020-05-05",297,16,207,696,6207,0.845980344772032,2055,7065,588,882,50,4572,60,2213,26,60
"1387","2020-05-06",275,16,201,634,6207,0.845980344772032,2055,7065,588,882,52,4624,57,2270,30,57
"1388","2020-05-07",245,16,202,588,6207,0.845980344772032,2055,7065,588,882,40,4664,64,2334,19,64
"1389","2020-05-08",218,16,196,542,6207,0.845980344772032,2055,7065,588,882,38,4702,42,2376,21,42
"1390","2020-05-09",192,16,197,496,6207,0.845980344772032,2055,7065,588,882,45,4747,25,2401,23,25
"1391","2020-05-10",193,16,189,453,6207,0.845980344772032,2055,7065,588,882,33,4780,30,2431,21,30
"1392","2020-05-11",181,16,191,417,6207,0.845980344772032,2055,7065,588,882,33,4813,30,2461,17,30
"1393","2020-05-12",167,16,190,388,6207,0.845980344772032,2055,7065,588,882,39,4852,35,2496,22,35
"1394","2020-05-13",153,16,208,370,6207,0.845980344772032,2055,7065,588,882,38,4890,33,2529,19,33
"1395","2020-05-14",149,16,208,348,6207,0.845980344772032,2055,7065,588,882,40,4930,14,2543,25,14
"1396","2020-05-15",125,16,220,313,6207,0.845980344772032,2055,7065,588,882,28,4958,29,2572,15,29
"1397","2020-05-16",123,16,230,275,6207,0.845980344772032,2055,7065,588,882,34,4992,42,2614,14,42
"1398","2020-05-17",100,16,231,251,6207,0.845980344772032,2055,7065,588,882,32,5024,49,2663,12,49
"1399","2020-05-18",90,16,228,225,6207,0.845980344772032,2055,7065,588,882,23,5047,61,2724,12,61
"1400","2020-05-19",82,16,233,221,6207,0.845980344772032,2055,7065,588,882,32,5079,44,2768,13,44
"1401","2020-05-20",79,16,243,215,6207,0.845980344772032,2055,7065,588,882,23,5102,58,2826,11,58
"1402","2020-05-21",80,16,241,196,6207,0.845980344772032,2055,7065,588,882,32,5134,53,2879,18,53
"1403","2020-05-22",75,16,230,183,6207,0.845980344772032,2055,7065,588,882,20,5154,48,2927,8,48
"1404","2020-05-23",77,16,209,172,6207,0.845980344772032,2055,7065,588,882,28,5182,36,2963,14,36
"1405","2020-05-24",66,16,222,153,6207,0.845980344772032,2055,7065,588,882,25,5207,37,3000,11,37
"1406","2020-05-25",64,16,206,153,6207,0.845980344772032,2055,7065,588,882,18,5225,43,3043,13,43
"1407","2020-05-26",65,16,221,147,6207,0.845980344772032,2055,7065,588,882,12,5237,22,3065,2,22
"1408","2020-05-27",59,16,220,130,6207,0.845980344772032,2055,7065,588,882,19,5256,35,3100,13,35
"1409","2020-05-28",54,16,228,129,6207,0.845980344772032,2055,7065,588,882,16,5272,28,3128,6,28
"1410","2020-05-29",48,16,239,127,6207,0.845980344772032,2055,7065,588,882,20,5292,48,3176,13,48
"1411","2020-05-30",43,16,216,123,6207,0.845980344772032,2055,7065,588,882,13,5305,43,3219,7,43
"1412","2020-05-31",40,16,207,112,6207,0.845980344772032,2055,7065,588,882,16,5321,24,3243,6,24
"1413","2020-06-01",35,16,190,108,6207,0.845980344772032,2055,7065,588,882,17,5338,25,3268,3,25
"1414","2020-06-02",30,16,167,106,6207,0.845980344772032,2055,7065,588,882,12,5350,27,3295,6,27
"1415","2020-06-03",30,16,155,102,6207,0.845980344772032,2055,7065,588,882,15,5365,37,3332,10,37
"1416","2020-06-04",28,16,145,94,6207,0.845980344772032,2055,7065,588,882,16,5381,30,3362,6,30
"1417","2020-06-05",30,16,135,93,6207,0.845980344772032,2055,7065,588,882,18,5399,34,3396,7,34
"1418","2020-06-06",31,16,143,89,6207,0.845980344772032,2055,7065,588,882,17,5416,42,3438,10,42
"1419","2020-06-07",31,16,169,87,6207,0.845980344772032,2055,7065,588,882,6,5422,28,3466,3,28
"1420","2020-03-13",3,17,43,70,5799,0.656320055181928,1995,7444,540,937,11,35,2,23,6,2
"1421","2020-03-14",5,17,46,97,5799,0.656320055181928,1995,7444,540,937,20,55,7,30,11,7
"1422","2020-03-15",16,17,52,129,5799,0.656320055181928,1995,7444,540,937,18,73,2,32,14,2
"1423","2020-03-16",18,17,61,159,5799,0.656320055181928,1995,7444,540,937,21,94,8,40,16,8
"1424","2020-03-17",23,17,76,216,5799,0.656320055181928,1995,7444,540,937,22,116,13,53,20,13
"1425","2020-03-18",32,17,95,270,5799,0.656320055181928,1995,7444,540,937,28,144,11,64,23,11
"1426","2020-03-19",38,17,95,324,5799,0.656320055181928,1995,7444,540,937,32,176,4,68,22,4
"1427","2020-03-20",58,17,115,377,5799,0.656320055181928,1995,7444,540,937,42,218,7,75,40,7
"1428","2020-03-21",86,17,123,428,5799,0.656320055181928,1995,7444,540,937,44,262,15,90,36,15
"1429","2020-03-22",109,17,136,505,5799,0.656320055181928,1995,7444,540,937,32,294,12,102,27,12
"1430","2020-03-23",119,17,143,562,5799,0.656320055181928,1995,7444,540,937,62,356,2,104,58,2
"1431","2020-03-24",122,17,139,627,5799,0.656320055181928,1995,7444,540,937,66,422,34,138,57,34
"1432","2020-03-25",135,17,161,676,5799,0.656320055181928,1995,7444,540,937,61,483,17,155,53,17
"1433","2020-03-26",152,17,156,736,5799,0.656320055181928,1995,7444,540,937,82,565,11,166,77,11
"1434","2020-03-27",224,17,145,778,5799,0.656320055181928,1995,7444,540,937,79,644,7,173,70,7
"1435","2020-03-28",257,17,146,813,5799,0.656320055181928,1995,7444,540,937,84,728,13,186,78,13
"1436","2020-03-29",259,17,137,856,5799,0.656320055181928,1995,7444,540,937,118,846,6,192,113,6
"1437","2020-03-30",273,17,149,934,5799,0.656320055181928,1995,7444,540,937,90,936,8,200,85,8
"1438","2020-03-31",277,17,143,990,5799,0.656320055181928,1995,7444,540,937,108,1044,6,206,103,6
"1439","2020-04-01",285,17,157,1058,5799,0.656320055181928,1995,7444,540,937,122,1166,12,218,113,12
"1440","2020-04-02",305,17,170,1100,5799,0.656320055181928,1995,7444,540,937,123,1289,34,252,120,34
"1441","2020-04-03",345,17,197,1155,5799,0.656320055181928,1995,7444,540,937,117,1406,21,273,112,21
"1442","2020-04-04",386,17,213,1209,5799,0.656320055181928,1995,7444,540,937,161,1567,11,284,155,11
"1443","2020-04-05",383,17,210,1233,5799,0.656320055181928,1995,7444,540,937,143,1710,17,301,142,17
"1444","2020-04-06",373,17,184,1281,5799,0.656320055181928,1995,7444,540,937,164,1874,27,328,156,27
"1445","2020-04-07",386,17,171,1291,5799,0.656320055181928,1995,7444,540,937,208,2082,35,363,206,35
"1446","2020-04-08",400,17,201,1297,5799,0.656320055181928,1995,7444,540,937,170,2252,36,399,167,36
"1447","2020-04-09",398,17,199,1308,5799,0.656320055181928,1995,7444,540,937,151,2403,29,428,143,29
"1448","2020-04-10",482,17,187,1350,5799,0.656320055181928,1995,7444,540,937,169,2572,18,446,162,18
"1449","2020-04-11",455,17,196,1354,5799,0.656320055181928,1995,7444,540,937,188,2760,11,457,183,11
"1450","2020-04-12",421,17,240,1323,5799,0.656320055181928,1995,7444,540,937,171,2931,14,471,168,14
"1451","2020-04-13",410,17,261,1361,5799,0.656320055181928,1995,7444,540,937,162,3093,38,509,157,38
"1452","2020-04-14",412,17,241,1332,5799,0.656320055181928,1995,7444,540,937,163,3256,17,526,156,17
"1453","2020-04-15",414,17,233,1345,5799,0.656320055181928,1995,7444,540,937,112,3368,8,534,107,8
"1454","2020-04-16",419,17,218,1343,5799,0.656320055181928,1995,7444,540,937,160,3528,16,550,154,16
"1455","2020-04-17",400,17,210,1349,5799,0.656320055181928,1995,7444,540,937,142,3670,41,591,133,41
"1456","2020-04-18",455,17,256,1288,5799,0.656320055181928,1995,7444,540,937,127,3797,17,608,123,17
"1457","2020-04-19",449,17,266,1278,5799,0.656320055181928,1995,7444,540,937,128,3925,48,656,124,48
"1458","2020-04-20",446,17,248,1235,5799,0.656320055181928,1995,7444,540,937,131,4056,49,705,131,49
"1459","2020-04-21",427,17,240,1223,5799,0.656320055181928,1995,7444,540,937,118,4174,63,768,115,63
"1460","2020-04-22",427,17,241,1172,5799,0.656320055181928,1995,7444,540,937,135,4309,65,833,129,65
"1461","2020-04-23",424,17,224,1131,5799,0.656320055181928,1995,7444,540,937,122,4431,28,861,115,28
"1462","2020-04-24",454,17,196,1106,5799,0.656320055181928,1995,7444,540,937,90,4521,26,887,84,26
"1463","2020-04-25",422,17,176,1060,5799,0.656320055181928,1995,7444,540,937,103,4624,17,904,99,17
"1464","2020-04-26",378,17,161,1033,5799,0.656320055181928,1995,7444,540,937,78,4702,51,955,78,51
"1465","2020-04-27",369,17,151,987,5799,0.656320055181928,1995,7444,540,937,84,4786,39,994,81,39
"1466","2020-04-28",348,17,145,951,5799,0.656320055181928,1995,7444,540,937,84,4870,31,1025,79,31
"1467","2020-04-29",334,17,190,901,5799,0.656320055181928,1995,7444,540,937,77,4947,52,1077,75,52
"1468","2020-04-30",326,17,185,864,5799,0.656320055181928,1995,7444,540,937,85,5032,23,1100,75,23
"1469","2020-05-01",293,17,166,836,5799,0.656320055181928,1995,7444,540,937,73,5105,21,1121,70,21
"1470","2020-05-02",281,17,159,820,5799,0.656320055181928,1995,7444,540,937,64,5169,16,1137,58,16
"1471","2020-05-03",282,17,210,774,5799,0.656320055181928,1995,7444,540,937,55,5224,14,1151,53,14
"1472","2020-05-04",258,17,222,734,5799,0.656320055181928,1995,7444,540,937,44,5268,12,1163,41,12
"1473","2020-05-05",258,17,251,705,5799,0.656320055181928,1995,7444,540,937,37,5305,46,1209,36,46
"1474","2020-05-06",250,17,245,665,5799,0.656320055181928,1995,7444,540,937,41,5346,20,1229,37,20
"1475","2020-05-07",246,17,222,619,5799,0.656320055181928,1995,7444,540,937,42,5388,5,1234,40,5
"1476","2020-05-08",249,17,209,588,5799,0.656320055181928,1995,7444,540,937,32,5420,29,1263,31,29
"1477","2020-05-09",250,17,206,557,5799,0.656320055181928,1995,7444,540,937,35,5455,41,1304,34,41
"1478","2020-05-10",219,17,219,522,5799,0.656320055181928,1995,7444,540,937,27,5482,45,1349,23,45
"1479","2020-05-11",209,17,215,490,5799,0.656320055181928,1995,7444,540,937,30,5512,34,1383,24,34
"1480","2020-05-12",198,17,205,473,5799,0.656320055181928,1995,7444,540,937,17,5529,45,1428,14,45
"1481","2020-05-13",186,17,188,447,5799,0.656320055181928,1995,7444,540,937,22,5551,27,1455,20,27
"1482","2020-05-14",165,17,149,422,5799,0.656320055181928,1995,7444,540,937,17,5568,12,1467,14,12
"1483","2020-05-15",168,17,143,406,5799,0.656320055181928,1995,7444,540,937,19,5587,36,1503,17,36
"1484","2020-05-16",165,17,132,388,5799,0.656320055181928,1995,7444,540,937,20,5607,34,1537,15,34
"1485","2020-05-17",136,17,124,360,5799,0.656320055181928,1995,7444,540,937,12,5619,24,1561,11,24
"1486","2020-05-18",129,17,155,337,5799,0.656320055181928,1995,7444,540,937,23,5642,16,1577,20,16
"1487","2020-05-19",121,17,188,329,5799,0.656320055181928,1995,7444,540,937,13,5655,35,1612,11,35
"1488","2020-05-20",125,17,196,316,5799,0.656320055181928,1995,7444,540,937,10,5665,18,1630,10,18
"1489","2020-05-21",124,17,180,299,5799,0.656320055181928,1995,7444,540,937,18,5683,34,1664,16,34
"1490","2020-05-22",103,17,189,291,5799,0.656320055181928,1995,7444,540,937,15,5698,54,1718,13,54
"1491","2020-05-23",91,17,210,282,5799,0.656320055181928,1995,7444,540,937,12,5710,25,1743,8,25
"1492","2020-05-24",98,17,246,283,5799,0.656320055181928,1995,7444,540,937,13,5723,20,1763,10,20
"1493","2020-05-25",100,17,226,253,5799,0.656320055181928,1995,7444,540,937,12,5735,46,1809,10,46
"1494","2020-05-26",99,17,203,244,5799,0.656320055181928,1995,7444,540,937,13,5748,36,1845,12,36
"1495","2020-05-27",96,17,188,234,5799,0.656320055181928,1995,7444,540,937,10,5758,19,1864,9,19
"1496","2020-05-28",90,17,174,224,5799,0.656320055181928,1995,7444,540,937,6,5764,19,1883,6,19
"1497","2020-05-29",85,17,183,220,5799,0.656320055181928,1995,7444,540,937,7,5771,9,1892,6,9
"1498","2020-05-30",82,17,182,210,5799,0.656320055181928,1995,7444,540,937,15,5786,13,1905,12,13
"1499","2020-05-31",69,17,162,198,5799,0.656320055181928,1995,7444,540,937,10,5796,6,1911,9,6
"1500","2020-06-01",63,17,144,184,5799,0.656320055181928,1995,7444,540,937,11,5807,5,1916,10,5
"1501","2020-06-02",55,17,150,177,5799,0.656320055181928,1995,7444,540,937,6,5813,25,1941,3,25
"1502","2020-06-03",48,17,142,163,5799,0.656320055181928,1995,7444,540,937,6,5819,31,1972,5,31
"1503","2020-06-04",51,17,163,151,5799,0.656320055181928,1995,7444,540,937,9,5828,28,2000,8,28
"1504","2020-06-05",54,17,179,151,5799,0.656320055181928,1995,7444,540,937,5,5833,21,2021,5,21
"1505","2020-06-06",51,17,170,141,5799,0.656320055181928,1995,7444,540,937,5,5838,11,2032,5,11
"1506","2020-06-07",47,17,135,143,5799,0.656320055181928,1995,7444,540,937,9,5847,17,2049,7,17
"1507","2020-03-07",2,18,0,0,5827,0.819975973914536,2025,7409,587,1178,NA,NA,NA,NA,NA,NA
"1508","2020-03-08",2,18,0,0,5827,0.819975973914536,2025,7409,587,1178,NA,NA,NA,NA,NA,NA
"1509","2020-03-09",0,18,0,0,5827,0.819975973914536,2025,7409,587,1178,NA,NA,NA,NA,NA,NA
"1510","2020-03-10",0,18,0,0,5827,0.819975973914536,2025,7409,587,1178,NA,NA,1,1,NA,1
"1511","2020-03-11",0,18,0,0,5827,0.819975973914536,2025,7409,587,1178,8,8,18,19,1,18
"1512","2020-03-12",0,18,0,0,5827,0.819975973914536,2025,7409,587,1178,7,15,26,45,2,26
"1513","2020-03-13",2,18,108,60,5827,0.819975973914536,2025,7409,587,1178,13,28,15,60,4,15
"1514","2020-03-14",3,18,135,92,5827,0.819975973914536,2025,7409,587,1178,14,42,21,81,7,21
"1515","2020-03-15",10,18,159,120,5827,0.819975973914536,2025,7409,587,1178,11,53,13,94,6,13
"1516","2020-03-16",12,18,176,160,5827,0.819975973914536,2025,7409,587,1178,18,71,32,126,11,32
"1517","2020-03-17",13,18,198,206,5827,0.819975973914536,2025,7409,587,1178,20,91,28,154,12,28
"1518","2020-03-18",22,18,212,242,5827,0.819975973914536,2025,7409,587,1178,18,109,16,170,10,16
"1519","2020-03-19",29,18,212,269,5827,0.819975973914536,2025,7409,587,1178,34,143,17,187,24,17
"1520","2020-03-20",49,18,193,319,5827,0.819975973914536,2025,7409,587,1178,46,189,35,222,35,35
"1521","2020-03-21",68,18,166,367,5827,0.819975973914536,2025,7409,587,1178,40,229,25,247,29,25
"1522","2020-03-22",86,18,201,421,5827,0.819975973914536,2025,7409,587,1178,59,288,34,281,50,34
"1523","2020-03-23",98,18,184,470,5827,0.819975973914536,2025,7409,587,1178,59,347,35,316,51,35
"1524","2020-03-24",111,18,202,534,5827,0.819975973914536,2025,7409,587,1178,57,404,30,346,54,30
"1525","2020-03-25",121,18,170,590,5827,0.819975973914536,2025,7409,587,1178,70,474,30,376,63,30
"1526","2020-03-26",133,18,167,651,5827,0.819975973914536,2025,7409,587,1178,70,544,41,417,64,41
"1527","2020-03-27",186,18,142,700,5827,0.819975973914536,2025,7409,587,1178,98,642,37,454,95,37
"1528","2020-03-28",196,18,135,739,5827,0.819975973914536,2025,7409,587,1178,89,731,41,495,82,41
"1529","2020-03-29",224,18,150,788,5827,0.819975973914536,2025,7409,587,1178,91,822,24,519,85,24
"1530","2020-03-30",236,18,192,846,5827,0.819975973914536,2025,7409,587,1178,117,939,21,540,103,21
"1531","2020-03-31",240,18,219,901,5827,0.819975973914536,2025,7409,587,1178,165,1104,25,565,156,25
"1532","2020-04-01",254,18,245,960,5827,0.819975973914536,2025,7409,587,1178,113,1217,15,580,104,15
"1533","2020-04-02",264,18,238,1013,5827,0.819975973914536,2025,7409,587,1178,175,1392,46,626,171,46
"1534","2020-04-03",305,18,232,1066,5827,0.819975973914536,2025,7409,587,1178,139,1531,48,674,128,48
"1535","2020-04-04",366,18,211,1123,5827,0.819975973914536,2025,7409,587,1178,152,1683,26,700,143,26
"1536","2020-04-05",351,18,218,1180,5827,0.819975973914536,2025,7409,587,1178,169,1852,17,717,160,17
"1537","2020-04-06",356,18,192,1228,5827,0.819975973914536,2025,7409,587,1178,175,2027,17,734,169,17
"1538","2020-04-07",360,18,193,1239,5827,0.819975973914536,2025,7409,587,1178,186,2213,20,754,181,20
"1539","2020-04-08",368,18,195,1296,5827,0.819975973914536,2025,7409,587,1178,174,2387,13,767,169,13
"1540","2020-04-09",380,18,193,1328,5827,0.819975973914536,2025,7409,587,1178,171,2558,33,800,166,33
"1541","2020-04-10",464,18,193,1378,5827,0.819975973914536,2025,7409,587,1178,186,2744,42,842,179,42
"1542","2020-04-11",501,18,184,1433,5827,0.819975973914536,2025,7409,587,1178,192,2936,41,883,186,41
"1543","2020-04-12",448,18,194,1491,5827,0.819975973914536,2025,7409,587,1178,230,3166,46,929,223,46
"1544","2020-04-13",456,18,185,1516,5827,0.819975973914536,2025,7409,587,1178,164,3330,46,975,156,46
"1545","2020-04-14",458,18,180,1535,5827,0.819975973914536,2025,7409,587,1178,175,3505,36,1011,167,36
"1546","2020-04-15",468,18,173,1538,5827,0.819975973914536,2025,7409,587,1178,165,3670,65,1076,157,65
"1547","2020-04-16",486,18,155,1526,5827,0.819975973914536,2025,7409,587,1178,170,3840,38,1114,163,38
"1548","2020-04-17",539,18,148,1545,5827,0.819975973914536,2025,7409,587,1178,197,4037,36,1150,190,36
"1549","2020-04-18",512,18,128,1515,5827,0.819975973914536,2025,7409,587,1178,133,4170,26,1176,125,26
"1550","2020-04-19",503,18,128,1489,5827,0.819975973914536,2025,7409,587,1178,149,4319,15,1191,146,15
"1551","2020-04-20",490,18,128,1454,5827,0.819975973914536,2025,7409,587,1178,117,4436,31,1222,111,31
"1552","2020-04-21",495,18,167,1437,5827,0.819975973914536,2025,7409,587,1178,120,4556,41,1263,112,41
"1553","2020-04-22",502,18,218,1410,5827,0.819975973914536,2025,7409,587,1178,115,4671,34,1297,108,34
"1554","2020-04-23",496,18,199,1369,5827,0.819975973914536,2025,7409,587,1178,101,4772,44,1341,98,44
"1555","2020-04-24",521,18,195,1309,5827,0.819975973914536,2025,7409,587,1178,109,4881,27,1368,103,27
"1556","2020-04-25",501,18,170,1255,5827,0.819975973914536,2025,7409,587,1178,84,4965,19,1387,79,19
"1557","2020-04-26",458,18,171,1212,5827,0.819975973914536,2025,7409,587,1178,90,5055,18,1405,88,18
"1558","2020-04-27",446,18,188,1192,5827,0.819975973914536,2025,7409,587,1178,86,5141,10,1415,81,10
"1559","2020-04-28",440,18,188,1131,5827,0.819975973914536,2025,7409,587,1178,50,5191,19,1434,47,19
"1560","2020-04-29",428,18,205,1076,5827,0.819975973914536,2025,7409,587,1178,65,5256,40,1474,60,40
"1561","2020-04-30",412,18,238,1018,5827,0.819975973914536,2025,7409,587,1178,63,5319,58,1532,58,58
"1562","2020-05-01",348,18,268,961,5827,0.819975973914536,2025,7409,587,1178,33,5352,57,1589,31,57
"1563","2020-05-02",344,18,239,906,5827,0.819975973914536,2025,7409,587,1178,59,5411,42,1631,55,42
"1564","2020-05-03",334,18,206,824,5827,0.819975973914536,2025,7409,587,1178,27,5438,20,1651,22,20
"1565","2020-05-04",312,18,190,786,5827,0.819975973914536,2025,7409,587,1178,48,5486,16,1667,45,16
"1566","2020-05-05",288,18,219,716,5827,0.819975973914536,2025,7409,587,1178,39,5525,40,1707,35,40
"1567","2020-05-06",273,18,211,650,5827,0.819975973914536,2025,7409,587,1178,19,5544,29,1736,17,29
"1568","2020-05-07",260,18,184,609,5827,0.819975973914536,2025,7409,587,1178,25,5569,25,1761,21,25
"1569","2020-05-08",258,18,155,559,5827,0.819975973914536,2025,7409,587,1178,21,5590,37,1798,18,37
"1570","2020-05-09",241,18,142,518,5827,0.819975973914536,2025,7409,587,1178,28,5618,21,1819,25,21
"1571","2020-05-10",208,18,134,482,5827,0.819975973914536,2025,7409,587,1178,19,5637,18,1837,16,18
"1572","2020-05-11",197,18,128,434,5827,0.819975973914536,2025,7409,587,1178,23,5660,24,1861,18,24
"1573","2020-05-12",189,18,140,402,5827,0.819975973914536,2025,7409,587,1178,15,5675,15,1876,12,15
"1574","2020-05-13",172,18,130,393,5827,0.819975973914536,2025,7409,587,1178,21,5696,13,1889,20,13
"1575","2020-05-14",159,18,124,371,5827,0.819975973914536,2025,7409,587,1178,22,5718,24,1913,17,24
"1576","2020-05-15",127,18,117,350,5827,0.819975973914536,2025,7409,587,1178,16,5734,16,1929,11,16
"1577","2020-05-16",122,18,108,330,5827,0.819975973914536,2025,7409,587,1178,20,5754,14,1943,17,14
"1578","2020-05-17",122,18,100,311,5827,0.819975973914536,2025,7409,587,1178,16,5770,30,1973,11,30
"1579","2020-05-18",120,18,101,300,5827,0.819975973914536,2025,7409,587,1178,11,5781,29,2002,11,29
"1580","2020-05-19",116,18,98,274,5827,0.819975973914536,2025,7409,587,1178,15,5796,40,2042,10,40
"1581","2020-05-20",113,18,143,259,5827,0.819975973914536,2025,7409,587,1178,7,5803,45,2087,7,45
"1582","2020-05-21",108,18,171,246,5827,0.819975973914536,2025,7409,587,1178,11,5814,19,2106,7,19
"1583","2020-05-22",101,18,208,229,5827,0.819975973914536,2025,7409,587,1178,9,5823,16,2122,7,16
"1584","2020-05-23",98,18,196,217,5827,0.819975973914536,2025,7409,587,1178,13,5836,14,2136,9,14
"1585","2020-05-24",81,18,175,212,5827,0.819975973914536,2025,7409,587,1178,12,5848,14,2150,9,14
"1586","2020-05-25",76,18,184,193,5827,0.819975973914536,2025,7409,587,1178,3,5851,30,2180,2,30
"1587","2020-05-26",73,18,185,186,5827,0.819975973914536,2025,7409,587,1178,3,5854,19,2199,2,19
"1588","2020-05-27",71,18,170,172,5827,0.819975973914536,2025,7409,587,1178,9,5863,14,2213,7,14
"1589","2020-05-28",71,18,190,166,5827,0.819975973914536,2025,7409,587,1178,7,5870,11,2224,4,11
"1590","2020-05-29",67,18,231,160,5827,0.819975973914536,2025,7409,587,1178,3,5873,22,2246,3,22
"1591","2020-05-30",60,18,226,156,5827,0.819975973914536,2025,7409,587,1178,3,5876,33,2279,1,33
"1592","2020-05-31",60,18,230,157,5827,0.819975973914536,2025,7409,587,1178,4,5880,20,2299,3,20
"1593","2020-06-01",50,18,222,153,5827,0.819975973914536,2025,7409,587,1178,2,5882,28,2327,1,28
"1594","2020-06-02",45,18,198,140,5827,0.819975973914536,2025,7409,587,1178,3,5885,23,2350,2,23
"1595","2020-06-03",44,18,183,127,5827,0.819975973914536,2025,7409,587,1178,6,5891,17,2367,5,17
"1596","2020-06-04",44,18,169,126,5827,0.819975973914536,2025,7409,587,1178,NA,NA,13,2380,NA,13
"1597","2020-06-05",39,18,151,123,5827,0.819975973914536,2025,7409,587,1178,1,5892,20,2400,1,20
"1598","2020-06-06",38,18,123,111,5827,0.819975973914536,2025,7409,587,1178,1,5893,9,2409,1,9
"1599","2020-06-07",40,18,142,99,5827,0.819975973914536,2025,7409,587,1178,1,5894,6,2415,1,6
"1600","2020-03-13",8,19,54,93,4902,0.544675642594859,2085,7322,522,632,29,92,46,83,3,46
"1601","2020-03-14",13,19,78,127,4902,0.544675642594859,2085,7322,522,632,43,135,44,127,23,44
"1602","2020-03-15",21,19,108,160,4902,0.544675642594859,2085,7322,522,632,58,193,19,146,30,19
"1603","2020-03-16",26,19,103,194,4902,0.544675642594859,2085,7322,522,632,66,259,20,166,31,20
"1604","2020-03-17",27,19,119,234,4902,0.544675642594859,2085,7322,522,632,76,335,5,171,53,5
"1605","2020-03-18",33,19,129,271,4902,0.544675642594859,2085,7322,522,632,62,397,10,181,45,10
"1606","2020-03-19",45,19,148,314,4902,0.544675642594859,2085,7322,522,632,71,468,6,187,51,6
"1607","2020-03-20",67,19,161,351,4902,0.544675642594859,2085,7322,522,632,118,586,8,195,78,8
"1608","2020-03-21",70,19,160,380,4902,0.544675642594859,2085,7322,522,632,122,708,10,205,87,10
"1609","2020-03-22",85,19,141,415,4902,0.544675642594859,2085,7322,522,632,115,823,37,242,88,37
"1610","2020-03-23",97,19,124,444,4902,0.544675642594859,2085,7322,522,632,124,947,19,261,100,19
"1611","2020-03-24",101,19,132,472,4902,0.544675642594859,2085,7322,522,632,125,1072,35,296,102,35
"1612","2020-03-25",111,19,152,506,4902,0.544675642594859,2085,7322,522,632,132,1204,18,314,106,18
"1613","2020-03-26",119,19,154,549,4902,0.544675642594859,2085,7322,522,632,134,1338,26,340,99,26
"1614","2020-03-27",154,19,151,600,4902,0.544675642594859,2085,7322,522,632,139,1477,50,390,105,50
"1615","2020-03-28",201,19,132,634,4902,0.544675642594859,2085,7322,522,632,173,1650,65,455,144,65
"1616","2020-03-29",208,19,115,661,4902,0.544675642594859,2085,7322,522,632,134,1784,52,507,116,52
"1617","2020-03-30",215,19,105,671,4902,0.544675642594859,2085,7322,522,632,146,1930,25,532,124,25
"1618","2020-03-31",227,19,117,671,4902,0.544675642594859,2085,7322,522,632,146,2076,12,544,118,12
"1619","2020-04-01",231,19,114,696,4902,0.544675642594859,2085,7322,522,632,146,2222,13,557,114,13
"1620","2020-04-02",234,19,114,699,4902,0.544675642594859,2085,7322,522,632,157,2379,37,594,134,37
"1621","2020-04-03",258,19,133,724,4902,0.544675642594859,2085,7322,522,632,149,2528,52,646,127,52
"1622","2020-04-04",234,19,149,757,4902,0.544675642594859,2085,7322,522,632,156,2684,50,696,132,50
"1623","2020-04-05",221,19,148,782,4902,0.544675642594859,2085,7322,522,632,189,2873,56,752,167,56
"1624","2020-04-06",215,19,142,780,4902,0.544675642594859,2085,7322,522,632,147,3020,34,786,124,34
"1625","2020-04-07",211,19,129,804,4902,0.544675642594859,2085,7322,522,632,170,3190,31,817,144,31
"1626","2020-04-08",219,19,146,811,4902,0.544675642594859,2085,7322,522,632,126,3316,21,838,112,21
"1627","2020-04-09",230,19,129,822,4902,0.544675642594859,2085,7322,522,632,152,3468,18,856,132,18
"1628","2020-04-10",241,19,124,846,4902,0.544675642594859,2085,7322,522,632,143,3611,12,868,112,12
"1629","2020-04-11",263,19,116,855,4902,0.544675642594859,2085,7322,522,632,141,3752,21,889,120,21
"1630","2020-04-12",272,19,117,873,4902,0.544675642594859,2085,7322,522,632,153,3905,54,943,125,54
"1631","2020-04-13",267,19,125,896,4902,0.544675642594859,2085,7322,522,632,130,4035,30,973,102,30
"1632","2020-04-14",253,19,135,908,4902,0.544675642594859,2085,7322,522,632,113,4148,62,1035,91,62
"1633","2020-04-15",261,19,139,912,4902,0.544675642594859,2085,7322,522,632,138,4286,65,1100,114,65
"1634","2020-04-16",262,19,138,913,4902,0.544675642594859,2085,7322,522,632,142,4428,61,1161,115,61
"1635","2020-04-17",311,19,160,922,4902,0.544675642594859,2085,7322,522,632,115,4543,42,1203,94,42
"1636","2020-04-18",336,19,161,927,4902,0.544675642594859,2085,7322,522,632,87,4630,63,1266,72,63
"1637","2020-04-19",294,19,152,939,4902,0.544675642594859,2085,7322,522,632,109,4739,26,1292,90,26
"1638","2020-04-20",292,19,165,922,4902,0.544675642594859,2085,7322,522,632,68,4807,22,1314,46,22
"1639","2020-04-21",287,19,172,907,4902,0.544675642594859,2085,7322,522,632,74,4881,38,1352,53,38
"1640","2020-04-22",288,19,154,917,4902,0.544675642594859,2085,7322,522,632,77,4958,47,1399,65,47
"1641","2020-04-23",281,19,135,901,4902,0.544675642594859,2085,7322,522,632,95,5053,29,1428,72,29
"1642","2020-04-24",310,19,119,902,4902,0.544675642594859,2085,7322,522,632,69,5122,18,1446,55,18
"1643","2020-04-25",292,19,118,878,4902,0.544675642594859,2085,7322,522,632,74,5196,46,1492,60,46
"1644","2020-04-26",289,19,119,869,4902,0.544675642594859,2085,7322,522,632,74,5270,24,1516,56,24
"1645","2020-04-27",292,19,165,849,4902,0.544675642594859,2085,7322,522,632,55,5325,16,1532,37,16
"1646","2020-04-28",298,19,179,827,4902,0.544675642594859,2085,7322,522,632,55,5380,52,1584,41,52
"1647","2020-04-29",294,19,180,811,4902,0.544675642594859,2085,7322,522,632,55,5435,35,1619,35,35
"1648","2020-04-30",296,19,184,788,4902,0.544675642594859,2085,7322,522,632,46,5481,29,1648,29,29
"1649","2020-05-01",294,19,183,772,4902,0.544675642594859,2085,7322,522,632,35,5516,47,1695,17,47
"1650","2020-05-02",298,19,188,732,4902,0.544675642594859,2085,7322,522,632,47,5563,43,1738,27,43
"1651","2020-05-03",282,19,186,699,4902,0.544675642594859,2085,7322,522,632,39,5602,30,1768,24,30
"1652","2020-05-04",259,19,206,696,4902,0.544675642594859,2085,7322,522,632,42,5644,14,1782,25,14
"1653","2020-05-05",241,19,223,694,4902,0.544675642594859,2085,7322,522,632,27,5671,33,1815,17,33
"1654","2020-05-06",240,19,229,674,4902,0.544675642594859,2085,7322,522,632,32,5703,22,1837,15,22
"1655","2020-05-07",231,19,227,658,4902,0.544675642594859,2085,7322,522,632,43,5746,18,1855,25,18
"1656","2020-05-08",225,19,216,636,4902,0.544675642594859,2085,7322,522,632,22,5768,8,1863,13,8
"1657","2020-05-09",215,19,226,609,4902,0.544675642594859,2085,7322,522,632,22,5790,4,1867,12,4
"1658","2020-05-10",193,19,224,603,4902,0.544675642594859,2085,7322,522,632,35,5825,5,1872,21,5
"1659","2020-05-11",194,19,237,590,4902,0.544675642594859,2085,7322,522,632,26,5851,6,1878,12,6
"1660","2020-05-12",190,19,213,581,4902,0.544675642594859,2085,7322,522,632,19,5870,11,1889,8,11
"1661","2020-05-13",176,19,213,546,4902,0.544675642594859,2085,7322,522,632,31,5901,6,1895,22,6
"1662","2020-05-14",171,19,203,524,4902,0.544675642594859,2085,7322,522,632,22,5923,55,1950,12,55
"1663","2020-05-15",166,19,209,499,4902,0.544675642594859,2085,7322,522,632,15,5938,49,1999,11,49
"1664","2020-05-16",185,19,217,492,4902,0.544675642594859,2085,7322,522,632,16,5954,65,2064,9,65
"1665","2020-05-17",177,19,194,470,4902,0.544675642594859,2085,7322,522,632,23,5977,26,2090,11,26
"1666","2020-05-18",172,19,179,448,4902,0.544675642594859,2085,7322,522,632,12,5989,52,2142,6,52
"1667","2020-05-19",173,19,161,424,4902,0.544675642594859,2085,7322,522,632,17,6006,28,2170,8,28
"1668","2020-05-20",168,19,172,420,4902,0.544675642594859,2085,7322,522,632,19,6025,23,2193,7,23
"1669","2020-05-21",166,19,185,402,4902,0.544675642594859,2085,7322,522,632,11,6036,19,2212,6,19
"1670","2020-05-22",160,19,194,391,4902,0.544675642594859,2085,7322,522,632,20,6056,24,2236,8,24
"1671","2020-05-23",144,19,194,380,4902,0.544675642594859,2085,7322,522,632,11,6067,35,2271,6,35
"1672","2020-05-24",129,19,181,360,4902,0.544675642594859,2085,7322,522,632,17,6084,52,2323,8,52
"1673","2020-05-25",126,19,191,333,4902,0.544675642594859,2085,7322,522,632,12,6096,55,2378,3,55
"1674","2020-05-26",119,19,165,319,4902,0.544675642594859,2085,7322,522,632,13,6109,28,2406,7,28
"1675","2020-05-27",116,19,146,303,4902,0.544675642594859,2085,7322,522,632,11,6120,40,2446,5,40
"1676","2020-05-28",114,19,159,289,4902,0.544675642594859,2085,7322,522,632,12,6132,31,2477,7,31
"1677","2020-05-29",113,19,182,287,4902,0.544675642594859,2085,7322,522,632,14,6146,14,2491,6,14
"1678","2020-05-30",103,19,184,274,4902,0.544675642594859,2085,7322,522,632,11,6157,7,2498,6,7
"1679","2020-05-31",100,19,168,252,4902,0.544675642594859,2085,7322,522,632,12,6169,9,2507,5,9
"1680","2020-06-01",88,19,170,246,4902,0.544675642594859,2085,7322,522,632,13,6182,10,2517,7,10
"1681","2020-06-02",80,19,163,240,4902,0.544675642594859,2085,7322,522,632,8,6190,13,2530,2,13
"1682","2020-06-03",80,19,145,237,4902,0.544675642594859,2085,7322,522,632,6,6196,19,2549,2,19
"1683","2020-06-04",77,19,150,223,4902,0.544675642594859,2085,7322,522,632,9,6205,24,2573,4,24
"1684","2020-06-05",69,19,144,210,4902,0.544675642594859,2085,7322,522,632,12,6217,21,2594,3,21
"1685","2020-06-06",80,19,136,199,4902,0.544675642594859,2085,7322,522,632,9,6226,23,2617,6,23
"1686","2020-06-07",78,19,118,196,4902,0.544675642594859,2085,7322,522,632,7,6233,24,2641,4,24
"1687","2020-03-13",1,20,92,30,5618,0.924528301886792,2025,7504,480,895,18,44,12,25,4,12
"1688","2020-03-14",2,20,126,47,5618,0.924528301886792,2025,7504,480,895,32,76,17,42,11,17
"1689","2020-03-15",3,20,137,62,5618,0.924528301886792,2025,7504,480,895,18,94,15,57,12,15
"1690","2020-03-16",3,20,115,85,5618,0.924528301886792,2025,7504,480,895,31,125,10,67,23,10
"1691","2020-03-17",6,20,108,109,5618,0.924528301886792,2025,7504,480,895,30,155,18,85,15,18
"1692","2020-03-18",11,20,91,122,5618,0.924528301886792,2025,7504,480,895,34,189,22,107,28,22
"1693","2020-03-19",14,20,76,145,5618,0.924528301886792,2025,7504,480,895,51,240,24,131,37,24
"1694","2020-03-20",26,20,81,166,5618,0.924528301886792,2025,7504,480,895,70,310,17,148,53,17
"1695","2020-03-21",42,20,109,197,5618,0.924528301886792,2025,7504,480,895,65,375,15,163,55,15
"1696","2020-03-22",55,20,111,236,5618,0.924528301886792,2025,7504,480,895,64,439,24,187,57,24
"1697","2020-03-23",64,20,106,270,5618,0.924528301886792,2025,7504,480,895,86,525,27,214,75,27
"1698","2020-03-24",71,20,108,315,5618,0.924528301886792,2025,7504,480,895,89,614,35,249,77,35
"1699","2020-03-25",78,20,169,367,5618,0.924528301886792,2025,7504,480,895,93,707,23,272,79,23
"1700","2020-03-26",94,20,193,409,5618,0.924528301886792,2025,7504,480,895,118,825,27,299,108,27
"1701","2020-03-27",118,20,216,458,5618,0.924528301886792,2025,7504,480,895,150,975,34,333,139,34
"1702","2020-03-28",152,20,215,495,5618,0.924528301886792,2025,7504,480,895,116,1091,19,352,106,19
"1703","2020-03-29",148,20,232,540,5618,0.924528301886792,2025,7504,480,895,126,1217,41,393,114,41
"1704","2020-03-30",153,20,241,608,5618,0.924528301886792,2025,7504,480,895,149,1366,15,408,135,15
"1705","2020-03-31",163,20,235,655,5618,0.924528301886792,2025,7504,480,895,153,1519,37,445,136,37
"1706","2020-04-01",175,20,240,720,5618,0.924528301886792,2025,7504,480,895,168,1687,29,474,159,29
"1707","2020-04-02",185,20,212,778,5618,0.924528301886792,2025,7504,480,895,150,1837,31,505,139,31
"1708","2020-04-03",220,20,181,828,5618,0.924528301886792,2025,7504,480,895,160,1997,44,549,157,44
"1709","2020-04-04",259,20,159,889,5618,0.924528301886792,2025,7504,480,895,179,2176,49,598,172,49
"1710","2020-04-05",262,20,140,957,5618,0.924528301886792,2025,7504,480,895,188,2364,36,634,179,36
"1711","2020-04-06",248,20,120,1019,5618,0.924528301886792,2025,7504,480,895,193,2557,55,689,181,55
"1712","2020-04-07",258,20,125,1096,5618,0.924528301886792,2025,7504,480,895,170,2727,44,733,166,44
"1713","2020-04-08",269,20,157,1145,5618,0.924528301886792,2025,7504,480,895,195,2922,30,763,186,30
"1714","2020-04-09",283,20,183,1189,5618,0.924528301886792,2025,7504,480,895,230,3152,26,789,221,26
"1715","2020-04-10",396,20,193,1234,5618,0.924528301886792,2025,7504,480,895,207,3359,34,823,203,34
"1716","2020-04-11",383,20,205,1304,5618,0.924528301886792,2025,7504,480,895,115,3474,44,867,109,44
"1717","2020-04-12",391,20,192,1344,5618,0.924528301886792,2025,7504,480,895,160,3634,40,907,154,40
"1718","2020-04-13",411,20,192,1389,5618,0.924528301886792,2025,7504,480,895,198,3832,30,937,189,30
"1719","2020-04-14",426,20,229,1434,5618,0.924528301886792,2025,7504,480,895,139,3971,32,969,133,32
"1720","2020-04-15",450,20,270,1488,5618,0.924528301886792,2025,7504,480,895,136,4107,25,994,128,25
"1721","2020-04-16",455,20,257,1515,5618,0.924528301886792,2025,7504,480,895,159,4266,33,1027,148,33
"1722","2020-04-17",495,20,271,1526,5618,0.924528301886792,2025,7504,480,895,141,4407,20,1047,133,20
"1723","2020-04-18",528,20,268,1518,5618,0.924528301886792,2025,7504,480,895,90,4497,41,1088,84,41
"1724","2020-04-19",521,20,228,1489,5618,0.924528301886792,2025,7504,480,895,103,4600,22,1110,100,22
"1725","2020-04-20",523,20,234,1514,5618,0.924528301886792,2025,7504,480,895,83,4683,32,1142,77,32
"1726","2020-04-21",504,20,230,1510,5618,0.924528301886792,2025,7504,480,895,93,4776,42,1184,85,42
"1727","2020-04-22",510,20,242,1495,5618,0.924528301886792,2025,7504,480,895,120,4896,36,1220,110,36
"1728","2020-04-23",507,20,232,1483,5618,0.924528301886792,2025,7504,480,895,89,4985,34,1254,83,34
"1729","2020-04-24",553,20,217,1439,5618,0.924528301886792,2025,7504,480,895,72,5057,35,1289,67,35
"1730","2020-04-25",534,20,186,1385,5618,0.924528301886792,2025,7504,480,895,92,5149,25,1314,82,25
"1731","2020-04-26",481,20,176,1333,5618,0.924528301886792,2025,7504,480,895,84,5233,41,1355,75,41
"1732","2020-04-27",452,20,180,1307,5618,0.924528301886792,2025,7504,480,895,70,5303,22,1377,60,22
"1733","2020-04-28",456,20,169,1229,5618,0.924528301886792,2025,7504,480,895,63,5366,38,1415,58,38
"1734","2020-04-29",430,20,158,1184,5618,0.924528301886792,2025,7504,480,895,51,5417,49,1464,46,49
"1735","2020-04-30",430,20,178,1126,5618,0.924528301886792,2025,7504,480,895,49,5466,33,1497,42,33
"1736","2020-05-01",394,20,177,1061,5618,0.924528301886792,2025,7504,480,895,41,5507,40,1537,38,40
"1737","2020-05-02",394,20,171,1023,5618,0.924528301886792,2025,7504,480,895,44,5551,27,1564,36,27
"1738","2020-05-03",362,20,156,978,5618,0.924528301886792,2025,7504,480,895,37,5588,31,1595,33,31
"1739","2020-05-04",358,20,145,914,5618,0.924528301886792,2025,7504,480,895,34,5622,31,1626,31,31
"1740","2020-05-05",335,20,147,848,5618,0.924528301886792,2025,7504,480,895,23,5645,38,1664,17,38
"1741","2020-05-06",329,20,157,787,5618,0.924528301886792,2025,7504,480,895,20,5665,29,1693,17,29
"1742","2020-05-07",314,20,168,732,5618,0.924528301886792,2025,7504,480,895,17,5682,37,1730,14,37
"1743","2020-05-08",292,20,162,681,5618,0.924528301886792,2025,7504,480,895,16,5698,34,1764,11,34
"1744","2020-05-09",286,20,212,652,5618,0.924528301886792,2025,7504,480,895,21,5719,20,1784,15,20
"1745","2020-05-10",252,20,229,622,5618,0.924528301886792,2025,7504,480,895,18,5737,28,1812,13,28
"1746","2020-05-11",248,20,221,587,5618,0.924528301886792,2025,7504,480,895,14,5751,21,1833,11,21
"1747","2020-05-12",230,20,189,533,5618,0.924528301886792,2025,7504,480,895,14,5765,26,1859,11,26
"1748","2020-05-13",216,20,168,504,5618,0.924528301886792,2025,7504,480,895,9,5774,21,1880,5,21
"1749","2020-05-14",208,20,179,477,5618,0.924528301886792,2025,7504,480,895,13,5787,24,1904,9,24
"1750","2020-05-15",187,20,213,448,5618,0.924528301886792,2025,7504,480,895,8,5795,24,1928,4,24
"1751","2020-05-16",167,20,216,416,5618,0.924528301886792,2025,7504,480,895,18,5813,15,1943,12,15
"1752","2020-05-17",169,20,212,383,5618,0.924528301886792,2025,7504,480,895,10,5823,18,1961,7,18
"1753","2020-05-18",147,20,207,362,5618,0.924528301886792,2025,7504,480,895,6,5829,25,1986,2,25
"1754","2020-05-19",143,20,194,344,5618,0.924528301886792,2025,7504,480,895,6,5835,25,2011,2,25
"1755","2020-05-20",140,20,193,325,5618,0.924528301886792,2025,7504,480,895,6,5841,25,2036,3,25
"1756","2020-05-21",133,20,207,308,5618,0.924528301886792,2025,7504,480,895,6,5847,38,2074,2,38
"1757","2020-05-22",108,20,215,285,5618,0.924528301886792,2025,7504,480,895,7,5854,23,2097,4,23
"1758","2020-05-23",106,20,228,259,5618,0.924528301886792,2025,7504,480,895,6,5860,20,2117,2,20
"1759","2020-05-24",97,20,204,238,5618,0.924528301886792,2025,7504,480,895,7,5867,39,2156,3,39
"1760","2020-05-25",94,20,206,215,5618,0.924528301886792,2025,7504,480,895,6,5873,27,2183,3,27
"1761","2020-05-26",87,20,189,198,5618,0.924528301886792,2025,7504,480,895,6,5879,23,2206,2,23
"1762","2020-05-27",76,20,170,183,5618,0.924528301886792,2025,7504,480,895,5,5884,12,2218,2,12
"1763","2020-05-28",69,20,149,174,5618,0.924528301886792,2025,7504,480,895,6,5890,23,2241,3,23
"1764","2020-05-29",74,20,153,151,5618,0.924528301886792,2025,7504,480,895,5,5895,14,2255,5,14
"1765","2020-05-30",67,20,189,141,5618,0.924528301886792,2025,7504,480,895,4,5899,17,2272,1,17
"1766","2020-05-31",54,20,200,139,5618,0.924528301886792,2025,7504,480,895,4,5903,39,2311,2,39
"1767","2020-06-01",50,20,188,135,5618,0.924528301886792,2025,7504,480,895,2,5905,22,2333,2,22
"1768","2020-06-02",50,20,170,123,5618,0.924528301886792,2025,7504,480,895,5,5910,34,2367,1,34
"1769","2020-06-03",51,20,149,126,5618,0.924528301886792,2025,7504,480,895,5,5915,31,2398,2,31
"1770","2020-06-04",45,20,146,118,5618,0.924528301886792,2025,7504,480,895,5,5920,30,2428,2,30
"1771","2020-06-05",42,20,157,115,5618,0.924528301886792,2025,7504,480,895,4,5924,40,2468,3,40
"1772","2020-06-06",39,20,148,117,5618,0.924528301886792,2025,7504,480,895,2,5926,25,2493,1,25
"1773","2020-06-07",38,20,143,108,5618,0.924528301886792,2025,7504,480,895,2,5928,27,2520,1,27
