"","Date","Absents","Paramset","Infections_or_Exposed_per_day_Patient","Infections_or_Exposed_per_day_HCW","total_infections","nosocomial_proportion","PCR_pooled","LFD_pooled","HCW_symp_test","patient_symp_test","new_hcw_infs","cumulative_hcw_infs","new_pat_infs","cumulative_pats_infs","new_nosocomial_hcw_infs","new_nosocomial_pat_infs"
"1","2020-03-12",1,1,19,50,6009,0.713429855217174,0,0,508,360,28,50,5,16,1,5
"2","2020-03-13",3,1,26,75,6009,0.713429855217174,0,0,508,360,25,75,5,21,1,5
"3","2020-03-14",4,1,23,104,6009,0.713429855217174,0,0,508,360,29,104,4,25,6,4
"4","2020-03-15",7,1,28,134,6009,0.713429855217174,0,0,508,360,30,134,3,28,10,3
"5","2020-03-16",12,1,31,172,6009,0.713429855217174,0,0,508,360,38,172,5,33,15,5
"6","2020-03-17",22,1,31,212,6009,0.713429855217174,0,0,508,360,41,213,5,38,12,5
"7","2020-03-18",32,1,32,259,6009,0.713429855217174,0,0,508,360,47,260,2,40,22,2
"8","2020-03-19",43,1,34,295,6009,0.713429855217174,0,0,508,360,44,304,6,46,30,6
"9","2020-03-20",59,1,46,347,6009,0.713429855217174,0,0,508,360,57,361,13,59,32,13
"10","2020-03-21",69,1,41,389,6009,0.713429855217174,0,0,508,360,53,414,3,62,32,3
"11","2020-03-22",84,1,53,441,6009,0.713429855217174,0,0,508,360,59,473,18,80,39,18
"12","2020-03-23",101,1,63,470,6009,0.713429855217174,0,0,508,360,52,525,20,100,27,20
"13","2020-03-24",116,1,66,527,6009,0.713429855217174,0,0,508,360,84,609,13,113,61,13
"14","2020-03-25",118,1,59,562,6009,0.713429855217174,0,0,508,360,67,676,9,122,40,9
"15","2020-03-26",124,1,65,607,6009,0.713429855217174,0,0,508,360,88,764,12,134,58,12
"16","2020-03-27",132,1,82,651,6009,0.713429855217174,0,0,508,360,77,841,24,158,55,24
"17","2020-03-28",139,1,99,698,6009,0.713429855217174,0,0,508,360,86,927,27,185,65,27
"18","2020-03-29",144,1,103,761,6009,0.713429855217174,0,0,508,360,113,1040,21,206,85,21
"19","2020-03-30",152,1,106,814,6009,0.713429855217174,0,0,508,360,99,1139,18,224,74,18
"20","2020-03-31",155,1,111,874,6009,0.713429855217174,0,0,508,360,110,1249,24,248,83,24
"21","2020-04-01",168,1,109,928,6009,0.713429855217174,0,0,508,360,127,1376,19,267,103,19
"22","2020-04-02",184,1,108,1012,6009,0.713429855217174,0,0,508,360,137,1513,16,283,113,16
"23","2020-04-03",193,1,97,1088,6009,0.713429855217174,0,0,508,360,138,1651,17,300,117,17
"24","2020-04-04",209,1,97,1156,6009,0.713429855217174,0,0,508,360,133,1784,17,317,100,17
"25","2020-04-05",234,1,104,1220,6009,0.713429855217174,0,0,508,360,136,1920,20,337,118,20
"26","2020-04-06",259,1,99,1271,6009,0.713429855217174,0,0,508,360,134,2054,20,357,113,20
"27","2020-04-07",280,1,95,1336,6009,0.713429855217174,0,0,508,360,146,2200,14,371,117,14
"28","2020-04-08",307,1,101,1375,6009,0.713429855217174,0,0,508,360,153,2353,18,389,135,18
"29","2020-04-09",323,1,102,1426,6009,0.713429855217174,0,0,508,360,137,2490,24,413,121,24
"30","2020-04-10",345,1,98,1460,6009,0.713429855217174,0,0,508,360,158,2648,16,429,138,16
"31","2020-04-11",366,1,94,1525,6009,0.713429855217174,0,0,508,360,158,2806,10,439,139,10
"32","2020-04-12",388,1,111,1503,6009,0.713429855217174,0,0,508,360,108,2914,23,462,83,23
"33","2020-04-13",385,1,111,1532,6009,0.713429855217174,0,0,508,360,158,3072,32,494,137,32
"34","2020-04-14",401,1,105,1543,6009,0.713429855217174,0,0,508,360,132,3204,19,513,111,19
"35","2020-04-15",411,1,106,1514,6009,0.713429855217174,0,0,508,360,115,3319,13,526,95,13
"36","2020-04-16",410,1,118,1497,6009,0.713429855217174,0,0,508,360,128,3447,27,553,109,27
"37","2020-04-17",425,1,104,1490,6009,0.713429855217174,0,0,508,360,115,3562,14,567,92,14
"38","2020-04-18",435,1,94,1473,6009,0.713429855217174,0,0,508,360,108,3670,11,578,94,11
"39","2020-04-19",429,1,96,1452,6009,0.713429855217174,0,0,508,360,114,3784,13,591,101,13
"40","2020-04-20",447,1,89,1427,6009,0.713429855217174,0,0,508,360,125,3909,19,610,107,19
"41","2020-04-21",456,1,98,1371,6009,0.713429855217174,0,0,508,360,76,3985,21,631,59,21
"42","2020-04-22",457,1,102,1319,6009,0.713429855217174,0,0,508,360,90,4075,15,646,73,15
"43","2020-04-23",457,1,109,1283,6009,0.713429855217174,0,0,508,360,98,4173,22,668,79,22
"44","2020-04-24",441,1,122,1238,6009,0.713429855217174,0,0,508,360,76,4249,24,692,52,24
"45","2020-04-25",420,1,122,1194,6009,0.713429855217174,0,0,508,360,90,4339,25,717,74,25
"46","2020-04-26",400,1,125,1151,6009,0.713429855217174,0,0,508,360,77,4416,23,740,57,23
"47","2020-04-27",368,1,119,1103,6009,0.713429855217174,0,0,508,360,72,4488,19,759,56,19
"48","2020-04-28",337,1,109,1067,6009,0.713429855217174,0,0,508,360,88,4576,13,772,76,13
"49","2020-04-29",322,1,104,1026,6009,0.713429855217174,0,0,508,360,73,4649,17,789,55,17
"50","2020-04-30",299,1,101,971,6009,0.713429855217174,0,0,508,360,66,4715,12,801,42,12
"51","2020-05-01",269,1,95,934,6009,0.713429855217174,0,0,508,360,64,4779,6,807,53,6
"52","2020-05-02",265,1,114,891,6009,0.713429855217174,0,0,508,360,52,4831,25,832,44,25
"53","2020-05-03",251,1,100,852,6009,0.713429855217174,0,0,508,360,57,4888,13,845,46,13
"54","2020-05-04",243,1,86,833,6009,0.713429855217174,0,0,508,360,61,4949,6,851,50,6
"55","2020-05-05",226,1,86,799,6009,0.713429855217174,0,0,508,360,59,5008,10,861,43,10
"56","2020-05-06",205,1,72,738,6009,0.713429855217174,0,0,508,360,34,5042,4,865,23,4
"57","2020-05-07",222,1,69,691,6009,0.713429855217174,0,0,508,360,41,5083,9,874,24,9
"58","2020-05-08",223,1,75,660,6009,0.713429855217174,0,0,508,360,40,5123,13,887,29,13
"59","2020-05-09",209,1,76,635,6009,0.713429855217174,0,0,508,360,37,5160,9,896,22,9
"60","2020-05-10",192,1,84,589,6009,0.713429855217174,0,0,508,360,35,5195,22,918,24,22
"61","2020-05-11",187,1,91,545,6009,0.713429855217174,0,0,508,360,30,5225,24,942,21,24
"62","2020-05-12",187,1,90,509,6009,0.713429855217174,0,0,508,360,40,5265,16,958,26,16
"63","2020-05-13",177,1,95,477,6009,0.713429855217174,0,0,508,360,26,5291,13,971,12,13
"64","2020-05-14",151,1,96,441,6009,0.713429855217174,0,0,508,360,24,5315,19,990,18,19
"65","2020-05-15",145,1,90,405,6009,0.713429855217174,0,0,508,360,22,5337,9,999,10,9
"66","2020-05-16",133,1,96,379,6009,0.713429855217174,0,0,508,360,24,5361,16,1015,15,16
"67","2020-05-17",135,1,95,363,6009,0.713429855217174,0,0,508,360,26,5387,15,1030,13,15
"68","2020-05-18",122,1,95,332,6009,0.713429855217174,0,0,508,360,16,5403,9,1039,9,9
"69","2020-05-19",114,1,108,305,6009,0.713429855217174,0,0,508,360,16,5419,30,1069,5,30
"70","2020-05-20",106,1,113,288,6009,0.713429855217174,0,0,508,360,19,5438,25,1094,12,25
"71","2020-05-21",95,1,119,269,6009,0.713429855217174,0,0,508,360,21,5459,23,1117,11,23
"72","2020-05-22",86,1,113,263,6009,0.713429855217174,0,0,508,360,27,5486,18,1135,13,18
"73","2020-05-23",81,1,99,249,6009,0.713429855217174,0,0,508,360,16,5502,11,1146,11,11
"74","2020-05-24",76,1,96,240,6009,0.713429855217174,0,0,508,360,19,5521,27,1173,14,27
"75","2020-05-25",75,1,95,218,6009,0.713429855217174,0,0,508,360,12,5533,16,1189,6,16
"76","2020-05-26",70,1,96,212,6009,0.713429855217174,0,0,508,360,13,5546,14,1203,8,14
"77","2020-05-27",69,1,88,205,6009,0.713429855217174,0,0,508,360,13,5559,13,1216,10,13
"78","2020-05-28",72,1,82,188,6009,0.713429855217174,0,0,508,360,5,5564,15,1231,1,15
"79","2020-05-29",67,1,92,186,6009,0.713429855217174,0,0,508,360,17,5581,17,1248,11,17
"80","2020-05-30",64,1,105,186,6009,0.713429855217174,0,0,508,360,19,5600,31,1279,10,31
"81","2020-05-31",61,1,94,169,6009,0.713429855217174,0,0,508,360,11,5611,12,1291,5,12
"82","2020-06-01",55,1,83,167,6009,0.713429855217174,0,0,508,360,15,5626,11,1302,10,11
"83","2020-06-02",50,1,78,168,6009,0.713429855217174,0,0,508,360,15,5641,11,1313,6,11
"84","2020-06-03",48,1,71,156,6009,0.713429855217174,0,0,508,360,9,5650,8,1321,6,8
"85","2020-06-04",46,1,62,155,6009,0.713429855217174,0,0,508,360,11,5661,5,1326,3,5
"86","2020-06-05",42,1,54,143,6009,0.713429855217174,0,0,508,360,9,5670,3,1329,7,3
"87","2020-06-06",44,1,52,127,6009,0.713429855217174,0,0,508,360,6,5676,6,1335,6,6
"88","2020-06-07",43,1,51,127,6009,0.713429855217174,0,0,508,360,11,5687,5,1340,6,5
"89","2020-03-14",1,2,26,53,3801,0.737963693764799,0,0,339,208,25,88,5,16,6,5
"90","2020-03-15",2,2,31,66,3801,0.737963693764799,0,0,339,208,17,105,4,20,7,4
"91","2020-03-16",3,2,32,88,3801,0.737963693764799,0,0,339,208,27,132,9,29,8,9
"92","2020-03-17",8,2,29,104,3801,0.737963693764799,0,0,339,208,38,170,12,41,15,12
"93","2020-03-18",11,2,31,118,3801,0.737963693764799,0,0,339,208,32,202,7,48,14,7
"94","2020-03-19",17,2,32,152,3801,0.737963693764799,0,0,339,208,35,237,8,56,20,8
"95","2020-03-20",25,2,27,174,3801,0.737963693764799,0,0,339,208,34,271,9,65,18,9
"96","2020-03-21",25,2,22,195,3801,0.737963693764799,0,0,339,208,28,299,5,70,15,5
"97","2020-03-22",30,2,26,218,3801,0.737963693764799,0,0,339,208,27,326,6,76,17,6
"98","2020-03-23",37,2,36,248,3801,0.737963693764799,0,0,339,208,32,358,14,90,16,14
"99","2020-03-24",43,2,30,273,3801,0.737963693764799,0,0,339,208,36,394,11,101,17,11
"100","2020-03-25",54,2,42,296,3801,0.737963693764799,0,0,339,208,26,420,16,117,11,16
"101","2020-03-26",55,2,49,320,3801,0.737963693764799,0,0,339,208,31,451,12,129,19,12
"102","2020-03-27",65,2,41,340,3801,0.737963693764799,0,0,339,208,32,483,26,155,16,26
"103","2020-03-28",79,2,40,350,3801,0.737963693764799,0,0,339,208,50,533,14,169,22,14
"104","2020-03-29",88,2,48,393,3801,0.737963693764799,0,0,339,208,37,570,26,195,18,26
"105","2020-03-30",89,2,57,447,3801,0.737963693764799,0,0,339,208,41,611,22,217,21,22
"106","2020-03-31",94,2,46,452,3801,0.737963693764799,0,0,339,208,33,644,18,235,16,18
"107","2020-04-01",98,2,48,482,3801,0.737963693764799,0,0,339,208,32,676,15,250,13,15
"108","2020-04-02",117,2,39,519,3801,0.737963693764799,0,0,339,208,30,706,7,257,16,7
"109","2020-04-03",113,2,33,548,3801,0.737963693764799,0,0,339,208,40,746,12,269,23,12
"110","2020-04-04",120,2,40,558,3801,0.737963693764799,0,0,339,208,37,783,15,284,19,15
"111","2020-04-05",124,2,38,569,3801,0.737963693764799,0,0,339,208,40,823,18,302,17,18
"112","2020-04-06",144,2,45,596,3801,0.737963693764799,0,0,339,208,48,871,15,317,28,15
"113","2020-04-07",153,2,47,622,3801,0.737963693764799,0,0,339,208,43,914,26,343,20,26
"114","2020-04-08",164,2,46,646,3801,0.737963693764799,0,0,339,208,50,964,15,358,24,15
"115","2020-04-09",167,2,54,655,3801,0.737963693764799,0,0,339,208,52,1016,18,376,25,18
"116","2020-04-10",184,2,65,686,3801,0.737963693764799,0,0,339,208,52,1068,21,397,20,21
"117","2020-04-11",191,2,71,701,3801,0.737963693764799,0,0,339,208,40,1108,23,420,15,23
"118","2020-04-12",197,2,73,719,3801,0.737963693764799,0,0,339,208,40,1148,18,438,21,18
"119","2020-04-13",192,2,81,732,3801,0.737963693764799,0,0,339,208,40,1188,12,450,18,12
"120","2020-04-14",193,2,77,727,3801,0.737963693764799,0,0,339,208,38,1226,20,470,14,20
"121","2020-04-15",192,2,77,733,3801,0.737963693764799,0,0,339,208,44,1270,20,490,17,20
"122","2020-04-16",192,2,73,752,3801,0.737963693764799,0,0,339,208,45,1315,26,516,20,26
"123","2020-04-17",198,2,64,749,3801,0.737963693764799,0,0,339,208,40,1355,11,527,22,11
"124","2020-04-18",202,2,54,752,3801,0.737963693764799,0,0,339,208,37,1392,18,545,14,18
"125","2020-04-19",209,2,55,751,3801,0.737963693764799,0,0,339,208,40,1432,16,561,17,16
"126","2020-04-20",223,2,61,750,3801,0.737963693764799,0,0,339,208,46,1478,14,575,20,14
"127","2020-04-21",217,2,69,753,3801,0.737963693764799,0,0,339,208,43,1521,6,581,16,6
"128","2020-04-22",217,2,78,729,3801,0.737963693764799,0,0,339,208,41,1562,14,595,17,14
"129","2020-04-23",211,2,75,727,3801,0.737963693764799,0,0,339,208,51,1613,15,610,19,15
"130","2020-04-24",206,2,71,694,3801,0.737963693764799,0,0,339,208,47,1660,11,621,19,11
"131","2020-04-25",200,2,67,690,3801,0.737963693764799,0,0,339,208,38,1698,16,637,11,16
"132","2020-04-26",199,2,71,681,3801,0.737963693764799,0,0,339,208,41,1739,15,652,19,15
"133","2020-04-27",189,2,65,664,3801,0.737963693764799,0,0,339,208,30,1769,23,675,15,23
"134","2020-04-28",193,2,67,644,3801,0.737963693764799,0,0,339,208,36,1805,16,691,16,16
"135","2020-04-29",188,2,60,603,3801,0.737963693764799,0,0,339,208,33,1838,10,701,10,10
"136","2020-04-30",186,2,76,588,3801,0.737963693764799,0,0,339,208,30,1868,13,714,11,13
"137","2020-05-01",170,2,88,582,3801,0.737963693764799,0,0,339,208,40,1908,21,735,22,21
"138","2020-05-02",168,2,103,589,3801,0.737963693764799,0,0,339,208,40,1948,11,746,18,11
"139","2020-05-03",166,2,106,572,3801,0.737963693764799,0,0,339,208,42,1990,14,760,17,14
"140","2020-05-04",164,2,104,562,3801,0.737963693764799,0,0,339,208,37,2027,18,778,13,18
"141","2020-05-05",158,2,96,545,3801,0.737963693764799,0,0,339,208,30,2057,20,798,13,20
"142","2020-05-06",165,2,91,547,3801,0.737963693764799,0,0,339,208,30,2087,25,823,11,25
"143","2020-05-07",164,2,100,525,3801,0.737963693764799,0,0,339,208,29,2116,28,851,9,28
"144","2020-05-08",170,2,123,513,3801,0.737963693764799,0,0,339,208,38,2154,24,875,17,24
"145","2020-05-09",159,2,121,508,3801,0.737963693764799,0,0,339,208,44,2198,14,889,21,14
"146","2020-05-10",147,2,97,475,3801,0.737963693764799,0,0,339,208,30,2228,25,914,7,25
"147","2020-05-11",137,2,93,460,3801,0.737963693764799,0,0,339,208,36,2264,21,935,15,21
"148","2020-05-12",135,2,85,443,3801,0.737963693764799,0,0,339,208,25,2289,24,959,15,24
"149","2020-05-13",122,2,99,422,3801,0.737963693764799,0,0,339,208,41,2330,25,984,19,25
"150","2020-05-14",119,2,88,405,3801,0.737963693764799,0,0,339,208,30,2360,12,996,16,12
"151","2020-05-15",120,2,87,405,3801,0.737963693764799,0,0,339,208,28,2388,15,1011,10,15
"152","2020-05-16",123,2,75,412,3801,0.737963693764799,0,0,339,208,38,2426,13,1024,21,13
"153","2020-05-17",121,2,63,397,3801,0.737963693764799,0,0,339,208,30,2456,12,1036,13,12
"154","2020-05-18",117,2,54,393,3801,0.737963693764799,0,0,339,208,30,2486,19,1055,14,19
"155","2020-05-19",118,2,49,391,3801,0.737963693764799,0,0,339,208,33,2519,14,1069,21,14
"156","2020-05-20",115,2,42,375,3801,0.737963693764799,0,0,339,208,26,2545,14,1083,12,14
"157","2020-05-21",111,2,59,357,3801,0.737963693764799,0,0,339,208,21,2566,22,1105,13,22
"158","2020-05-22",107,2,60,350,3801,0.737963693764799,0,0,339,208,28,2594,27,1132,12,27
"159","2020-05-23",105,2,73,344,3801,0.737963693764799,0,0,339,208,29,2623,32,1164,8,32
"160","2020-05-24",102,2,76,341,3801,0.737963693764799,0,0,339,208,17,2640,25,1189,6,25
"161","2020-05-25",101,2,73,330,3801,0.737963693764799,0,0,339,208,16,2656,25,1214,8,25
"162","2020-05-26",107,2,68,306,3801,0.737963693764799,0,0,339,208,20,2676,8,1222,11,8
"163","2020-05-27",105,2,58,299,3801,0.737963693764799,0,0,339,208,22,2698,16,1238,12,16
"164","2020-05-28",102,2,50,294,3801,0.737963693764799,0,0,339,208,18,2716,27,1265,8,27
"165","2020-05-29",93,2,42,282,3801,0.737963693764799,0,0,339,208,19,2735,28,1293,4,28
"166","2020-05-30",90,2,41,274,3801,0.737963693764799,0,0,339,208,15,2750,18,1311,5,18
"167","2020-05-31",88,2,39,269,3801,0.737963693764799,0,0,339,208,17,2767,27,1338,7,27
"168","2020-06-01",85,2,40,269,3801,0.737963693764799,0,0,339,208,13,2780,21,1359,6,21
"169","2020-06-02",68,2,36,266,3801,0.737963693764799,0,0,339,208,17,2797,17,1376,6,17
"170","2020-06-03",67,2,35,257,3801,0.737963693764799,0,0,339,208,12,2809,18,1394,5,18
"171","2020-06-04",65,2,41,248,3801,0.737963693764799,0,0,339,208,12,2821,23,1417,4,23
"172","2020-06-05",64,2,46,250,3801,0.737963693764799,0,0,339,208,20,2841,25,1442,10,25
"173","2020-06-06",62,2,55,250,3801,0.737963693764799,0,0,339,208,11,2852,19,1461,5,19
"174","2020-06-07",63,2,43,236,3801,0.737963693764799,0,0,339,208,18,2870,21,1482,11,21
"175","2020-03-12",1,3,43,39,3708,0.50512405609493,0,0,328,805,10,17,9,15,5,9
"176","2020-03-13",2,3,54,63,3708,0.50512405609493,0,0,328,805,14,31,13,28,5,13
"177","2020-03-14",5,3,63,78,3708,0.50512405609493,0,0,328,805,9,40,7,35,5,7
"178","2020-03-15",10,3,74,104,3708,0.50512405609493,0,0,328,805,18,58,6,41,12,6
"179","2020-03-16",13,3,94,129,3708,0.50512405609493,0,0,328,805,26,84,13,54,20,13
"180","2020-03-17",21,3,107,161,3708,0.50512405609493,0,0,328,805,21,105,15,69,18,15
"181","2020-03-18",27,3,133,195,3708,0.50512405609493,0,0,328,805,18,123,12,81,16,12
"182","2020-03-19",32,3,137,221,3708,0.50512405609493,0,0,328,805,32,155,16,97,20,16
"183","2020-03-20",45,3,138,260,3708,0.50512405609493,0,0,328,805,25,180,29,126,20,29
"184","2020-03-21",47,3,144,299,3708,0.50512405609493,0,0,328,805,36,216,16,142,29,16
"185","2020-03-22",53,3,178,338,3708,0.50512405609493,0,0,328,805,43,259,19,161,38,19
"186","2020-03-23",66,3,187,373,3708,0.50512405609493,0,0,328,805,36,295,16,177,32,16
"187","2020-03-24",72,3,186,404,3708,0.50512405609493,0,0,328,805,65,360,13,190,61,13
"188","2020-03-25",78,3,185,422,3708,0.50512405609493,0,0,328,805,67,427,21,211,61,21
"189","2020-03-26",92,3,177,441,3708,0.50512405609493,0,0,328,805,62,489,20,231,56,20
"190","2020-03-27",99,3,164,465,3708,0.50512405609493,0,0,328,805,71,560,21,252,65,21
"191","2020-03-28",108,3,166,471,3708,0.50512405609493,0,0,328,805,82,642,15,267,79,15
"192","2020-03-29",115,3,162,477,3708,0.50512405609493,0,0,328,805,94,736,24,291,90,24
"193","2020-03-30",124,3,149,494,3708,0.50512405609493,0,0,328,805,89,825,10,301,84,10
"194","2020-03-31",131,3,155,497,3708,0.50512405609493,0,0,328,805,110,935,19,320,100,19
"195","2020-04-01",138,3,159,511,3708,0.50512405609493,0,0,328,805,107,1042,16,336,100,16
"196","2020-04-02",138,3,178,507,3708,0.50512405609493,0,0,328,805,105,1147,23,359,97,23
"197","2020-04-03",138,3,176,516,3708,0.50512405609493,0,0,328,805,140,1287,23,382,133,23
"198","2020-04-04",144,3,196,525,3708,0.50512405609493,0,0,328,805,140,1427,22,404,133,22
"199","2020-04-05",145,3,182,512,3708,0.50512405609493,0,0,328,805,123,1550,23,427,117,23
"200","2020-04-06",137,3,199,514,3708,0.50512405609493,0,0,328,805,127,1677,38,465,118,38
"201","2020-04-07",134,3,178,537,3708,0.50512405609493,0,0,328,805,193,1870,18,483,185,18
"202","2020-04-08",145,3,194,563,3708,0.50512405609493,0,0,328,805,154,2024,14,497,150,14
"203","2020-04-09",145,3,216,558,3708,0.50512405609493,0,0,328,805,152,2176,16,513,147,16
"204","2020-04-10",148,3,222,553,3708,0.50512405609493,0,0,328,805,152,2328,17,530,148,17
"205","2020-04-11",155,3,247,555,3708,0.50512405609493,0,0,328,805,177,2505,17,547,173,17
"206","2020-04-12",161,3,265,564,3708,0.50512405609493,0,0,328,805,175,2680,19,566,169,19
"207","2020-04-13",171,3,256,554,3708,0.50512405609493,0,0,328,805,172,2852,22,588,169,22
"208","2020-04-14",176,3,251,551,3708,0.50512405609493,0,0,328,805,152,3004,22,610,147,22
"209","2020-04-15",169,3,259,569,3708,0.50512405609493,0,0,328,805,171,3175,23,633,166,23
"210","2020-04-16",169,3,271,579,3708,0.50512405609493,0,0,328,805,130,3305,34,667,128,34
"211","2020-04-17",166,3,273,576,3708,0.50512405609493,0,0,328,805,153,3458,21,688,149,21
"212","2020-04-18",157,3,253,581,3708,0.50512405609493,0,0,328,805,184,3642,24,712,177,24
"213","2020-04-19",150,3,240,572,3708,0.50512405609493,0,0,328,805,146,3788,14,726,145,14
"214","2020-04-20",153,3,226,559,3708,0.50512405609493,0,0,328,805,149,3937,13,739,140,13
"215","2020-04-21",151,3,203,555,3708,0.50512405609493,0,0,328,805,128,4065,20,759,125,20
"216","2020-04-22",152,3,205,555,3708,0.50512405609493,0,0,328,805,112,4177,33,792,110,33
"217","2020-04-23",151,3,242,560,3708,0.50512405609493,0,0,328,805,109,4286,19,811,105,19
"218","2020-04-24",158,3,231,567,3708,0.50512405609493,0,0,328,805,132,4418,20,831,131,20
"219","2020-04-25",156,3,232,568,3708,0.50512405609493,0,0,328,805,89,4507,32,863,86,32
"220","2020-04-26",157,3,217,567,3708,0.50512405609493,0,0,328,805,106,4613,22,885,99,22
"221","2020-04-27",148,3,199,556,3708,0.50512405609493,0,0,328,805,67,4680,26,911,64,26
"222","2020-04-28",155,3,212,530,3708,0.50512405609493,0,0,328,805,82,4762,20,931,77,20
"223","2020-04-29",155,3,225,530,3708,0.50512405609493,0,0,328,805,90,4852,20,951,88,20
"224","2020-04-30",155,3,222,504,3708,0.50512405609493,0,0,328,805,80,4932,22,973,75,22
"225","2020-05-01",145,3,210,514,3708,0.50512405609493,0,0,328,805,58,4990,14,987,56,14
"226","2020-05-02",149,3,199,524,3708,0.50512405609493,0,0,328,805,47,5037,14,1001,44,14
"227","2020-05-03",157,3,234,538,3708,0.50512405609493,0,0,328,805,54,5091,14,1015,51,14
"228","2020-05-04",149,3,239,525,3708,0.50512405609493,0,0,328,805,45,5136,27,1042,44,27
"229","2020-05-05",139,3,237,518,3708,0.50512405609493,0,0,328,805,40,5176,26,1068,40,26
"230","2020-05-06",133,3,247,523,3708,0.50512405609493,0,0,328,805,50,5226,37,1105,46,37
"231","2020-05-07",136,3,234,538,3708,0.50512405609493,0,0,328,805,51,5277,27,1132,50,27
"232","2020-05-08",136,3,243,525,3708,0.50512405609493,0,0,328,805,44,5321,18,1150,43,18
"233","2020-05-09",147,3,257,531,3708,0.50512405609493,0,0,328,805,31,5352,11,1161,27,11
"234","2020-05-10",143,3,261,525,3708,0.50512405609493,0,0,328,805,41,5393,14,1175,38,14
"235","2020-05-11",148,3,254,531,3708,0.50512405609493,0,0,328,805,35,5428,24,1199,27,24
"236","2020-05-12",150,3,260,514,3708,0.50512405609493,0,0,328,805,29,5457,19,1218,25,19
"237","2020-05-13",148,3,271,512,3708,0.50512405609493,0,0,328,805,42,5499,14,1232,35,14
"238","2020-05-14",146,3,268,501,3708,0.50512405609493,0,0,328,805,16,5515,8,1240,16,8
"239","2020-05-15",152,3,266,485,3708,0.50512405609493,0,0,328,805,19,5534,24,1264,19,24
"240","2020-05-16",136,3,260,472,3708,0.50512405609493,0,0,328,805,20,5554,26,1290,17,26
"241","2020-05-17",124,3,247,459,3708,0.50512405609493,0,0,328,805,19,5573,30,1320,18,30
"242","2020-05-18",119,3,240,435,3708,0.50512405609493,0,0,328,805,15,5588,32,1352,14,32
"243","2020-05-19",113,3,234,425,3708,0.50512405609493,0,0,328,805,18,5606,23,1375,15,23
"244","2020-05-20",115,3,230,422,3708,0.50512405609493,0,0,328,805,25,5631,36,1411,22,36
"245","2020-05-21",113,3,223,410,3708,0.50512405609493,0,0,328,805,9,5640,28,1439,5,28
"246","2020-05-22",100,3,218,390,3708,0.50512405609493,0,0,328,805,9,5649,22,1461,7,22
"247","2020-05-23",101,3,230,380,3708,0.50512405609493,0,0,328,805,14,5663,15,1476,11,15
"248","2020-05-24",105,3,221,358,3708,0.50512405609493,0,0,328,805,14,5677,16,1492,12,16
"249","2020-05-25",107,3,204,353,3708,0.50512405609493,0,0,328,805,9,5686,25,1517,8,25
"250","2020-05-26",103,3,211,341,3708,0.50512405609493,0,0,328,805,10,5696,22,1539,8,22
"251","2020-05-27",98,3,230,325,3708,0.50512405609493,0,0,328,805,8,5704,20,1559,6,20
"252","2020-05-28",93,3,230,330,3708,0.50512405609493,0,0,328,805,9,5713,19,1578,9,19
"253","2020-05-29",99,3,217,310,3708,0.50512405609493,0,0,328,805,6,5719,11,1589,6,11
"254","2020-05-30",95,3,211,300,3708,0.50512405609493,0,0,328,805,9,5728,24,1613,7,24
"255","2020-05-31",93,3,199,298,3708,0.50512405609493,0,0,328,805,9,5737,19,1632,8,19
"256","2020-06-01",89,3,209,291,3708,0.50512405609493,0,0,328,805,12,5749,27,1659,8,27
"257","2020-06-02",89,3,238,277,3708,0.50512405609493,0,0,328,805,6,5755,24,1683,6,24
"258","2020-06-03",85,3,232,260,3708,0.50512405609493,0,0,328,805,5,5760,31,1714,5,31
"259","2020-06-04",92,3,225,246,3708,0.50512405609493,0,0,328,805,12,5772,25,1739,11,25
"260","2020-06-05",87,3,230,232,3708,0.50512405609493,0,0,328,805,7,5779,17,1756,5,17
"261","2020-06-06",82,3,223,229,3708,0.50512405609493,0,0,328,805,4,5783,24,1780,4,24
"262","2020-06-07",77,3,226,218,3708,0.50512405609493,0,0,328,805,8,5791,14,1794,4,14
"263","2020-03-14",2,4,22,47,3470,0.765129682997118,0,0,297,337,43,117,14,82,26,14
"264","2020-03-15",3,4,28,68,3470,0.765129682997118,0,0,297,337,44,161,14,96,25,14
"265","2020-03-16",4,4,27,87,3470,0.765129682997118,0,0,297,337,48,209,30,126,28,30
"266","2020-03-17",5,4,32,100,3470,0.765129682997118,0,0,297,337,64,273,35,161,49,35
"267","2020-03-18",9,4,24,117,3470,0.765129682997118,0,0,297,337,80,353,40,201,66,40
"268","2020-03-19",13,4,27,134,3470,0.765129682997118,0,0,297,337,104,457,45,246,80,45
"269","2020-03-20",16,4,27,154,3470,0.765129682997118,0,0,297,337,119,576,48,294,99,48
"270","2020-03-21",21,4,32,191,3470,0.765129682997118,0,0,297,337,171,747,21,315,154,21
"271","2020-03-22",29,4,35,203,3470,0.765129682997118,0,0,297,337,217,964,25,340,199,25
"272","2020-03-23",40,4,30,225,3470,0.765129682997118,0,0,297,337,221,1185,34,374,203,34
"273","2020-03-24",48,4,25,240,3470,0.765129682997118,0,0,297,337,243,1428,21,395,225,21
"274","2020-03-25",57,4,23,272,3470,0.765129682997118,0,0,297,337,317,1745,19,414,293,19
"275","2020-03-26",67,4,23,296,3470,0.765129682997118,0,0,297,337,386,2131,37,451,364,37
"276","2020-03-27",79,4,32,312,3470,0.765129682997118,0,0,297,337,397,2528,23,474,368,23
"277","2020-03-28",76,4,38,327,3470,0.765129682997118,0,0,297,337,490,3018,44,518,471,44
"278","2020-03-29",78,4,37,345,3470,0.765129682997118,0,0,297,337,397,3415,36,554,378,36
"279","2020-03-30",74,4,50,351,3470,0.765129682997118,0,0,297,337,514,3929,45,599,503,45
"280","2020-03-31",85,4,63,378,3470,0.765129682997118,0,0,297,337,502,4431,17,616,494,17
"281","2020-04-01",88,4,75,413,3470,0.765129682997118,0,0,297,337,428,4859,19,635,418,19
"282","2020-04-02",91,4,70,435,3470,0.765129682997118,0,0,297,337,434,5293,23,658,426,23
"283","2020-04-03",85,4,69,455,3470,0.765129682997118,0,0,297,337,396,5689,62,720,388,62
"284","2020-04-04",93,4,73,482,3470,0.765129682997118,0,0,297,337,351,6040,42,762,343,42
"285","2020-04-05",103,4,93,500,3470,0.765129682997118,0,0,297,337,359,6399,21,783,357,21
"286","2020-04-06",113,4,100,501,3470,0.765129682997118,0,0,297,337,253,6652,16,799,246,16
"287","2020-04-07",115,4,115,520,3470,0.765129682997118,0,0,297,337,140,6792,16,815,138,16
"288","2020-04-08",119,4,118,553,3470,0.765129682997118,0,0,297,337,156,6948,8,823,144,8
"289","2020-04-09",121,4,110,551,3470,0.765129682997118,0,0,297,337,97,7045,7,830,94,7
"290","2020-04-10",139,4,113,564,3470,0.765129682997118,0,0,297,337,84,7129,12,842,78,12
"291","2020-04-11",155,4,103,583,3470,0.765129682997118,0,0,297,337,64,7193,43,885,60,43
"292","2020-04-12",156,4,109,600,3470,0.765129682997118,0,0,297,337,44,7237,40,925,43,40
"293","2020-04-13",160,4,104,634,3470,0.765129682997118,0,0,297,337,44,7281,18,943,41,18
"294","2020-04-14",160,4,99,626,3470,0.765129682997118,0,0,297,337,35,7316,20,963,29,20
"295","2020-04-15",162,4,88,622,3470,0.765129682997118,0,0,297,337,35,7351,23,986,28,23
"296","2020-04-16",159,4,99,635,3470,0.765129682997118,0,0,297,337,29,7380,44,1030,26,44
"297","2020-04-17",162,4,93,635,3470,0.765129682997118,0,0,297,337,24,7404,29,1059,22,29
"298","2020-04-18",165,4,101,654,3470,0.765129682997118,0,0,297,337,19,7423,23,1082,18,23
"299","2020-04-19",167,4,124,662,3470,0.765129682997118,0,0,297,337,12,7435,18,1100,12,18
"300","2020-04-20",174,4,153,655,3470,0.765129682997118,0,0,297,337,11,7446,40,1140,9,40
"301","2020-04-21",174,4,150,650,3470,0.765129682997118,0,0,297,337,13,7459,18,1158,9,18
"302","2020-04-22",178,4,129,637,3470,0.765129682997118,0,0,297,337,7,7466,57,1215,5,57
"303","2020-04-23",188,4,123,629,3470,0.765129682997118,0,0,297,337,6,7472,59,1274,5,59
"304","2020-04-24",181,4,134,617,3470,0.765129682997118,0,0,297,337,8,7480,65,1339,6,65
"305","2020-04-25",178,4,150,589,3470,0.765129682997118,0,0,297,337,6,7486,56,1395,6,56
"306","2020-04-26",174,4,136,597,3470,0.765129682997118,0,0,297,337,10,7496,55,1450,3,55
"307","2020-04-27",168,4,126,598,3470,0.765129682997118,0,0,297,337,9,7505,38,1488,8,38
"308","2020-04-28",180,4,116,592,3470,0.765129682997118,0,0,297,337,7,7512,15,1503,5,15
"309","2020-04-29",176,4,105,596,3470,0.765129682997118,0,0,297,337,3,7515,12,1515,2,12
"310","2020-04-30",174,4,95,621,3470,0.765129682997118,0,0,297,337,3,7518,23,1538,2,23
"311","2020-05-01",177,4,117,599,3470,0.765129682997118,0,0,297,337,4,7522,61,1599,3,61
"312","2020-05-02",172,4,114,580,3470,0.765129682997118,0,0,297,337,4,7526,52,1651,3,52
"313","2020-05-03",177,4,96,558,3470,0.765129682997118,0,0,297,337,6,7532,33,1684,3,33
"314","2020-05-04",179,4,90,551,3470,0.765129682997118,0,0,297,337,4,7536,16,1700,4,16
"315","2020-05-05",169,4,93,548,3470,0.765129682997118,0,0,297,337,6,7542,47,1747,5,47
"316","2020-05-06",170,4,97,540,3470,0.765129682997118,0,0,297,337,5,7547,47,1794,4,47
"317","2020-05-07",159,4,116,524,3470,0.765129682997118,0,0,297,337,2,7549,60,1854,NA,60
"318","2020-05-08",146,4,133,502,3470,0.765129682997118,0,0,297,337,4,7553,28,1882,1,28
"319","2020-05-09",139,4,151,495,3470,0.765129682997118,0,0,297,337,4,7557,17,1899,2,17
"320","2020-05-10",137,4,143,499,3470,0.765129682997118,0,0,297,337,2,7559,17,1916,NA,17
"321","2020-05-11",141,4,146,487,3470,0.765129682997118,0,0,297,337,2,7561,14,1930,1,14
"322","2020-05-12",139,4,145,482,3470,0.765129682997118,0,0,297,337,2,7563,21,1951,NA,21
"323","2020-05-13",138,4,140,462,3470,0.765129682997118,0,0,297,337,4,7567,36,1987,2,36
"324","2020-05-14",145,4,128,448,3470,0.765129682997118,0,0,297,337,5,7572,19,2006,4,19
"325","2020-05-15",149,4,141,435,3470,0.765129682997118,0,0,297,337,1,7573,29,2035,NA,29
"326","2020-05-16",158,4,151,427,3470,0.765129682997118,0,0,297,337,1,7574,52,2087,NA,52
"327","2020-05-17",157,4,136,405,3470,0.765129682997118,0,0,297,337,2,7576,46,2133,1,46
"328","2020-05-18",148,4,128,390,3470,0.765129682997118,0,0,297,337,4,7580,43,2176,4,43
"329","2020-05-19",143,4,123,364,3470,0.765129682997118,0,0,297,337,1,7581,31,2207,NA,31
"330","2020-05-20",135,4,127,371,3470,0.765129682997118,0,0,297,337,2,7583,24,2231,2,24
"331","2020-05-21",127,4,116,364,3470,0.765129682997118,0,0,297,337,1,7584,39,2270,1,39
"332","2020-05-22",128,4,115,341,3470,0.765129682997118,0,0,297,337,1,7585,23,2293,1,23
"333","2020-05-23",119,4,117,333,3470,0.765129682997118,0,0,297,337,5,7590,42,2335,3,42
"334","2020-05-24",110,4,105,319,3470,0.765129682997118,0,0,297,337,2,7592,26,2361,NA,26
"335","2020-05-25",107,4,95,322,3470,0.765129682997118,0,0,297,337,4,7596,17,2378,2,17
"336","2020-05-26",101,4,103,323,3470,0.765129682997118,0,0,297,337,1,7597,20,2398,NA,20
"337","2020-05-27",99,4,89,303,3470,0.765129682997118,0,0,297,337,1,7598,20,2418,1,20
"338","2020-05-28",95,4,71,289,3470,0.765129682997118,0,0,297,337,3,7601,15,2433,2,15
"339","2020-05-29",89,4,64,273,3470,0.765129682997118,0,0,297,337,1,7602,10,2443,NA,10
"340","2020-05-30",82,4,57,273,3470,0.765129682997118,0,0,297,337,1,7603,15,2458,NA,15
"341","2020-05-31",82,4,52,262,3470,0.765129682997118,0,0,297,337,1,7604,20,2478,NA,20
"342","2020-06-01",75,4,54,249,3470,0.765129682997118,0,0,297,337,1,7605,26,2504,1,26
"343","2020-06-02",76,4,55,249,3470,0.765129682997118,0,0,297,337,NA,NA,18,2522,NA,18
"344","2020-06-03",76,4,56,232,3470,0.765129682997118,0,0,297,337,1,7606,25,2547,NA,25
"345","2020-06-04",78,4,62,226,3470,0.765129682997118,0,0,297,337,1,7607,18,2565,NA,18
"346","2020-06-05",76,4,64,226,3470,0.765129682997118,0,0,297,337,NA,NA,9,2574,NA,9
"347","2020-06-06",77,4,61,223,3470,0.765129682997118,0,0,297,337,1,7608,28,2602,NA,28
"348","2020-06-07",79,4,58,208,3470,0.765129682997118,0,0,297,337,NA,NA,18,2620,NA,18
"349","2020-03-13",3,5,26,36,3006,0.607784431137725,0,0,265,205,14,25,1,9,6,1
"350","2020-03-14",5,5,30,48,3006,0.607784431137725,0,0,265,205,14,39,5,14,6,5
"351","2020-03-15",9,5,25,65,3006,0.607784431137725,0,0,265,205,13,52,7,21,4,7
"352","2020-03-16",11,5,25,82,3006,0.607784431137725,0,0,265,205,17,69,10,31,8,10
"353","2020-03-17",14,5,23,101,3006,0.607784431137725,0,0,265,205,14,83,19,50,9,19
"354","2020-03-18",18,5,28,124,3006,0.607784431137725,0,0,265,205,16,99,19,69,7,19
"355","2020-03-19",20,5,29,149,3006,0.607784431137725,0,0,265,205,17,116,15,84,11,15
"356","2020-03-20",24,5,38,165,3006,0.607784431137725,0,0,265,205,22,138,28,112,15,28
"357","2020-03-21",30,5,33,186,3006,0.607784431137725,0,0,265,205,26,164,20,132,16,20
"358","2020-03-22",31,5,39,204,3006,0.607784431137725,0,0,265,205,25,189,14,146,18,14
"359","2020-03-23",32,5,45,218,3006,0.607784431137725,0,0,265,205,18,207,15,161,11,15
"360","2020-03-24",39,5,54,248,3006,0.607784431137725,0,0,265,205,30,237,15,176,20,15
"361","2020-03-25",50,5,59,268,3006,0.607784431137725,0,0,265,205,19,256,13,189,13,13
"362","2020-03-26",60,5,47,295,3006,0.607784431137725,0,0,265,205,36,292,13,202,30,13
"363","2020-03-27",63,5,40,322,3006,0.607784431137725,0,0,265,205,28,320,18,220,20,18
"364","2020-03-28",70,5,39,345,3006,0.607784431137725,0,0,265,205,26,346,25,245,19,25
"365","2020-03-29",77,5,39,372,3006,0.607784431137725,0,0,265,205,25,371,24,269,18,24
"366","2020-03-30",88,5,30,387,3006,0.607784431137725,0,0,265,205,30,401,17,286,16,17
"367","2020-03-31",96,5,32,405,3006,0.607784431137725,0,0,265,205,28,429,30,316,23,30
"368","2020-04-01",88,5,31,433,3006,0.607784431137725,0,0,265,205,36,465,23,339,30,23
"369","2020-04-02",103,5,32,448,3006,0.607784431137725,0,0,265,205,20,485,18,357,12,18
"370","2020-04-03",104,5,36,465,3006,0.607784431137725,0,0,265,205,24,509,18,375,15,18
"371","2020-04-04",107,5,32,483,3006,0.607784431137725,0,0,265,205,36,545,27,402,25,27
"372","2020-04-05",112,5,35,498,3006,0.607784431137725,0,0,265,205,34,579,39,441,25,39
"373","2020-04-06",125,5,41,500,3006,0.607784431137725,0,0,265,205,23,602,32,473,21,32
"374","2020-04-07",132,5,41,514,3006,0.607784431137725,0,0,265,205,25,627,23,496,18,23
"375","2020-04-08",147,5,41,518,3006,0.607784431137725,0,0,265,205,45,672,30,526,35,30
"376","2020-04-09",139,5,48,518,3006,0.607784431137725,0,0,265,205,36,708,28,554,24,28
"377","2020-04-10",145,5,59,508,3006,0.607784431137725,0,0,265,205,37,745,28,582,25,28
"378","2020-04-11",150,5,67,512,3006,0.607784431137725,0,0,265,205,37,782,26,608,26,26
"379","2020-04-12",149,5,68,499,3006,0.607784431137725,0,0,265,205,33,815,25,633,25,25
"380","2020-04-13",143,5,71,525,3006,0.607784431137725,0,0,265,205,40,855,38,671,31,38
"381","2020-04-14",134,5,64,527,3006,0.607784431137725,0,0,265,205,27,882,49,720,22,49
"382","2020-04-15",128,5,58,540,3006,0.607784431137725,0,0,265,205,21,903,20,740,15,20
"383","2020-04-16",124,5,57,537,3006,0.607784431137725,0,0,265,205,28,931,25,765,20,25
"384","2020-04-17",126,5,58,541,3006,0.607784431137725,0,0,265,205,23,954,25,790,17,25
"385","2020-04-18",131,5,61,549,3006,0.607784431137725,0,0,265,205,32,986,28,818,21,28
"386","2020-04-19",136,5,55,544,3006,0.607784431137725,0,0,265,205,39,1025,22,840,28,22
"387","2020-04-20",136,5,72,551,3006,0.607784431137725,0,0,265,205,33,1058,33,873,18,33
"388","2020-04-21",148,5,68,560,3006,0.607784431137725,0,0,265,205,21,1079,15,888,15,15
"389","2020-04-22",157,5,85,569,3006,0.607784431137725,0,0,265,205,37,1116,38,926,29,38
"390","2020-04-23",165,5,96,565,3006,0.607784431137725,0,0,265,205,24,1140,29,955,21,29
"391","2020-04-24",179,5,85,571,3006,0.607784431137725,0,0,265,205,19,1159,21,976,11,21
"392","2020-04-25",177,5,89,562,3006,0.607784431137725,0,0,265,205,18,1177,16,992,13,16
"393","2020-04-26",170,5,82,559,3006,0.607784431137725,0,0,265,205,21,1198,12,1004,16,12
"394","2020-04-27",172,5,80,569,3006,0.607784431137725,0,0,265,205,17,1215,18,1022,10,18
"395","2020-04-28",163,5,92,567,3006,0.607784431137725,0,0,265,205,22,1237,32,1054,12,32
"396","2020-04-29",162,5,92,559,3006,0.607784431137725,0,0,265,205,21,1258,25,1079,10,25
"397","2020-04-30",166,5,96,552,3006,0.607784431137725,0,0,265,205,24,1282,17,1096,17,17
"398","2020-05-01",155,5,93,544,3006,0.607784431137725,0,0,265,205,37,1319,18,1114,22,18
"399","2020-05-02",152,5,97,522,3006,0.607784431137725,0,0,265,205,21,1340,30,1144,14,30
"400","2020-05-03",160,5,87,505,3006,0.607784431137725,0,0,265,205,24,1364,25,1169,13,25
"401","2020-05-04",165,5,89,495,3006,0.607784431137725,0,0,265,205,23,1387,20,1189,12,20
"402","2020-05-05",165,5,93,479,3006,0.607784431137725,0,0,265,205,20,1407,17,1206,12,17
"403","2020-05-06",168,5,102,478,3006,0.607784431137725,0,0,265,205,26,1433,33,1239,18,33
"404","2020-05-07",157,5,112,476,3006,0.607784431137725,0,0,265,205,22,1455,44,1283,13,44
"405","2020-05-08",152,5,113,446,3006,0.607784431137725,0,0,265,205,24,1479,38,1321,15,38
"406","2020-05-09",143,5,115,425,3006,0.607784431137725,0,0,265,205,25,1504,50,1371,16,50
"407","2020-05-10",133,5,122,412,3006,0.607784431137725,0,0,265,205,17,1521,35,1406,12,35
"408","2020-05-11",119,5,134,403,3006,0.607784431137725,0,0,265,205,25,1546,24,1430,19,24
"409","2020-05-12",120,5,135,378,3006,0.607784431137725,0,0,265,205,23,1569,24,1454,12,24
"410","2020-05-13",110,5,123,355,3006,0.607784431137725,0,0,265,205,31,1600,35,1489,22,35
"411","2020-05-14",105,5,109,339,3006,0.607784431137725,0,0,265,205,20,1620,29,1518,17,29
"412","2020-05-15",100,5,103,327,3006,0.607784431137725,0,0,265,205,16,1636,23,1541,12,23
"413","2020-05-16",106,5,94,316,3006,0.607784431137725,0,0,265,205,23,1659,15,1556,16,15
"414","2020-05-17",111,5,95,305,3006,0.607784431137725,0,0,265,205,19,1678,20,1576,16,20
"415","2020-05-18",113,5,94,303,3006,0.607784431137725,0,0,265,205,14,1692,22,1598,9,22
"416","2020-05-19",112,5,94,293,3006,0.607784431137725,0,0,265,205,21,1713,28,1626,16,28
"417","2020-05-20",108,5,83,276,3006,0.607784431137725,0,0,265,205,19,1732,16,1642,14,16
"418","2020-05-21",107,5,76,261,3006,0.607784431137725,0,0,265,205,17,1749,38,1680,13,38
"419","2020-05-22",103,5,73,248,3006,0.607784431137725,0,0,265,205,17,1766,30,1710,11,30
"420","2020-05-23",90,5,82,240,3006,0.607784431137725,0,0,265,205,19,1785,28,1738,15,28
"421","2020-05-24",86,5,76,222,3006,0.607784431137725,0,0,265,205,11,1796,24,1762,6,24
"422","2020-05-25",81,5,68,221,3006,0.607784431137725,0,0,265,205,23,1819,25,1787,22,25
"423","2020-05-26",69,5,67,214,3006,0.607784431137725,0,0,265,205,18,1837,24,1811,12,24
"424","2020-05-27",65,5,53,199,3006,0.607784431137725,0,0,265,205,17,1854,22,1833,13,22
"425","2020-05-28",66,5,54,191,3006,0.607784431137725,0,0,265,205,24,1878,24,1857,15,24
"426","2020-05-29",70,5,56,189,3006,0.607784431137725,0,0,265,205,27,1905,17,1874,22,17
"427","2020-05-30",69,5,55,185,3006,0.607784431137725,0,0,265,205,14,1919,24,1898,12,24
"428","2020-05-31",62,5,50,180,3006,0.607784431137725,0,0,265,205,22,1941,12,1910,15,12
"429","2020-06-01",59,5,48,173,3006,0.607784431137725,0,0,265,205,14,1955,23,1933,13,23
"430","2020-06-02",57,5,45,168,3006,0.607784431137725,0,0,265,205,10,1965,21,1954,9,21
"431","2020-06-03",57,5,43,156,3006,0.607784431137725,0,0,265,205,20,1985,19,1973,18,19
"432","2020-06-04",51,5,43,147,3006,0.607784431137725,0,0,265,205,20,2005,18,1991,19,18
"433","2020-06-05",46,5,48,144,3006,0.607784431137725,0,0,265,205,16,2021,4,1995,13,4
"434","2020-06-06",45,5,49,135,3006,0.607784431137725,0,0,265,205,15,2036,9,2004,11,9
"435","2020-06-07",42,5,52,121,3006,0.607784431137725,0,0,265,205,17,2053,13,2017,13,13
"436","2020-03-15",6,6,51,77,7590,0.937417654808959,0,0,636,546,13,65,14,44,7,14
"437","2020-03-16",11,6,51,120,7590,0.937417654808959,0,0,636,546,20,85,12,56,9,12
"438","2020-03-17",15,6,63,166,7590,0.937417654808959,0,0,636,546,23,108,4,60,7,4
"439","2020-03-18",18,6,63,204,7590,0.937417654808959,0,0,636,546,18,126,5,65,7,5
"440","2020-03-19",20,6,65,243,7590,0.937417654808959,0,0,636,546,19,145,20,85,7,20
"441","2020-03-20",25,6,57,300,7590,0.937417654808959,0,0,636,546,25,170,20,105,10,20
"442","2020-03-21",34,6,68,379,7590,0.937417654808959,0,0,636,546,35,205,12,117,18,12
"443","2020-03-22",36,6,75,461,7590,0.937417654808959,0,0,636,546,37,242,4,121,16,4
"444","2020-03-23",52,6,77,548,7590,0.937417654808959,0,0,636,546,24,266,7,128,16,7
"445","2020-03-24",66,6,88,657,7590,0.937417654808959,0,0,636,546,22,288,12,140,13,12
"446","2020-03-25",91,6,82,788,7590,0.937417654808959,0,0,636,546,26,314,12,152,16,12
"447","2020-03-26",121,6,76,952,7590,0.937417654808959,0,0,636,546,32,346,20,172,17,20
"448","2020-03-27",144,6,79,1090,7590,0.937417654808959,0,0,636,546,33,379,28,200,17,28
"449","2020-03-28",171,6,70,1282,7590,0.937417654808959,0,0,636,546,24,403,15,215,12,15
"450","2020-03-29",211,6,89,1442,7590,0.937417654808959,0,0,636,546,26,429,16,231,16,16
"451","2020-03-30",263,6,119,1685,7590,0.937417654808959,0,0,636,546,29,458,23,254,15,23
"452","2020-03-31",308,6,135,1899,7590,0.937417654808959,0,0,636,546,44,502,26,280,25,26
"453","2020-04-01",343,6,130,2124,7590,0.937417654808959,0,0,636,546,36,538,11,291,20,11
"454","2020-04-02",388,6,150,2317,7590,0.937417654808959,0,0,636,546,40,578,9,300,21,9
"455","2020-04-03",444,6,143,2566,7590,0.937417654808959,0,0,636,546,50,628,11,311,26,11
"456","2020-04-04",531,6,125,2851,7590,0.937417654808959,0,0,636,546,34,662,8,319,21,8
"457","2020-04-05",585,6,130,3020,7590,0.937417654808959,0,0,636,546,43,705,13,332,31,13
"458","2020-04-06",633,6,136,3193,7590,0.937417654808959,0,0,636,546,46,751,5,337,27,5
"459","2020-04-07",684,6,136,3330,7590,0.937417654808959,0,0,636,546,26,777,11,348,8,11
"460","2020-04-08",768,6,132,3524,7590,0.937417654808959,0,0,636,546,45,822,32,380,21,32
"461","2020-04-09",825,6,112,3604,7590,0.937417654808959,0,0,636,546,38,860,28,408,20,28
"462","2020-04-10",885,6,108,3648,7590,0.937417654808959,0,0,636,546,27,887,21,429,9,21
"463","2020-04-11",925,6,88,3635,7590,0.937417654808959,0,0,636,546,42,929,15,444,13,15
"464","2020-04-12",974,6,79,3516,7590,0.937417654808959,0,0,636,546,37,966,28,472,22,28
"465","2020-04-13",1017,6,78,3368,7590,0.937417654808959,0,0,636,546,46,1012,29,501,34,29
"466","2020-04-14",1041,6,74,3179,7590,0.937417654808959,0,0,636,546,29,1041,12,513,12,12
"467","2020-04-15",1026,6,79,2947,7590,0.937417654808959,0,0,636,546,42,1083,9,522,24,9
"468","2020-04-16",1032,6,73,2685,7590,0.937417654808959,0,0,636,546,42,1125,19,541,19,19
"469","2020-04-17",987,6,108,2432,7590,0.937417654808959,0,0,636,546,44,1169,12,553,22,12
"470","2020-04-18",934,6,109,2173,7590,0.937417654808959,0,0,636,546,34,1203,10,563,15,10
"471","2020-04-19",882,6,131,1908,7590,0.937417654808959,0,0,636,546,39,1242,4,567,21,4
"472","2020-04-20",788,6,151,1660,7590,0.937417654808959,0,0,636,546,50,1292,6,573,30,6
"473","2020-04-21",724,6,174,1419,7590,0.937417654808959,0,0,636,546,35,1327,11,584,21,11
"474","2020-04-22",647,6,172,1211,7590,0.937417654808959,0,0,636,546,45,1372,14,598,30,14
"475","2020-04-23",565,6,158,1047,7590,0.937417654808959,0,0,636,546,40,1412,26,624,30,26
"476","2020-04-24",513,6,144,892,7590,0.937417654808959,0,0,636,546,45,1457,60,684,28,60
"477","2020-04-25",451,6,151,759,7590,0.937417654808959,0,0,636,546,36,1493,53,737,19,53
"478","2020-04-26",380,6,141,662,7590,0.937417654808959,0,0,636,546,33,1526,43,780,18,43
"479","2020-04-27",330,6,133,546,7590,0.937417654808959,0,0,636,546,30,1556,30,810,14,30
"480","2020-04-28",275,6,115,458,7590,0.937417654808959,0,0,636,546,29,1585,40,850,11,40
"481","2020-04-29",237,6,106,397,7590,0.937417654808959,0,0,636,546,16,1601,20,870,6,20
"482","2020-04-30",200,6,102,351,7590,0.937417654808959,0,0,636,546,33,1634,21,891,18,21
"483","2020-05-01",164,6,144,292,7590,0.937417654808959,0,0,636,546,33,1667,13,904,11,13
"484","2020-05-02",122,6,151,245,7590,0.937417654808959,0,0,636,546,39,1706,29,933,12,29
"485","2020-05-03",104,6,162,204,7590,0.937417654808959,0,0,636,546,25,1731,39,972,12,39
"486","2020-05-04",91,6,157,171,7590,0.937417654808959,0,0,636,546,36,1767,52,1024,16,52
"487","2020-05-05",79,6,147,152,7590,0.937417654808959,0,0,636,546,28,1795,16,1040,11,16
"488","2020-05-06",65,6,132,133,7590,0.937417654808959,0,0,636,546,32,1827,11,1051,11,11
"489","2020-05-07",49,6,125,115,7590,0.937417654808959,0,0,636,546,20,1847,6,1057,7,6
"490","2020-05-08",43,6,112,101,7590,0.937417654808959,0,0,636,546,23,1870,12,1069,12,12
"491","2020-05-09",46,6,102,81,7590,0.937417654808959,0,0,636,546,16,1886,31,1100,8,31
"492","2020-05-10",39,6,108,69,7590,0.937417654808959,0,0,636,546,30,1916,20,1120,10,20
"493","2020-05-11",32,6,129,61,7590,0.937417654808959,0,0,636,546,29,1945,44,1164,15,44
"494","2020-05-12",26,6,155,53,7590,0.937417654808959,0,0,636,546,26,1971,26,1190,9,26
"495","2020-05-13",23,6,168,53,7590,0.937417654808959,0,0,636,546,22,1993,16,1206,7,16
"496","2020-05-14",20,6,173,48,7590,0.937417654808959,0,0,636,546,18,2011,14,1220,13,14
"497","2020-05-15",17,6,195,50,7590,0.937417654808959,0,0,636,546,29,2040,29,1249,14,29
"498","2020-05-16",8,6,176,45,7590,0.937417654808959,0,0,636,546,26,2066,42,1291,11,42
"499","2020-05-17",6,6,180,44,7590,0.937417654808959,0,0,636,546,28,2094,28,1319,12,28
"500","2020-05-18",8,6,165,40,7590,0.937417654808959,0,0,636,546,10,2104,30,1349,2,30
"501","2020-05-19",8,6,158,40,7590,0.937417654808959,0,0,636,546,16,2120,16,1365,7,16
"502","2020-05-20",11,6,149,40,7590,0.937417654808959,0,0,636,546,14,2134,21,1386,6,21
"503","2020-05-21",10,6,146,40,7590,0.937417654808959,0,0,636,546,17,2151,16,1402,4,16
"504","2020-05-22",8,6,131,40,7590,0.937417654808959,0,0,636,546,13,2164,36,1438,10,36
"505","2020-05-23",9,6,125,38,7590,0.937417654808959,0,0,636,546,17,2181,16,1454,9,16
"506","2020-05-24",11,6,119,37,7590,0.937417654808959,0,0,636,546,23,2204,14,1468,6,14
"507","2020-05-25",10,6,116,33,7590,0.937417654808959,0,0,636,546,22,2226,14,1482,6,14
"508","2020-05-26",11,6,129,37,7590,0.937417654808959,0,0,636,546,17,2243,30,1512,6,30
"509","2020-05-27",11,6,120,42,7590,0.937417654808959,0,0,636,546,13,2256,22,1534,6,22
"510","2020-05-28",12,6,119,38,7590,0.937417654808959,0,0,636,546,18,2274,39,1573,10,39
"511","2020-05-29",16,6,111,33,7590,0.937417654808959,0,0,636,546,14,2288,29,1602,7,29
"512","2020-05-30",15,6,103,34,7590,0.937417654808959,0,0,636,546,12,2300,13,1615,9,13
"513","2020-05-31",12,6,96,31,7590,0.937417654808959,0,0,636,546,23,2323,13,1628,10,13
"514","2020-06-01",12,6,83,31,7590,0.937417654808959,0,0,636,546,17,2340,19,1647,9,19
"515","2020-06-02",11,6,83,29,7590,0.937417654808959,0,0,636,546,13,2353,7,1654,7,7
"516","2020-06-03",10,6,79,28,7590,0.937417654808959,0,0,636,546,13,2366,24,1678,7,24
"517","2020-06-04",8,6,81,27,7590,0.937417654808959,0,0,636,546,12,2378,25,1703,6,25
"518","2020-06-05",4,6,74,23,7590,0.937417654808959,0,0,636,546,12,2390,15,1718,4,15
"519","2020-06-06",5,6,74,23,7590,0.937417654808959,0,0,636,546,13,2403,16,1734,5,16
"520","2020-06-07",6,6,64,20,7590,0.937417654808959,0,0,636,546,11,2414,11,1745,5,11
"521","2020-03-15",4,7,22,93,3410,0.386803519061584,0,0,288,227,6,33,10,38,2,10
"522","2020-03-16",4,7,30,127,3410,0.386803519061584,0,0,288,227,16,49,8,46,10,8
"523","2020-03-17",10,7,36,152,3410,0.386803519061584,0,0,288,227,7,56,6,52,4,6
"524","2020-03-18",15,7,41,171,3410,0.386803519061584,0,0,288,227,15,71,20,72,7,20
"525","2020-03-19",21,7,36,191,3410,0.386803519061584,0,0,288,227,19,90,21,93,13,21
"526","2020-03-20",31,7,39,219,3410,0.386803519061584,0,0,288,227,20,110,20,113,10,20
"527","2020-03-21",42,7,37,250,3410,0.386803519061584,0,0,288,227,21,131,26,139,17,26
"528","2020-03-22",43,7,31,280,3410,0.386803519061584,0,0,288,227,18,149,33,172,13,33
"529","2020-03-23",59,7,31,299,3410,0.386803519061584,0,0,288,227,21,170,23,195,12,23
"530","2020-03-24",65,7,31,318,3410,0.386803519061584,0,0,288,227,18,188,21,216,11,21
"531","2020-03-25",67,7,36,337,3410,0.386803519061584,0,0,288,227,23,211,12,228,17,12
"532","2020-03-26",73,7,35,352,3410,0.386803519061584,0,0,288,227,19,230,7,235,15,7
"533","2020-03-27",68,7,36,371,3410,0.386803519061584,0,0,288,227,26,256,5,240,20,5
"534","2020-03-28",67,7,43,387,3410,0.386803519061584,0,0,288,227,17,273,22,262,10,22
"535","2020-03-29",80,7,44,409,3410,0.386803519061584,0,0,288,227,21,294,12,274,16,12
"536","2020-03-30",82,7,42,423,3410,0.386803519061584,0,0,288,227,24,318,24,298,16,24
"537","2020-03-31",83,7,36,435,3410,0.386803519061584,0,0,288,227,26,344,28,326,20,28
"538","2020-04-01",102,7,53,447,3410,0.386803519061584,0,0,288,227,24,368,17,343,20,17
"539","2020-04-02",116,7,59,467,3410,0.386803519061584,0,0,288,227,24,392,25,368,15,25
"540","2020-04-03",127,7,60,480,3410,0.386803519061584,0,0,288,227,29,421,28,396,18,28
"541","2020-04-04",143,7,54,498,3410,0.386803519061584,0,0,288,227,25,446,39,435,17,39
"542","2020-04-05",148,7,53,494,3410,0.386803519061584,0,0,288,227,28,474,52,487,18,52
"543","2020-04-06",151,7,47,505,3410,0.386803519061584,0,0,288,227,29,503,24,511,21,24
"544","2020-04-07",162,7,42,521,3410,0.386803519061584,0,0,288,227,30,533,16,527,25,16
"545","2020-04-08",155,7,40,526,3410,0.386803519061584,0,0,288,227,35,568,15,542,26,15
"546","2020-04-09",153,7,49,537,3410,0.386803519061584,0,0,288,227,26,594,7,549,15,7
"547","2020-04-10",162,7,55,536,3410,0.386803519061584,0,0,288,227,34,628,4,553,23,4
"548","2020-04-11",153,7,54,536,3410,0.386803519061584,0,0,288,227,31,659,4,557,22,4
"549","2020-04-12",150,7,54,527,3410,0.386803519061584,0,0,288,227,34,693,17,574,24,17
"550","2020-04-13",149,7,63,543,3410,0.386803519061584,0,0,288,227,27,720,16,590,21,16
"551","2020-04-14",156,7,65,533,3410,0.386803519061584,0,0,288,227,34,754,11,601,29,11
"552","2020-04-15",158,7,56,534,3410,0.386803519061584,0,0,288,227,26,780,9,610,16,9
"553","2020-04-16",157,7,46,543,3410,0.386803519061584,0,0,288,227,32,812,9,619,21,9
"554","2020-04-17",155,7,67,534,3410,0.386803519061584,0,0,288,227,28,840,30,649,21,30
"555","2020-04-18",163,7,67,533,3410,0.386803519061584,0,0,288,227,41,881,23,672,24,23
"556","2020-04-19",168,7,73,527,3410,0.386803519061584,0,0,288,227,33,914,37,709,26,37
"557","2020-04-20",168,7,77,514,3410,0.386803519061584,0,0,288,227,35,949,20,729,24,20
"558","2020-04-21",156,7,74,516,3410,0.386803519061584,0,0,288,227,36,985,14,743,29,14
"559","2020-04-22",159,7,81,522,3410,0.386803519061584,0,0,288,227,32,1017,24,767,22,24
"560","2020-04-23",152,7,70,526,3410,0.386803519061584,0,0,288,227,33,1050,10,777,22,10
"561","2020-04-24",147,7,81,510,3410,0.386803519061584,0,0,288,227,32,1082,9,786,24,9
"562","2020-04-25",139,7,90,492,3410,0.386803519061584,0,0,288,227,24,1106,7,793,16,7
"563","2020-04-26",134,7,94,505,3410,0.386803519061584,0,0,288,227,37,1143,30,823,26,30
"564","2020-04-27",135,7,106,498,3410,0.386803519061584,0,0,288,227,33,1176,22,845,22,22
"565","2020-04-28",143,7,101,499,3410,0.386803519061584,0,0,288,227,41,1217,30,875,29,30
"566","2020-04-29",139,7,104,495,3410,0.386803519061584,0,0,288,227,44,1261,23,898,31,23
"567","2020-04-30",155,7,104,522,3410,0.386803519061584,0,0,288,227,44,1305,36,934,30,36
"568","2020-05-01",159,7,106,515,3410,0.386803519061584,0,0,288,227,31,1336,16,950,28,16
"569","2020-05-02",167,7,103,511,3410,0.386803519061584,0,0,288,227,35,1371,32,982,30,32
"570","2020-05-03",170,7,87,507,3410,0.386803519061584,0,0,288,227,32,1403,11,993,20,11
"571","2020-05-04",164,7,69,499,3410,0.386803519061584,0,0,288,227,50,1453,45,1038,41,45
"572","2020-05-05",166,7,74,491,3410,0.386803519061584,0,0,288,227,34,1487,14,1052,28,14
"573","2020-05-06",166,7,70,488,3410,0.386803519061584,0,0,288,227,33,1520,13,1065,28,13
"574","2020-05-07",151,7,59,488,3410,0.386803519061584,0,0,288,227,46,1566,7,1072,40,7
"575","2020-05-08",142,7,74,462,3410,0.386803519061584,0,0,288,227,42,1608,3,1075,34,3
"576","2020-05-09",136,7,72,449,3410,0.386803519061584,0,0,288,227,48,1656,4,1079,42,4
"577","2020-05-10",128,7,75,437,3410,0.386803519061584,0,0,288,227,35,1691,10,1089,32,10
"578","2020-05-11",130,7,74,437,3410,0.386803519061584,0,0,288,227,39,1730,26,1115,33,26
"579","2020-05-12",119,7,73,433,3410,0.386803519061584,0,0,288,227,37,1767,34,1149,26,34
"580","2020-05-13",124,7,84,434,3410,0.386803519061584,0,0,288,227,32,1799,46,1195,23,46
"581","2020-05-14",123,7,89,428,3410,0.386803519061584,0,0,288,227,40,1839,26,1221,29,26
"582","2020-05-15",131,7,97,422,3410,0.386803519061584,0,0,288,227,27,1866,10,1231,19,10
"583","2020-05-16",129,7,93,433,3410,0.386803519061584,0,0,288,227,36,1902,32,1263,29,32
"584","2020-05-17",120,7,99,421,3410,0.386803519061584,0,0,288,227,30,1932,28,1291,25,28
"585","2020-05-18",121,7,96,413,3410,0.386803519061584,0,0,288,227,47,1979,37,1328,43,37
"586","2020-05-19",120,7,88,397,3410,0.386803519061584,0,0,288,227,18,1997,19,1347,14,19
"587","2020-05-20",117,7,80,391,3410,0.386803519061584,0,0,288,227,30,2027,6,1353,23,6
"588","2020-05-21",116,7,74,392,3410,0.386803519061584,0,0,288,227,25,2052,6,1359,16,6
"589","2020-05-22",112,7,73,377,3410,0.386803519061584,0,0,288,227,22,2074,24,1383,16,24
"590","2020-05-23",118,7,74,373,3410,0.386803519061584,0,0,288,227,27,2101,14,1397,21,14
"591","2020-05-24",127,7,70,361,3410,0.386803519061584,0,0,288,227,26,2127,14,1411,19,14
"592","2020-05-25",127,7,55,342,3410,0.386803519061584,0,0,288,227,20,2147,11,1422,14,11
"593","2020-05-26",125,7,57,340,3410,0.386803519061584,0,0,288,227,20,2167,9,1431,16,9
"594","2020-05-27",118,7,60,327,3410,0.386803519061584,0,0,288,227,27,2194,10,1441,21,10
"595","2020-05-28",121,7,63,333,3410,0.386803519061584,0,0,288,227,21,2215,13,1454,19,13
"596","2020-05-29",116,7,52,314,3410,0.386803519061584,0,0,288,227,17,2232,15,1469,12,15
"597","2020-05-30",104,7,55,297,3410,0.386803519061584,0,0,288,227,21,2253,25,1494,15,25
"598","2020-05-31",107,7,55,291,3410,0.386803519061584,0,0,288,227,23,2276,11,1505,21,11
"599","2020-06-01",101,7,54,279,3410,0.386803519061584,0,0,288,227,16,2292,13,1518,12,13
"600","2020-06-02",99,7,50,269,3410,0.386803519061584,0,0,288,227,21,2313,7,1525,17,7
"601","2020-06-03",94,7,52,256,3410,0.386803519061584,0,0,288,227,24,2337,5,1530,21,5
"602","2020-06-04",83,7,58,240,3410,0.386803519061584,0,0,288,227,18,2355,8,1538,15,8
"603","2020-06-05",88,7,57,236,3410,0.386803519061584,0,0,288,227,14,2369,14,1552,12,14
"604","2020-06-06",89,7,52,230,3410,0.386803519061584,0,0,288,227,21,2390,2,1554,21,2
"605","2020-06-07",81,7,53,224,3410,0.386803519061584,0,0,288,227,13,2403,22,1576,13,22
"606","2020-03-13",1,8,33,41,3057,0.491004252535165,0,0,300,595,13,41,1,10,NA,1
"607","2020-03-14",3,8,59,60,3057,0.491004252535165,0,0,300,595,14,55,7,17,4,7
"608","2020-03-15",3,8,74,78,3057,0.491004252535165,0,0,300,595,15,70,5,22,1,5
"609","2020-03-16",7,8,91,101,3057,0.491004252535165,0,0,300,595,11,81,16,38,2,16
"610","2020-03-17",15,8,102,122,3057,0.491004252535165,0,0,300,595,18,99,6,44,5,6
"611","2020-03-18",18,8,128,145,3057,0.491004252535165,0,0,300,595,17,116,6,50,7,6
"612","2020-03-19",24,8,134,174,3057,0.491004252535165,0,0,300,595,23,139,6,56,7,6
"613","2020-03-20",30,8,148,197,3057,0.491004252535165,0,0,300,595,17,156,5,61,10,5
"614","2020-03-21",37,8,187,222,3057,0.491004252535165,0,0,300,595,19,175,15,76,5,15
"615","2020-03-22",46,8,175,235,3057,0.491004252535165,0,0,300,595,31,206,7,83,13,7
"616","2020-03-23",55,8,153,254,3057,0.491004252535165,0,0,300,595,28,234,3,86,14,3
"617","2020-03-24",57,8,165,270,3057,0.491004252535165,0,0,300,595,31,265,10,96,17,10
"618","2020-03-25",69,8,173,274,3057,0.491004252535165,0,0,300,595,23,288,20,116,10,20
"619","2020-03-26",67,8,184,304,3057,0.491004252535165,0,0,300,595,37,325,8,124,26,8
"620","2020-03-27",69,8,192,323,3057,0.491004252535165,0,0,300,595,28,353,11,135,12,11
"621","2020-03-28",77,8,198,337,3057,0.491004252535165,0,0,300,595,30,383,19,154,20,19
"622","2020-03-29",85,8,198,359,3057,0.491004252535165,0,0,300,595,23,406,20,174,10,20
"623","2020-03-30",87,8,196,379,3057,0.491004252535165,0,0,300,595,33,439,15,189,20,15
"624","2020-03-31",92,8,197,407,3057,0.491004252535165,0,0,300,595,33,472,14,203,19,14
"625","2020-04-01",88,8,205,421,3057,0.491004252535165,0,0,300,595,20,492,13,216,8,13
"626","2020-04-02",102,8,220,433,3057,0.491004252535165,0,0,300,595,26,518,15,231,15,15
"627","2020-04-03",106,8,201,462,3057,0.491004252535165,0,0,300,595,29,547,32,263,18,32
"628","2020-04-04",107,8,187,475,3057,0.491004252535165,0,0,300,595,30,577,21,284,15,21
"629","2020-04-05",111,8,216,498,3057,0.491004252535165,0,0,300,595,38,615,20,304,19,20
"630","2020-04-06",122,8,218,499,3057,0.491004252535165,0,0,300,595,26,641,24,328,16,24
"631","2020-04-07",117,8,223,495,3057,0.491004252535165,0,0,300,595,24,665,19,347,12,19
"632","2020-04-08",127,8,209,500,3057,0.491004252535165,0,0,300,595,49,714,19,366,24,19
"633","2020-04-09",130,8,206,511,3057,0.491004252535165,0,0,300,595,29,743,20,386,7,20
"634","2020-04-10",142,8,208,505,3057,0.491004252535165,0,0,300,595,26,769,23,409,14,23
"635","2020-04-11",148,8,206,498,3057,0.491004252535165,0,0,300,595,36,805,14,423,17,14
"636","2020-04-12",144,8,179,504,3057,0.491004252535165,0,0,300,595,24,829,18,441,9,18
"637","2020-04-13",141,8,158,498,3057,0.491004252535165,0,0,300,595,32,861,20,461,14,20
"638","2020-04-14",146,8,168,495,3057,0.491004252535165,0,0,300,595,39,900,6,467,17,6
"639","2020-04-15",146,8,201,490,3057,0.491004252535165,0,0,300,595,39,939,18,485,19,18
"640","2020-04-16",163,8,222,488,3057,0.491004252535165,0,0,300,595,33,972,18,503,17,18
"641","2020-04-17",155,8,244,489,3057,0.491004252535165,0,0,300,595,31,1003,9,512,15,9
"642","2020-04-18",155,8,259,490,3057,0.491004252535165,0,0,300,595,33,1036,5,517,13,5
"643","2020-04-19",156,8,248,504,3057,0.491004252535165,0,0,300,595,33,1069,6,523,15,6
"644","2020-04-20",150,8,232,505,3057,0.491004252535165,0,0,300,595,28,1097,9,532,10,9
"645","2020-04-21",152,8,241,481,3057,0.491004252535165,0,0,300,595,33,1130,18,550,16,18
"646","2020-04-22",152,8,247,473,3057,0.491004252535165,0,0,300,595,20,1150,16,566,4,16
"647","2020-04-23",131,8,255,477,3057,0.491004252535165,0,0,300,595,33,1183,15,581,15,15
"648","2020-04-24",137,8,244,452,3057,0.491004252535165,0,0,300,595,32,1215,17,598,14,17
"649","2020-04-25",135,8,255,454,3057,0.491004252535165,0,0,300,595,34,1249,19,617,16,19
"650","2020-04-26",139,8,260,458,3057,0.491004252535165,0,0,300,595,28,1277,18,635,10,18
"651","2020-04-27",147,8,288,450,3057,0.491004252535165,0,0,300,595,24,1301,9,644,6,9
"652","2020-04-28",152,8,287,474,3057,0.491004252535165,0,0,300,595,34,1335,6,650,14,6
"653","2020-04-29",155,8,288,456,3057,0.491004252535165,0,0,300,595,30,1365,5,655,11,5
"654","2020-04-30",155,8,274,446,3057,0.491004252535165,0,0,300,595,31,1396,10,665,11,10
"655","2020-05-01",143,8,268,428,3057,0.491004252535165,0,0,300,595,27,1423,7,672,14,7
"656","2020-05-02",140,8,270,439,3057,0.491004252535165,0,0,300,595,34,1457,6,678,16,6
"657","2020-05-03",142,8,291,429,3057,0.491004252535165,0,0,300,595,29,1486,11,689,13,11
"658","2020-05-04",131,8,281,425,3057,0.491004252535165,0,0,300,595,31,1517,13,702,16,13
"659","2020-05-05",127,8,288,414,3057,0.491004252535165,0,0,300,595,30,1547,11,713,11,11
"660","2020-05-06",118,8,279,399,3057,0.491004252535165,0,0,300,595,19,1566,12,725,6,12
"661","2020-05-07",120,8,300,402,3057,0.491004252535165,0,0,300,595,39,1605,15,740,20,15
"662","2020-05-08",120,8,274,395,3057,0.491004252535165,0,0,300,595,25,1630,25,765,8,25
"663","2020-05-09",113,8,251,378,3057,0.491004252535165,0,0,300,595,26,1656,24,789,16,24
"664","2020-05-10",102,8,237,368,3057,0.491004252535165,0,0,300,595,28,1684,13,802,14,13
"665","2020-05-11",103,8,221,375,3057,0.491004252535165,0,0,300,595,25,1709,18,820,13,18
"666","2020-05-12",102,8,226,356,3057,0.491004252535165,0,0,300,595,17,1726,20,840,9,20
"667","2020-05-13",99,8,217,356,3057,0.491004252535165,0,0,300,595,24,1750,25,865,13,25
"668","2020-05-14",98,8,211,354,3057,0.491004252535165,0,0,300,595,18,1768,21,886,10,21
"669","2020-05-15",102,8,215,346,3057,0.491004252535165,0,0,300,595,26,1794,31,917,11,31
"670","2020-05-16",106,8,205,341,3057,0.491004252535165,0,0,300,595,19,1813,16,933,8,16
"671","2020-05-17",111,8,220,348,3057,0.491004252535165,0,0,300,595,18,1831,11,944,7,11
"672","2020-05-18",114,8,231,349,3057,0.491004252535165,0,0,300,595,18,1849,6,950,6,6
"673","2020-05-19",103,8,222,349,3057,0.491004252535165,0,0,300,595,18,1867,7,957,6,7
"674","2020-05-20",104,8,245,362,3057,0.491004252535165,0,0,300,595,18,1885,17,974,7,17
"675","2020-05-21",91,8,242,366,3057,0.491004252535165,0,0,300,595,27,1912,13,987,13,13
"676","2020-05-22",98,8,249,348,3057,0.491004252535165,0,0,300,595,16,1928,28,1015,7,28
"677","2020-05-23",94,8,249,332,3057,0.491004252535165,0,0,300,595,19,1947,12,1027,5,12
"678","2020-05-24",99,8,247,336,3057,0.491004252535165,0,0,300,595,14,1961,34,1061,9,34
"679","2020-05-25",92,8,266,327,3057,0.491004252535165,0,0,300,595,11,1972,30,1091,6,30
"680","2020-05-26",97,8,285,303,3057,0.491004252535165,0,0,300,595,21,1993,21,1112,10,21
"681","2020-05-27",100,8,276,299,3057,0.491004252535165,0,0,300,595,13,2006,15,1127,4,15
"682","2020-05-28",106,8,275,295,3057,0.491004252535165,0,0,300,595,18,2024,19,1146,7,19
"683","2020-05-29",101,8,271,281,3057,0.491004252535165,0,0,300,595,14,2038,14,1160,4,14
"684","2020-05-30",98,8,251,271,3057,0.491004252535165,0,0,300,595,13,2051,7,1167,4,7
"685","2020-05-31",93,8,243,267,3057,0.491004252535165,0,0,300,595,6,2057,5,1172,5,5
"686","2020-06-01",87,8,234,267,3057,0.491004252535165,0,0,300,595,13,2070,4,1176,6,4
"687","2020-06-02",84,8,243,264,3057,0.491004252535165,0,0,300,595,18,2088,1,1177,6,1
"688","2020-06-03",79,8,244,242,3057,0.491004252535165,0,0,300,595,13,2101,14,1191,9,14
"689","2020-06-04",78,8,231,233,3057,0.491004252535165,0,0,300,595,19,2120,5,1196,9,5
"690","2020-06-05",72,8,217,223,3057,0.491004252535165,0,0,300,595,14,2134,7,1203,8,7
"691","2020-06-06",74,8,216,214,3057,0.491004252535165,0,0,300,595,9,2143,10,1213,8,10
"692","2020-06-07",61,8,226,207,3057,0.491004252535165,0,0,300,595,11,2154,6,1219,6,6
"693","2020-03-14",1,9,54,22,7142,0.974516942033044,0,0,648,478,6,19,6,29,2,6
"694","2020-03-15",2,9,63,35,7142,0.974516942033044,0,0,648,478,8,27,3,32,7,3
"695","2020-03-16",5,9,71,49,7142,0.974516942033044,0,0,648,478,3,30,3,35,2,3
"696","2020-03-17",6,9,61,64,7142,0.974516942033044,0,0,648,478,9,39,5,40,7,5
"697","2020-03-18",8,9,60,82,7142,0.974516942033044,0,0,648,478,10,49,6,46,7,6
"698","2020-03-19",11,9,59,102,7142,0.974516942033044,0,0,648,478,13,62,14,60,11,14
"699","2020-03-20",16,9,53,119,7142,0.974516942033044,0,0,648,478,13,75,12,72,12,12
"700","2020-03-21",18,9,63,142,7142,0.974516942033044,0,0,648,478,18,93,11,83,16,11
"701","2020-03-22",22,9,76,175,7142,0.974516942033044,0,0,648,478,21,114,6,89,19,6
"702","2020-03-23",27,9,67,204,7142,0.974516942033044,0,0,648,478,17,131,7,96,13,7
"703","2020-03-24",34,9,73,228,7142,0.974516942033044,0,0,648,478,17,148,15,111,14,15
"704","2020-03-25",41,9,80,283,7142,0.974516942033044,0,0,648,478,30,178,9,120,24,9
"705","2020-03-26",47,9,99,328,7142,0.974516942033044,0,0,648,478,32,210,1,121,30,1
"706","2020-03-27",56,9,90,412,7142,0.974516942033044,0,0,648,478,20,230,23,144,19,23
"707","2020-03-28",66,9,99,489,7142,0.974516942033044,0,0,648,478,41,271,31,175,38,31
"708","2020-03-29",71,9,108,581,7142,0.974516942033044,0,0,648,478,30,301,23,198,27,23
"709","2020-03-30",87,9,102,683,7142,0.974516942033044,0,0,648,478,39,340,5,203,36,5
"710","2020-03-31",109,9,112,785,7142,0.974516942033044,0,0,648,478,37,377,7,210,31,7
"711","2020-04-01",128,9,112,945,7142,0.974516942033044,0,0,648,478,41,418,27,237,35,27
"712","2020-04-02",150,9,96,1067,7142,0.974516942033044,0,0,648,478,40,458,11,248,39,11
"713","2020-04-03",179,9,90,1242,7142,0.974516942033044,0,0,648,478,45,503,16,264,41,16
"714","2020-04-04",213,9,100,1418,7142,0.974516942033044,0,0,648,478,52,555,14,278,46,14
"715","2020-04-05",255,9,97,1659,7142,0.974516942033044,0,0,648,478,49,604,16,294,46,16
"716","2020-04-06",296,9,118,1838,7142,0.974516942033044,0,0,648,478,47,651,20,314,45,20
"717","2020-04-07",322,9,122,2034,7142,0.974516942033044,0,0,648,478,66,717,37,351,62,37
"718","2020-04-08",386,9,140,2222,7142,0.974516942033044,0,0,648,478,52,769,21,372,50,21
"719","2020-04-09",441,9,136,2404,7142,0.974516942033044,0,0,648,478,69,838,29,401,66,29
"720","2020-04-10",496,9,117,2617,7142,0.974516942033044,0,0,648,478,56,894,21,422,53,21
"721","2020-04-11",565,9,108,2830,7142,0.974516942033044,0,0,648,478,83,977,23,445,80,23
"722","2020-04-12",618,9,109,2987,7142,0.974516942033044,0,0,648,478,72,1049,12,457,68,12
"723","2020-04-13",674,9,104,3113,7142,0.974516942033044,0,0,648,478,65,1114,19,476,59,19
"724","2020-04-14",717,9,111,3216,7142,0.974516942033044,0,0,648,478,55,1169,43,519,49,43
"725","2020-04-15",761,9,113,3208,7142,0.974516942033044,0,0,648,478,67,1236,31,550,63,31
"726","2020-04-16",821,9,110,3264,7142,0.974516942033044,0,0,648,478,86,1322,22,572,83,22
"727","2020-04-17",860,9,106,3246,7142,0.974516942033044,0,0,648,478,91,1413,13,585,84,13
"728","2020-04-18",872,9,97,3153,7142,0.974516942033044,0,0,648,478,102,1515,6,591,96,6
"729","2020-04-19",908,9,85,3077,7142,0.974516942033044,0,0,648,478,72,1587,17,608,69,17
"730","2020-04-20",927,9,78,2902,7142,0.974516942033044,0,0,648,478,71,1658,24,632,70,24
"731","2020-04-21",960,9,64,2737,7142,0.974516942033044,0,0,648,478,89,1747,23,655,86,23
"732","2020-04-22",940,9,63,2526,7142,0.974516942033044,0,0,648,478,65,1812,15,670,61,15
"733","2020-04-23",914,9,69,2334,7142,0.974516942033044,0,0,648,478,81,1893,9,679,79,9
"734","2020-04-24",886,9,80,2118,7142,0.974516942033044,0,0,648,478,85,1978,20,699,82,20
"735","2020-04-25",839,9,111,1889,7142,0.974516942033044,0,0,648,478,90,2068,26,725,87,26
"736","2020-04-26",778,9,109,1646,7142,0.974516942033044,0,0,648,478,64,2132,39,764,60,39
"737","2020-04-27",705,9,120,1437,7142,0.974516942033044,0,0,648,478,96,2228,24,788,93,24
"738","2020-04-28",621,9,112,1268,7142,0.974516942033044,0,0,648,478,71,2299,15,803,68,15
"739","2020-04-29",551,9,106,1085,7142,0.974516942033044,0,0,648,478,79,2378,34,837,78,34
"740","2020-04-30",469,9,110,909,7142,0.974516942033044,0,0,648,478,76,2454,15,852,70,15
"741","2020-05-01",389,9,87,767,7142,0.974516942033044,0,0,648,478,66,2520,21,873,63,21
"742","2020-05-02",344,9,113,644,7142,0.974516942033044,0,0,648,478,92,2612,34,907,90,34
"743","2020-05-03",286,9,107,531,7142,0.974516942033044,0,0,648,478,50,2662,15,922,47,15
"744","2020-05-04",240,9,94,444,7142,0.974516942033044,0,0,648,478,54,2716,22,944,52,22
"745","2020-05-05",207,9,87,383,7142,0.974516942033044,0,0,648,478,63,2779,48,992,62,48
"746","2020-05-06",181,9,75,319,7142,0.974516942033044,0,0,648,478,37,2816,54,1046,35,54
"747","2020-05-07",154,9,79,255,7142,0.974516942033044,0,0,648,478,59,2875,36,1082,55,36
"748","2020-05-08",132,9,84,224,7142,0.974516942033044,0,0,648,478,62,2937,19,1101,61,19
"749","2020-05-09",104,9,89,191,7142,0.974516942033044,0,0,648,478,42,2979,16,1117,41,16
"750","2020-05-10",87,9,76,160,7142,0.974516942033044,0,0,648,478,46,3025,9,1126,41,9
"751","2020-05-11",74,9,91,139,7142,0.974516942033044,0,0,648,478,46,3071,12,1138,45,12
"752","2020-05-12",62,9,90,117,7142,0.974516942033044,0,0,648,478,60,3131,6,1144,59,6
"753","2020-05-13",49,9,97,98,7142,0.974516942033044,0,0,648,478,28,3159,33,1177,27,33
"754","2020-05-14",41,9,92,82,7142,0.974516942033044,0,0,648,478,38,3197,37,1214,36,37
"755","2020-05-15",41,9,100,70,7142,0.974516942033044,0,0,648,478,36,3233,22,1236,35,22
"756","2020-05-16",37,9,103,64,7142,0.974516942033044,0,0,648,478,53,3286,48,1284,52,48
"757","2020-05-17",34,9,112,54,7142,0.974516942033044,0,0,648,478,37,3323,30,1314,37,30
"758","2020-05-18",27,9,94,43,7142,0.974516942033044,0,0,648,478,37,3360,19,1333,34,19
"759","2020-05-19",25,9,81,38,7142,0.974516942033044,0,0,648,478,37,3397,17,1350,34,17
"760","2020-05-20",19,9,79,36,7142,0.974516942033044,0,0,648,478,43,3440,12,1362,42,12
"761","2020-05-21",18,9,95,30,7142,0.974516942033044,0,0,648,478,28,3468,31,1393,27,31
"762","2020-05-22",11,9,105,22,7142,0.974516942033044,0,0,648,478,34,3502,40,1433,30,40
"763","2020-05-23",8,9,103,25,7142,0.974516942033044,0,0,648,478,28,3530,40,1473,28,40
"764","2020-05-24",9,9,97,23,7142,0.974516942033044,0,0,648,478,43,3573,27,1500,39,27
"765","2020-05-25",8,9,117,23,7142,0.974516942033044,0,0,648,478,25,3598,31,1531,24,31
"766","2020-05-26",9,9,110,24,7142,0.974516942033044,0,0,648,478,23,3621,24,1555,23,24
"767","2020-05-27",11,9,124,22,7142,0.974516942033044,0,0,648,478,30,3651,25,1580,26,25
"768","2020-05-28",9,9,108,22,7142,0.974516942033044,0,0,648,478,38,3689,15,1595,36,15
"769","2020-05-29",9,9,108,22,7142,0.974516942033044,0,0,648,478,32,3721,26,1621,31,26
"770","2020-05-30",8,9,115,21,7142,0.974516942033044,0,0,648,478,18,3739,17,1638,17,17
"771","2020-05-31",6,9,123,19,7142,0.974516942033044,0,0,648,478,31,3770,7,1645,27,7
"772","2020-06-01",7,9,124,18,7142,0.974516942033044,0,0,648,478,26,3796,7,1652,26,7
"773","2020-06-02",5,9,120,21,7142,0.974516942033044,0,0,648,478,23,3819,10,1662,23,10
"774","2020-06-03",2,9,105,21,7142,0.974516942033044,0,0,648,478,29,3848,20,1682,26,20
"775","2020-06-04",2,9,88,19,7142,0.974516942033044,0,0,648,478,23,3871,10,1692,21,10
"776","2020-06-05",2,9,87,18,7142,0.974516942033044,0,0,648,478,18,3889,8,1700,18,8
"777","2020-06-06",2,9,74,15,7142,0.974516942033044,0,0,648,478,22,3911,8,1708,21,8
"778","2020-06-07",1,9,77,17,7142,0.974516942033044,0,0,648,478,23,3934,7,1715,23,7
"779","2020-03-15",1,10,56,19,1242,0.702898550724638,0,0,93,421,13,66,7,30,8,7
"780","2020-03-16",1,10,55,27,1242,0.702898550724638,0,0,93,421,22,88,8,38,10,8
"781","2020-03-17",4,10,52,35,1242,0.702898550724638,0,0,93,421,16,104,3,41,9,3
"782","2020-03-18",6,10,73,40,1242,0.702898550724638,0,0,93,421,18,122,7,48,13,7
"783","2020-03-19",6,10,75,43,1242,0.702898550724638,0,0,93,421,34,156,6,54,20,6
"784","2020-03-20",10,10,84,48,1242,0.702898550724638,0,0,93,421,32,188,4,58,17,4
"785","2020-03-21",11,10,82,56,1242,0.702898550724638,0,0,93,421,26,214,6,64,15,6
"786","2020-03-22",12,10,73,58,1242,0.702898550724638,0,0,93,421,35,249,6,70,22,6
"787","2020-03-23",13,10,62,65,1242,0.702898550724638,0,0,93,421,38,287,10,80,28,10
"788","2020-03-24",12,10,67,70,1242,0.702898550724638,0,0,93,421,33,320,5,85,21,5
"789","2020-03-25",14,10,69,75,1242,0.702898550724638,0,0,93,421,36,356,12,97,26,12
"790","2020-03-26",20,10,77,80,1242,0.702898550724638,0,0,93,421,42,398,10,107,31,10
"791","2020-03-27",16,10,85,84,1242,0.702898550724638,0,0,93,421,40,438,2,109,25,2
"792","2020-03-28",18,10,83,88,1242,0.702898550724638,0,0,93,421,40,478,5,114,32,5
"793","2020-03-29",20,10,82,87,1242,0.702898550724638,0,0,93,421,60,538,13,127,45,13
"794","2020-03-30",24,10,78,95,1242,0.702898550724638,0,0,93,421,68,606,15,142,51,15
"795","2020-03-31",26,10,67,105,1242,0.702898550724638,0,0,93,421,45,651,7,149,31,7
"796","2020-04-01",22,10,66,103,1242,0.702898550724638,0,0,93,421,63,714,8,157,52,8
"797","2020-04-02",20,10,64,108,1242,0.702898550724638,0,0,93,421,71,785,3,160,54,3
"798","2020-04-03",22,10,66,119,1242,0.702898550724638,0,0,93,421,62,847,3,163,49,3
"799","2020-04-04",20,10,63,129,1242,0.702898550724638,0,0,93,421,44,891,6,169,37,6
"800","2020-04-05",24,10,60,139,1242,0.702898550724638,0,0,93,421,55,946,7,176,39,7
"801","2020-04-06",24,10,70,151,1242,0.702898550724638,0,0,93,421,76,1022,8,184,63,8
"802","2020-04-07",27,10,78,161,1242,0.702898550724638,0,0,93,421,71,1093,7,191,59,7
"803","2020-04-08",34,10,86,176,1242,0.702898550724638,0,0,93,421,66,1159,13,204,52,13
"804","2020-04-09",31,10,93,184,1242,0.702898550724638,0,0,93,421,61,1220,11,215,50,11
"805","2020-04-10",39,10,115,196,1242,0.702898550724638,0,0,93,421,79,1299,16,231,59,16
"806","2020-04-11",42,10,102,194,1242,0.702898550724638,0,0,93,421,58,1357,17,248,48,17
"807","2020-04-12",45,10,99,194,1242,0.702898550724638,0,0,93,421,78,1435,15,263,60,15
"808","2020-04-13",46,10,94,206,1242,0.702898550724638,0,0,93,421,72,1507,24,287,63,24
"809","2020-04-14",50,10,100,224,1242,0.702898550724638,0,0,93,421,69,1576,8,295,52,8
"810","2020-04-15",46,10,109,228,1242,0.702898550724638,0,0,93,421,78,1654,16,311,68,16
"811","2020-04-16",49,10,95,226,1242,0.702898550724638,0,0,93,421,76,1730,11,322,64,11
"812","2020-04-17",51,10,101,230,1242,0.702898550724638,0,0,93,421,64,1794,6,328,53,6
"813","2020-04-18",60,10,116,229,1242,0.702898550724638,0,0,93,421,61,1855,1,329,48,1
"814","2020-04-19",55,10,121,227,1242,0.702898550724638,0,0,93,421,67,1922,8,337,50,8
"815","2020-04-20",58,10,117,226,1242,0.702898550724638,0,0,93,421,71,1993,14,351,57,14
"816","2020-04-21",55,10,106,221,1242,0.702898550724638,0,0,93,421,56,2049,16,367,45,16
"817","2020-04-22",63,10,132,221,1242,0.702898550724638,0,0,93,421,56,2105,18,385,44,18
"818","2020-04-23",70,10,143,225,1242,0.702898550724638,0,0,93,421,65,2170,12,397,50,12
"819","2020-04-24",68,10,148,217,1242,0.702898550724638,0,0,93,421,40,2210,12,409,31,12
"820","2020-04-25",61,10,157,208,1242,0.702898550724638,0,0,93,421,60,2270,12,421,48,12
"821","2020-04-26",66,10,150,204,1242,0.702898550724638,0,0,93,421,60,2330,12,433,49,12
"822","2020-04-27",62,10,168,193,1242,0.702898550724638,0,0,93,421,51,2381,9,442,35,9
"823","2020-04-28",64,10,157,177,1242,0.702898550724638,0,0,93,421,51,2432,9,451,45,9
"824","2020-04-29",62,10,144,175,1242,0.702898550724638,0,0,93,421,39,2471,6,457,27,6
"825","2020-04-30",59,10,131,182,1242,0.702898550724638,0,0,93,421,52,2523,22,479,41,22
"826","2020-05-01",56,10,138,184,1242,0.702898550724638,0,0,93,421,53,2576,22,501,41,22
"827","2020-05-02",57,10,159,190,1242,0.702898550724638,0,0,93,421,49,2625,32,533,41,32
"828","2020-05-03",52,10,165,183,1242,0.702898550724638,0,0,93,421,40,2665,19,552,32,19
"829","2020-05-04",57,10,137,173,1242,0.702898550724638,0,0,93,421,45,2710,20,572,34,20
"830","2020-05-05",54,10,123,177,1242,0.702898550724638,0,0,93,421,45,2755,20,592,37,20
"831","2020-05-06",52,10,119,172,1242,0.702898550724638,0,0,93,421,52,2807,13,605,40,13
"832","2020-05-07",54,10,116,174,1242,0.702898550724638,0,0,93,421,39,2846,25,630,32,25
"833","2020-05-08",54,10,117,165,1242,0.702898550724638,0,0,93,421,38,2884,34,664,31,34
"834","2020-05-09",51,10,126,167,1242,0.702898550724638,0,0,93,421,50,2934,20,684,44,20
"835","2020-05-10",52,10,146,163,1242,0.702898550724638,0,0,93,421,24,2958,13,697,15,13
"836","2020-05-11",48,10,149,166,1242,0.702898550724638,0,0,93,421,42,3000,12,709,28,12
"837","2020-05-12",47,10,146,155,1242,0.702898550724638,0,0,93,421,30,3030,16,725,22,16
"838","2020-05-13",49,10,158,151,1242,0.702898550724638,0,0,93,421,25,3055,22,747,20,22
"839","2020-05-14",45,10,170,144,1242,0.702898550724638,0,0,93,421,36,3091,9,756,22,9
"840","2020-05-15",41,10,155,129,1242,0.702898550724638,0,0,93,421,41,3132,9,765,28,9
"841","2020-05-16",39,10,149,121,1242,0.702898550724638,0,0,93,421,34,3166,6,771,24,6
"842","2020-05-17",35,10,140,124,1242,0.702898550724638,0,0,93,421,36,3202,9,780,29,9
"843","2020-05-18",33,10,138,120,1242,0.702898550724638,0,0,93,421,24,3226,5,785,21,5
"844","2020-05-19",35,10,146,123,1242,0.702898550724638,0,0,93,421,37,3263,4,789,28,4
"845","2020-05-20",30,10,129,119,1242,0.702898550724638,0,0,93,421,30,3293,5,794,20,5
"846","2020-05-21",29,10,110,125,1242,0.702898550724638,0,0,93,421,26,3319,19,813,22,19
"847","2020-05-22",31,10,94,126,1242,0.702898550724638,0,0,93,421,30,3349,8,821,26,8
"848","2020-05-23",34,10,76,128,1242,0.702898550724638,0,0,93,421,32,3381,16,837,25,16
"849","2020-05-24",34,10,68,127,1242,0.702898550724638,0,0,93,421,23,3404,13,850,16,13
"850","2020-05-25",32,10,71,131,1242,0.702898550724638,0,0,93,421,23,3427,12,862,15,12
"851","2020-05-26",28,10,64,135,1242,0.702898550724638,0,0,93,421,14,3441,12,874,10,12
"852","2020-05-27",26,10,51,139,1242,0.702898550724638,0,0,93,421,21,3462,4,878,15,4
"853","2020-05-28",27,10,45,133,1242,0.702898550724638,0,0,93,421,24,3486,1,879,18,1
"854","2020-05-29",31,10,55,134,1242,0.702898550724638,0,0,93,421,22,3508,5,884,16,5
"855","2020-05-30",34,10,74,141,1242,0.702898550724638,0,0,93,421,26,3534,6,890,22,6
"856","2020-05-31",39,10,68,141,1242,0.702898550724638,0,0,93,421,24,3558,6,896,17,6
"857","2020-06-01",42,10,69,146,1242,0.702898550724638,0,0,93,421,25,3583,5,901,20,5
"858","2020-06-02",46,10,86,141,1242,0.702898550724638,0,0,93,421,21,3604,NA,NA,15,NA
"859","2020-06-03",47,10,74,146,1242,0.702898550724638,0,0,93,421,21,3625,4,905,13,4
"860","2020-06-04",46,10,74,148,1242,0.702898550724638,0,0,93,421,17,3642,9,914,15,9
"861","2020-06-05",42,10,66,146,1242,0.702898550724638,0,0,93,421,25,3667,15,929,17,15
"862","2020-06-06",39,10,69,147,1242,0.702898550724638,0,0,93,421,20,3687,8,937,15,8
"863","2020-06-07",36,10,75,149,1242,0.702898550724638,0,0,93,421,12,3699,6,943,12,6
"864","2020-03-15",4,11,45,66,3329,0.609492340042055,0,0,302,435,26,104,18,67,10,18
"865","2020-03-16",5,11,49,85,3329,0.609492340042055,0,0,302,435,25,129,29,96,8,29
"866","2020-03-17",11,11,60,106,3329,0.609492340042055,0,0,302,435,32,161,28,124,15,28
"867","2020-03-18",14,11,59,127,3329,0.609492340042055,0,0,302,435,35,196,36,160,12,36
"868","2020-03-19",18,11,58,150,3329,0.609492340042055,0,0,302,435,31,227,27,187,15,27
"869","2020-03-20",20,11,51,175,3329,0.609492340042055,0,0,302,435,53,280,24,211,35,24
"870","2020-03-21",26,11,46,205,3329,0.609492340042055,0,0,302,435,44,324,31,242,22,31
"871","2020-03-22",30,11,51,232,3329,0.609492340042055,0,0,302,435,47,371,49,291,26,49
"872","2020-03-23",36,11,47,252,3329,0.609492340042055,0,0,302,435,48,419,37,328,24,37
"873","2020-03-24",36,11,38,287,3329,0.609492340042055,0,0,302,435,50,469,33,361,26,33
"874","2020-03-25",45,11,29,313,3329,0.609492340042055,0,0,302,435,41,510,31,392,28,31
"875","2020-03-26",52,11,48,361,3329,0.609492340042055,0,0,302,435,42,552,22,414,23,22
"876","2020-03-27",67,11,41,394,3329,0.609492340042055,0,0,302,435,56,608,29,443,32,29
"877","2020-03-28",72,11,44,426,3329,0.609492340042055,0,0,302,435,39,647,28,471,24,28
"878","2020-03-29",79,11,45,466,3329,0.609492340042055,0,0,302,435,42,689,18,489,30,18
"879","2020-03-30",94,11,43,502,3329,0.609492340042055,0,0,302,435,51,740,23,512,30,23
"880","2020-03-31",108,11,57,528,3329,0.609492340042055,0,0,302,435,46,786,31,543,21,31
"881","2020-04-01",109,11,58,564,3329,0.609492340042055,0,0,302,435,50,836,32,575,31,32
"882","2020-04-02",125,11,48,594,3329,0.609492340042055,0,0,302,435,40,876,40,615,23,40
"883","2020-04-03",127,11,60,608,3329,0.609492340042055,0,0,302,435,59,935,27,642,30,27
"884","2020-04-04",151,11,74,613,3329,0.609492340042055,0,0,302,435,47,982,46,688,30,46
"885","2020-04-05",160,11,74,645,3329,0.609492340042055,0,0,302,435,42,1024,34,722,24,34
"886","2020-04-06",157,11,74,656,3329,0.609492340042055,0,0,302,435,40,1064,32,754,21,32
"887","2020-04-07",167,11,75,658,3329,0.609492340042055,0,0,302,435,58,1122,22,776,30,22
"888","2020-04-08",183,11,69,652,3329,0.609492340042055,0,0,302,435,69,1191,39,815,40,39
"889","2020-04-09",180,11,74,652,3329,0.609492340042055,0,0,302,435,50,1241,57,872,28,57
"890","2020-04-10",200,11,68,624,3329,0.609492340042055,0,0,302,435,45,1286,41,913,22,41
"891","2020-04-11",195,11,69,612,3329,0.609492340042055,0,0,302,435,49,1335,62,975,26,62
"892","2020-04-12",192,11,66,616,3329,0.609492340042055,0,0,302,435,59,1394,49,1024,26,49
"893","2020-04-13",199,11,64,624,3329,0.609492340042055,0,0,302,435,45,1439,46,1070,25,46
"894","2020-04-14",195,11,80,647,3329,0.609492340042055,0,0,302,435,44,1483,52,1122,21,52
"895","2020-04-15",196,11,103,641,3329,0.609492340042055,0,0,302,435,59,1542,46,1168,29,46
"896","2020-04-16",208,11,120,650,3329,0.609492340042055,0,0,302,435,62,1604,57,1225,38,57
"897","2020-04-17",190,11,101,639,3329,0.609492340042055,0,0,302,435,50,1654,44,1269,22,44
"898","2020-04-18",183,11,129,633,3329,0.609492340042055,0,0,302,435,55,1709,41,1310,21,41
"899","2020-04-19",176,11,129,623,3329,0.609492340042055,0,0,302,435,46,1755,28,1338,24,28
"900","2020-04-20",178,11,111,629,3329,0.609492340042055,0,0,302,435,43,1798,34,1372,23,34
"901","2020-04-21",186,11,126,628,3329,0.609492340042055,0,0,302,435,51,1849,20,1392,27,20
"902","2020-04-22",187,11,123,614,3329,0.609492340042055,0,0,302,435,55,1904,36,1428,34,36
"903","2020-04-23",177,11,115,607,3329,0.609492340042055,0,0,302,435,59,1963,59,1487,31,59
"904","2020-04-24",180,11,109,616,3329,0.609492340042055,0,0,302,435,44,2007,33,1520,17,33
"905","2020-04-25",184,11,92,594,3329,0.609492340042055,0,0,302,435,55,2062,43,1563,32,43
"906","2020-04-26",193,11,91,567,3329,0.609492340042055,0,0,302,435,59,2121,28,1591,34,28
"907","2020-04-27",185,11,79,556,3329,0.609492340042055,0,0,302,435,42,2163,31,1622,21,31
"908","2020-04-28",173,11,99,550,3329,0.609492340042055,0,0,302,435,36,2199,31,1653,22,31
"909","2020-04-29",164,11,98,558,3329,0.609492340042055,0,0,302,435,44,2243,35,1688,24,35
"910","2020-04-30",167,11,102,540,3329,0.609492340042055,0,0,302,435,35,2278,31,1719,14,31
"911","2020-05-01",169,11,110,522,3329,0.609492340042055,0,0,302,435,50,2328,37,1756,22,37
"912","2020-05-02",161,11,105,500,3329,0.609492340042055,0,0,302,435,51,2379,26,1782,26,26
"913","2020-05-03",164,11,122,486,3329,0.609492340042055,0,0,302,435,52,2431,57,1839,23,57
"914","2020-05-04",165,11,122,472,3329,0.609492340042055,0,0,302,435,49,2480,35,1874,30,35
"915","2020-05-05",167,11,116,464,3329,0.609492340042055,0,0,302,435,51,2531,36,1910,27,36
"916","2020-05-06",158,11,111,451,3329,0.609492340042055,0,0,302,435,48,2579,45,1955,28,45
"917","2020-05-07",142,11,118,428,3329,0.609492340042055,0,0,302,435,51,2630,33,1988,27,33
"918","2020-05-08",137,11,139,417,3329,0.609492340042055,0,0,302,435,43,2673,50,2038,19,50
"919","2020-05-09",134,11,164,399,3329,0.609492340042055,0,0,302,435,44,2717,39,2077,20,39
"920","2020-05-10",125,11,190,392,3329,0.609492340042055,0,0,302,435,45,2762,46,2123,20,46
"921","2020-05-11",116,11,196,361,3329,0.609492340042055,0,0,302,435,52,2814,39,2162,27,39
"922","2020-05-12",107,11,189,339,3329,0.609492340042055,0,0,302,435,33,2847,51,2213,17,51
"923","2020-05-13",108,11,183,315,3329,0.609492340042055,0,0,302,435,54,2901,47,2260,32,47
"924","2020-05-14",109,11,160,286,3329,0.609492340042055,0,0,302,435,34,2935,50,2310,15,50
"925","2020-05-15",98,11,132,277,3329,0.609492340042055,0,0,302,435,34,2969,53,2363,17,53
"926","2020-05-16",91,11,107,266,3329,0.609492340042055,0,0,302,435,36,3005,48,2411,16,48
"927","2020-05-17",87,11,126,273,3329,0.609492340042055,0,0,302,435,35,3040,37,2448,18,37
"928","2020-05-18",83,11,128,260,3329,0.609492340042055,0,0,302,435,30,3070,34,2482,16,34
"929","2020-05-19",82,11,137,253,3329,0.609492340042055,0,0,302,435,38,3108,34,2516,19,34
"930","2020-05-20",77,11,122,240,3329,0.609492340042055,0,0,302,435,40,3148,29,2545,18,29
"931","2020-05-21",70,11,121,240,3329,0.609492340042055,0,0,302,435,38,3186,35,2580,26,35
"932","2020-05-22",66,11,134,247,3329,0.609492340042055,0,0,302,435,29,3215,30,2610,15,30
"933","2020-05-23",66,11,124,242,3329,0.609492340042055,0,0,302,435,24,3239,46,2656,17,46
"934","2020-05-24",59,11,113,237,3329,0.609492340042055,0,0,302,435,27,3266,26,2682,18,26
"935","2020-05-25",64,11,98,242,3329,0.609492340042055,0,0,302,435,26,3292,33,2715,13,33
"936","2020-05-26",59,11,123,239,3329,0.609492340042055,0,0,302,435,22,3314,39,2754,11,39
"937","2020-05-27",63,11,121,235,3329,0.609492340042055,0,0,302,435,26,3340,42,2796,14,42
"938","2020-05-28",69,11,114,217,3329,0.609492340042055,0,0,302,435,24,3364,35,2831,14,35
"939","2020-05-29",70,11,99,205,3329,0.609492340042055,0,0,302,435,25,3389,30,2861,10,30
"940","2020-05-30",67,11,101,213,3329,0.609492340042055,0,0,302,435,25,3414,22,2883,16,22
"941","2020-05-31",68,11,93,206,3329,0.609492340042055,0,0,302,435,27,3441,28,2911,14,28
"942","2020-06-01",62,11,89,202,3329,0.609492340042055,0,0,302,435,21,3462,36,2947,15,36
"943","2020-06-02",60,11,88,202,3329,0.609492340042055,0,0,302,435,19,3481,59,3006,11,59
"944","2020-06-03",54,11,92,197,3329,0.609492340042055,0,0,302,435,17,3498,35,3041,12,35
"945","2020-06-04",49,11,95,189,3329,0.609492340042055,0,0,302,435,16,3514,40,3081,11,40
"946","2020-06-05",46,11,92,179,3329,0.609492340042055,0,0,302,435,18,3532,42,3123,10,42
"947","2020-06-06",44,11,102,165,3329,0.609492340042055,0,0,302,435,15,3547,31,3154,8,31
"948","2020-06-07",45,11,101,167,3329,0.609492340042055,0,0,302,435,13,3560,37,3191,10,37
"949","2020-03-16",5,12,30,132,2973,0.424487050117726,0,0,277,378,19,88,4,25,11,4
"950","2020-03-17",12,12,42,169,2973,0.424487050117726,0,0,277,378,13,101,8,33,7,8
"951","2020-03-18",19,12,43,200,2973,0.424487050117726,0,0,277,378,19,120,1,34,12,1
"952","2020-03-19",24,12,47,229,2973,0.424487050117726,0,0,277,378,21,141,5,39,19,5
"953","2020-03-20",27,12,50,256,2973,0.424487050117726,0,0,277,378,24,165,4,43,14,4
"954","2020-03-21",38,12,45,276,2973,0.424487050117726,0,0,277,378,39,204,8,51,27,8
"955","2020-03-22",54,12,44,290,2973,0.424487050117726,0,0,277,378,19,223,9,60,18,9
"956","2020-03-23",58,12,57,310,2973,0.424487050117726,0,0,277,378,34,257,1,61,23,1
"957","2020-03-24",71,12,59,324,2973,0.424487050117726,0,0,277,378,29,286,2,63,19,2
"958","2020-03-25",75,12,70,322,2973,0.424487050117726,0,0,277,378,44,330,4,67,34,4
"959","2020-03-26",89,12,67,324,2973,0.424487050117726,0,0,277,378,38,368,NA,NA,27,NA
"960","2020-03-27",101,12,84,331,2973,0.424487050117726,0,0,277,378,36,404,14,81,30,14
"961","2020-03-28",104,12,96,351,2973,0.424487050117726,0,0,277,378,35,439,9,90,26,9
"962","2020-03-29",106,12,99,358,2973,0.424487050117726,0,0,277,378,36,475,6,96,24,6
"963","2020-03-30",112,12,108,373,2973,0.424487050117726,0,0,277,378,35,510,15,111,25,15
"964","2020-03-31",104,12,104,382,2973,0.424487050117726,0,0,277,378,49,559,18,129,40,18
"965","2020-04-01",115,12,98,383,2973,0.424487050117726,0,0,277,378,61,620,21,150,46,21
"966","2020-04-02",111,12,87,377,2973,0.424487050117726,0,0,277,378,52,672,8,158,34,8
"967","2020-04-03",106,12,81,393,2973,0.424487050117726,0,0,277,378,56,728,14,172,47,14
"968","2020-04-04",110,12,92,397,2973,0.424487050117726,0,0,277,378,50,778,10,182,40,10
"969","2020-04-05",109,12,96,403,2973,0.424487050117726,0,0,277,378,52,830,26,208,42,26
"970","2020-04-06",111,12,99,415,2973,0.424487050117726,0,0,277,378,45,875,20,228,40,20
"971","2020-04-07",116,12,112,417,2973,0.424487050117726,0,0,277,378,52,927,26,254,40,26
"972","2020-04-08",115,12,101,429,2973,0.424487050117726,0,0,277,378,80,1007,18,272,67,18
"973","2020-04-09",118,12,100,447,2973,0.424487050117726,0,0,277,378,50,1057,21,293,42,21
"974","2020-04-10",132,12,104,480,2973,0.424487050117726,0,0,277,378,64,1121,20,313,48,20
"975","2020-04-11",142,12,115,479,2973,0.424487050117726,0,0,277,378,62,1183,17,330,50,17
"976","2020-04-12",142,12,119,480,2973,0.424487050117726,0,0,277,378,53,1236,16,346,46,16
"977","2020-04-13",146,12,109,486,2973,0.424487050117726,0,0,277,378,74,1310,12,358,64,12
"978","2020-04-14",146,12,103,484,2973,0.424487050117726,0,0,277,378,53,1363,8,366,43,8
"979","2020-04-15",153,12,99,490,2973,0.424487050117726,0,0,277,378,52,1415,9,375,46,9
"980","2020-04-16",153,12,115,492,2973,0.424487050117726,0,0,277,378,66,1481,21,396,51,21
"981","2020-04-17",148,12,104,491,2973,0.424487050117726,0,0,277,378,57,1538,14,410,46,14
"982","2020-04-18",132,12,106,475,2973,0.424487050117726,0,0,277,378,66,1604,27,437,55,27
"983","2020-04-19",125,12,100,477,2973,0.424487050117726,0,0,277,378,62,1666,38,475,52,38
"984","2020-04-20",128,12,100,481,2973,0.424487050117726,0,0,277,378,49,1715,35,510,39,35
"985","2020-04-21",128,12,83,479,2973,0.424487050117726,0,0,277,378,56,1771,34,544,47,34
"986","2020-04-22",117,12,83,477,2973,0.424487050117726,0,0,277,378,46,1817,15,559,38,15
"987","2020-04-23",115,12,86,469,2973,0.424487050117726,0,0,277,378,51,1868,25,584,42,25
"988","2020-04-24",114,12,87,472,2973,0.424487050117726,0,0,277,378,54,1922,25,609,36,25
"989","2020-04-25",120,12,84,461,2973,0.424487050117726,0,0,277,378,53,1975,32,641,45,32
"990","2020-04-26",125,12,84,452,2973,0.424487050117726,0,0,277,378,62,2037,18,659,48,18
"991","2020-04-27",125,12,90,436,2973,0.424487050117726,0,0,277,378,54,2091,18,677,45,18
"992","2020-04-28",124,12,88,425,2973,0.424487050117726,0,0,277,378,55,2146,18,695,45,18
"993","2020-04-29",122,12,81,425,2973,0.424487050117726,0,0,277,378,51,2197,17,712,43,17
"994","2020-04-30",123,12,83,415,2973,0.424487050117726,0,0,277,378,63,2260,16,728,48,16
"995","2020-05-01",125,12,88,425,2973,0.424487050117726,0,0,277,378,36,2296,33,761,28,33
"996","2020-05-02",120,12,95,422,2973,0.424487050117726,0,0,277,378,45,2341,14,775,38,14
"997","2020-05-03",124,12,90,422,2973,0.424487050117726,0,0,277,378,42,2383,6,781,36,6
"998","2020-05-04",116,12,88,416,2973,0.424487050117726,0,0,277,378,48,2431,10,791,40,10
"999","2020-05-05",118,12,98,403,2973,0.424487050117726,0,0,277,378,42,2473,12,803,31,12
"1000","2020-05-06",119,12,113,400,2973,0.424487050117726,0,0,277,378,44,2517,22,825,35,22
"1001","2020-05-07",117,12,130,386,2973,0.424487050117726,0,0,277,378,40,2557,28,853,24,28
"1002","2020-05-08",108,12,119,392,2973,0.424487050117726,0,0,277,378,39,2596,37,890,30,37
"1003","2020-05-09",110,12,111,394,2973,0.424487050117726,0,0,277,378,44,2640,30,920,34,30
"1004","2020-05-10",107,12,123,390,2973,0.424487050117726,0,0,277,378,44,2684,28,948,37,28
"1005","2020-05-11",109,12,124,391,2973,0.424487050117726,0,0,277,378,49,2733,28,976,41,28
"1006","2020-05-12",105,12,121,382,2973,0.424487050117726,0,0,277,378,33,2766,29,1005,27,29
"1007","2020-05-13",111,12,121,386,2973,0.424487050117726,0,0,277,378,35,2801,13,1018,31,13
"1008","2020-05-14",104,12,113,371,2973,0.424487050117726,0,0,277,378,35,2836,18,1036,28,18
"1009","2020-05-15",105,12,111,372,2973,0.424487050117726,0,0,277,378,27,2863,29,1065,19,29
"1010","2020-05-16",104,12,89,375,2973,0.424487050117726,0,0,277,378,28,2891,28,1093,22,28
"1011","2020-05-17",99,12,94,357,2973,0.424487050117726,0,0,277,378,25,2916,19,1112,18,19
"1012","2020-05-18",98,12,90,353,2973,0.424487050117726,0,0,277,378,32,2948,13,1125,21,13
"1013","2020-05-19",96,12,93,355,2973,0.424487050117726,0,0,277,378,22,2970,23,1148,15,23
"1014","2020-05-20",91,12,92,343,2973,0.424487050117726,0,0,277,378,36,3006,19,1167,32,19
"1015","2020-05-21",101,12,96,338,2973,0.424487050117726,0,0,277,378,31,3037,14,1181,26,14
"1016","2020-05-22",103,12,105,340,2973,0.424487050117726,0,0,277,378,19,3056,23,1204,16,23
"1017","2020-05-23",102,12,132,329,2973,0.424487050117726,0,0,277,378,28,3084,15,1219,21,15
"1018","2020-05-24",102,12,134,313,2973,0.424487050117726,0,0,277,378,32,3116,14,1233,27,14
"1019","2020-05-25",91,12,133,289,2973,0.424487050117726,0,0,277,378,29,3145,9,1242,24,9
"1020","2020-05-26",98,12,123,276,2973,0.424487050117726,0,0,277,378,33,3178,20,1262,26,20
"1021","2020-05-27",90,12,124,268,2973,0.424487050117726,0,0,277,378,17,3195,8,1270,13,8
"1022","2020-05-28",80,12,134,263,2973,0.424487050117726,0,0,277,378,19,3214,4,1274,16,4
"1023","2020-05-29",75,12,136,248,2973,0.424487050117726,0,0,277,378,14,3228,11,1285,13,11
"1024","2020-05-30",69,12,126,235,2973,0.424487050117726,0,0,277,378,16,3244,10,1295,12,10
"1025","2020-05-31",70,12,130,232,2973,0.424487050117726,0,0,277,378,25,3269,4,1299,17,4
"1026","2020-06-01",75,12,130,219,2973,0.424487050117726,0,0,277,378,18,3287,11,1310,15,11
"1027","2020-06-02",61,12,122,213,2973,0.424487050117726,0,0,277,378,20,3307,7,1317,15,7
"1028","2020-06-03",63,12,115,197,2973,0.424487050117726,0,0,277,378,21,3328,18,1335,12,18
"1029","2020-06-04",58,12,113,186,2973,0.424487050117726,0,0,277,378,18,3346,12,1347,12,12
"1030","2020-06-05",60,12,114,178,2973,0.424487050117726,0,0,277,378,18,3364,14,1361,16,14
"1031","2020-06-06",59,12,99,171,2973,0.424487050117726,0,0,277,378,17,3381,8,1369,14,8
"1032","2020-06-07",56,12,104,172,2973,0.424487050117726,0,0,277,378,15,3396,7,1376,11,7
"1033","2020-03-15",1,13,19,53,1841,0.706137968495383,0,0,158,309,17,65,3,33,4,3
"1034","2020-03-16",1,13,19,64,1841,0.706137968495383,0,0,158,309,17,82,3,36,2,3
"1035","2020-03-17",5,13,28,80,1841,0.706137968495383,0,0,158,309,19,101,2,38,9,2
"1036","2020-03-18",7,13,39,92,1841,0.706137968495383,0,0,158,309,25,126,5,43,15,5
"1037","2020-03-19",10,13,45,105,1841,0.706137968495383,0,0,158,309,25,151,6,49,13,6
"1038","2020-03-20",16,13,48,125,1841,0.706137968495383,0,0,158,309,18,169,7,56,11,7
"1039","2020-03-21",23,13,42,148,1841,0.706137968495383,0,0,158,309,29,198,8,64,20,8
"1040","2020-03-22",25,13,46,163,1841,0.706137968495383,0,0,158,309,27,225,9,73,14,9
"1041","2020-03-23",35,13,44,179,1841,0.706137968495383,0,0,158,309,25,250,10,83,15,10
"1042","2020-03-24",35,13,52,186,1841,0.706137968495383,0,0,158,309,41,291,13,96,22,13
"1043","2020-03-25",39,13,50,197,1841,0.706137968495383,0,0,158,309,36,327,9,105,25,9
"1044","2020-03-26",47,13,48,210,1841,0.706137968495383,0,0,158,309,42,369,7,112,29,7
"1045","2020-03-27",52,13,50,214,1841,0.706137968495383,0,0,158,309,43,412,7,119,27,7
"1046","2020-03-28",52,13,51,235,1841,0.706137968495383,0,0,158,309,43,455,5,124,32,5
"1047","2020-03-29",53,13,55,236,1841,0.706137968495383,0,0,158,309,48,503,7,131,32,7
"1048","2020-03-30",57,13,49,254,1841,0.706137968495383,0,0,158,309,38,541,5,136,23,5
"1049","2020-03-31",63,13,50,271,1841,0.706137968495383,0,0,158,309,43,584,3,139,29,3
"1050","2020-04-01",66,13,61,281,1841,0.706137968495383,0,0,158,309,50,634,2,141,32,2
"1051","2020-04-02",64,13,72,288,1841,0.706137968495383,0,0,158,309,58,692,6,147,43,6
"1052","2020-04-03",66,13,69,288,1841,0.706137968495383,0,0,158,309,47,739,7,154,30,7
"1053","2020-04-04",75,13,85,286,1841,0.706137968495383,0,0,158,309,55,794,5,159,41,5
"1054","2020-04-05",77,13,95,289,1841,0.706137968495383,0,0,158,309,51,845,7,166,39,7
"1055","2020-04-06",69,13,98,293,1841,0.706137968495383,0,0,158,309,35,880,7,173,22,7
"1056","2020-04-07",68,13,109,288,1841,0.706137968495383,0,0,158,309,49,929,5,178,33,5
"1057","2020-04-08",67,13,110,292,1841,0.706137968495383,0,0,158,309,49,978,7,185,32,7
"1058","2020-04-09",70,13,124,290,1841,0.706137968495383,0,0,158,309,46,1024,12,197,32,12
"1059","2020-04-10",74,13,131,301,1841,0.706137968495383,0,0,158,309,37,1061,10,207,25,10
"1060","2020-04-11",68,13,127,305,1841,0.706137968495383,0,0,158,309,50,1111,15,222,30,15
"1061","2020-04-12",78,13,124,301,1841,0.706137968495383,0,0,158,309,47,1158,10,232,33,10
"1062","2020-04-13",93,13,120,306,1841,0.706137968495383,0,0,158,309,64,1222,9,241,52,9
"1063","2020-04-14",101,13,117,322,1841,0.706137968495383,0,0,158,309,43,1265,4,245,28,4
"1064","2020-04-15",104,13,110,319,1841,0.706137968495383,0,0,158,309,62,1327,9,254,44,9
"1065","2020-04-16",107,13,134,312,1841,0.706137968495383,0,0,158,309,58,1385,7,261,37,7
"1066","2020-04-17",104,13,130,312,1841,0.706137968495383,0,0,158,309,46,1431,7,268,38,7
"1067","2020-04-18",104,13,120,319,1841,0.706137968495383,0,0,158,309,54,1485,10,278,35,10
"1068","2020-04-19",107,13,129,321,1841,0.706137968495383,0,0,158,309,56,1541,7,285,35,7
"1069","2020-04-20",97,13,123,328,1841,0.706137968495383,0,0,158,309,56,1597,17,302,33,17
"1070","2020-04-21",97,13,121,324,1841,0.706137968495383,0,0,158,309,58,1655,11,313,41,11
"1071","2020-04-22",98,13,127,326,1841,0.706137968495383,0,0,158,309,49,1704,13,326,27,13
"1072","2020-04-23",96,13,119,322,1841,0.706137968495383,0,0,158,309,43,1747,26,352,28,26
"1073","2020-04-24",93,13,142,319,1841,0.706137968495383,0,0,158,309,49,1796,11,363,33,11
"1074","2020-04-25",97,13,140,304,1841,0.706137968495383,0,0,158,309,52,1848,16,379,33,16
"1075","2020-04-26",89,13,152,301,1841,0.706137968495383,0,0,158,309,39,1887,11,390,31,11
"1076","2020-04-27",88,13,145,279,1841,0.706137968495383,0,0,158,309,56,1943,10,400,29,10
"1077","2020-04-28",89,13,135,287,1841,0.706137968495383,0,0,158,309,49,1992,17,417,33,17
"1078","2020-04-29",88,13,134,290,1841,0.706137968495383,0,0,158,309,50,2042,15,432,32,15
"1079","2020-04-30",85,13,138,289,1841,0.706137968495383,0,0,158,309,44,2086,15,447,28,15
"1080","2020-05-01",92,13,136,285,1841,0.706137968495383,0,0,158,309,42,2128,14,461,19,14
"1081","2020-05-02",87,13,148,273,1841,0.706137968495383,0,0,158,309,42,2170,20,481,30,20
"1082","2020-05-03",81,13,162,265,1841,0.706137968495383,0,0,158,309,36,2206,15,496,26,15
"1083","2020-05-04",85,13,166,249,1841,0.706137968495383,0,0,158,309,42,2248,17,513,32,17
"1084","2020-05-05",76,13,177,248,1841,0.706137968495383,0,0,158,309,37,2285,17,530,27,17
"1085","2020-05-06",76,13,174,248,1841,0.706137968495383,0,0,158,309,38,2323,15,545,21,15
"1086","2020-05-07",76,13,185,247,1841,0.706137968495383,0,0,158,309,41,2364,20,565,26,20
"1087","2020-05-08",66,13,173,254,1841,0.706137968495383,0,0,158,309,19,2383,17,582,13,17
"1088","2020-05-09",64,13,162,252,1841,0.706137968495383,0,0,158,309,35,2418,18,600,19,18
"1089","2020-05-10",70,13,168,255,1841,0.706137968495383,0,0,158,309,30,2448,23,623,11,23
"1090","2020-05-11",64,13,162,259,1841,0.706137968495383,0,0,158,309,31,2479,26,649,19,26
"1091","2020-05-12",64,13,161,251,1841,0.706137968495383,0,0,158,309,22,2501,24,673,9,24
"1092","2020-05-13",65,13,179,240,1841,0.706137968495383,0,0,158,309,27,2528,12,685,18,12
"1093","2020-05-14",64,13,164,234,1841,0.706137968495383,0,0,158,309,20,2548,18,703,10,18
"1094","2020-05-15",65,13,180,225,1841,0.706137968495383,0,0,158,309,21,2569,9,712,8,9
"1095","2020-05-16",69,13,174,220,1841,0.706137968495383,0,0,158,309,22,2591,12,724,16,12
"1096","2020-05-17",71,13,173,211,1841,0.706137968495383,0,0,158,309,28,2619,12,736,15,12
"1097","2020-05-18",68,13,179,211,1841,0.706137968495383,0,0,158,309,21,2640,9,745,12,9
"1098","2020-05-19",65,13,178,206,1841,0.706137968495383,0,0,158,309,19,2659,13,758,13,13
"1099","2020-05-20",69,13,187,187,1841,0.706137968495383,0,0,158,309,20,2679,12,770,8,12
"1100","2020-05-21",67,13,182,189,1841,0.706137968495383,0,0,158,309,22,2701,10,780,11,10
"1101","2020-05-22",66,13,178,181,1841,0.706137968495383,0,0,158,309,16,2717,12,792,10,12
"1102","2020-05-23",62,13,179,182,1841,0.706137968495383,0,0,158,309,18,2735,15,807,9,15
"1103","2020-05-24",51,13,185,174,1841,0.706137968495383,0,0,158,309,13,2748,5,812,8,5
"1104","2020-05-25",52,13,189,165,1841,0.706137968495383,0,0,158,309,20,2768,5,817,9,5
"1105","2020-05-26",51,13,183,151,1841,0.706137968495383,0,0,158,309,17,2785,4,821,8,4
"1106","2020-05-27",42,13,176,144,1841,0.706137968495383,0,0,158,309,10,2795,1,822,5,1
"1107","2020-05-28",42,13,167,130,1841,0.706137968495383,0,0,158,309,16,2811,4,826,10,4
"1108","2020-05-29",37,13,160,121,1841,0.706137968495383,0,0,158,309,19,2830,9,835,13,9
"1109","2020-05-30",36,13,151,118,1841,0.706137968495383,0,0,158,309,14,2844,10,845,7,10
"1110","2020-05-31",39,13,150,108,1841,0.706137968495383,0,0,158,309,11,2855,1,846,6,1
"1111","2020-06-01",39,13,158,105,1841,0.706137968495383,0,0,158,309,13,2868,5,851,7,5
"1112","2020-06-02",39,13,154,107,1841,0.706137968495383,0,0,158,309,12,2880,3,854,5,3
"1113","2020-06-03",37,13,143,109,1841,0.706137968495383,0,0,158,309,11,2891,3,857,7,3
"1114","2020-06-04",31,13,147,108,1841,0.706137968495383,0,0,158,309,7,2898,6,863,4,6
"1115","2020-06-05",34,13,141,103,1841,0.706137968495383,0,0,158,309,14,2912,7,870,8,7
"1116","2020-06-06",33,13,152,102,1841,0.706137968495383,0,0,158,309,7,2919,6,876,5,6
"1117","2020-06-07",32,13,169,103,1841,0.706137968495383,0,0,158,309,10,2929,8,884,4,8
"1118","2020-03-14",1,14,36,40,5910,0.929441624365482,0,0,574,540,17,60,8,43,9,8
"1119","2020-03-15",2,14,37,57,5910,0.929441624365482,0,0,574,540,17,77,4,47,12,4
"1120","2020-03-16",6,14,48,83,5910,0.929441624365482,0,0,574,540,43,120,8,55,24,8
"1121","2020-03-17",10,14,54,104,5910,0.929441624365482,0,0,574,540,46,166,11,66,33,11
"1122","2020-03-18",12,14,55,120,5910,0.929441624365482,0,0,574,540,39,205,11,77,31,11
"1123","2020-03-19",15,14,69,150,5910,0.929441624365482,0,0,574,540,43,248,11,88,31,11
"1124","2020-03-20",19,14,89,172,5910,0.929441624365482,0,0,574,540,61,309,9,97,48,9
"1125","2020-03-21",25,14,90,202,5910,0.929441624365482,0,0,574,540,91,400,16,113,81,16
"1126","2020-03-22",31,14,98,238,5910,0.929441624365482,0,0,574,540,90,490,16,129,82,16
"1127","2020-03-23",34,14,94,266,5910,0.929441624365482,0,0,574,540,98,588,17,146,87,17
"1128","2020-03-24",40,14,93,319,5910,0.929441624365482,0,0,574,540,131,719,17,163,121,17
"1129","2020-03-25",48,14,98,373,5910,0.929441624365482,0,0,574,540,158,877,12,175,149,12
"1130","2020-03-26",61,14,107,418,5910,0.929441624365482,0,0,574,540,190,1067,11,186,181,11
"1131","2020-03-27",69,14,101,471,5910,0.929441624365482,0,0,574,540,174,1241,9,195,161,9
"1132","2020-03-28",78,14,95,526,5910,0.929441624365482,0,0,574,540,224,1465,6,201,218,6
"1133","2020-03-29",87,14,104,587,5910,0.929441624365482,0,0,574,540,218,1683,29,230,204,29
"1134","2020-03-30",93,14,93,650,5910,0.929441624365482,0,0,574,540,299,1982,33,263,291,33
"1135","2020-03-31",109,14,94,734,5910,0.929441624365482,0,0,574,540,291,2273,41,304,281,41
"1136","2020-04-01",136,14,99,805,5910,0.929441624365482,0,0,574,540,319,2592,27,331,312,27
"1137","2020-04-02",160,14,99,864,5910,0.929441624365482,0,0,574,540,288,2880,38,369,284,38
"1138","2020-04-03",171,14,103,945,5910,0.929441624365482,0,0,574,540,367,3247,19,388,362,19
"1139","2020-04-04",202,14,108,1030,5910,0.929441624365482,0,0,574,540,397,3644,17,405,392,17
"1140","2020-04-05",228,14,123,1094,5910,0.929441624365482,0,0,574,540,325,3969,25,430,317,25
"1141","2020-04-06",264,14,144,1142,5910,0.929441624365482,0,0,574,540,365,4334,22,452,361,22
"1142","2020-04-07",284,14,142,1271,5910,0.929441624365482,0,0,574,540,349,4683,33,485,346,33
"1143","2020-04-08",298,14,123,1333,5910,0.929441624365482,0,0,574,540,398,5081,18,503,393,18
"1144","2020-04-09",295,14,115,1403,5910,0.929441624365482,0,0,574,540,325,5406,9,512,319,9
"1145","2020-04-10",331,14,109,1466,5910,0.929441624365482,0,0,574,540,301,5707,10,522,301,10
"1146","2020-04-11",346,14,110,1553,5910,0.929441624365482,0,0,574,540,273,5980,7,529,271,7
"1147","2020-04-12",349,14,113,1613,5910,0.929441624365482,0,0,574,540,177,6157,4,533,173,4
"1148","2020-04-13",377,14,109,1655,5910,0.929441624365482,0,0,574,540,184,6341,6,539,182,6
"1149","2020-04-14",404,14,113,1680,5910,0.929441624365482,0,0,574,540,151,6492,10,549,149,10
"1150","2020-04-15",412,14,128,1718,5910,0.929441624365482,0,0,574,540,121,6613,7,556,118,7
"1151","2020-04-16",445,14,134,1692,5910,0.929441624365482,0,0,574,540,69,6682,7,563,66,7
"1152","2020-04-17",467,14,134,1705,5910,0.929441624365482,0,0,574,540,87,6769,41,604,85,41
"1153","2020-04-18",481,14,126,1762,5910,0.929441624365482,0,0,574,540,74,6843,21,625,73,21
"1154","2020-04-19",513,14,118,1753,5910,0.929441624365482,0,0,574,540,67,6910,33,658,66,33
"1155","2020-04-20",506,14,115,1749,5910,0.929441624365482,0,0,574,540,49,6959,34,692,48,34
"1156","2020-04-21",492,14,114,1694,5910,0.929441624365482,0,0,574,540,44,7003,51,743,42,51
"1157","2020-04-22",498,14,132,1642,5910,0.929441624365482,0,0,574,540,32,7035,23,766,31,23
"1158","2020-04-23",487,14,132,1596,5910,0.929441624365482,0,0,574,540,33,7068,21,787,32,21
"1159","2020-04-24",472,14,131,1545,5910,0.929441624365482,0,0,574,540,27,7095,15,802,24,15
"1160","2020-04-25",473,14,146,1484,5910,0.929441624365482,0,0,574,540,27,7122,32,834,25,32
"1161","2020-04-26",454,14,147,1454,5910,0.929441624365482,0,0,574,540,17,7139,15,849,16,15
"1162","2020-04-27",437,14,151,1354,5910,0.929441624365482,0,0,574,540,19,7158,8,857,17,8
"1163","2020-04-28",439,14,153,1284,5910,0.929441624365482,0,0,574,540,13,7171,5,862,13,5
"1164","2020-04-29",429,14,153,1236,5910,0.929441624365482,0,0,574,540,20,7191,13,875,18,13
"1165","2020-04-30",415,14,141,1176,5910,0.929441624365482,0,0,574,540,10,7201,10,885,9,10
"1166","2020-05-01",406,14,132,1080,5910,0.929441624365482,0,0,574,540,12,7213,42,927,11,42
"1167","2020-05-02",366,14,118,969,5910,0.929441624365482,0,0,574,540,4,7217,41,968,2,41
"1168","2020-05-03",346,14,115,923,5910,0.929441624365482,0,0,574,540,6,7223,42,1010,6,42
"1169","2020-05-04",328,14,123,857,5910,0.929441624365482,0,0,574,540,3,7226,27,1037,2,27
"1170","2020-05-05",302,14,141,790,5910,0.929441624365482,0,0,574,540,9,7235,17,1054,7,17
"1171","2020-05-06",282,14,156,736,5910,0.929441624365482,0,0,574,540,7,7242,19,1073,7,19
"1172","2020-05-07",268,14,158,695,5910,0.929441624365482,0,0,574,540,2,7244,12,1085,2,12
"1173","2020-05-08",249,14,145,652,5910,0.929441624365482,0,0,574,540,4,7248,4,1089,2,4
"1174","2020-05-09",241,14,121,603,5910,0.929441624365482,0,0,574,540,3,7251,9,1098,3,9
"1175","2020-05-10",221,14,118,575,5910,0.929441624365482,0,0,574,540,2,7253,27,1125,2,27
"1176","2020-05-11",209,14,125,544,5910,0.929441624365482,0,0,574,540,4,7257,30,1155,1,30
"1177","2020-05-12",201,14,129,506,5910,0.929441624365482,0,0,574,540,3,7260,42,1197,1,42
"1178","2020-05-13",183,14,117,476,5910,0.929441624365482,0,0,574,540,4,7264,43,1240,2,43
"1179","2020-05-14",162,14,109,420,5910,0.929441624365482,0,0,574,540,4,7268,28,1268,3,28
"1180","2020-05-15",140,14,112,386,5910,0.929441624365482,0,0,574,540,8,7276,40,1308,3,40
"1181","2020-05-16",124,14,134,359,5910,0.929441624365482,0,0,574,540,3,7279,24,1332,2,24
"1182","2020-05-17",124,14,155,336,5910,0.929441624365482,0,0,574,540,4,7283,30,1362,4,30
"1183","2020-05-18",115,14,160,308,5910,0.929441624365482,0,0,574,540,2,7285,14,1376,1,14
"1184","2020-05-19",101,14,160,293,5910,0.929441624365482,0,0,574,540,3,7288,30,1406,3,30
"1185","2020-05-20",98,14,174,276,5910,0.929441624365482,0,0,574,540,3,7291,23,1429,2,23
"1186","2020-05-21",96,14,164,254,5910,0.929441624365482,0,0,574,540,3,7294,24,1453,2,24
"1187","2020-05-22",98,14,152,228,5910,0.929441624365482,0,0,574,540,4,7298,15,1468,3,15
"1188","2020-05-23",90,14,137,215,5910,0.929441624365482,0,0,574,540,2,7300,17,1485,1,17
"1189","2020-05-24",85,14,131,203,5910,0.929441624365482,0,0,574,540,4,7304,20,1505,2,20
"1190","2020-05-25",83,14,138,184,5910,0.929441624365482,0,0,574,540,1,7305,18,1523,1,18
"1191","2020-05-26",75,14,135,161,5910,0.929441624365482,0,0,574,540,7,7312,33,1556,6,33
"1192","2020-05-27",67,14,128,147,5910,0.929441624365482,0,0,574,540,5,7317,20,1576,3,20
"1193","2020-05-28",61,14,131,132,5910,0.929441624365482,0,0,574,540,1,7318,24,1600,1,24
"1194","2020-05-29",52,14,120,126,5910,0.929441624365482,0,0,574,540,NA,NA,13,1613,NA,13
"1195","2020-05-30",55,14,127,122,5910,0.929441624365482,0,0,574,540,2,7320,10,1623,1,10
"1196","2020-05-31",44,14,132,118,5910,0.929441624365482,0,0,574,540,3,7323,14,1637,3,14
"1197","2020-06-01",37,14,140,111,5910,0.929441624365482,0,0,574,540,3,7326,5,1642,1,5
"1198","2020-06-02",35,14,144,98,5910,0.929441624365482,0,0,574,540,1,7327,9,1651,NA,9
"1199","2020-06-03",32,14,145,93,5910,0.929441624365482,0,0,574,540,NA,NA,16,1667,NA,16
"1200","2020-06-04",34,14,139,93,5910,0.929441624365482,0,0,574,540,2,7329,16,1683,1,16
"1201","2020-06-05",28,14,139,93,5910,0.929441624365482,0,0,574,540,NA,NA,5,1688,NA,5
"1202","2020-06-06",25,14,135,85,5910,0.929441624365482,0,0,574,540,2,7331,13,1701,2,13
"1203","2020-06-07",26,14,127,88,5910,0.929441624365482,0,0,574,540,1,7332,11,1712,1,11
"1204","2020-03-13",1,15,82,74,8036,0.890741662518666,0,0,552,461,16,51,10,20,2,10
"1205","2020-03-14",3,15,87,117,8036,0.890741662518666,0,0,552,461,22,73,5,25,2,5
"1206","2020-03-15",7,15,87,161,8036,0.890741662518666,0,0,552,461,20,93,7,32,8,7
"1207","2020-03-16",11,15,106,209,8036,0.890741662518666,0,0,552,461,34,127,4,36,9,4
"1208","2020-03-17",19,15,126,272,8036,0.890741662518666,0,0,552,461,26,153,7,43,8,7
"1209","2020-03-18",32,15,152,351,8036,0.890741662518666,0,0,552,461,21,174,7,50,3,7
"1210","2020-03-19",48,15,179,445,8036,0.890741662518666,0,0,552,461,27,201,8,58,8,8
"1211","2020-03-20",58,15,202,556,8036,0.890741662518666,0,0,552,461,39,240,7,65,17,7
"1212","2020-03-21",85,15,174,717,8036,0.890741662518666,0,0,552,461,44,284,8,73,14,8
"1213","2020-03-22",111,15,169,916,8036,0.890741662518666,0,0,552,461,34,318,2,75,12,2
"1214","2020-03-23",125,15,173,1118,8036,0.890741662518666,0,0,552,461,33,351,3,78,10,3
"1215","2020-03-24",157,15,165,1320,8036,0.890741662518666,0,0,552,461,35,386,7,85,16,7
"1216","2020-03-25",192,15,153,1598,8036,0.890741662518666,0,0,552,461,47,433,5,90,14,5
"1217","2020-03-26",233,15,162,1937,8036,0.890741662518666,0,0,552,461,34,467,5,95,11,5
"1218","2020-03-27",279,15,161,2258,8036,0.890741662518666,0,0,552,461,45,512,7,102,15,7
"1219","2020-03-28",341,15,176,2661,8036,0.890741662518666,0,0,552,461,39,551,10,112,17,10
"1220","2020-03-29",420,15,167,2951,8036,0.890741662518666,0,0,552,461,48,599,9,121,25,9
"1221","2020-03-30",500,15,179,3339,8036,0.890741662518666,0,0,552,461,43,642,6,127,28,6
"1222","2020-03-31",590,15,159,3686,8036,0.890741662518666,0,0,552,461,49,691,4,131,24,4
"1223","2020-04-01",673,15,143,3941,8036,0.890741662518666,0,0,552,461,43,734,17,148,13,17
"1224","2020-04-02",756,15,141,4144,8036,0.890741662518666,0,0,552,461,46,780,12,160,15,12
"1225","2020-04-03",870,15,187,4279,8036,0.890741662518666,0,0,552,461,53,833,10,170,25,10
"1226","2020-04-04",959,15,192,4362,8036,0.890741662518666,0,0,552,461,47,880,5,175,20,5
"1227","2020-04-05",1036,15,173,4420,8036,0.890741662518666,0,0,552,461,41,921,7,182,22,7
"1228","2020-04-06",1133,15,161,4375,8036,0.890741662518666,0,0,552,461,47,968,7,189,19,7
"1229","2020-04-07",1161,15,141,4151,8036,0.890741662518666,0,0,552,461,53,1021,2,191,27,2
"1230","2020-04-08",1191,15,122,3910,8036,0.890741662518666,0,0,552,461,50,1071,5,196,23,5
"1231","2020-04-09",1201,15,98,3590,8036,0.890741662518666,0,0,552,461,52,1123,10,206,17,10
"1232","2020-04-10",1173,15,106,3235,8036,0.890741662518666,0,0,552,461,47,1170,18,224,27,18
"1233","2020-04-11",1138,15,128,2881,8036,0.890741662518666,0,0,552,461,36,1206,8,232,14,8
"1234","2020-04-12",1079,15,157,2493,8036,0.890741662518666,0,0,552,461,52,1258,10,242,20,10
"1235","2020-04-13",989,15,139,2138,8036,0.890741662518666,0,0,552,461,59,1317,16,258,25,16
"1236","2020-04-14",916,15,140,1831,8036,0.890741662518666,0,0,552,461,45,1362,12,270,21,12
"1237","2020-04-15",822,15,135,1544,8036,0.890741662518666,0,0,552,461,52,1414,5,275,26,5
"1238","2020-04-16",721,15,165,1272,8036,0.890741662518666,0,0,552,461,51,1465,3,278,21,3
"1239","2020-04-17",622,15,159,1047,8036,0.890741662518666,0,0,552,461,40,1505,21,299,25,21
"1240","2020-04-18",513,15,154,847,8036,0.890741662518666,0,0,552,461,42,1547,14,313,19,14
"1241","2020-04-19",416,15,148,691,8036,0.890741662518666,0,0,552,461,37,1584,14,327,16,14
"1242","2020-04-20",334,15,152,572,8036,0.890741662518666,0,0,552,461,42,1626,12,339,21,12
"1243","2020-04-21",273,15,151,475,8036,0.890741662518666,0,0,552,461,53,1679,8,347,18,8
"1244","2020-04-22",224,15,176,388,8036,0.890741662518666,0,0,552,461,53,1732,21,368,24,21
"1245","2020-04-23",195,15,216,329,8036,0.890741662518666,0,0,552,461,49,1781,9,377,27,9
"1246","2020-04-24",160,15,246,271,8036,0.890741662518666,0,0,552,461,36,1817,15,392,12,15
"1247","2020-04-25",131,15,264,215,8036,0.890741662518666,0,0,552,461,47,1864,17,409,18,17
"1248","2020-04-26",113,15,271,185,8036,0.890741662518666,0,0,552,461,58,1922,17,426,22,17
"1249","2020-04-27",103,15,251,171,8036,0.890741662518666,0,0,552,461,40,1962,32,458,15,32
"1250","2020-04-28",80,15,213,148,8036,0.890741662518666,0,0,552,461,43,2005,19,477,13,19
"1251","2020-04-29",67,15,191,136,8036,0.890741662518666,0,0,552,461,44,2049,19,496,13,19
"1252","2020-04-30",49,15,182,112,8036,0.890741662518666,0,0,552,461,56,2105,18,514,20,18
"1253","2020-05-01",44,15,214,96,8036,0.890741662518666,0,0,552,461,47,2152,21,535,19,21
"1254","2020-05-02",39,15,236,85,8036,0.890741662518666,0,0,552,461,34,2186,15,550,16,15
"1255","2020-05-03",32,15,215,75,8036,0.890741662518666,0,0,552,461,38,2224,10,560,12,10
"1256","2020-05-04",22,15,190,72,8036,0.890741662518666,0,0,552,461,39,2263,6,566,15,6
"1257","2020-05-05",24,15,198,68,8036,0.890741662518666,0,0,552,461,36,2299,11,577,13,11
"1258","2020-05-06",19,15,208,61,8036,0.890741662518666,0,0,552,461,41,2340,8,585,18,8
"1259","2020-05-07",18,15,238,56,8036,0.890741662518666,0,0,552,461,43,2383,6,591,14,6
"1260","2020-05-08",18,15,216,56,8036,0.890741662518666,0,0,552,461,36,2419,20,611,13,20
"1261","2020-05-09",19,15,196,55,8036,0.890741662518666,0,0,552,461,35,2454,6,617,12,6
"1262","2020-05-10",15,15,169,47,8036,0.890741662518666,0,0,552,461,38,2492,12,629,16,12
"1263","2020-05-11",12,15,155,44,8036,0.890741662518666,0,0,552,461,38,2530,15,644,12,15
"1264","2020-05-12",10,15,166,40,8036,0.890741662518666,0,0,552,461,42,2572,10,654,13,10
"1265","2020-05-13",14,15,177,40,8036,0.890741662518666,0,0,552,461,40,2612,19,673,20,19
"1266","2020-05-14",15,15,164,42,8036,0.890741662518666,0,0,552,461,32,2644,20,693,12,20
"1267","2020-05-15",13,15,156,40,8036,0.890741662518666,0,0,552,461,31,2675,17,710,11,17
"1268","2020-05-16",12,15,178,39,8036,0.890741662518666,0,0,552,461,45,2720,13,723,16,13
"1269","2020-05-17",13,15,215,38,8036,0.890741662518666,0,0,552,461,31,2751,16,739,14,16
"1270","2020-05-18",14,15,202,36,8036,0.890741662518666,0,0,552,461,33,2784,17,756,13,17
"1271","2020-05-19",15,15,196,34,8036,0.890741662518666,0,0,552,461,32,2816,15,771,12,15
"1272","2020-05-20",12,15,193,30,8036,0.890741662518666,0,0,552,461,35,2851,11,782,12,11
"1273","2020-05-21",13,15,200,27,8036,0.890741662518666,0,0,552,461,35,2886,9,791,15,9
"1274","2020-05-22",11,15,177,22,8036,0.890741662518666,0,0,552,461,34,2920,13,804,20,13
"1275","2020-05-23",9,15,193,23,8036,0.890741662518666,0,0,552,461,23,2943,16,820,11,16
"1276","2020-05-24",8,15,180,25,8036,0.890741662518666,0,0,552,461,17,2960,5,825,5,5
"1277","2020-05-25",7,15,155,27,8036,0.890741662518666,0,0,552,461,27,2987,4,829,11,4
"1278","2020-05-26",5,15,154,24,8036,0.890741662518666,0,0,552,461,23,3010,12,841,14,12
"1279","2020-05-27",5,15,137,20,8036,0.890741662518666,0,0,552,461,19,3029,12,853,9,12
"1280","2020-05-28",2,15,126,21,8036,0.890741662518666,0,0,552,461,32,3061,10,863,18,10
"1281","2020-05-29",3,15,110,22,8036,0.890741662518666,0,0,552,461,19,3080,4,867,8,4
"1282","2020-05-30",4,15,99,22,8036,0.890741662518666,0,0,552,461,19,3099,10,877,5,10
"1283","2020-05-31",4,15,117,21,8036,0.890741662518666,0,0,552,461,26,3125,8,885,19,8
"1284","2020-06-01",4,15,126,20,8036,0.890741662518666,0,0,552,461,24,3149,8,893,7,8
"1285","2020-06-02",5,15,117,18,8036,0.890741662518666,0,0,552,461,21,3170,4,897,7,4
"1286","2020-06-03",4,15,117,15,8036,0.890741662518666,0,0,552,461,17,3187,12,909,9,12
"1287","2020-06-04",5,15,114,16,8036,0.890741662518666,0,0,552,461,14,3201,8,917,7,8
"1288","2020-06-05",4,15,107,11,8036,0.890741662518666,0,0,552,461,18,3219,9,926,10,9
"1289","2020-06-06",3,15,120,10,8036,0.890741662518666,0,0,552,461,13,3232,9,935,8,9
"1290","2020-06-07",2,15,113,6,8036,0.890741662518666,0,0,552,461,22,3254,6,941,11,6
"1291","2020-03-15",2,16,29,52,2079,0.688311688311688,0,0,184,562,18,78,21,66,8,21
"1292","2020-03-16",6,16,42,69,2079,0.688311688311688,0,0,184,562,23,101,22,88,4,22
"1293","2020-03-17",8,16,65,82,2079,0.688311688311688,0,0,184,562,22,123,25,113,12,25
"1294","2020-03-18",14,16,78,98,2079,0.688311688311688,0,0,184,562,25,148,37,150,14,37
"1295","2020-03-19",19,16,78,114,2079,0.688311688311688,0,0,184,562,32,180,35,185,13,35
"1296","2020-03-20",27,16,104,133,2079,0.688311688311688,0,0,184,562,28,208,32,217,12,32
"1297","2020-03-21",31,16,101,151,2079,0.688311688311688,0,0,184,562,29,237,54,271,16,54
"1298","2020-03-22",36,16,99,170,2079,0.688311688311688,0,0,184,562,23,260,35,306,9,35
"1299","2020-03-23",40,16,96,183,2079,0.688311688311688,0,0,184,562,33,293,22,328,13,22
"1300","2020-03-24",46,16,96,207,2079,0.688311688311688,0,0,184,562,29,322,26,354,13,26
"1301","2020-03-25",46,16,88,216,2079,0.688311688311688,0,0,184,562,24,346,39,393,10,39
"1302","2020-03-26",53,16,88,238,2079,0.688311688311688,0,0,184,562,47,393,35,428,24,35
"1303","2020-03-27",54,16,92,249,2079,0.688311688311688,0,0,184,562,37,430,38,466,16,38
"1304","2020-03-28",55,16,104,260,2079,0.688311688311688,0,0,184,562,42,472,39,505,20,39
"1305","2020-03-29",59,16,111,263,2079,0.688311688311688,0,0,184,562,46,518,33,538,18,33
"1306","2020-03-30",63,16,107,278,2079,0.688311688311688,0,0,184,562,42,560,39,577,30,39
"1307","2020-03-31",64,16,125,286,2079,0.688311688311688,0,0,184,562,50,610,29,606,26,29
"1308","2020-04-01",66,16,125,298,2079,0.688311688311688,0,0,184,562,37,647,39,645,22,39
"1309","2020-04-02",68,16,127,291,2079,0.688311688311688,0,0,184,562,45,692,46,691,23,46
"1310","2020-04-03",72,16,128,293,2079,0.688311688311688,0,0,184,562,51,743,30,721,23,30
"1311","2020-04-04",77,16,132,297,2079,0.688311688311688,0,0,184,562,52,795,30,751,23,30
"1312","2020-04-05",74,16,148,308,2079,0.688311688311688,0,0,184,562,55,850,51,802,31,51
"1313","2020-04-06",68,16,165,299,2079,0.688311688311688,0,0,184,562,46,896,42,844,26,42
"1314","2020-04-07",70,16,149,291,2079,0.688311688311688,0,0,184,562,45,941,52,896,25,52
"1315","2020-04-08",74,16,149,307,2079,0.688311688311688,0,0,184,562,43,984,35,931,21,35
"1316","2020-04-09",67,16,161,315,2079,0.688311688311688,0,0,184,562,47,1031,38,969,22,38
"1317","2020-04-10",69,16,150,331,2079,0.688311688311688,0,0,184,562,45,1076,34,1003,24,34
"1318","2020-04-11",73,16,152,341,2079,0.688311688311688,0,0,184,562,40,1116,28,1031,20,28
"1319","2020-04-12",83,16,152,344,2079,0.688311688311688,0,0,184,562,43,1159,23,1054,24,23
"1320","2020-04-13",92,16,171,356,2079,0.688311688311688,0,0,184,562,44,1203,20,1074,29,20
"1321","2020-04-14",105,16,187,357,2079,0.688311688311688,0,0,184,562,38,1241,40,1114,25,40
"1322","2020-04-15",105,16,174,343,2079,0.688311688311688,0,0,184,562,44,1285,58,1172,23,58
"1323","2020-04-16",116,16,171,343,2079,0.688311688311688,0,0,184,562,55,1340,46,1218,32,46
"1324","2020-04-17",115,16,163,324,2079,0.688311688311688,0,0,184,562,49,1389,61,1279,19,61
"1325","2020-04-18",114,16,158,332,2079,0.688311688311688,0,0,184,562,40,1429,62,1341,23,62
"1326","2020-04-19",115,16,146,347,2079,0.688311688311688,0,0,184,562,53,1482,34,1375,26,34
"1327","2020-04-20",109,16,142,354,2079,0.688311688311688,0,0,184,562,45,1527,46,1421,22,46
"1328","2020-04-21",96,16,136,333,2079,0.688311688311688,0,0,184,562,35,1562,36,1457,21,36
"1329","2020-04-22",97,16,152,340,2079,0.688311688311688,0,0,184,562,34,1596,55,1512,21,55
"1330","2020-04-23",91,16,161,329,2079,0.688311688311688,0,0,184,562,44,1640,51,1563,27,51
"1331","2020-04-24",88,16,154,314,2079,0.688311688311688,0,0,184,562,35,1675,35,1598,21,35
"1332","2020-04-25",90,16,133,306,2079,0.688311688311688,0,0,184,562,45,1720,58,1656,19,58
"1333","2020-04-26",82,16,124,293,2079,0.688311688311688,0,0,184,562,46,1766,48,1704,21,48
"1334","2020-04-27",87,16,135,280,2079,0.688311688311688,0,0,184,562,36,1802,60,1764,24,60
"1335","2020-04-28",84,16,146,272,2079,0.688311688311688,0,0,184,562,57,1859,64,1828,35,64
"1336","2020-04-29",83,16,147,264,2079,0.688311688311688,0,0,184,562,34,1893,59,1887,13,59
"1337","2020-04-30",82,16,134,262,2079,0.688311688311688,0,0,184,562,31,1924,44,1931,15,44
"1338","2020-05-01",84,16,132,271,2079,0.688311688311688,0,0,184,562,30,1954,37,1968,14,37
"1339","2020-05-02",79,16,144,262,2079,0.688311688311688,0,0,184,562,40,1994,50,2018,20,50
"1340","2020-05-03",80,16,143,271,2079,0.688311688311688,0,0,184,562,35,2029,58,2076,21,58
"1341","2020-05-04",75,16,135,274,2079,0.688311688311688,0,0,184,562,35,2064,45,2121,16,45
"1342","2020-05-05",81,16,129,263,2079,0.688311688311688,0,0,184,562,26,2090,57,2178,7,57
"1343","2020-05-06",83,16,149,264,2079,0.688311688311688,0,0,184,562,32,2122,44,2222,16,44
"1344","2020-05-07",80,16,169,263,2079,0.688311688311688,0,0,184,562,37,2159,55,2277,16,55
"1345","2020-05-08",79,16,185,266,2079,0.688311688311688,0,0,184,562,33,2192,37,2314,15,37
"1346","2020-05-09",81,16,196,270,2079,0.688311688311688,0,0,184,562,24,2216,35,2349,9,35
"1347","2020-05-10",83,16,198,262,2079,0.688311688311688,0,0,184,562,29,2245,36,2385,15,36
"1348","2020-05-11",84,16,174,266,2079,0.688311688311688,0,0,184,562,43,2288,31,2416,30,31
"1349","2020-05-12",85,16,160,266,2079,0.688311688311688,0,0,184,562,21,2309,33,2449,11,33
"1350","2020-05-13",79,16,169,266,2079,0.688311688311688,0,0,184,562,40,2349,34,2483,17,34
"1351","2020-05-14",84,16,168,255,2079,0.688311688311688,0,0,184,562,31,2380,42,2525,16,42
"1352","2020-05-15",80,16,163,253,2079,0.688311688311688,0,0,184,562,26,2406,42,2567,13,42
"1353","2020-05-16",76,16,145,243,2079,0.688311688311688,0,0,184,562,26,2432,35,2602,11,35
"1354","2020-05-17",73,16,133,236,2079,0.688311688311688,0,0,184,562,35,2467,50,2652,16,50
"1355","2020-05-18",72,16,135,224,2079,0.688311688311688,0,0,184,562,37,2504,48,2700,18,48
"1356","2020-05-19",65,16,139,226,2079,0.688311688311688,0,0,184,562,31,2535,33,2733,16,33
"1357","2020-05-20",67,16,135,224,2079,0.688311688311688,0,0,184,562,38,2573,49,2782,23,49
"1358","2020-05-21",59,16,157,221,2079,0.688311688311688,0,0,184,562,31,2604,38,2820,18,38
"1359","2020-05-22",58,16,161,213,2079,0.688311688311688,0,0,184,562,22,2626,42,2862,10,43
"1360","2020-05-23",60,16,151,209,2079,0.688311688311688,0,0,184,562,22,2648,41,2903,13,41
"1361","2020-05-24",55,16,142,201,2079,0.688311688311688,0,0,184,562,31,2679,42,2945,19,42
"1362","2020-05-25",53,16,147,210,2079,0.688311688311688,0,0,184,562,21,2700,50,2995,10,50
"1363","2020-05-26",51,16,147,201,2079,0.688311688311688,0,0,184,562,23,2723,62,3057,11,62
"1364","2020-05-27",52,16,143,201,2079,0.688311688311688,0,0,184,562,25,2748,45,3102,15,45
"1365","2020-05-28",59,16,146,204,2079,0.688311688311688,0,0,184,562,29,2777,39,3141,17,39
"1366","2020-05-29",62,16,143,211,2079,0.688311688311688,0,0,184,562,23,2800,36,3177,12,36
"1367","2020-05-30",64,16,132,209,2079,0.688311688311688,0,0,184,562,14,2814,47,3224,6,47
"1368","2020-05-31",69,16,114,216,2079,0.688311688311688,0,0,184,562,27,2841,39,3263,10,39
"1369","2020-06-01",67,16,127,213,2079,0.688311688311688,0,0,184,562,21,2862,38,3301,12,38
"1370","2020-06-02",71,16,123,206,2079,0.688311688311688,0,0,184,562,24,2886,41,3342,18,41
"1371","2020-06-03",68,16,121,208,2079,0.688311688311688,0,0,184,562,15,2901,33,3375,7,33
"1372","2020-06-04",63,16,109,209,2079,0.688311688311688,0,0,184,562,16,2917,36,3411,10,36
"1373","2020-06-05",62,16,91,195,2079,0.688311688311688,0,0,184,562,16,2933,31,3442,9,31
"1374","2020-06-06",60,16,88,194,2079,0.688311688311688,0,0,184,562,15,2948,30,3472,5,30
"1375","2020-06-07",53,16,89,195,2079,0.688311688311688,0,0,184,562,9,2957,36,3508,5,36
"1376","2020-03-13",1,17,31,33,2471,0.475920679886686,0,0,194,475,6,17,17,28,5,17
"1377","2020-03-14",1,17,42,52,2471,0.475920679886686,0,0,194,475,6,23,18,46,3,18
"1378","2020-03-15",5,17,57,65,2471,0.475920679886686,0,0,194,475,13,36,15,61,9,15
"1379","2020-03-16",11,17,51,85,2471,0.475920679886686,0,0,194,475,14,50,15,76,11,15
"1380","2020-03-17",16,17,51,108,2471,0.475920679886686,0,0,194,475,15,65,8,84,14,8
"1381","2020-03-18",17,17,52,126,2471,0.475920679886686,0,0,194,475,18,83,14,98,17,14
"1382","2020-03-19",21,17,69,139,2471,0.475920679886686,0,0,194,475,21,104,9,107,19,9
"1383","2020-03-20",21,17,84,161,2471,0.475920679886686,0,0,194,475,21,125,9,116,19,9
"1384","2020-03-21",26,17,71,188,2471,0.475920679886686,0,0,194,475,24,149,18,134,19,18
"1385","2020-03-22",30,17,65,213,2471,0.475920679886686,0,0,194,475,39,188,19,153,35,19
"1386","2020-03-23",41,17,60,227,2471,0.475920679886686,0,0,194,475,35,223,8,161,35,8
"1387","2020-03-24",49,17,62,239,2471,0.475920679886686,0,0,194,475,35,258,12,173,34,12
"1388","2020-03-25",53,17,67,255,2471,0.475920679886686,0,0,194,475,65,323,14,187,63,14
"1389","2020-03-26",59,17,83,267,2471,0.475920679886686,0,0,194,475,59,382,31,218,56,31
"1390","2020-03-27",70,17,97,287,2471,0.475920679886686,0,0,194,475,94,476,7,225,90,7
"1391","2020-03-28",72,17,99,288,2471,0.475920679886686,0,0,194,475,88,564,17,242,87,17
"1392","2020-03-29",77,17,89,290,2471,0.475920679886686,0,0,194,475,112,676,23,265,109,23
"1393","2020-03-30",70,17,102,293,2471,0.475920679886686,0,0,194,475,123,799,10,275,123,10
"1394","2020-03-31",68,17,98,312,2471,0.475920679886686,0,0,194,475,130,929,28,303,127,28
"1395","2020-04-01",72,17,97,321,2471,0.475920679886686,0,0,194,475,193,1122,18,321,189,18
"1396","2020-04-02",71,17,83,332,2471,0.475920679886686,0,0,194,475,164,1286,13,334,161,13
"1397","2020-04-03",67,17,79,350,2471,0.475920679886686,0,0,194,475,218,1504,10,344,215,10
"1398","2020-04-04",69,17,77,353,2471,0.475920679886686,0,0,194,475,225,1729,21,365,221,21
"1399","2020-04-05",67,17,89,373,2471,0.475920679886686,0,0,194,475,311,2040,18,383,307,18
"1400","2020-04-06",80,17,76,397,2471,0.475920679886686,0,0,194,475,242,2282,32,415,238,32
"1401","2020-04-07",92,17,78,399,2471,0.475920679886686,0,0,194,475,276,2558,28,443,275,28
"1402","2020-04-08",105,17,106,412,2471,0.475920679886686,0,0,194,475,290,2848,34,477,282,34
"1403","2020-04-09",113,17,112,416,2471,0.475920679886686,0,0,194,475,307,3155,24,501,305,24
"1404","2020-04-10",120,17,114,405,2471,0.475920679886686,0,0,194,475,340,3495,17,518,337,17
"1405","2020-04-11",123,17,106,413,2471,0.475920679886686,0,0,194,475,364,3859,11,529,359,11
"1406","2020-04-12",129,17,116,416,2471,0.475920679886686,0,0,194,475,332,4191,17,546,329,17
"1407","2020-04-13",115,17,125,424,2471,0.475920679886686,0,0,194,475,326,4517,10,556,325,10
"1408","2020-04-14",105,17,125,408,2471,0.475920679886686,0,0,194,475,312,4829,17,573,310,17
"1409","2020-04-15",99,17,103,417,2471,0.475920679886686,0,0,194,475,243,5072,25,598,242,25
"1410","2020-04-16",104,17,100,416,2471,0.475920679886686,0,0,194,475,310,5382,15,613,307,15
"1411","2020-04-17",107,17,92,421,2471,0.475920679886686,0,0,194,475,242,5624,15,628,241,15
"1412","2020-04-18",116,17,86,406,2471,0.475920679886686,0,0,194,475,195,5819,10,638,195,10
"1413","2020-04-19",120,17,70,412,2471,0.475920679886686,0,0,194,475,218,6037,6,644,215,6
"1414","2020-04-20",127,17,69,429,2471,0.475920679886686,0,0,194,475,128,6165,4,648,128,4
"1415","2020-04-21",129,17,74,431,2471,0.475920679886686,0,0,194,475,129,6294,3,651,127,3
"1416","2020-04-22",122,17,87,443,2471,0.475920679886686,0,0,194,475,101,6395,8,659,100,8
"1417","2020-04-23",111,17,113,440,2471,0.475920679886686,0,0,194,475,121,6516,8,667,119,8
"1418","2020-04-24",111,17,160,437,2471,0.475920679886686,0,0,194,475,88,6604,20,687,88,20
"1419","2020-04-25",112,17,182,427,2471,0.475920679886686,0,0,194,475,55,6659,39,726,55,39
"1420","2020-04-26",105,17,190,423,2471,0.475920679886686,0,0,194,475,40,6699,18,744,40,18
"1421","2020-04-27",111,17,187,427,2471,0.475920679886686,0,0,194,475,45,6744,28,772,44,28
"1422","2020-04-28",118,17,197,413,2471,0.475920679886686,0,0,194,475,47,6791,23,795,45,23
"1423","2020-04-29",122,17,186,392,2471,0.475920679886686,0,0,194,475,33,6824,19,814,33,19
"1424","2020-04-30",128,17,161,389,2471,0.475920679886686,0,0,194,475,34,6858,11,825,34,11
"1425","2020-05-01",127,17,151,373,2471,0.475920679886686,0,0,194,475,23,6881,14,839,23,14
"1426","2020-05-02",115,17,157,370,2471,0.475920679886686,0,0,194,475,21,6902,31,870,20,31
"1427","2020-05-03",116,17,164,351,2471,0.475920679886686,0,0,194,475,15,6917,17,887,15,17
"1428","2020-05-04",106,17,194,350,2471,0.475920679886686,0,0,194,475,10,6927,9,896,10,9
"1429","2020-05-05",94,17,168,350,2471,0.475920679886686,0,0,194,475,11,6938,15,911,11,15
"1430","2020-05-06",94,17,158,352,2471,0.475920679886686,0,0,194,475,5,6943,7,918,5,7
"1431","2020-05-07",88,17,127,339,2471,0.475920679886686,0,0,194,475,4,6947,10,928,3,10
"1432","2020-05-08",85,17,122,330,2471,0.475920679886686,0,0,194,475,9,6956,21,949,8,21
"1433","2020-05-09",87,17,139,303,2471,0.475920679886686,0,0,194,475,8,6964,9,958,6,9
"1434","2020-05-10",83,17,139,295,2471,0.475920679886686,0,0,194,475,7,6971,6,964,7,6
"1435","2020-05-11",83,17,154,302,2471,0.475920679886686,0,0,194,475,7,6978,24,988,6,24
"1436","2020-05-12",87,17,151,302,2471,0.475920679886686,0,0,194,475,3,6981,21,1009,1,21
"1437","2020-05-13",83,17,134,296,2471,0.475920679886686,0,0,194,475,3,6984,24,1033,2,24
"1438","2020-05-14",86,17,122,276,2471,0.475920679886686,0,0,194,475,2,6986,22,1055,2,22
"1439","2020-05-15",81,17,125,279,2471,0.475920679886686,0,0,194,475,3,6989,15,1070,3,15
"1440","2020-05-16",80,17,145,282,2471,0.475920679886686,0,0,194,475,5,6994,21,1091,4,21
"1441","2020-05-17",80,17,154,287,2471,0.475920679886686,0,0,194,475,3,6997,25,1116,2,25
"1442","2020-05-18",77,17,154,271,2471,0.475920679886686,0,0,194,475,NA,NA,13,1129,NA,13
"1443","2020-05-19",74,17,134,249,2471,0.475920679886686,0,0,194,475,1,6998,8,1137,1,8
"1444","2020-05-20",79,17,122,236,2471,0.475920679886686,0,0,194,475,4,7002,11,1148,2,11
"1445","2020-05-21",71,17,115,225,2471,0.475920679886686,0,0,194,475,1,7003,19,1167,1,19
"1446","2020-05-22",73,17,130,218,2471,0.475920679886686,0,0,194,475,1,7004,21,1188,1,21
"1447","2020-05-23",71,17,124,212,2471,0.475920679886686,0,0,194,475,6,7010,21,1209,2,21
"1448","2020-05-24",68,17,113,211,2471,0.475920679886686,0,0,194,475,1,7011,15,1224,NA,15
"1449","2020-05-25",68,17,106,206,2471,0.475920679886686,0,0,194,475,NA,NA,33,1257,NA,33
"1450","2020-05-26",61,17,119,204,2471,0.475920679886686,0,0,194,475,2,7013,9,1266,2,9
"1451","2020-05-27",55,17,116,202,2471,0.475920679886686,0,0,194,475,NA,NA,26,1292,NA,26
"1452","2020-05-28",62,17,140,193,2471,0.475920679886686,0,0,194,475,3,7016,18,1310,2,18
"1453","2020-05-29",64,17,136,193,2471,0.475920679886686,0,0,194,475,2,7018,24,1334,1,24
"1454","2020-05-30",67,17,114,187,2471,0.475920679886686,0,0,194,475,1,7019,21,1355,1,21
"1455","2020-05-31",67,17,105,193,2471,0.475920679886686,0,0,194,475,NA,NA,21,1376,NA,21
"1456","2020-06-01",66,17,111,197,2471,0.475920679886686,0,0,194,475,1,7020,27,1403,1,27
"1457","2020-06-02",70,17,98,188,2471,0.475920679886686,0,0,194,475,3,7023,17,1420,2,17
"1458","2020-06-03",68,17,110,186,2471,0.475920679886686,0,0,194,475,3,7026,10,1430,2,10
"1459","2020-06-04",59,17,107,180,2471,0.475920679886686,0,0,194,475,2,7028,11,1441,1,11
"1460","2020-06-05",52,17,101,175,2471,0.475920679886686,0,0,194,475,4,7032,13,1454,4,13
"1461","2020-06-06",44,17,101,164,2471,0.475920679886686,0,0,194,475,NA,NA,3,1457,NA,3
"1462","2020-06-07",41,17,86,158,2471,0.475920679886686,0,0,194,475,3,7035,11,1468,3,11
"1463","2020-03-13",1,18,25,21,2437,0.732457940090275,0,0,204,724,4,9,11,37,2,11
"1464","2020-03-14",1,18,37,27,2437,0.732457940090275,0,0,204,724,2,11,10,47,NA,10
"1465","2020-03-15",1,18,46,33,2437,0.732457940090275,0,0,204,724,8,19,8,55,1,8
"1466","2020-03-16",2,18,47,49,2437,0.732457940090275,0,0,204,724,8,27,10,65,3,10
"1467","2020-03-17",5,18,56,56,2437,0.732457940090275,0,0,204,724,8,35,8,73,4,8
"1468","2020-03-18",8,18,76,71,2437,0.732457940090275,0,0,204,724,6,41,20,93,4,20
"1469","2020-03-19",12,18,89,88,2437,0.732457940090275,0,0,204,724,4,45,20,113,2,20
"1470","2020-03-20",15,18,98,106,2437,0.732457940090275,0,0,204,724,6,51,18,131,3,18
"1471","2020-03-21",17,18,112,123,2437,0.732457940090275,0,0,204,724,10,61,10,141,3,10
"1472","2020-03-22",20,18,141,137,2437,0.732457940090275,0,0,204,724,4,65,7,148,2,7
"1473","2020-03-23",29,18,141,151,2437,0.732457940090275,0,0,204,724,8,73,8,156,7,8
"1474","2020-03-24",31,18,132,163,2437,0.732457940090275,0,0,204,724,6,79,15,171,3,15
"1475","2020-03-25",36,18,116,177,2437,0.732457940090275,0,0,204,724,16,95,9,180,8,9
"1476","2020-03-26",38,18,106,187,2437,0.732457940090275,0,0,204,724,11,106,17,197,9,17
"1477","2020-03-27",42,18,102,201,2437,0.732457940090275,0,0,204,724,8,114,23,220,8,23
"1478","2020-03-28",50,18,97,203,2437,0.732457940090275,0,0,204,724,8,122,17,237,8,17
"1479","2020-03-29",51,18,92,212,2437,0.732457940090275,0,0,204,724,11,133,9,246,6,9
"1480","2020-03-30",45,18,105,217,2437,0.732457940090275,0,0,204,724,15,148,7,253,9,7
"1481","2020-03-31",47,18,114,230,2437,0.732457940090275,0,0,204,724,15,163,7,260,11,7
"1482","2020-04-01",54,18,118,230,2437,0.732457940090275,0,0,204,724,4,167,4,264,4,4
"1483","2020-04-02",55,18,114,232,2437,0.732457940090275,0,0,204,724,15,182,10,274,12,10
"1484","2020-04-03",52,18,127,243,2437,0.732457940090275,0,0,204,724,19,201,4,278,13,4
"1485","2020-04-04",48,18,150,245,2437,0.732457940090275,0,0,204,724,16,217,2,280,16,2
"1486","2020-04-05",50,18,188,252,2437,0.732457940090275,0,0,204,724,19,236,10,290,16,10
"1487","2020-04-06",52,18,183,259,2437,0.732457940090275,0,0,204,724,24,260,9,299,19,9
"1488","2020-04-07",58,18,169,269,2437,0.732457940090275,0,0,204,724,21,281,24,323,14,24
"1489","2020-04-08",58,18,153,284,2437,0.732457940090275,0,0,204,724,25,306,14,337,18,14
"1490","2020-04-09",59,18,134,287,2437,0.732457940090275,0,0,204,724,18,324,20,357,14,20
"1491","2020-04-10",69,18,123,297,2437,0.732457940090275,0,0,204,724,24,348,33,390,13,33
"1492","2020-04-11",76,18,107,308,2437,0.732457940090275,0,0,204,724,16,364,13,403,14,13
"1493","2020-04-12",81,18,113,317,2437,0.732457940090275,0,0,204,724,12,376,16,419,10,16
"1494","2020-04-13",86,18,111,317,2437,0.732457940090275,0,0,204,724,30,406,8,427,20,8
"1495","2020-04-14",88,18,105,329,2437,0.732457940090275,0,0,204,724,30,436,18,445,22,18
"1496","2020-04-15",86,18,92,328,2437,0.732457940090275,0,0,204,724,23,459,29,474,19,29
"1497","2020-04-16",89,18,91,329,2437,0.732457940090275,0,0,204,724,20,479,11,485,18,11
"1498","2020-04-17",83,18,102,325,2437,0.732457940090275,0,0,204,724,18,497,8,493,14,8
"1499","2020-04-18",77,18,115,326,2437,0.732457940090275,0,0,204,724,16,513,36,529,14,36
"1500","2020-04-19",82,18,141,339,2437,0.732457940090275,0,0,204,724,19,532,19,548,15,19
"1501","2020-04-20",85,18,138,336,2437,0.732457940090275,0,0,204,724,19,551,21,569,16,21
"1502","2020-04-21",83,18,135,337,2437,0.732457940090275,0,0,204,724,21,572,18,587,15,18
"1503","2020-04-22",89,18,130,337,2437,0.732457940090275,0,0,204,724,19,591,35,622,18,35
"1504","2020-04-23",93,18,119,347,2437,0.732457940090275,0,0,204,724,23,614,31,653,15,31
"1505","2020-04-24",99,18,109,353,2437,0.732457940090275,0,0,204,724,15,629,31,684,5,31
"1506","2020-04-25",102,18,101,345,2437,0.732457940090275,0,0,204,724,13,642,30,714,12,30
"1507","2020-04-26",103,18,120,347,2437,0.732457940090275,0,0,204,724,20,662,22,736,16,22
"1508","2020-04-27",107,18,124,350,2437,0.732457940090275,0,0,204,724,8,670,35,771,5,35
"1509","2020-04-28",121,18,128,364,2437,0.732457940090275,0,0,204,724,11,681,25,796,7,25
"1510","2020-04-29",121,18,132,378,2437,0.732457940090275,0,0,204,724,14,695,19,815,9,19
"1511","2020-04-30",122,18,141,388,2437,0.732457940090275,0,0,204,724,25,720,20,835,17,20
"1512","2020-05-01",116,18,141,390,2437,0.732457940090275,0,0,204,724,18,738,23,858,9,23
"1513","2020-05-02",121,18,147,385,2437,0.732457940090275,0,0,204,724,22,760,38,896,15,38
"1514","2020-05-03",120,18,130,383,2437,0.732457940090275,0,0,204,724,16,776,36,932,8,36
"1515","2020-05-04",112,18,154,407,2437,0.732457940090275,0,0,204,724,16,792,15,947,8,15
"1516","2020-05-05",105,18,137,397,2437,0.732457940090275,0,0,204,724,16,808,17,964,9,17
"1517","2020-05-06",102,18,131,399,2437,0.732457940090275,0,0,204,724,14,822,8,972,9,8
"1518","2020-05-07",97,18,116,397,2437,0.732457940090275,0,0,204,724,14,836,24,996,12,24
"1519","2020-05-08",100,18,92,409,2437,0.732457940090275,0,0,204,724,13,849,14,1010,7,14
"1520","2020-05-09",101,18,89,428,2437,0.732457940090275,0,0,204,724,17,866,33,1043,12,33
"1521","2020-05-10",101,18,84,421,2437,0.732457940090275,0,0,204,724,12,878,23,1066,9,23
"1522","2020-05-11",110,18,97,427,2437,0.732457940090275,0,0,204,724,17,895,28,1094,11,28
"1523","2020-05-12",119,18,124,431,2437,0.732457940090275,0,0,204,724,9,904,25,1119,4,25
"1524","2020-05-13",124,18,157,429,2437,0.732457940090275,0,0,204,724,11,915,34,1153,5,34
"1525","2020-05-14",126,18,153,426,2437,0.732457940090275,0,0,204,724,4,919,43,1196,4,43
"1526","2020-05-15",130,18,152,408,2437,0.732457940090275,0,0,204,724,9,928,20,1216,7,20
"1527","2020-05-16",127,18,160,396,2437,0.732457940090275,0,0,204,724,9,937,26,1242,5,26
"1528","2020-05-17",116,18,166,393,2437,0.732457940090275,0,0,204,724,11,948,31,1273,6,31
"1529","2020-05-18",108,18,179,408,2437,0.732457940090275,0,0,204,724,11,959,19,1292,4,19
"1530","2020-05-19",100,18,172,388,2437,0.732457940090275,0,0,204,724,13,972,29,1321,7,29
"1531","2020-05-20",101,18,146,375,2437,0.732457940090275,0,0,204,724,12,984,15,1336,8,15
"1532","2020-05-21",107,18,126,357,2437,0.732457940090275,0,0,204,724,17,1001,12,1348,11,12
"1533","2020-05-22",109,18,130,340,2437,0.732457940090275,0,0,204,724,10,1011,9,1357,9,9
"1534","2020-05-23",109,18,114,337,2437,0.732457940090275,0,0,204,724,15,1026,8,1365,12,8
"1535","2020-05-24",115,18,113,322,2437,0.732457940090275,0,0,204,724,16,1042,6,1371,10,6
"1536","2020-05-25",118,18,104,308,2437,0.732457940090275,0,0,204,724,11,1053,8,1379,8,8
"1537","2020-05-26",112,18,95,295,2437,0.732457940090275,0,0,204,724,13,1066,6,1385,10,6
"1538","2020-05-27",103,18,92,293,2437,0.732457940090275,0,0,204,724,14,1080,9,1394,12,9
"1539","2020-05-28",98,18,88,278,2437,0.732457940090275,0,0,204,724,10,1090,7,1401,8,7
"1540","2020-05-29",89,18,93,271,2437,0.732457940090275,0,0,204,724,14,1104,14,1415,12,14
"1541","2020-05-30",83,18,111,260,2437,0.732457940090275,0,0,204,724,15,1119,18,1433,12,18
"1542","2020-05-31",81,18,95,254,2437,0.732457940090275,0,0,204,724,14,1133,11,1444,12,11
"1543","2020-06-01",75,18,96,242,2437,0.732457940090275,0,0,204,724,16,1149,12,1456,12,12
"1544","2020-06-02",79,18,91,239,2437,0.732457940090275,0,0,204,724,12,1161,28,1484,11,28
"1545","2020-06-03",77,18,80,238,2437,0.732457940090275,0,0,204,724,14,1175,3,1487,10,3
"1546","2020-06-04",69,18,78,231,2437,0.732457940090275,0,0,204,724,11,1186,9,1496,10,9
"1547","2020-06-05",73,18,72,223,2437,0.732457940090275,0,0,204,724,16,1202,8,1504,13,8
"1548","2020-06-06",71,18,63,217,2437,0.732457940090275,0,0,204,724,19,1221,14,1518,17,14
"1549","2020-06-07",70,18,76,206,2437,0.732457940090275,0,0,204,724,13,1234,12,1530,12,12
"1550","2020-03-14",1,19,19,55,2217,0.435272891294542,0,0,196,326,21,50,11,53,3,11
"1551","2020-03-15",4,19,24,70,2217,0.435272891294542,0,0,196,326,16,66,4,57,1,4
"1552","2020-03-16",7,19,37,81,2217,0.435272891294542,0,0,196,326,19,85,8,65,5,8
"1553","2020-03-17",8,19,41,98,2217,0.435272891294542,0,0,196,326,21,106,18,83,6,18
"1554","2020-03-18",9,19,44,115,2217,0.435272891294542,0,0,196,326,23,129,12,95,10,12
"1555","2020-03-19",18,19,42,134,2217,0.435272891294542,0,0,196,326,28,157,5,100,18,5
"1556","2020-03-20",19,19,44,145,2217,0.435272891294542,0,0,196,326,30,187,5,105,16,5
"1557","2020-03-21",24,19,50,158,2217,0.435272891294542,0,0,196,326,37,224,4,109,25,4
"1558","2020-03-22",29,19,46,185,2217,0.435272891294542,0,0,196,326,35,259,6,115,18,6
"1559","2020-03-23",34,19,41,203,2217,0.435272891294542,0,0,196,326,32,291,3,118,21,3
"1560","2020-03-24",39,19,44,219,2217,0.435272891294542,0,0,196,326,49,340,1,119,30,1
"1561","2020-03-25",53,19,57,229,2217,0.435272891294542,0,0,196,326,39,379,3,122,28,3
"1562","2020-03-26",55,19,54,256,2217,0.435272891294542,0,0,196,326,61,440,16,138,42,16
"1563","2020-03-27",57,19,59,264,2217,0.435272891294542,0,0,196,326,55,495,2,140,45,2
"1564","2020-03-28",67,19,75,273,2217,0.435272891294542,0,0,196,326,60,555,5,145,40,5
"1565","2020-03-29",74,19,81,279,2217,0.435272891294542,0,0,196,326,66,621,3,148,49,3
"1566","2020-03-30",84,19,75,293,2217,0.435272891294542,0,0,196,326,58,679,4,152,41,4
"1567","2020-03-31",85,19,72,302,2217,0.435272891294542,0,0,196,326,63,742,17,169,47,17
"1568","2020-04-01",83,19,68,303,2217,0.435272891294542,0,0,196,326,73,815,8,177,53,8
"1569","2020-04-02",82,19,80,305,2217,0.435272891294542,0,0,196,326,67,882,5,182,51,5
"1570","2020-04-03",85,19,98,306,2217,0.435272891294542,0,0,196,326,57,939,7,189,43,7
"1571","2020-04-04",81,19,107,311,2217,0.435272891294542,0,0,196,326,51,990,17,206,37,17
"1572","2020-04-05",80,19,110,323,2217,0.435272891294542,0,0,196,326,68,1058,14,220,51,14
"1573","2020-04-06",80,19,113,323,2217,0.435272891294542,0,0,196,326,63,1121,9,229,48,9
"1574","2020-04-07",82,19,100,312,2217,0.435272891294542,0,0,196,326,55,1176,11,240,42,11
"1575","2020-04-08",82,19,107,327,2217,0.435272891294542,0,0,196,326,48,1224,8,248,35,8
"1576","2020-04-09",81,19,103,330,2217,0.435272891294542,0,0,196,326,68,1292,7,255,42,7
"1577","2020-04-10",85,19,110,333,2217,0.435272891294542,0,0,196,326,41,1333,11,266,25,11
"1578","2020-04-11",89,19,97,338,2217,0.435272891294542,0,0,196,326,50,1383,7,273,29,7
"1579","2020-04-12",86,19,97,332,2217,0.435272891294542,0,0,196,326,53,1436,9,282,41,9
"1580","2020-04-13",83,19,104,334,2217,0.435272891294542,0,0,196,326,57,1493,8,290,37,8
"1581","2020-04-14",86,19,83,340,2217,0.435272891294542,0,0,196,326,74,1567,28,318,48,28
"1582","2020-04-15",82,19,85,343,2217,0.435272891294542,0,0,196,326,58,1625,34,352,41,34
"1583","2020-04-16",87,19,86,343,2217,0.435272891294542,0,0,196,326,68,1693,29,381,51,29
"1584","2020-04-17",91,19,84,342,2217,0.435272891294542,0,0,196,326,61,1754,15,396,39,15
"1585","2020-04-18",89,19,72,347,2217,0.435272891294542,0,0,196,326,52,1806,37,433,39,37
"1586","2020-04-19",94,19,67,356,2217,0.435272891294542,0,0,196,326,48,1854,14,447,32,14
"1587","2020-04-20",88,19,73,355,2217,0.435272891294542,0,0,196,326,64,1918,9,456,41,9
"1588","2020-04-21",92,19,85,350,2217,0.435272891294542,0,0,196,326,58,1976,27,483,31,27
"1589","2020-04-22",95,19,84,342,2217,0.435272891294542,0,0,196,326,47,2023,26,509,34,26
"1590","2020-04-23",95,19,91,347,2217,0.435272891294542,0,0,196,326,47,2070,8,517,31,8
"1591","2020-04-24",96,19,92,340,2217,0.435272891294542,0,0,196,326,50,2120,14,531,39,14
"1592","2020-04-25",90,19,94,341,2217,0.435272891294542,0,0,196,326,42,2162,9,540,26,9
"1593","2020-04-26",91,19,97,336,2217,0.435272891294542,0,0,196,326,42,2204,9,549,27,9
"1594","2020-04-27",97,19,83,329,2217,0.435272891294542,0,0,196,326,47,2251,10,559,25,10
"1595","2020-04-28",91,19,66,320,2217,0.435272891294542,0,0,196,326,47,2298,32,591,24,32
"1596","2020-04-29",91,19,57,309,2217,0.435272891294542,0,0,196,326,55,2353,15,606,36,15
"1597","2020-04-30",94,19,60,321,2217,0.435272891294542,0,0,196,326,39,2392,30,636,20,30
"1598","2020-05-01",85,19,60,317,2217,0.435272891294542,0,0,196,326,43,2435,22,658,28,22
"1599","2020-05-02",85,19,56,325,2217,0.435272891294542,0,0,196,326,27,2462,15,673,13,15
"1600","2020-05-03",85,19,55,322,2217,0.435272891294542,0,0,196,326,41,2503,31,704,31,31
"1601","2020-05-04",77,19,60,330,2217,0.435272891294542,0,0,196,326,34,2537,16,720,19,16
"1602","2020-05-05",77,19,67,324,2217,0.435272891294542,0,0,196,326,41,2578,15,735,24,15
"1603","2020-05-06",77,19,72,312,2217,0.435272891294542,0,0,196,326,37,2615,13,748,14,13
"1604","2020-05-07",69,19,70,319,2217,0.435272891294542,0,0,196,326,24,2639,30,778,13,30
"1605","2020-05-08",82,19,84,319,2217,0.435272891294542,0,0,196,326,33,2672,43,821,22,43
"1606","2020-05-09",96,19,98,320,2217,0.435272891294542,0,0,196,326,26,2698,42,863,12,42
"1607","2020-05-10",91,19,93,312,2217,0.435272891294542,0,0,196,326,26,2724,52,915,15,52
"1608","2020-05-11",99,19,98,308,2217,0.435272891294542,0,0,196,326,18,2742,44,959,10,44
"1609","2020-05-12",100,19,107,295,2217,0.435272891294542,0,0,196,326,22,2764,28,987,9,28
"1610","2020-05-13",103,19,118,293,2217,0.435272891294542,0,0,196,326,14,2778,32,1019,8,32
"1611","2020-05-14",104,19,123,279,2217,0.435272891294542,0,0,196,326,16,2794,21,1040,5,21
"1612","2020-05-15",93,19,142,273,2217,0.435272891294542,0,0,196,326,31,2825,13,1053,17,13
"1613","2020-05-16",80,19,125,263,2217,0.435272891294542,0,0,196,326,21,2846,4,1057,12,4
"1614","2020-05-17",80,19,112,248,2217,0.435272891294542,0,0,196,326,28,2874,30,1087,14,30
"1615","2020-05-18",76,19,96,246,2217,0.435272891294542,0,0,196,326,18,2892,26,1113,7,26
"1616","2020-05-19",77,19,85,242,2217,0.435272891294542,0,0,196,326,20,2912,25,1138,8,25
"1617","2020-05-20",73,19,93,235,2217,0.435272891294542,0,0,196,326,20,2932,14,1152,12,14
"1618","2020-05-21",70,19,92,243,2217,0.435272891294542,0,0,196,326,23,2955,15,1167,15,15
"1619","2020-05-22",75,19,103,233,2217,0.435272891294542,0,0,196,326,20,2975,35,1202,14,35
"1620","2020-05-23",71,19,96,230,2217,0.435272891294542,0,0,196,326,22,2997,18,1220,9,18
"1621","2020-05-24",67,19,119,223,2217,0.435272891294542,0,0,196,326,18,3015,9,1229,6,9
"1622","2020-05-25",61,19,143,202,2217,0.435272891294542,0,0,196,326,21,3036,10,1239,9,10
"1623","2020-05-26",56,19,133,206,2217,0.435272891294542,0,0,196,326,19,3055,26,1265,6,26
"1624","2020-05-27",56,19,132,196,2217,0.435272891294542,0,0,196,326,20,3075,24,1289,17,24
"1625","2020-05-28",63,19,130,199,2217,0.435272891294542,0,0,196,326,16,3091,19,1308,11,19
"1626","2020-05-29",55,19,115,192,2217,0.435272891294542,0,0,196,326,10,3101,8,1316,4,8
"1627","2020-05-30",60,19,89,185,2217,0.435272891294542,0,0,196,326,27,3128,14,1330,15,14
"1628","2020-05-31",62,19,73,165,2217,0.435272891294542,0,0,196,326,12,3140,12,1342,9,12
"1629","2020-06-01",63,19,62,167,2217,0.435272891294542,0,0,196,326,15,3155,14,1356,7,14
"1630","2020-06-02",62,19,55,170,2217,0.435272891294542,0,0,196,326,23,3178,13,1369,13,13
"1631","2020-06-03",58,19,67,164,2217,0.435272891294542,0,0,196,326,17,3195,14,1383,6,14
"1632","2020-06-04",53,19,56,161,2217,0.435272891294542,0,0,196,326,13,3208,19,1402,4,19
"1633","2020-06-05",53,19,57,156,2217,0.435272891294542,0,0,196,326,13,3221,16,1418,7,16
"1634","2020-06-06",49,19,51,150,2217,0.435272891294542,0,0,196,326,10,3231,28,1446,9,28
"1635","2020-06-07",44,19,51,149,2217,0.435272891294542,0,0,196,326,15,3246,14,1460,12,14
"1636","2020-03-14",1,20,34,19,3974,0.936084549572219,0,0,371,539,8,38,3,15,3,3
"1637","2020-03-15",1,20,26,27,3974,0.936084549572219,0,0,371,539,15,53,3,18,12,3
"1638","2020-03-16",2,20,29,30,3974,0.936084549572219,0,0,371,539,11,64,4,22,6,4
"1639","2020-03-17",5,20,33,39,3974,0.936084549572219,0,0,371,539,16,80,8,30,10,8
"1640","2020-03-18",7,20,38,49,3974,0.936084549572219,0,0,371,539,14,94,12,42,9,12
"1641","2020-03-19",7,20,50,60,3974,0.936084549572219,0,0,371,539,19,113,7,49,13,7
"1642","2020-03-20",10,20,55,71,3974,0.936084549572219,0,0,371,539,24,137,9,58,20,9
"1643","2020-03-21",10,20,53,85,3974,0.936084549572219,0,0,371,539,26,163,6,64,19,6
"1644","2020-03-22",10,20,53,104,3974,0.936084549572219,0,0,371,539,21,184,7,71,17,7
"1645","2020-03-23",12,20,48,115,3974,0.936084549572219,0,0,371,539,26,210,9,80,21,9
"1646","2020-03-24",12,20,58,129,3974,0.936084549572219,0,0,371,539,21,231,13,93,17,13
"1647","2020-03-25",19,20,55,155,3974,0.936084549572219,0,0,371,539,20,251,10,103,15,10
"1648","2020-03-26",19,20,50,177,3974,0.936084549572219,0,0,371,539,22,273,11,114,15,11
"1649","2020-03-27",21,20,71,190,3974,0.936084549572219,0,0,371,539,22,295,8,122,19,8
"1650","2020-03-28",27,20,97,221,3974,0.936084549572219,0,0,371,539,35,330,10,132,24,10
"1651","2020-03-29",35,20,105,237,3974,0.936084549572219,0,0,371,539,20,350,13,145,17,13
"1652","2020-03-30",39,20,89,270,3974,0.936084549572219,0,0,371,539,31,381,7,152,26,7
"1653","2020-03-31",44,20,78,292,3974,0.936084549572219,0,0,371,539,33,414,9,161,27,9
"1654","2020-04-01",54,20,102,319,3974,0.936084549572219,0,0,371,539,35,449,12,173,30,12
"1655","2020-04-02",68,20,100,341,3974,0.936084549572219,0,0,371,539,25,474,22,195,17,22
"1656","2020-04-03",77,20,91,352,3974,0.936084549572219,0,0,371,539,22,496,11,206,19,11
"1657","2020-04-04",79,20,90,385,3974,0.936084549572219,0,0,371,539,23,519,23,229,16,23
"1658","2020-04-05",82,20,90,409,3974,0.936084549572219,0,0,371,539,37,556,25,254,30,25
"1659","2020-04-06",93,20,98,425,3974,0.936084549572219,0,0,371,539,28,584,29,283,20,29
"1660","2020-04-07",114,20,121,475,3974,0.936084549572219,0,0,371,539,18,602,27,310,14,27
"1661","2020-04-08",115,20,115,499,3974,0.936084549572219,0,0,371,539,30,632,27,337,21,27
"1662","2020-04-09",124,20,126,531,3974,0.936084549572219,0,0,371,539,23,655,31,368,19,31
"1663","2020-04-10",127,20,121,541,3974,0.936084549572219,0,0,371,539,34,689,25,393,28,25
"1664","2020-04-11",139,20,128,582,3974,0.936084549572219,0,0,371,539,33,722,20,413,26,20
"1665","2020-04-12",156,20,114,613,3974,0.936084549572219,0,0,371,539,25,747,21,434,18,21
"1666","2020-04-13",165,20,114,638,3974,0.936084549572219,0,0,371,539,30,777,22,456,24,22
"1667","2020-04-14",155,20,149,651,3974,0.936084549572219,0,0,371,539,39,816,22,478,31,22
"1668","2020-04-15",172,20,163,673,3974,0.936084549572219,0,0,371,539,26,842,16,494,20,16
"1669","2020-04-16",177,20,147,712,3974,0.936084549572219,0,0,371,539,21,863,33,527,11,33
"1670","2020-04-17",190,20,132,750,3974,0.936084549572219,0,0,371,539,30,893,22,549,23,22
"1671","2020-04-18",196,20,110,800,3974,0.936084549572219,0,0,371,539,32,925,25,574,25,25
"1672","2020-04-19",204,20,108,783,3974,0.936084549572219,0,0,371,539,28,953,27,601,23,27
"1673","2020-04-20",205,20,117,792,3974,0.936084549572219,0,0,371,539,36,989,21,622,22,21
"1674","2020-04-21",226,20,114,809,3974,0.936084549572219,0,0,371,539,19,1008,17,639,16,17
"1675","2020-04-22",225,20,106,816,3974,0.936084549572219,0,0,371,539,28,1036,24,663,22,24
"1676","2020-04-23",226,20,97,831,3974,0.936084549572219,0,0,371,539,28,1064,21,684,16,21
"1677","2020-04-24",238,20,107,837,3974,0.936084549572219,0,0,371,539,31,1095,30,714,24,30
"1678","2020-04-25",245,20,118,850,3974,0.936084549572219,0,0,371,539,16,1111,23,737,12,23
"1679","2020-04-26",244,20,149,844,3974,0.936084549572219,0,0,371,539,29,1140,36,773,19,36
"1680","2020-04-27",257,20,137,870,3974,0.936084549572219,0,0,371,539,17,1157,22,795,13,22
"1681","2020-04-28",241,20,125,859,3974,0.936084549572219,0,0,371,539,27,1184,22,817,19,22
"1682","2020-04-29",251,20,136,877,3974,0.936084549572219,0,0,371,539,25,1209,18,835,19,18
"1683","2020-04-30",261,20,131,866,3974,0.936084549572219,0,0,371,539,33,1242,23,858,25,23
"1684","2020-05-01",254,20,141,831,3974,0.936084549572219,0,0,371,539,20,1262,28,886,13,28
"1685","2020-05-02",255,20,156,853,3974,0.936084549572219,0,0,371,539,22,1284,31,917,16,31
"1686","2020-05-03",253,20,144,819,3974,0.936084549572219,0,0,371,539,26,1310,40,957,20,40
"1687","2020-05-04",250,20,147,800,3974,0.936084549572219,0,0,371,539,13,1323,31,988,8,31
"1688","2020-05-05",252,20,182,784,3974,0.936084549572219,0,0,371,539,26,1349,37,1025,14,37
"1689","2020-05-06",243,20,205,745,3974,0.936084549572219,0,0,371,539,19,1368,34,1059,12,34
"1690","2020-05-07",233,20,197,719,3974,0.936084549572219,0,0,371,539,23,1391,38,1097,13,38
"1691","2020-05-08",226,20,185,711,3974,0.936084549572219,0,0,371,539,32,1423,22,1119,26,22
"1692","2020-05-09",225,20,158,669,3974,0.936084549572219,0,0,371,539,19,1442,24,1143,15,24
"1693","2020-05-10",215,20,144,632,3974,0.936084549572219,0,0,371,539,20,1462,32,1175,12,32
"1694","2020-05-11",201,20,135,602,3974,0.936084549572219,0,0,371,539,21,1483,34,1209,15,34
"1695","2020-05-12",194,20,110,582,3974,0.936084549572219,0,0,371,539,21,1504,29,1238,19,29
"1696","2020-05-13",187,20,120,556,3974,0.936084549572219,0,0,371,539,15,1519,44,1282,11,44
"1697","2020-05-14",179,20,144,529,3974,0.936084549572219,0,0,371,539,16,1535,28,1310,12,28
"1698","2020-05-15",171,20,131,498,3974,0.936084549572219,0,0,371,539,14,1549,35,1345,10,35
"1699","2020-05-16",163,20,164,490,3974,0.936084549572219,0,0,371,539,20,1569,29,1374,10,29
"1700","2020-05-17",166,20,159,476,3974,0.936084549572219,0,0,371,539,21,1590,32,1406,17,32
"1701","2020-05-18",165,20,150,468,3974,0.936084549572219,0,0,371,539,20,1610,38,1444,11,38
"1702","2020-05-19",164,20,144,455,3974,0.936084549572219,0,0,371,539,16,1626,37,1481,9,37
"1703","2020-05-20",152,20,136,453,3974,0.936084549572219,0,0,371,539,8,1634,27,1508,5,27
"1704","2020-05-21",143,20,142,440,3974,0.936084549572219,0,0,371,539,16,1650,28,1536,11,28
"1705","2020-05-22",142,20,168,430,3974,0.936084549572219,0,0,371,539,13,1663,34,1570,9,34
"1706","2020-05-23",135,20,178,404,3974,0.936084549572219,0,0,371,539,17,1680,40,1610,12,40
"1707","2020-05-24",124,20,176,406,3974,0.936084549572219,0,0,371,539,16,1696,45,1655,12,45
"1708","2020-05-25",116,20,163,384,3974,0.936084549572219,0,0,371,539,8,1704,37,1692,6,37
"1709","2020-05-26",109,20,161,370,3974,0.936084549572219,0,0,371,539,7,1711,33,1725,4,33
"1710","2020-05-27",102,20,151,380,3974,0.936084549572219,0,0,371,539,9,1720,27,1752,5,27
"1711","2020-05-28",106,20,142,364,3974,0.936084549572219,0,0,371,539,7,1727,22,1774,2,22
"1712","2020-05-29",105,20,153,359,3974,0.936084549572219,0,0,371,539,8,1735,28,1802,3,28
"1713","2020-05-30",100,20,139,346,3974,0.936084549572219,0,0,371,539,10,1745,26,1828,7,26
"1714","2020-05-31",97,20,116,335,3974,0.936084549572219,0,0,371,539,8,1753,25,1853,6,25
"1715","2020-06-01",107,20,96,325,3974,0.936084549572219,0,0,371,539,11,1764,30,1883,8,30
"1716","2020-06-02",107,20,89,314,3974,0.936084549572219,0,0,371,539,11,1775,29,1912,4,29
"1717","2020-06-03",112,20,98,314,3974,0.936084549572219,0,0,371,539,15,1790,18,1930,5,18
"1718","2020-06-04",113,20,78,302,3974,0.936084549572219,0,0,371,539,7,1797,24,1954,6,24
"1719","2020-06-05",103,20,79,293,3974,0.936084549572219,0,0,371,539,8,1805,27,1981,7,27
"1720","2020-06-06",104,20,69,281,3974,0.936084549572219,0,0,371,539,9,1814,30,2011,4,30
"1721","2020-06-07",105,20,64,277,3974,0.936084549572219,0,0,371,539,7,1821,41,2052,5,41
