"","Date","Absents","Paramset","Infections_or_Exposed_per_day_Patient","Infections_or_Exposed_per_day_HCW","total_infections","nosocomial_proportion","PCR_pooled","LFD_pooled","HCW_symp_test","patient_symp_test","new_hcw_infs","cumulative_hcw_infs","new_pat_infs","cumulative_pats_infs","new_nosocomial_hcw_infs","new_nosocomial_pat_infs"
"1","2020-03-13",1,1,60,145,7893,0.695679716204232,0,0,678,544,51,145,25,44,6,25
"2","2020-03-14",4,1,83,187,7893,0.695679716204232,0,0,678,544,42,187,24,68,12,24
"3","2020-03-15",9,1,92,258,7893,0.695679716204232,0,0,678,544,71,258,20,88,29,20
"4","2020-03-16",17,1,108,345,7893,0.695679716204232,0,0,678,544,88,346,31,119,44,31
"5","2020-03-17",30,1,118,430,7893,0.695679716204232,0,0,678,544,86,432,29,148,42,29
"6","2020-03-18",43,1,130,516,7893,0.695679716204232,0,0,678,544,93,525,24,172,45,24
"7","2020-03-19",65,1,126,597,7893,0.695679716204232,0,0,678,544,94,619,25,197,50,25
"8","2020-03-20",83,1,127,693,7893,0.695679716204232,0,0,678,544,118,737,24,221,80,24
"9","2020-03-21",107,1,135,809,7893,0.695679716204232,0,0,678,544,142,879,28,249,98,28
"10","2020-03-22",129,1,152,908,7893,0.695679716204232,0,0,678,544,142,1021,35,284,106,35
"11","2020-03-23",156,1,143,1017,7893,0.695679716204232,0,0,678,544,146,1167,19,303,107,19
"12","2020-03-24",180,1,140,1149,7893,0.695679716204232,0,0,678,544,174,1341,30,333,139,30
"13","2020-03-25",209,1,169,1283,7893,0.695679716204232,0,0,678,544,188,1529,48,381,145,48
"14","2020-03-26",228,1,177,1447,7893,0.695679716204232,0,0,678,544,228,1757,40,421,193,40
"15","2020-03-27",263,1,195,1620,7893,0.695679716204232,0,0,678,544,238,1995,40,461,199,40
"16","2020-03-28",301,1,190,1779,7893,0.695679716204232,0,0,678,544,230,2225,24,485,184,24
"17","2020-03-29",345,1,194,2022,7893,0.695679716204232,0,0,678,544,334,2559,40,525,295,40
"18","2020-03-30",384,1,178,2153,7893,0.695679716204232,0,0,678,544,253,2812,24,549,214,24
"19","2020-03-31",438,1,182,2275,7893,0.695679716204232,0,0,678,544,246,3058,45,594,222,45
"20","2020-04-01",494,1,179,2396,7893,0.695679716204232,0,0,678,544,257,3315,21,615,218,21
"21","2020-04-02",529,1,168,2492,7893,0.695679716204232,0,0,678,544,239,3554,12,627,213,12
"22","2020-04-03",559,1,147,2555,7893,0.695679716204232,0,0,678,544,224,3778,22,649,191,22
"23","2020-04-04",584,1,123,2641,7893,0.695679716204232,0,0,678,544,288,4066,11,660,260,11
"24","2020-04-05",607,1,129,2719,7893,0.695679716204232,0,0,678,544,253,4319,21,681,220,21
"25","2020-04-06",655,1,158,2725,7893,0.695679716204232,0,0,678,544,221,4540,39,720,201,39
"26","2020-04-07",674,1,202,2715,7893,0.695679716204232,0,0,678,544,214,4754,56,776,183,56
"27","2020-04-08",709,1,200,2708,7893,0.695679716204232,0,0,678,544,212,4966,31,807,175,31
"28","2020-04-09",732,1,191,2643,7893,0.695679716204232,0,0,678,544,170,5136,35,842,144,35
"29","2020-04-10",754,1,176,2582,7893,0.695679716204232,0,0,678,544,193,5329,24,866,162,24
"30","2020-04-11",771,1,191,2461,7893,0.695679716204232,0,0,678,544,137,5466,40,906,119,40
"31","2020-04-12",782,1,189,2374,7893,0.695679716204232,0,0,678,544,170,5636,29,935,154,29
"32","2020-04-13",742,1,185,2220,7893,0.695679716204232,0,0,678,544,108,5744,33,968,84,33
"33","2020-04-14",715,1,170,2094,7893,0.695679716204232,0,0,678,544,85,5829,19,987,68,19
"34","2020-04-15",673,1,147,1971,7893,0.695679716204232,0,0,678,544,114,5943,7,994,96,7
"35","2020-04-16",665,1,141,1827,7893,0.695679716204232,0,0,678,544,90,6033,19,1013,76,19
"36","2020-04-17",623,1,149,1692,7893,0.695679716204232,0,0,678,544,80,6113,23,1036,59,23
"37","2020-04-18",599,1,154,1566,7893,0.695679716204232,0,0,678,544,78,6191,30,1066,63,30
"38","2020-04-19",549,1,174,1445,7893,0.695679716204232,0,0,678,544,74,6265,39,1105,63,39
"39","2020-04-20",524,1,209,1343,7893,0.695679716204232,0,0,678,544,49,6314,54,1159,34,54
"40","2020-04-21",494,1,219,1210,7893,0.695679716204232,0,0,678,544,43,6357,50,1209,31,50
"41","2020-04-22",449,1,231,1099,7893,0.695679716204232,0,0,678,544,44,6401,48,1257,35,48
"42","2020-04-23",418,1,216,1012,7893,0.695679716204232,0,0,678,544,56,6457,22,1279,41,22
"43","2020-04-24",385,1,196,904,7893,0.695679716204232,0,0,678,544,43,6500,29,1308,32,29
"44","2020-04-25",334,1,200,817,7893,0.695679716204232,0,0,678,544,39,6539,37,1345,26,37
"45","2020-04-26",300,1,247,733,7893,0.695679716204232,0,0,678,544,32,6571,55,1400,23,55
"46","2020-04-27",270,1,223,673,7893,0.695679716204232,0,0,678,544,32,6603,20,1420,18,21
"47","2020-04-28",243,1,215,617,7893,0.695679716204232,0,0,678,544,29,6632,31,1451,13,31
"48","2020-04-29",215,1,215,559,7893,0.695679716204232,0,0,678,544,20,6652,48,1499,13,48
"49","2020-04-30",177,1,234,514,7893,0.695679716204232,0,0,678,544,36,6688,49,1548,14,49
"50","2020-05-01",159,1,233,458,7893,0.695679716204232,0,0,678,544,21,6709,39,1587,11,39
"51","2020-05-02",141,1,215,438,7893,0.695679716204232,0,0,678,544,32,6741,21,1608,16,21
"52","2020-05-03",136,1,221,399,7893,0.695679716204232,0,0,678,544,21,6762,39,1647,14,39
"53","2020-05-04",129,1,215,371,7893,0.695679716204232,0,0,678,544,11,6773,34,1681,5,34
"54","2020-05-05",119,1,237,355,7893,0.695679716204232,0,0,678,544,20,6793,41,1722,6,41
"55","2020-05-06",115,1,223,331,7893,0.695679716204232,0,0,678,544,19,6812,33,1755,6,33
"56","2020-05-07",105,1,209,310,7893,0.695679716204232,0,0,678,544,14,6826,23,1778,11,23
"57","2020-05-08",103,1,226,287,7893,0.695679716204232,0,0,678,544,20,6846,50,1828,6,50
"58","2020-05-09",98,1,252,289,7893,0.695679716204232,0,0,678,544,29,6875,54,1882,13,54
"59","2020-05-10",85,1,257,274,7893,0.695679716204232,0,0,678,544,14,6889,56,1938,7,56
"60","2020-05-11",80,1,254,245,7893,0.695679716204232,0,0,678,544,13,6902,45,1983,9,45
"61","2020-05-12",75,1,260,233,7893,0.695679716204232,0,0,678,544,16,6918,48,2031,8,48
"62","2020-05-13",65,1,256,222,7893,0.695679716204232,0,0,678,544,17,6935,45,2076,7,45
"63","2020-05-14",61,1,231,206,7893,0.695679716204232,0,0,678,544,9,6944,25,2101,3,25
"64","2020-05-15",57,1,211,190,7893,0.695679716204232,0,0,678,544,13,6957,21,2122,2,21
"65","2020-05-16",57,1,196,185,7893,0.695679716204232,0,0,678,544,12,6969,24,2146,3,24
"66","2020-05-17",59,1,176,190,7893,0.695679716204232,0,0,678,544,18,6987,20,2166,10,20
"67","2020-05-18",49,1,172,179,7893,0.695679716204232,0,0,678,544,13,7000,25,2191,5,25
"68","2020-05-19",47,1,197,171,7893,0.695679716204232,0,0,678,544,18,7018,49,2240,7,49
"69","2020-05-20",49,1,184,167,7893,0.695679716204232,0,0,678,544,9,7027,26,2266,3,26
"70","2020-05-21",48,1,159,158,7893,0.695679716204232,0,0,678,544,6,7033,17,2283,2,17
"71","2020-05-22",45,1,155,145,7893,0.695679716204232,0,0,678,544,5,7038,35,2318,1,35
"72","2020-05-23",45,1,183,142,7893,0.695679716204232,0,0,678,544,12,7050,38,2356,7,38
"73","2020-05-24",48,1,188,143,7893,0.695679716204232,0,0,678,544,11,7061,35,2391,5,35
"74","2020-05-25",51,1,196,144,7893,0.695679716204232,0,0,678,544,8,7069,39,2430,2,39
"75","2020-05-26",48,1,182,136,7893,0.695679716204232,0,0,678,544,7,7076,26,2456,2,26
"76","2020-05-27",48,1,173,127,7893,0.695679716204232,0,0,678,544,8,7084,21,2477,4,21
"77","2020-05-28",48,1,167,113,7893,0.695679716204232,0,0,678,544,4,7088,23,2500,2,23
"78","2020-05-29",47,1,164,111,7893,0.695679716204232,0,0,678,544,6,7094,13,2513,3,13
"79","2020-05-30",43,1,145,97,7893,0.695679716204232,0,0,678,544,4,7098,16,2529,1,16
"80","2020-05-31",39,1,128,90,7893,0.695679716204232,0,0,678,544,4,7102,11,2540,2,11
"81","2020-06-01",33,1,116,83,7893,0.695679716204232,0,0,678,544,5,7107,7,2547,1,7
"82","2020-06-02",28,1,110,73,7893,0.695679716204232,0,0,678,544,3,7110,19,2566,2,19
"83","2020-06-03",28,1,120,77,7893,0.695679716204232,0,0,678,544,5,7115,17,2583,1,17
"84","2020-06-04",23,1,122,66,7893,0.695679716204232,0,0,678,544,3,7118,19,2602,1,19
"85","2020-06-05",26,1,118,65,7893,0.695679716204232,0,0,678,544,8,7126,15,2617,3,15
"86","2020-06-06",24,1,130,62,7893,0.695679716204232,0,0,678,544,6,7132,29,2646,NA,29
"87","2020-06-07",20,1,146,64,7893,0.695679716204232,0,0,678,544,7,7139,32,2678,4,32
"88","2020-03-13",1,2,53,81,4873,0.632464600861892,0,0,390,371,45,118,11,26,7,11
"89","2020-03-14",4,2,61,120,4873,0.632464600861892,0,0,390,371,50,168,23,49,10,23
"90","2020-03-15",7,2,66,158,4873,0.632464600861892,0,0,390,371,50,218,18,67,12,18
"91","2020-03-16",14,2,53,194,4873,0.632464600861892,0,0,390,371,44,262,17,84,14,17
"92","2020-03-17",22,2,65,228,4873,0.632464600861892,0,0,390,371,65,327,20,104,22,20
"93","2020-03-18",33,2,54,277,4873,0.632464600861892,0,0,390,371,61,388,25,129,22,25
"94","2020-03-19",48,2,52,324,4873,0.632464600861892,0,0,390,371,42,430,28,157,12,28
"95","2020-03-20",58,2,48,368,4873,0.632464600861892,0,0,390,371,64,494,20,177,27,20
"96","2020-03-21",65,2,39,424,4873,0.632464600861892,0,0,390,371,59,553,17,194,23,17
"97","2020-03-22",82,2,44,479,4873,0.632464600861892,0,0,390,371,50,603,25,219,21,25
"98","2020-03-23",100,2,39,501,4873,0.632464600861892,0,0,390,371,71,674,35,254,31,35
"99","2020-03-24",105,2,40,544,4873,0.632464600861892,0,0,390,371,56,730,23,277,18,23
"100","2020-03-25",115,2,36,582,4873,0.632464600861892,0,0,390,371,50,780,27,304,18,27
"101","2020-03-26",118,2,33,646,4873,0.632464600861892,0,0,390,371,64,844,22,326,19,22
"102","2020-03-27",126,2,35,679,4873,0.632464600861892,0,0,390,371,57,901,15,341,22,15
"103","2020-03-28",143,2,44,730,4873,0.632464600861892,0,0,390,371,48,949,35,376,18,35
"104","2020-03-29",154,2,56,765,4873,0.632464600861892,0,0,390,371,41,990,28,404,17,28
"105","2020-03-30",153,2,52,808,4873,0.632464600861892,0,0,390,371,66,1056,24,428,20,24
"106","2020-03-31",178,2,56,843,4873,0.632464600861892,0,0,390,371,71,1127,24,452,22,24
"107","2020-04-01",194,2,63,871,4873,0.632464600861892,0,0,390,371,61,1188,22,474,25,22
"108","2020-04-02",203,2,69,915,4873,0.632464600861892,0,0,390,371,50,1238,29,503,17,29
"109","2020-04-03",217,2,80,935,4873,0.632464600861892,0,0,390,371,53,1291,21,524,21,21
"110","2020-04-04",227,2,104,952,4873,0.632464600861892,0,0,390,371,52,1343,19,543,15,19
"111","2020-04-05",236,2,97,972,4873,0.632464600861892,0,0,390,371,67,1410,17,560,28,17
"112","2020-04-06",262,2,95,999,4873,0.632464600861892,0,0,390,371,51,1461,20,580,20,20
"113","2020-04-07",259,2,98,980,4873,0.632464600861892,0,0,390,371,77,1538,17,597,33,17
"114","2020-04-08",267,2,90,996,4873,0.632464600861892,0,0,390,371,50,1588,22,619,21,22
"115","2020-04-09",280,2,81,1002,4873,0.632464600861892,0,0,390,371,66,1654,43,662,26,43
"116","2020-04-10",282,2,82,1013,4873,0.632464600861892,0,0,390,371,43,1697,44,706,11,44
"117","2020-04-11",279,2,94,993,4873,0.632464600861892,0,0,390,371,74,1771,38,744,27,38
"118","2020-04-12",283,2,80,988,4873,0.632464600861892,0,0,390,371,72,1843,27,771,20,27
"119","2020-04-13",277,2,78,968,4873,0.632464600861892,0,0,390,371,60,1903,32,803,24,32
"120","2020-04-14",280,2,69,977,4873,0.632464600861892,0,0,390,371,59,1962,23,826,21,23
"121","2020-04-15",278,2,99,975,4873,0.632464600861892,0,0,390,371,56,2018,28,854,15,28
"122","2020-04-16",271,2,124,965,4873,0.632464600861892,0,0,390,371,66,2084,31,885,33,31
"123","2020-04-17",272,2,126,953,4873,0.632464600861892,0,0,390,371,57,2141,27,912,15,27
"124","2020-04-18",285,2,131,925,4873,0.632464600861892,0,0,390,371,74,2215,35,947,24,35
"125","2020-04-19",274,2,119,901,4873,0.632464600861892,0,0,390,371,54,2269,29,976,15,29
"126","2020-04-20",256,2,117,886,4873,0.632464600861892,0,0,390,371,57,2326,24,1000,21,24
"127","2020-04-21",254,2,143,857,4873,0.632464600861892,0,0,390,371,53,2379,25,1025,17,25
"128","2020-04-22",240,2,132,828,4873,0.632464600861892,0,0,390,371,57,2436,18,1043,17,18
"129","2020-04-23",245,2,127,809,4873,0.632464600861892,0,0,390,371,56,2492,28,1071,23,28
"130","2020-04-24",245,2,144,788,4873,0.632464600861892,0,0,390,371,58,2550,28,1099,18,28
"131","2020-04-25",217,2,125,756,4873,0.632464600861892,0,0,390,371,64,2614,29,1128,22,29
"132","2020-04-26",210,2,108,736,4873,0.632464600861892,0,0,390,371,53,2667,35,1163,17,35
"133","2020-04-27",217,2,94,704,4873,0.632464600861892,0,0,390,371,49,2716,35,1198,18,35
"134","2020-04-28",214,2,84,678,4873,0.632464600861892,0,0,390,371,70,2786,46,1244,23,46
"135","2020-04-29",208,2,95,656,4873,0.632464600861892,0,0,390,371,58,2844,36,1280,15,36
"136","2020-04-30",196,2,105,639,4873,0.632464600861892,0,0,390,371,62,2906,50,1330,15,50
"137","2020-05-01",186,2,111,609,4873,0.632464600861892,0,0,390,371,48,2954,22,1352,21,22
"138","2020-05-02",191,2,128,595,4873,0.632464600861892,0,0,390,371,46,3000,47,1399,9,47
"139","2020-05-03",186,2,151,595,4873,0.632464600861892,0,0,390,371,54,3054,27,1426,18,27
"140","2020-05-04",177,2,141,581,4873,0.632464600861892,0,0,390,371,51,3105,55,1481,11,55
"141","2020-05-05",162,2,131,560,4873,0.632464600861892,0,0,390,371,48,3153,48,1529,10,48
"142","2020-05-06",158,2,114,552,4873,0.632464600861892,0,0,390,371,49,3202,44,1573,14,44
"143","2020-05-07",154,2,102,537,4873,0.632464600861892,0,0,390,371,41,3243,40,1613,8,40
"144","2020-05-08",144,2,84,523,4873,0.632464600861892,0,0,390,371,38,3281,31,1644,9,31
"145","2020-05-09",142,2,113,519,4873,0.632464600861892,0,0,390,371,54,3335,46,1690,16,46
"146","2020-05-10",140,2,124,520,4873,0.632464600861892,0,0,390,371,47,3382,39,1729,14,39
"147","2020-05-11",138,2,169,510,4873,0.632464600861892,0,0,390,371,29,3411,48,1777,5,48
"148","2020-05-12",135,2,162,478,4873,0.632464600861892,0,0,390,371,35,3446,52,1829,6,52
"149","2020-05-13",135,2,156,457,4873,0.632464600861892,0,0,390,371,37,3483,32,1861,19,32
"150","2020-05-14",133,2,149,452,4873,0.632464600861892,0,0,390,371,34,3517,50,1911,9,50
"151","2020-05-15",134,2,142,440,4873,0.632464600861892,0,0,390,371,40,3557,40,1951,15,40
"152","2020-05-16",127,2,131,430,4873,0.632464600861892,0,0,390,371,44,3601,30,1981,13,30
"153","2020-05-17",122,2,130,417,4873,0.632464600861892,0,0,390,371,34,3635,19,2000,8,19
"154","2020-05-18",115,2,127,401,4873,0.632464600861892,0,0,390,371,44,3679,31,2031,18,31
"155","2020-05-19",122,2,121,393,4873,0.632464600861892,0,0,390,371,19,3698,30,2061,5,30
"156","2020-05-20",130,2,105,380,4873,0.632464600861892,0,0,390,371,29,3727,41,2102,12,41
"157","2020-05-21",126,2,106,369,4873,0.632464600861892,0,0,390,371,29,3756,33,2135,9,33
"158","2020-05-22",128,2,105,350,4873,0.632464600861892,0,0,390,371,35,3791,37,2172,11,37
"159","2020-05-23",125,2,101,329,4873,0.632464600861892,0,0,390,371,22,3813,30,2202,7,30
"160","2020-05-24",125,2,117,315,4873,0.632464600861892,0,0,390,371,33,3846,24,2226,9,24
"161","2020-05-25",124,2,120,308,4873,0.632464600861892,0,0,390,371,35,3881,41,2267,12,41
"162","2020-05-26",116,2,122,305,4873,0.632464600861892,0,0,390,371,22,3903,41,2308,5,41
"163","2020-05-27",103,2,113,296,4873,0.632464600861892,0,0,390,371,32,3935,33,2341,7,33
"164","2020-05-28",98,2,121,272,4873,0.632464600861892,0,0,390,371,17,3952,25,2366,4,25
"165","2020-05-29",88,2,108,245,4873,0.632464600861892,0,0,390,371,22,3974,24,2390,9,24
"166","2020-05-30",83,2,97,240,4873,0.632464600861892,0,0,390,371,24,3998,39,2429,8,39
"167","2020-05-31",86,2,84,239,4873,0.632464600861892,0,0,390,371,32,4030,18,2447,7,18
"168","2020-06-01",86,2,70,225,4873,0.632464600861892,0,0,390,371,24,4054,22,2469,12,22
"169","2020-06-02",82,2,74,227,4873,0.632464600861892,0,0,390,371,19,4073,36,2505,8,36
"170","2020-06-03",79,2,75,220,4873,0.632464600861892,0,0,390,371,21,4094,16,2521,10,16
"171","2020-06-04",79,2,71,200,4873,0.632464600861892,0,0,390,371,20,4114,15,2536,8,15
"172","2020-06-05",79,2,82,192,4873,0.632464600861892,0,0,390,371,19,4133,16,2552,4,16
"173","2020-06-06",82,2,67,186,4873,0.632464600861892,0,0,390,371,20,4153,24,2576,6,24
"174","2020-06-07",74,2,75,184,4873,0.632464600861892,0,0,390,371,15,4168,18,2594,8,18
"175","2020-03-12",1,3,38,78,5229,0.367947982405814,0,0,451,990,18,35,19,34,8,19
"176","2020-03-13",4,3,46,116,5229,0.367947982405814,0,0,451,990,19,54,19,53,9,19
"177","2020-03-14",5,3,72,157,5229,0.367947982405814,0,0,451,990,28,82,17,70,14,17
"178","2020-03-15",8,3,101,214,5229,0.367947982405814,0,0,451,990,27,109,10,80,21,10
"179","2020-03-16",17,3,121,276,5229,0.367947982405814,0,0,451,990,34,143,18,98,25,18
"180","2020-03-17",29,3,137,329,5229,0.367947982405814,0,0,451,990,40,183,20,118,29,20
"181","2020-03-18",40,3,172,393,5229,0.367947982405814,0,0,451,990,54,237,23,141,42,23
"182","2020-03-19",60,3,221,443,5229,0.367947982405814,0,0,451,990,50,287,24,165,36,24
"183","2020-03-20",68,3,235,487,5229,0.367947982405814,0,0,451,990,62,349,16,181,49,16
"184","2020-03-21",82,3,235,545,5229,0.367947982405814,0,0,451,990,63,412,22,203,51,22
"185","2020-03-22",103,3,271,623,5229,0.367947982405814,0,0,451,990,72,484,26,229,66,26
"186","2020-03-23",114,3,279,668,5229,0.367947982405814,0,0,451,990,78,562,35,264,69,35
"187","2020-03-24",137,3,285,694,5229,0.367947982405814,0,0,451,990,94,656,31,295,85,31
"188","2020-03-25",157,3,277,728,5229,0.367947982405814,0,0,451,990,98,754,21,316,87,21
"189","2020-03-26",164,3,290,750,5229,0.367947982405814,0,0,451,990,110,864,36,352,105,36
"190","2020-03-27",178,3,286,759,5229,0.367947982405814,0,0,451,990,138,1002,34,386,130,34
"191","2020-03-28",196,3,268,781,5229,0.367947982405814,0,0,451,990,97,1099,34,420,83,34
"192","2020-03-29",201,3,271,793,5229,0.367947982405814,0,0,451,990,166,1265,26,446,152,26
"193","2020-03-30",212,3,248,823,5229,0.367947982405814,0,0,451,990,163,1428,20,466,151,20
"194","2020-03-31",213,3,279,817,5229,0.367947982405814,0,0,451,990,133,1561,16,482,126,16
"195","2020-04-01",219,3,276,814,5229,0.367947982405814,0,0,451,990,161,1722,15,497,145,15
"196","2020-04-02",227,3,262,813,5229,0.367947982405814,0,0,451,990,193,1915,12,509,179,12
"197","2020-04-03",231,3,247,822,5229,0.367947982405814,0,0,451,990,180,2095,35,544,168,35
"198","2020-04-04",237,3,245,853,5229,0.367947982405814,0,0,451,990,180,2275,25,569,171,25
"199","2020-04-05",243,3,254,856,5229,0.367947982405814,0,0,451,990,185,2460,22,591,171,22
"200","2020-04-06",249,3,286,870,5229,0.367947982405814,0,0,451,990,148,2608,22,613,134,22
"201","2020-04-07",244,3,321,848,5229,0.367947982405814,0,0,451,990,159,2767,49,662,145,49
"202","2020-04-08",249,3,300,865,5229,0.367947982405814,0,0,451,990,213,2980,46,708,195,46
"203","2020-04-09",250,3,278,853,5229,0.367947982405814,0,0,451,990,206,3186,38,746,197,38
"204","2020-04-10",251,3,276,844,5229,0.367947982405814,0,0,451,990,172,3358,31,777,163,31
"205","2020-04-11",254,3,283,850,5229,0.367947982405814,0,0,451,990,164,3522,45,822,148,45
"206","2020-04-12",247,3,281,835,5229,0.367947982405814,0,0,451,990,165,3687,27,849,160,27
"207","2020-04-13",245,3,267,832,5229,0.367947982405814,0,0,451,990,193,3880,19,868,178,19
"208","2020-04-14",254,3,292,824,5229,0.367947982405814,0,0,451,990,178,4058,38,906,167,38
"209","2020-04-15",245,3,311,824,5229,0.367947982405814,0,0,451,990,152,4210,18,924,143,18
"210","2020-04-16",241,3,317,823,5229,0.367947982405814,0,0,451,990,120,4330,22,946,110,22
"211","2020-04-17",247,3,325,810,5229,0.367947982405814,0,0,451,990,135,4465,38,984,125,38
"212","2020-04-18",257,3,315,794,5229,0.367947982405814,0,0,451,990,176,4641,48,1032,169,48
"213","2020-04-19",251,3,297,782,5229,0.367947982405814,0,0,451,990,101,4742,38,1070,94,38
"214","2020-04-20",235,3,304,771,5229,0.367947982405814,0,0,451,990,93,4835,19,1089,81,19
"215","2020-04-21",228,3,286,778,5229,0.367947982405814,0,0,451,990,120,4955,32,1121,114,32
"216","2020-04-22",228,3,267,782,5229,0.367947982405814,0,0,451,990,78,5033,33,1154,72,33
"217","2020-04-23",224,3,269,788,5229,0.367947982405814,0,0,451,990,95,5128,21,1175,89,21
"218","2020-04-24",214,3,303,790,5229,0.367947982405814,0,0,451,990,85,5213,13,1188,75,13
"219","2020-04-25",190,3,298,799,5229,0.367947982405814,0,0,451,990,81,5294,24,1212,77,24
"220","2020-04-26",195,3,295,798,5229,0.367947982405814,0,0,451,990,69,5363,14,1226,60,14
"221","2020-04-27",215,3,298,768,5229,0.367947982405814,0,0,451,990,49,5412,19,1245,39,19
"222","2020-04-28",204,3,283,772,5229,0.367947982405814,0,0,451,990,45,5457,27,1272,42,27
"223","2020-04-29",210,3,323,773,5229,0.367947982405814,0,0,451,990,50,5507,36,1308,45,36
"224","2020-04-30",209,3,351,759,5229,0.367947982405814,0,0,451,990,44,5551,34,1342,36,34
"225","2020-05-01",217,3,368,742,5229,0.367947982405814,0,0,451,990,41,5592,53,1395,38,53
"226","2020-05-02",221,3,362,706,5229,0.367947982405814,0,0,451,990,31,5623,33,1428,29,33
"227","2020-05-03",219,3,339,696,5229,0.367947982405814,0,0,451,990,30,5653,31,1459,27,31
"228","2020-05-04",213,3,329,674,5229,0.367947982405814,0,0,451,990,28,5681,46,1505,22,46
"229","2020-05-05",214,3,346,664,5229,0.367947982405814,0,0,451,990,33,5714,26,1531,28,26
"230","2020-05-06",200,3,338,637,5229,0.367947982405814,0,0,451,990,33,5747,28,1559,27,28
"231","2020-05-07",194,3,330,618,5229,0.367947982405814,0,0,451,990,33,5780,30,1589,27,30
"232","2020-05-08",182,3,326,590,5229,0.367947982405814,0,0,451,990,25,5805,43,1632,18,43
"233","2020-05-09",184,3,337,587,5229,0.367947982405814,0,0,451,990,26,5831,37,1669,22,37
"234","2020-05-10",183,3,319,591,5229,0.367947982405814,0,0,451,990,15,5846,36,1705,15,36
"235","2020-05-11",170,3,304,562,5229,0.367947982405814,0,0,451,990,29,5875,20,1725,25,20
"236","2020-05-12",171,3,315,557,5229,0.367947982405814,0,0,451,990,20,5895,14,1739,16,14
"237","2020-05-13",178,3,302,547,5229,0.367947982405814,0,0,451,990,20,5915,37,1776,13,37
"238","2020-05-14",180,3,296,540,5229,0.367947982405814,0,0,451,990,16,5931,29,1805,13,29
"239","2020-05-15",177,3,303,530,5229,0.367947982405814,0,0,451,990,17,5948,12,1817,10,12
"240","2020-05-16",162,3,287,526,5229,0.367947982405814,0,0,451,990,18,5966,36,1853,15,36
"241","2020-05-17",155,3,281,489,5229,0.367947982405814,0,0,451,990,15,5981,21,1874,12,21
"242","2020-05-18",156,3,294,468,5229,0.367947982405814,0,0,451,990,6,5987,29,1903,4,29
"243","2020-05-19",154,3,322,453,5229,0.367947982405814,0,0,451,990,14,6001,35,1938,10,35
"244","2020-05-20",141,3,332,434,5229,0.367947982405814,0,0,451,990,15,6016,12,1950,13,12
"245","2020-05-21",134,3,340,431,5229,0.367947982405814,0,0,451,990,8,6024,16,1966,6,16
"246","2020-05-22",130,3,318,425,5229,0.367947982405814,0,0,451,990,10,6034,20,1986,8,20
"247","2020-05-23",129,3,321,415,5229,0.367947982405814,0,0,451,990,15,6049,25,2011,12,25
"248","2020-05-24",127,3,317,387,5229,0.367947982405814,0,0,451,990,5,6054,10,2021,4,10
"249","2020-05-25",122,3,325,378,5229,0.367947982405814,0,0,451,990,9,6063,14,2035,4,14
"250","2020-05-26",117,3,342,360,5229,0.367947982405814,0,0,451,990,12,6075,18,2053,12,18
"251","2020-05-27",115,3,383,355,5229,0.367947982405814,0,0,451,990,7,6082,13,2066,4,13
"252","2020-05-28",111,3,398,340,5229,0.367947982405814,0,0,451,990,8,6090,15,2081,8,15
"253","2020-05-29",114,3,395,329,5229,0.367947982405814,0,0,451,990,11,6101,28,2109,5,28
"254","2020-05-30",109,3,396,323,5229,0.367947982405814,0,0,451,990,4,6105,23,2132,4,23
"255","2020-05-31",106,3,385,318,5229,0.367947982405814,0,0,451,990,3,6108,24,2156,2,24
"256","2020-06-01",102,3,377,304,5229,0.367947982405814,0,0,451,990,6,6114,18,2174,4,18
"257","2020-06-02",90,3,393,290,5229,0.367947982405814,0,0,451,990,11,6125,32,2206,8,32
"258","2020-06-03",84,3,371,290,5229,0.367947982405814,0,0,451,990,6,6131,28,2234,2,28
"259","2020-06-04",86,3,343,274,5229,0.367947982405814,0,0,451,990,4,6135,28,2262,1,28
"260","2020-06-05",84,3,312,258,5229,0.367947982405814,0,0,451,990,4,6139,17,2279,4,17
"261","2020-06-06",80,3,295,256,5229,0.367947982405814,0,0,451,990,5,6144,37,2316,5,37
"262","2020-06-07",75,3,288,247,5229,0.367947982405814,0,0,451,990,7,6151,16,2332,4,16
"263","2020-03-14",1,4,55,72,4608,0.658420138888889,0,0,401,638,69,234,19,113,32,19
"264","2020-03-15",2,4,52,104,4608,0.658420138888889,0,0,401,638,92,326,6,119,54,6
"265","2020-03-16",8,4,53,137,4608,0.658420138888889,0,0,401,638,110,436,45,164,65,45
"266","2020-03-17",14,4,56,168,4608,0.658420138888889,0,0,401,638,142,578,29,193,100,29
"267","2020-03-18",18,4,55,200,4608,0.658420138888889,0,0,401,638,200,778,45,238,169,45
"268","2020-03-19",28,4,55,241,4608,0.658420138888889,0,0,401,638,266,1044,26,264,229,26
"269","2020-03-20",33,4,80,272,4608,0.658420138888889,0,0,401,638,322,1366,15,279,281,15
"270","2020-03-21",39,4,94,304,4608,0.658420138888889,0,0,401,638,390,1756,13,292,342,13
"271","2020-03-22",49,4,82,356,4608,0.658420138888889,0,0,401,638,356,2112,25,317,328,25
"272","2020-03-23",62,4,118,382,4608,0.658420138888889,0,0,401,638,517,2629,54,371,483,54
"273","2020-03-24",72,4,136,434,4608,0.658420138888889,0,0,401,638,494,3123,26,397,477,26
"274","2020-03-25",78,4,151,471,4608,0.658420138888889,0,0,401,638,594,3717,24,421,565,24
"275","2020-03-26",91,4,149,507,4608,0.658420138888889,0,0,401,638,581,4298,59,480,559,59
"276","2020-03-27",108,4,134,546,4608,0.658420138888889,0,0,401,638,586,4884,28,508,563,28
"277","2020-03-28",118,4,120,583,4608,0.658420138888889,0,0,401,638,588,5472,12,520,565,12
"278","2020-03-29",135,4,124,616,4608,0.658420138888889,0,0,401,638,408,5880,25,545,395,25
"279","2020-03-30",132,4,156,653,4608,0.658420138888889,0,0,401,638,319,6199,76,621,314,76
"280","2020-03-31",147,4,165,661,4608,0.658420138888889,0,0,401,638,309,6508,58,679,297,58
"281","2020-04-01",162,4,155,684,4608,0.658420138888889,0,0,401,638,303,6811,43,722,294,43
"282","2020-04-02",167,4,137,695,4608,0.658420138888889,0,0,401,638,230,7041,18,740,218,18
"283","2020-04-03",178,4,119,719,4608,0.658420138888889,0,0,401,638,147,7188,24,764,143,24
"284","2020-04-04",196,4,115,747,4608,0.658420138888889,0,0,401,638,134,7322,18,782,126,18
"285","2020-04-05",204,4,135,766,4608,0.658420138888889,0,0,401,638,85,7407,20,802,82,20
"286","2020-04-06",222,4,153,772,4608,0.658420138888889,0,0,401,638,59,7466,27,829,56,27
"287","2020-04-07",224,4,150,795,4608,0.658420138888889,0,0,401,638,50,7516,17,846,45,17
"288","2020-04-08",223,4,148,808,4608,0.658420138888889,0,0,401,638,35,7551,70,916,31,70
"289","2020-04-09",216,4,133,811,4608,0.658420138888889,0,0,401,638,28,7579,24,940,25,24
"290","2020-04-10",212,4,145,812,4608,0.658420138888889,0,0,401,638,32,7611,5,945,30,5
"291","2020-04-11",221,4,162,831,4608,0.658420138888889,0,0,401,638,25,7636,13,958,21,13
"292","2020-04-12",219,4,169,808,4608,0.658420138888889,0,0,401,638,10,7646,72,1030,8,72
"293","2020-04-13",221,4,147,835,4608,0.658420138888889,0,0,401,638,16,7662,30,1060,12,30
"294","2020-04-14",233,4,147,855,4608,0.658420138888889,0,0,401,638,12,7674,16,1076,6,16
"295","2020-04-15",247,4,155,886,4608,0.658420138888889,0,0,401,638,6,7680,21,1097,2,21
"296","2020-04-16",264,4,161,864,4608,0.658420138888889,0,0,401,638,7,7687,38,1135,5,38
"297","2020-04-17",261,4,154,845,4608,0.658420138888889,0,0,401,638,5,7692,40,1175,2,40
"298","2020-04-18",247,4,180,833,4608,0.658420138888889,0,0,401,638,8,7700,20,1195,4,20
"299","2020-04-19",253,4,187,827,4608,0.658420138888889,0,0,401,638,10,7710,12,1207,5,12
"300","2020-04-20",249,4,196,833,4608,0.658420138888889,0,0,401,638,4,7714,14,1221,2,14
"301","2020-04-21",237,4,223,809,4608,0.658420138888889,0,0,401,638,6,7720,60,1281,3,60
"302","2020-04-22",232,4,227,781,4608,0.658420138888889,0,0,401,638,4,7724,35,1316,2,35
"303","2020-04-23",218,4,252,780,4608,0.658420138888889,0,0,401,638,2,7726,55,1371,1,55
"304","2020-04-24",223,4,290,772,4608,0.658420138888889,0,0,401,638,5,7731,48,1419,1,48
"305","2020-04-25",220,4,306,764,4608,0.658420138888889,0,0,401,638,5,7736,46,1465,3,46
"306","2020-04-26",206,4,269,777,4608,0.658420138888889,0,0,401,638,4,7740,30,1495,2,30
"307","2020-04-27",209,4,236,762,4608,0.658420138888889,0,0,401,638,2,7742,16,1511,NA,16
"308","2020-04-28",204,4,199,750,4608,0.658420138888889,0,0,401,638,5,7747,15,1526,2,15
"309","2020-04-29",196,4,191,726,4608,0.658420138888889,0,0,401,638,5,7752,52,1578,2,52
"310","2020-04-30",195,4,183,703,4608,0.658420138888889,0,0,401,638,3,7755,30,1608,1,30
"311","2020-05-01",188,4,220,698,4608,0.658420138888889,0,0,401,638,2,7757,49,1657,2,49
"312","2020-05-02",187,4,196,703,4608,0.658420138888889,0,0,401,638,5,7762,40,1697,3,40
"313","2020-05-03",194,4,221,682,4608,0.658420138888889,0,0,401,638,6,7768,31,1728,3,31
"314","2020-05-04",193,4,218,678,4608,0.658420138888889,0,0,401,638,2,7770,19,1747,NA,19
"315","2020-05-05",195,4,196,656,4608,0.658420138888889,0,0,401,638,2,7772,11,1758,1,11
"316","2020-05-06",193,4,180,640,4608,0.658420138888889,0,0,401,638,3,7775,61,1819,1,61
"317","2020-05-07",191,4,193,618,4608,0.658420138888889,0,0,401,638,4,7779,33,1852,4,33
"318","2020-05-08",190,4,180,601,4608,0.658420138888889,0,0,401,638,2,7781,16,1868,NA,16
"319","2020-05-09",184,4,180,586,4608,0.658420138888889,0,0,401,638,1,7782,65,1933,1,65
"320","2020-05-10",171,4,181,586,4608,0.658420138888889,0,0,401,638,4,7786,66,1999,2,66
"321","2020-05-11",160,4,196,553,4608,0.658420138888889,0,0,401,638,3,7789,29,2028,3,29
"322","2020-05-12",148,4,194,538,4608,0.658420138888889,0,0,401,638,2,7791,35,2063,1,35
"323","2020-05-13",151,4,218,524,4608,0.658420138888889,0,0,401,638,2,7793,59,2122,1,59
"324","2020-05-14",160,4,205,514,4608,0.658420138888889,0,0,401,638,1,7794,27,2149,NA,27
"325","2020-05-15",155,4,198,503,4608,0.658420138888889,0,0,401,638,3,7797,74,2223,2,74
"326","2020-05-16",160,4,188,492,4608,0.658420138888889,0,0,401,638,3,7800,48,2271,NA,48
"327","2020-05-17",154,4,183,471,4608,0.658420138888889,0,0,401,638,4,7804,30,2301,NA,30
"328","2020-05-18",146,4,177,450,4608,0.658420138888889,0,0,401,638,6,7810,40,2341,2,40
"329","2020-05-19",155,4,156,430,4608,0.658420138888889,0,0,401,638,2,7812,21,2362,NA,21
"330","2020-05-20",149,4,141,426,4608,0.658420138888889,0,0,401,638,3,7815,11,2373,2,11
"331","2020-05-21",133,4,136,411,4608,0.658420138888889,0,0,401,638,2,7817,12,2385,1,12
"332","2020-05-22",123,4,152,397,4608,0.658420138888889,0,0,401,638,1,7818,11,2396,NA,11
"333","2020-05-23",115,4,160,380,4608,0.658420138888889,0,0,401,638,1,7819,15,2411,NA,15
"334","2020-05-24",116,4,141,361,4608,0.658420138888889,0,0,401,638,2,7821,12,2423,NA,12
"335","2020-05-25",115,4,120,344,4608,0.658420138888889,0,0,401,638,1,7822,23,2446,NA,23
"336","2020-05-26",100,4,98,331,4608,0.658420138888889,0,0,401,638,2,7824,31,2477,NA,31
"337","2020-05-27",93,4,99,314,4608,0.658420138888889,0,0,401,638,1,7825,16,2493,NA,16
"338","2020-05-28",93,4,91,307,4608,0.658420138888889,0,0,401,638,3,7828,13,2506,1,13
"339","2020-05-29",97,4,103,282,4608,0.658420138888889,0,0,401,638,NA,NA,7,2513,NA,7
"340","2020-05-30",93,4,131,279,4608,0.658420138888889,0,0,401,638,2,7830,14,2527,2,14
"341","2020-05-31",88,4,154,275,4608,0.658420138888889,0,0,401,638,NA,NA,28,2555,NA,28
"342","2020-06-01",85,4,163,262,4608,0.658420138888889,0,0,401,638,1,7831,30,2585,NA,30
"343","2020-06-02",87,4,167,250,4608,0.658420138888889,0,0,401,638,2,7833,22,2607,NA,22
"344","2020-06-03",86,4,141,239,4608,0.658420138888889,0,0,401,638,2,7835,12,2619,NA,12
"345","2020-06-04",83,4,145,231,4608,0.658420138888889,0,0,401,638,2,7837,6,2625,NA,6
"346","2020-06-05",79,4,150,216,4608,0.658420138888889,0,0,401,638,NA,NA,12,2637,NA,12
"347","2020-06-06",76,4,146,212,4608,0.658420138888889,0,0,401,638,NA,NA,20,2657,NA,20
"348","2020-06-07",71,4,133,201,4608,0.658420138888889,0,0,401,638,NA,NA,36,2693,NA,36
"349","2020-03-13",1,5,37,76,4085,0.439412484700122,0,0,345,371,11,30,29,53,1,29
"350","2020-03-14",4,5,46,103,4085,0.439412484700122,0,0,345,371,17,47,19,72,1,19
"351","2020-03-15",7,5,52,132,4085,0.439412484700122,0,0,345,371,8,55,22,94,3,22
"352","2020-03-16",9,5,51,165,4085,0.439412484700122,0,0,345,371,14,69,16,110,8,16
"353","2020-03-17",16,5,50,204,4085,0.439412484700122,0,0,345,371,20,89,36,146,12,36
"354","2020-03-18",26,5,52,250,4085,0.439412484700122,0,0,345,371,29,118,44,190,15,44
"355","2020-03-19",33,5,49,284,4085,0.439412484700122,0,0,345,371,19,137,27,217,6,27
"356","2020-03-20",37,5,55,315,4085,0.439412484700122,0,0,345,371,22,159,23,240,12,23
"357","2020-03-21",43,5,63,365,4085,0.439412484700122,0,0,345,371,27,186,35,275,18,35
"358","2020-03-22",51,5,52,394,4085,0.439412484700122,0,0,345,371,34,220,31,306,18,31
"359","2020-03-23",72,5,42,423,4085,0.439412484700122,0,0,345,371,28,248,29,335,18,29
"360","2020-03-24",82,5,45,460,4085,0.439412484700122,0,0,345,371,14,262,21,356,6,21
"361","2020-03-25",89,5,50,504,4085,0.439412484700122,0,0,345,371,32,294,25,381,17,25
"362","2020-03-26",101,5,70,552,4085,0.439412484700122,0,0,345,371,33,327,24,405,20,24
"363","2020-03-27",116,5,98,571,4085,0.439412484700122,0,0,345,371,40,367,18,423,23,18
"364","2020-03-28",134,5,89,587,4085,0.439412484700122,0,0,345,371,33,400,17,440,19,17
"365","2020-03-29",147,5,70,608,4085,0.439412484700122,0,0,345,371,26,426,20,460,15,20
"366","2020-03-30",153,5,62,648,4085,0.439412484700122,0,0,345,371,47,473,37,497,23,37
"367","2020-03-31",153,5,67,668,4085,0.439412484700122,0,0,345,371,42,515,28,525,28,28
"368","2020-04-01",172,5,69,690,4085,0.439412484700122,0,0,345,371,34,549,33,558,21,33
"369","2020-04-02",171,5,99,700,4085,0.439412484700122,0,0,345,371,48,597,39,597,32,39
"370","2020-04-03",181,5,123,695,4085,0.439412484700122,0,0,345,371,48,645,46,643,29,46
"371","2020-04-04",188,5,111,698,4085,0.439412484700122,0,0,345,371,29,674,34,677,15,34
"372","2020-04-05",193,5,114,700,4085,0.439412484700122,0,0,345,371,30,704,28,705,16,28
"373","2020-04-06",191,5,110,698,4085,0.439412484700122,0,0,345,371,43,747,25,730,22,25
"374","2020-04-07",201,5,126,684,4085,0.439412484700122,0,0,345,371,33,780,20,750,18,20
"375","2020-04-08",194,5,135,671,4085,0.439412484700122,0,0,345,371,45,825,25,775,31,25
"376","2020-04-09",203,5,156,698,4085,0.439412484700122,0,0,345,371,39,864,29,804,24,29
"377","2020-04-10",204,5,141,681,4085,0.439412484700122,0,0,345,371,47,911,15,819,25,15
"378","2020-04-11",202,5,125,683,4085,0.439412484700122,0,0,345,371,50,961,18,837,28,18
"379","2020-04-12",203,5,122,678,4085,0.439412484700122,0,0,345,371,44,1005,9,846,26,9
"380","2020-04-13",201,5,115,663,4085,0.439412484700122,0,0,345,371,49,1054,16,862,33,16
"381","2020-04-14",204,5,123,650,4085,0.439412484700122,0,0,345,371,56,1110,32,894,38,32
"382","2020-04-15",200,5,125,669,4085,0.439412484700122,0,0,345,371,43,1153,55,949,27,55
"383","2020-04-16",198,5,117,659,4085,0.439412484700122,0,0,345,371,51,1204,43,992,30,43
"384","2020-04-17",200,5,110,639,4085,0.439412484700122,0,0,345,371,51,1255,35,1027,32,35
"385","2020-04-18",191,5,115,624,4085,0.439412484700122,0,0,345,371,49,1304,46,1073,31,46
"386","2020-04-19",183,5,131,613,4085,0.439412484700122,0,0,345,371,39,1343,45,1118,22,45
"387","2020-04-20",174,5,131,600,4085,0.439412484700122,0,0,345,371,42,1385,42,1160,28,42
"388","2020-04-21",173,5,126,600,4085,0.439412484700122,0,0,345,371,50,1435,41,1201,23,41
"389","2020-04-22",177,5,141,580,4085,0.439412484700122,0,0,345,371,41,1476,41,1242,21,41
"390","2020-04-23",175,5,139,588,4085,0.439412484700122,0,0,345,371,28,1504,35,1277,17,35
"391","2020-04-24",168,5,142,577,4085,0.439412484700122,0,0,345,371,34,1538,36,1313,15,36
"392","2020-04-25",161,5,142,560,4085,0.439412484700122,0,0,345,371,42,1580,29,1342,20,29
"393","2020-04-26",159,5,144,551,4085,0.439412484700122,0,0,345,371,33,1613,21,1363,22,21
"394","2020-04-27",160,5,139,539,4085,0.439412484700122,0,0,345,371,41,1654,20,1383,18,20
"395","2020-04-28",159,5,136,527,4085,0.439412484700122,0,0,345,371,30,1684,17,1400,11,17
"396","2020-04-29",151,5,158,534,4085,0.439412484700122,0,0,345,371,31,1715,33,1433,17,33
"397","2020-04-30",146,5,157,535,4085,0.439412484700122,0,0,345,371,36,1751,49,1482,22,49
"398","2020-05-01",143,5,164,543,4085,0.439412484700122,0,0,345,371,37,1788,39,1521,22,39
"399","2020-05-02",142,5,148,547,4085,0.439412484700122,0,0,345,371,27,1815,29,1550,16,29
"400","2020-05-03",145,5,170,536,4085,0.439412484700122,0,0,345,371,32,1847,30,1580,23,30
"401","2020-05-04",144,5,187,547,4085,0.439412484700122,0,0,345,371,31,1878,51,1631,17,51
"402","2020-05-05",143,5,189,555,4085,0.439412484700122,0,0,345,371,42,1920,44,1675,24,44
"403","2020-05-06",137,5,171,543,4085,0.439412484700122,0,0,345,371,45,1965,43,1718,24,43
"404","2020-05-07",134,5,165,543,4085,0.439412484700122,0,0,345,371,26,1991,28,1746,10,28
"405","2020-05-08",135,5,145,546,4085,0.439412484700122,0,0,345,371,30,2021,28,1774,16,28
"406","2020-05-09",145,5,134,536,4085,0.439412484700122,0,0,345,371,18,2039,35,1809,13,35
"407","2020-05-10",149,5,144,541,4085,0.439412484700122,0,0,345,371,26,2065,29,1838,10,29
"408","2020-05-11",161,5,150,538,4085,0.439412484700122,0,0,345,371,24,2089,24,1862,16,24
"409","2020-05-12",159,5,145,529,4085,0.439412484700122,0,0,345,371,37,2126,40,1902,21,40
"410","2020-05-13",169,5,149,514,4085,0.439412484700122,0,0,345,371,33,2159,23,1925,19,23
"411","2020-05-14",177,5,146,504,4085,0.439412484700122,0,0,345,371,28,2187,33,1958,15,33
"412","2020-05-15",173,5,152,489,4085,0.439412484700122,0,0,345,371,31,2218,15,1973,14,15
"413","2020-05-16",164,5,152,488,4085,0.439412484700122,0,0,345,371,21,2239,24,1997,12,24
"414","2020-05-17",159,5,144,470,4085,0.439412484700122,0,0,345,371,23,2262,24,2021,14,24
"415","2020-05-18",149,5,163,463,4085,0.439412484700122,0,0,345,371,39,2301,20,2041,26,20
"416","2020-05-19",143,5,151,439,4085,0.439412484700122,0,0,345,371,24,2325,36,2077,16,36
"417","2020-05-20",134,5,156,431,4085,0.439412484700122,0,0,345,371,20,2345,39,2116,9,39
"418","2020-05-21",130,5,134,407,4085,0.439412484700122,0,0,345,371,24,2369,32,2148,11,32
"419","2020-05-22",128,5,119,399,4085,0.439412484700122,0,0,345,371,26,2395,28,2176,12,28
"420","2020-05-23",124,5,124,364,4085,0.439412484700122,0,0,345,371,27,2422,24,2200,9,24
"421","2020-05-24",113,5,122,348,4085,0.439412484700122,0,0,345,371,20,2442,40,2240,11,40
"422","2020-05-25",106,5,127,340,4085,0.439412484700122,0,0,345,371,21,2463,49,2289,11,49
"423","2020-05-26",99,5,114,320,4085,0.439412484700122,0,0,345,371,25,2488,45,2334,13,45
"424","2020-05-27",95,5,99,294,4085,0.439412484700122,0,0,345,371,23,2511,49,2383,15,49
"425","2020-05-28",89,5,104,287,4085,0.439412484700122,0,0,345,371,24,2535,27,2410,16,27
"426","2020-05-29",87,5,102,270,4085,0.439412484700122,0,0,345,371,23,2558,38,2448,14,38
"427","2020-05-30",83,5,109,268,4085,0.439412484700122,0,0,345,371,12,2570,32,2480,6,32
"428","2020-05-31",84,5,111,270,4085,0.439412484700122,0,0,345,371,20,2590,25,2505,11,25
"429","2020-06-01",82,5,106,261,4085,0.439412484700122,0,0,345,371,19,2609,26,2531,10,26
"430","2020-06-02",79,5,105,259,4085,0.439412484700122,0,0,345,371,16,2625,49,2580,10,49
"431","2020-06-03",83,5,92,253,4085,0.439412484700122,0,0,345,371,15,2640,39,2619,8,39
"432","2020-06-04",80,5,94,234,4085,0.439412484700122,0,0,345,371,19,2659,43,2662,11,43
"433","2020-06-05",75,5,92,221,4085,0.439412484700122,0,0,345,371,19,2678,33,2695,10,33
"434","2020-06-06",77,5,101,221,4085,0.439412484700122,0,0,345,371,18,2696,24,2719,13,24
"435","2020-06-07",70,5,95,212,4085,0.439412484700122,0,0,345,371,13,2709,24,2743,9,24
"436","2020-03-12",2,6,77,52,8124,0.90780403741999,0,0,787,942,36,61,28,43,1,28
"437","2020-03-13",2,6,117,85,8124,0.90780403741999,0,0,787,942,17,78,35,78,3,35
"438","2020-03-14",4,6,145,118,8124,0.90780403741999,0,0,787,942,32,110,41,119,12,41
"439","2020-03-15",9,6,143,175,8124,0.90780403741999,0,0,787,942,27,137,39,158,6,39
"440","2020-03-16",16,6,143,255,8124,0.90780403741999,0,0,787,942,38,175,23,181,8,23
"441","2020-03-17",26,6,143,345,8124,0.90780403741999,0,0,787,942,45,220,27,208,10,27
"442","2020-03-18",37,6,145,453,8124,0.90780403741999,0,0,787,942,37,257,24,232,11,24
"443","2020-03-19",52,6,162,592,8124,0.90780403741999,0,0,787,942,29,286,24,256,15,24
"444","2020-03-20",68,6,190,750,8124,0.90780403741999,0,0,787,942,47,333,26,282,19,26
"445","2020-03-21",90,6,186,1009,8124,0.90780403741999,0,0,787,942,47,380,31,313,15,31
"446","2020-03-22",125,6,188,1261,8124,0.90780403741999,0,0,787,942,34,414,30,343,15,30
"447","2020-03-23",155,6,172,1597,8124,0.90780403741999,0,0,787,942,35,449,38,381,13,38
"448","2020-03-24",214,6,141,1961,8124,0.90780403741999,0,0,787,942,38,487,34,415,16,34
"449","2020-03-25",282,6,135,2336,8124,0.90780403741999,0,0,787,942,56,543,20,435,24,20
"450","2020-03-26",356,6,120,2703,8124,0.90780403741999,0,0,787,942,36,579,37,472,12,37
"451","2020-03-27",433,6,111,3262,8124,0.90780403741999,0,0,787,942,40,619,24,496,12,24
"452","2020-03-28",525,6,104,3583,8124,0.90780403741999,0,0,787,942,45,664,46,542,16,46
"453","2020-03-29",619,6,131,3869,8124,0.90780403741999,0,0,787,942,38,702,48,590,15,48
"454","2020-03-30",732,6,142,4141,8124,0.90780403741999,0,0,787,942,47,749,28,618,17,28
"455","2020-03-31",839,6,127,4313,8124,0.90780403741999,0,0,787,942,45,794,35,653,14,35
"456","2020-04-01",926,6,120,4382,8124,0.90780403741999,0,0,787,942,56,850,31,684,22,31
"457","2020-04-02",1005,6,132,4374,8124,0.90780403741999,0,0,787,942,45,895,16,700,12,16
"458","2020-04-03",1106,6,133,4286,8124,0.90780403741999,0,0,787,942,52,947,36,736,15,36
"459","2020-04-04",1182,6,133,4213,8124,0.90780403741999,0,0,787,942,43,990,21,757,15,21
"460","2020-04-05",1223,6,130,4033,8124,0.90780403741999,0,0,787,942,55,1045,12,769,27,12
"461","2020-04-06",1247,6,111,3791,8124,0.90780403741999,0,0,787,942,55,1100,17,786,17,17
"462","2020-04-07",1235,6,139,3477,8124,0.90780403741999,0,0,787,942,46,1146,46,832,18,46
"463","2020-04-08",1202,6,159,3160,8124,0.90780403741999,0,0,787,942,45,1191,64,896,13,64
"464","2020-04-09",1169,6,173,2850,8124,0.90780403741999,0,0,787,942,45,1236,30,926,11,30
"465","2020-04-10",1105,6,204,2515,8124,0.90780403741999,0,0,787,942,60,1296,23,949,26,23
"466","2020-04-11",1010,6,204,2217,8124,0.90780403741999,0,0,787,942,50,1346,28,977,19,28
"467","2020-04-12",935,6,237,1874,8124,0.90780403741999,0,0,787,942,70,1416,16,993,25,16
"468","2020-04-13",839,6,208,1598,8124,0.90780403741999,0,0,787,942,43,1459,25,1018,10,25
"469","2020-04-14",746,6,200,1387,8124,0.90780403741999,0,0,787,942,42,1501,41,1059,17,41
"470","2020-04-15",671,6,193,1182,8124,0.90780403741999,0,0,787,942,46,1547,25,1084,17,25
"471","2020-04-16",576,6,172,987,8124,0.90780403741999,0,0,787,942,54,1601,17,1101,15,17
"472","2020-04-17",482,6,159,836,8124,0.90780403741999,0,0,787,942,43,1644,19,1120,12,19
"473","2020-04-18",415,6,176,704,8124,0.90780403741999,0,0,787,942,53,1697,19,1139,24,19
"474","2020-04-19",343,6,218,596,8124,0.90780403741999,0,0,787,942,61,1758,19,1158,25,19
"475","2020-04-20",287,6,244,496,8124,0.90780403741999,0,0,787,942,52,1810,10,1168,18,10
"476","2020-04-21",234,6,225,396,8124,0.90780403741999,0,0,787,942,46,1856,18,1186,21,18
"477","2020-04-22",188,6,238,329,8124,0.90780403741999,0,0,787,942,53,1909,12,1198,23,12
"478","2020-04-23",155,6,215,279,8124,0.90780403741999,0,0,787,942,52,1961,11,1209,21,11
"479","2020-04-24",133,6,231,228,8124,0.90780403741999,0,0,787,942,51,2012,17,1226,25,17
"480","2020-04-25",106,6,252,194,8124,0.90780403741999,0,0,787,942,45,2057,57,1283,26,57
"481","2020-04-26",85,6,229,175,8124,0.90780403741999,0,0,787,942,49,2106,73,1356,22,73
"482","2020-04-27",70,6,205,144,8124,0.90780403741999,0,0,787,942,37,2143,56,1412,13,56
"483","2020-04-28",56,6,180,130,8124,0.90780403741999,0,0,787,942,48,2191,37,1449,15,37
"484","2020-04-29",46,6,173,100,8124,0.90780403741999,0,0,787,942,48,2239,46,1495,12,46
"485","2020-04-30",39,6,171,88,8124,0.90780403741999,0,0,787,942,42,2281,59,1554,9,59
"486","2020-05-01",29,6,152,69,8124,0.90780403741999,0,0,787,942,46,2327,36,1590,9,36
"487","2020-05-02",31,6,133,57,8124,0.90780403741999,0,0,787,942,43,2370,25,1615,16,25
"488","2020-05-03",28,6,116,52,8124,0.90780403741999,0,0,787,942,50,2420,48,1663,23,48
"489","2020-05-04",24,6,114,48,8124,0.90780403741999,0,0,787,942,32,2452,32,1695,6,32
"490","2020-05-05",20,6,177,43,8124,0.90780403741999,0,0,787,942,39,2491,36,1731,10,36
"491","2020-05-06",19,6,221,39,8124,0.90780403741999,0,0,787,942,33,2524,36,1767,10,36
"492","2020-05-07",19,6,206,39,8124,0.90780403741999,0,0,787,942,39,2563,23,1790,9,23
"493","2020-05-08",16,6,200,36,8124,0.90780403741999,0,0,787,942,32,2595,11,1801,9,11
"494","2020-05-09",14,6,178,33,8124,0.90780403741999,0,0,787,942,40,2635,60,1861,10,60
"495","2020-05-10",10,6,157,31,8124,0.90780403741999,0,0,787,942,26,2661,59,1920,7,59
"496","2020-05-11",9,6,152,32,8124,0.90780403741999,0,0,787,942,23,2684,34,1954,6,34
"497","2020-05-12",10,6,149,33,8124,0.90780403741999,0,0,787,942,31,2715,23,1977,14,23
"498","2020-05-13",9,6,138,28,8124,0.90780403741999,0,0,787,942,41,2756,16,1993,5,16
"499","2020-05-14",8,6,121,34,8124,0.90780403741999,0,0,787,942,30,2786,15,2008,7,15
"500","2020-05-15",8,6,114,36,8124,0.90780403741999,0,0,787,942,36,2822,27,2035,13,27
"501","2020-05-16",7,6,104,33,8124,0.90780403741999,0,0,787,942,26,2848,25,2060,7,25
"502","2020-05-17",8,6,149,32,8124,0.90780403741999,0,0,787,942,31,2879,65,2125,11,65
"503","2020-05-18",8,6,148,33,8124,0.90780403741999,0,0,787,942,27,2906,40,2165,13,40
"504","2020-05-19",9,6,161,33,8124,0.90780403741999,0,0,787,942,22,2928,50,2215,9,50
"505","2020-05-20",11,6,183,30,8124,0.90780403741999,0,0,787,942,33,2961,40,2255,14,40
"506","2020-05-21",10,6,213,30,8124,0.90780403741999,0,0,787,942,20,2981,50,2305,6,50
"507","2020-05-22",10,6,200,28,8124,0.90780403741999,0,0,787,942,23,3004,54,2359,8,54
"508","2020-05-23",9,6,242,28,8124,0.90780403741999,0,0,787,942,26,3030,34,2393,6,34
"509","2020-05-24",10,6,256,27,8124,0.90780403741999,0,0,787,942,15,3045,18,2411,4,19
"510","2020-05-25",9,6,251,27,8124,0.90780403741999,0,0,787,942,22,3067,17,2428,2,17
"511","2020-05-26",7,6,246,25,8124,0.90780403741999,0,0,787,942,29,3096,29,2457,12,29
"512","2020-05-27",5,6,236,24,8124,0.90780403741999,0,0,787,942,18,3114,38,2495,9,38
"513","2020-05-28",6,6,204,23,8124,0.90780403741999,0,0,787,942,15,3129,20,2515,2,20
"514","2020-05-29",7,6,190,22,8124,0.90780403741999,0,0,787,942,21,3150,21,2536,3,21
"515","2020-05-30",7,6,166,20,8124,0.90780403741999,0,0,787,942,19,3169,12,2548,4,12
"516","2020-05-31",6,6,174,18,8124,0.90780403741999,0,0,787,942,18,3187,16,2564,3,16
"517","2020-06-01",6,6,178,19,8124,0.90780403741999,0,0,787,942,14,3201,15,2579,2,15
"518","2020-06-02",6,6,181,18,8124,0.90780403741999,0,0,787,942,10,3211,9,2588,4,9
"519","2020-06-03",6,6,181,19,8124,0.90780403741999,0,0,787,942,16,3227,13,2601,8,13
"520","2020-06-04",6,6,168,19,8124,0.90780403741999,0,0,787,942,21,3248,38,2639,10,38
"521","2020-06-05",5,6,141,16,8124,0.90780403741999,0,0,787,942,21,3269,29,2668,6,29
"522","2020-06-06",5,6,132,16,8124,0.90780403741999,0,0,787,942,23,3292,39,2707,6,39
"523","2020-06-07",5,6,144,15,8124,0.90780403741999,0,0,787,942,11,3303,45,2752,5,45
"524","2020-03-12",1,7,21,87,5164,0.279821843532146,0,0,455,461,15,29,20,39,1,20
"525","2020-03-13",1,7,40,140,5164,0.279821843532146,0,0,455,461,15,44,10,49,5,10
"526","2020-03-14",2,7,41,204,5164,0.279821843532146,0,0,455,461,17,61,4,53,7,4
"527","2020-03-15",12,7,38,269,5164,0.279821843532146,0,0,455,461,25,86,3,56,7,3
"528","2020-03-16",27,7,53,329,5164,0.279821843532146,0,0,455,461,35,121,15,71,15,15
"529","2020-03-17",41,7,51,386,5164,0.279821843532146,0,0,455,461,27,148,27,98,17,27
"530","2020-03-18",58,7,62,451,5164,0.279821843532146,0,0,455,461,30,178,33,131,14,33
"531","2020-03-19",79,7,67,500,5164,0.279821843532146,0,0,455,461,35,213,14,145,20,14
"532","2020-03-20",100,7,66,560,5164,0.279821843532146,0,0,455,461,28,241,11,156,17,11
"533","2020-03-21",116,7,69,589,5164,0.279821843532146,0,0,455,461,45,286,42,198,30,42
"534","2020-03-22",128,7,67,622,5164,0.279821843532146,0,0,455,461,35,321,29,227,15,29
"535","2020-03-23",133,7,78,649,5164,0.279821843532146,0,0,455,461,31,352,43,270,24,43
"536","2020-03-24",152,7,84,685,5164,0.279821843532146,0,0,455,461,38,390,43,313,19,43
"537","2020-03-25",164,7,82,716,5164,0.279821843532146,0,0,455,461,29,419,13,326,16,13
"538","2020-03-26",180,7,78,742,5164,0.279821843532146,0,0,455,461,34,453,15,341,19,15
"539","2020-03-27",186,7,67,765,5164,0.279821843532146,0,0,455,461,30,483,40,381,16,40
"540","2020-03-28",193,7,68,785,5164,0.279821843532146,0,0,455,461,52,535,41,422,36,41
"541","2020-03-29",208,7,94,786,5164,0.279821843532146,0,0,455,461,31,566,51,473,27,51
"542","2020-03-30",218,7,100,789,5164,0.279821843532146,0,0,455,461,31,597,59,532,20,59
"543","2020-03-31",221,7,97,791,5164,0.279821843532146,0,0,455,461,33,630,31,563,22,31
"544","2020-04-01",223,7,108,817,5164,0.279821843532146,0,0,455,461,46,676,24,587,29,24
"545","2020-04-02",219,7,102,837,5164,0.279821843532146,0,0,455,461,55,731,38,625,39,38
"546","2020-04-03",217,7,103,857,5164,0.279821843532146,0,0,455,461,38,769,27,652,28,27
"547","2020-04-04",219,7,95,877,5164,0.279821843532146,0,0,455,461,30,799,31,683,20,31
"548","2020-04-05",210,7,114,882,5164,0.279821843532146,0,0,455,461,37,836,18,701,24,18
"549","2020-04-06",221,7,119,904,5164,0.279821843532146,0,0,455,461,39,875,37,738,25,37
"550","2020-04-07",212,7,109,884,5164,0.279821843532146,0,0,455,461,39,914,19,757,26,19
"551","2020-04-08",226,7,103,888,5164,0.279821843532146,0,0,455,461,47,961,35,792,37,35
"552","2020-04-09",221,7,95,871,5164,0.279821843532146,0,0,455,461,53,1014,42,834,37,42
"553","2020-04-10",224,7,85,863,5164,0.279821843532146,0,0,455,461,38,1052,47,881,31,47
"554","2020-04-11",241,7,87,853,5164,0.279821843532146,0,0,455,461,42,1094,24,905,19,24
"555","2020-04-12",237,7,114,860,5164,0.279821843532146,0,0,455,461,44,1138,15,920,29,15
"556","2020-04-13",229,7,138,832,5164,0.279821843532146,0,0,455,461,43,1181,31,951,24,31
"557","2020-04-14",233,7,151,824,5164,0.279821843532146,0,0,455,461,39,1220,31,982,25,31
"558","2020-04-15",218,7,157,825,5164,0.279821843532146,0,0,455,461,66,1286,42,1024,41,42
"559","2020-04-16",214,7,162,819,5164,0.279821843532146,0,0,455,461,42,1328,56,1080,24,56
"560","2020-04-17",221,7,174,789,5164,0.279821843532146,0,0,455,461,45,1373,40,1120,28,40
"561","2020-04-18",219,7,191,787,5164,0.279821843532146,0,0,455,461,57,1430,29,1149,29,29
"562","2020-04-19",223,7,184,789,5164,0.279821843532146,0,0,455,461,46,1476,40,1189,27,40
"563","2020-04-20",218,7,176,788,5164,0.279821843532146,0,0,455,461,45,1521,25,1214,26,25
"564","2020-04-21",227,7,177,790,5164,0.279821843532146,0,0,455,461,50,1571,38,1252,39,38
"565","2020-04-22",229,7,197,764,5164,0.279821843532146,0,0,455,461,43,1614,29,1281,30,29
"566","2020-04-23",225,7,203,746,5164,0.279821843532146,0,0,455,461,41,1655,15,1296,20,15
"567","2020-04-24",211,7,191,743,5164,0.279821843532146,0,0,455,461,33,1688,27,1323,19,27
"568","2020-04-25",193,7,179,732,5164,0.279821843532146,0,0,455,461,44,1732,21,1344,24,21
"569","2020-04-26",200,7,172,710,5164,0.279821843532146,0,0,455,461,41,1773,13,1357,24,13
"570","2020-04-27",188,7,154,693,5164,0.279821843532146,0,0,455,461,33,1806,13,1370,21,13
"571","2020-04-28",177,7,133,676,5164,0.279821843532146,0,0,455,461,41,1847,42,1412,24,42
"572","2020-04-29",188,7,118,660,5164,0.279821843532146,0,0,455,461,54,1901,30,1442,35,30
"573","2020-04-30",191,7,100,641,5164,0.279821843532146,0,0,455,461,48,1949,20,1462,31,20
"574","2020-05-01",186,7,96,621,5164,0.279821843532146,0,0,455,461,37,1986,55,1517,23,55
"575","2020-05-02",188,7,97,623,5164,0.279821843532146,0,0,455,461,47,2033,39,1556,30,39
"576","2020-05-03",181,7,99,621,5164,0.279821843532146,0,0,455,461,46,2079,18,1574,35,18
"577","2020-05-04",187,7,104,626,5164,0.279821843532146,0,0,455,461,32,2111,25,1599,17,25
"578","2020-05-05",184,7,98,628,5164,0.279821843532146,0,0,455,461,62,2173,30,1629,34,30
"579","2020-05-06",163,7,83,604,5164,0.279821843532146,0,0,455,461,40,2213,16,1645,24,16
"580","2020-05-07",156,7,80,600,5164,0.279821843532146,0,0,455,461,27,2240,8,1653,14,8
"581","2020-05-08",165,7,115,583,5164,0.279821843532146,0,0,455,461,33,2273,10,1663,20,10
"582","2020-05-09",161,7,120,580,5164,0.279821843532146,0,0,455,461,46,2319,9,1672,29,9
"583","2020-05-10",168,7,108,589,5164,0.279821843532146,0,0,455,461,43,2362,5,1677,20,5
"584","2020-05-11",162,7,120,577,5164,0.279821843532146,0,0,455,461,38,2400,14,1691,22,14
"585","2020-05-12",168,7,122,562,5164,0.279821843532146,0,0,455,461,39,2439,4,1695,29,4
"586","2020-05-13",163,7,115,548,5164,0.279821843532146,0,0,455,461,44,2483,5,1700,23,5
"587","2020-05-14",169,7,121,537,5164,0.279821843532146,0,0,455,461,24,2507,19,1719,17,19
"588","2020-05-15",167,7,136,549,5164,0.279821843532146,0,0,455,461,29,2536,13,1732,16,13
"589","2020-05-16",161,7,129,537,5164,0.279821843532146,0,0,455,461,45,2581,50,1782,27,50
"590","2020-05-17",147,7,122,515,5164,0.279821843532146,0,0,455,461,39,2620,57,1839,26,57
"591","2020-05-18",146,7,109,511,5164,0.279821843532146,0,0,455,461,33,2653,56,1895,22,56
"592","2020-05-19",141,7,102,496,5164,0.279821843532146,0,0,455,461,27,2680,39,1934,19,39
"593","2020-05-20",149,7,93,480,5164,0.279821843532146,0,0,455,461,27,2707,14,1948,18,14
"594","2020-05-21",146,7,73,465,5164,0.279821843532146,0,0,455,461,28,2735,14,1962,20,14
"595","2020-05-22",137,7,92,435,5164,0.279821843532146,0,0,455,461,36,2771,38,2000,29,38
"596","2020-05-23",140,7,108,408,5164,0.279821843532146,0,0,455,461,35,2806,23,2023,19,23
"597","2020-05-24",129,7,111,403,5164,0.279821843532146,0,0,455,461,28,2834,18,2041,23,18
"598","2020-05-25",128,7,98,399,5164,0.279821843532146,0,0,455,461,26,2860,17,2058,17,17
"599","2020-05-26",113,7,88,371,5164,0.279821843532146,0,0,455,461,33,2893,14,2072,25,14
"600","2020-05-27",101,7,84,352,5164,0.279821843532146,0,0,455,461,12,2905,36,2108,7,36
"601","2020-05-28",97,7,85,328,5164,0.279821843532146,0,0,455,461,20,2925,34,2142,15,34
"602","2020-05-29",92,7,74,323,5164,0.279821843532146,0,0,455,461,20,2945,21,2163,16,21
"603","2020-05-30",87,7,68,304,5164,0.279821843532146,0,0,455,461,18,2963,29,2192,10,29
"604","2020-05-31",89,7,82,298,5164,0.279821843532146,0,0,455,461,24,2987,31,2223,15,31
"605","2020-06-01",87,7,76,292,5164,0.279821843532146,0,0,455,461,23,3010,20,2243,13,20
"606","2020-06-02",89,7,93,275,5164,0.279821843532146,0,0,455,461,22,3032,60,2303,14,60
"607","2020-06-03",87,7,92,266,5164,0.279821843532146,0,0,455,461,16,3048,40,2343,12,40
"608","2020-06-04",85,7,87,253,5164,0.279821843532146,0,0,455,461,20,3068,30,2373,15,30
"609","2020-06-05",89,7,77,251,5164,0.279821843532146,0,0,455,461,23,3091,29,2402,17,29
"610","2020-06-06",85,7,75,247,5164,0.279821843532146,0,0,455,461,11,3102,15,2417,9,15
"611","2020-06-07",82,7,74,234,5164,0.279821843532146,0,0,455,461,11,3113,19,2436,7,19
"612","2020-03-13",2,8,141,82,4538,0.398633759365359,0,0,385,1061,32,97,25,39,3,25
"613","2020-03-14",4,8,134,125,4538,0.398633759365359,0,0,385,1061,29,126,26,65,8,26
"614","2020-03-15",9,8,137,164,4538,0.398633759365359,0,0,385,1061,35,161,12,77,8,12
"615","2020-03-16",10,8,165,212,4538,0.398633759365359,0,0,385,1061,39,200,10,87,14,10
"616","2020-03-17",20,8,178,255,4538,0.398633759365359,0,0,385,1061,32,232,19,106,9,19
"617","2020-03-18",28,8,173,314,4538,0.398633759365359,0,0,385,1061,28,260,16,122,9,16
"618","2020-03-19",36,8,164,355,4538,0.398633759365359,0,0,385,1061,35,295,32,154,9,32
"619","2020-03-20",48,8,173,401,4538,0.398633759365359,0,0,385,1061,48,343,21,175,21,21
"620","2020-03-21",60,8,203,438,4538,0.398633759365359,0,0,385,1061,36,379,31,206,14,31
"621","2020-03-22",74,8,205,484,4538,0.398633759365359,0,0,385,1061,39,418,30,236,19,30
"622","2020-03-23",87,8,195,525,4538,0.398633759365359,0,0,385,1061,39,457,27,263,16,27
"623","2020-03-24",100,8,185,544,4538,0.398633759365359,0,0,385,1061,36,493,18,281,13,18
"624","2020-03-25",118,8,195,583,4538,0.398633759365359,0,0,385,1061,42,535,11,292,18,11
"625","2020-03-26",134,8,208,594,4538,0.398633759365359,0,0,385,1061,30,565,26,318,9,26
"626","2020-03-27",144,8,201,615,4538,0.398633759365359,0,0,385,1061,55,620,21,339,24,21
"627","2020-03-28",156,8,226,624,4538,0.398633759365359,0,0,385,1061,57,677,15,354,15,15
"628","2020-03-29",167,8,249,633,4538,0.398633759365359,0,0,385,1061,35,712,13,367,11,13
"629","2020-03-30",183,8,240,660,4538,0.398633759365359,0,0,385,1061,54,766,8,375,21,8
"630","2020-03-31",189,8,257,674,4538,0.398633759365359,0,0,385,1061,53,819,11,386,21,11
"631","2020-04-01",187,8,249,694,4538,0.398633759365359,0,0,385,1061,32,851,27,413,16,27
"632","2020-04-02",190,8,236,695,4538,0.398633759365359,0,0,385,1061,50,901,15,428,22,15
"633","2020-04-03",192,8,240,706,4538,0.398633759365359,0,0,385,1061,59,960,21,449,25,21
"634","2020-04-04",201,8,266,711,4538,0.398633759365359,0,0,385,1061,58,1018,18,467,18,18
"635","2020-04-05",188,8,261,712,4538,0.398633759365359,0,0,385,1061,69,1087,31,498,31,31
"636","2020-04-06",185,8,248,718,4538,0.398633759365359,0,0,385,1061,56,1143,44,542,23,44
"637","2020-04-07",183,8,213,726,4538,0.398633759365359,0,0,385,1061,63,1206,32,574,20,32
"638","2020-04-08",182,8,243,733,4538,0.398633759365359,0,0,385,1061,55,1261,42,616,20,42
"639","2020-04-09",184,8,231,734,4538,0.398633759365359,0,0,385,1061,51,1312,29,645,20,29
"640","2020-04-10",188,8,231,734,4538,0.398633759365359,0,0,385,1061,47,1359,20,665,11,20
"641","2020-04-11",181,8,234,735,4538,0.398633759365359,0,0,385,1061,53,1412,46,711,18,46
"642","2020-04-12",207,8,229,740,4538,0.398633759365359,0,0,385,1061,45,1457,45,756,17,45
"643","2020-04-13",208,8,220,729,4538,0.398633759365359,0,0,385,1061,48,1505,46,802,12,46
"644","2020-04-14",215,8,198,724,4538,0.398633759365359,0,0,385,1061,52,1557,26,828,18,26
"645","2020-04-15",225,8,195,719,4538,0.398633759365359,0,0,385,1061,40,1597,15,843,8,15
"646","2020-04-16",223,8,210,707,4538,0.398633759365359,0,0,385,1061,54,1651,9,852,5,9
"647","2020-04-17",231,8,237,715,4538,0.398633759365359,0,0,385,1061,48,1699,31,883,12,31
"648","2020-04-18",228,8,228,734,4538,0.398633759365359,0,0,385,1061,51,1750,22,905,7,22
"649","2020-04-19",215,8,235,749,4538,0.398633759365359,0,0,385,1061,49,1799,23,928,9,23
"650","2020-04-20",212,8,258,751,4538,0.398633759365359,0,0,385,1061,43,1842,14,942,12,14
"651","2020-04-21",202,8,249,747,4538,0.398633759365359,0,0,385,1061,59,1901,14,956,22,14
"652","2020-04-22",199,8,231,726,4538,0.398633759365359,0,0,385,1061,42,1943,54,1010,13,54
"653","2020-04-23",197,8,219,726,4538,0.398633759365359,0,0,385,1061,65,2008,18,1028,22,18
"654","2020-04-24",190,8,211,734,4538,0.398633759365359,0,0,385,1061,47,2055,45,1073,15,45
"655","2020-04-25",195,8,194,728,4538,0.398633759365359,0,0,385,1061,46,2101,26,1099,16,26
"656","2020-04-26",205,8,216,722,4538,0.398633759365359,0,0,385,1061,51,2152,16,1115,20,16
"657","2020-04-27",209,8,218,726,4538,0.398633759365359,0,0,385,1061,45,2197,44,1159,17,44
"658","2020-04-28",215,8,242,709,4538,0.398633759365359,0,0,385,1061,53,2250,54,1213,14,54
"659","2020-04-29",212,8,265,699,4538,0.398633759365359,0,0,385,1061,38,2288,53,1266,8,53
"660","2020-04-30",221,8,286,676,4538,0.398633759365359,0,0,385,1061,28,2316,27,1293,5,27
"661","2020-05-01",219,8,311,673,4538,0.398633759365359,0,0,385,1061,26,2342,53,1346,7,53
"662","2020-05-02",208,8,341,672,4538,0.398633759365359,0,0,385,1061,41,2383,41,1387,9,41
"663","2020-05-03",200,8,336,662,4538,0.398633759365359,0,0,385,1061,32,2415,31,1418,5,31
"664","2020-05-04",191,8,336,620,4538,0.398633759365359,0,0,385,1061,30,2445,20,1438,2,20
"665","2020-05-05",183,8,310,612,4538,0.398633759365359,0,0,385,1061,34,2479,35,1473,2,35
"666","2020-05-06",182,8,297,596,4538,0.398633759365359,0,0,385,1061,32,2511,25,1498,7,25
"667","2020-05-07",165,8,286,570,4538,0.398633759365359,0,0,385,1061,40,2551,22,1520,3,22
"668","2020-05-08",163,8,278,543,4538,0.398633759365359,0,0,385,1061,40,2591,20,1540,9,20
"669","2020-05-09",166,8,287,541,4538,0.398633759365359,0,0,385,1061,27,2618,20,1560,5,20
"670","2020-05-10",152,8,280,515,4538,0.398633759365359,0,0,385,1061,29,2647,9,1569,6,9
"671","2020-05-11",160,8,278,511,4538,0.398633759365359,0,0,385,1061,38,2685,33,1602,13,33
"672","2020-05-12",154,8,302,517,4538,0.398633759365359,0,0,385,1061,32,2717,43,1645,7,43
"673","2020-05-13",147,8,297,507,4538,0.398633759365359,0,0,385,1061,31,2748,40,1685,8,40
"674","2020-05-14",143,8,307,501,4538,0.398633759365359,0,0,385,1061,31,2779,30,1715,5,30
"675","2020-05-15",140,8,299,496,4538,0.398633759365359,0,0,385,1061,27,2806,19,1734,9,19
"676","2020-05-16",140,8,302,473,4538,0.398633759365359,0,0,385,1061,34,2840,14,1748,7,14
"677","2020-05-17",132,8,331,470,4538,0.398633759365359,0,0,385,1061,31,2871,25,1773,6,25
"678","2020-05-18",117,8,320,465,4538,0.398633759365359,0,0,385,1061,20,2891,20,1793,3,20
"679","2020-05-19",132,8,298,455,4538,0.398633759365359,0,0,385,1061,27,2918,20,1813,8,20
"680","2020-05-20",128,8,300,436,4538,0.398633759365359,0,0,385,1061,29,2947,32,1845,7,32
"681","2020-05-21",130,8,313,444,4538,0.398633759365359,0,0,385,1061,18,2965,17,1862,6,17
"682","2020-05-22",124,8,316,417,4538,0.398633759365359,0,0,385,1061,16,2981,15,1877,4,15
"683","2020-05-23",120,8,302,396,4538,0.398633759365359,0,0,385,1061,19,3000,24,1901,3,24
"684","2020-05-24",129,8,305,367,4538,0.398633759365359,0,0,385,1061,21,3021,17,1918,6,17
"685","2020-05-25",133,8,304,355,4538,0.398633759365359,0,0,385,1061,22,3043,33,1951,2,33
"686","2020-05-26",113,8,316,348,4538,0.398633759365359,0,0,385,1061,19,3062,29,1980,4,29
"687","2020-05-27",114,8,303,330,4538,0.398633759365359,0,0,385,1061,20,3082,24,2004,4,24
"688","2020-05-28",109,8,287,320,4538,0.398633759365359,0,0,385,1061,18,3100,24,2028,8,24
"689","2020-05-29",104,8,312,304,4538,0.398633759365359,0,0,385,1061,21,3121,30,2058,6,30
"690","2020-05-30",103,8,303,313,4538,0.398633759365359,0,0,385,1061,20,3141,20,2078,5,20
"691","2020-05-31",95,8,284,285,4538,0.398633759365359,0,0,385,1061,15,3156,14,2092,2,14
"692","2020-06-01",88,8,275,274,4538,0.398633759365359,0,0,385,1061,16,3172,10,2102,6,10
"693","2020-06-02",93,8,280,262,4538,0.398633759365359,0,0,385,1061,19,3191,8,2110,3,8
"694","2020-06-03",93,8,277,261,4538,0.398633759365359,0,0,385,1061,13,3204,25,2135,1,25
"695","2020-06-04",98,8,280,253,4538,0.398633759365359,0,0,385,1061,20,3224,12,2147,7,12
"696","2020-06-05",92,8,281,241,4538,0.398633759365359,0,0,385,1061,18,3242,15,2162,5,15
"697","2020-06-06",84,8,274,228,4538,0.398633759365359,0,0,385,1061,16,3258,9,2171,4,9
"698","2020-06-07",82,8,249,222,4538,0.398633759365359,0,0,385,1061,15,3273,10,2181,3,10
"699","2020-03-14",1,9,98,46,7654,0.962633916906193,0,0,740,743,11,34,7,38,5,7
"700","2020-03-15",2,9,109,71,7654,0.962633916906193,0,0,740,743,17,51,29,67,14,29
"701","2020-03-16",2,9,110,108,7654,0.962633916906193,0,0,740,743,17,68,18,85,12,18
"702","2020-03-17",6,9,115,153,7654,0.962633916906193,0,0,740,743,16,84,29,114,10,29
"703","2020-03-18",8,9,124,199,7654,0.962633916906193,0,0,740,743,16,100,18,132,12,18
"704","2020-03-19",18,9,132,266,7654,0.962633916906193,0,0,740,743,25,125,18,150,15,18
"705","2020-03-20",27,9,135,348,7654,0.962633916906193,0,0,740,743,25,150,21,171,19,21
"706","2020-03-21",35,9,123,443,7654,0.962633916906193,0,0,740,743,31,181,39,210,29,39
"707","2020-03-22",45,9,117,567,7654,0.962633916906193,0,0,740,743,43,224,31,241,36,31
"708","2020-03-23",72,9,119,691,7654,0.962633916906193,0,0,740,743,36,260,33,274,27,33
"709","2020-03-24",89,9,149,839,7654,0.962633916906193,0,0,740,743,54,314,40,314,50,40
"710","2020-03-25",124,9,151,1014,7654,0.962633916906193,0,0,740,743,47,361,50,364,42,50
"711","2020-03-26",142,9,138,1213,7654,0.962633916906193,0,0,740,743,45,406,31,395,36,31
"712","2020-03-27",172,9,130,1523,7654,0.962633916906193,0,0,740,743,46,452,25,420,37,25
"713","2020-03-28",221,9,122,1735,7654,0.962633916906193,0,0,740,743,55,507,51,471,50,51
"714","2020-03-29",267,9,131,1983,7654,0.962633916906193,0,0,740,743,56,563,49,520,45,49
"715","2020-03-30",306,9,146,2273,7654,0.962633916906193,0,0,740,743,54,617,29,549,45,29
"716","2020-03-31",376,9,164,2484,7654,0.962633916906193,0,0,740,743,58,675,16,565,48,16
"717","2020-04-01",429,9,174,2804,7654,0.962633916906193,0,0,740,743,72,747,32,597,63,32
"718","2020-04-02",516,9,182,3090,7654,0.962633916906193,0,0,740,743,70,817,28,625,66,28
"719","2020-04-03",576,9,174,3305,7654,0.962633916906193,0,0,740,743,80,897,44,669,73,44
"720","2020-04-04",659,9,167,3534,7654,0.962633916906193,0,0,740,743,77,974,23,692,70,23
"721","2020-04-05",742,9,191,3628,7654,0.962633916906193,0,0,740,743,67,1041,11,703,63,11
"722","2020-04-06",826,9,227,3780,7654,0.962633916906193,0,0,740,743,54,1095,6,709,43,6
"723","2020-04-07",883,9,241,3775,7654,0.962633916906193,0,0,740,743,66,1161,6,715,60,6
"724","2020-04-08",966,9,242,3764,7654,0.962633916906193,0,0,740,743,83,1244,10,725,78,10
"725","2020-04-09",1013,9,254,3726,7654,0.962633916906193,0,0,740,743,85,1329,48,773,76,48
"726","2020-04-10",1091,9,234,3587,7654,0.962633916906193,0,0,740,743,91,1420,18,791,79,18
"727","2020-04-11",1086,9,204,3444,7654,0.962633916906193,0,0,740,743,93,1513,12,803,86,12
"728","2020-04-12",1068,9,188,3191,7654,0.962633916906193,0,0,740,743,86,1599,11,814,80,11
"729","2020-04-13",1031,9,162,2964,7654,0.962633916906193,0,0,740,743,73,1672,15,829,65,15
"730","2020-04-14",1018,9,151,2696,7654,0.962633916906193,0,0,740,743,85,1757,64,893,81,64
"731","2020-04-15",956,9,200,2411,7654,0.962633916906193,0,0,740,743,78,1835,70,963,71,70
"732","2020-04-16",897,9,208,2154,7654,0.962633916906193,0,0,740,743,100,1935,59,1022,92,59
"733","2020-04-17",801,9,217,1876,7654,0.962633916906193,0,0,740,743,96,2031,53,1075,92,53
"734","2020-04-18",751,9,211,1647,7654,0.962633916906193,0,0,740,743,96,2127,34,1109,87,34
"735","2020-04-19",695,9,183,1411,7654,0.962633916906193,0,0,740,743,64,2191,29,1138,61,29
"736","2020-04-20",646,9,212,1213,7654,0.962633916906193,0,0,740,743,99,2290,52,1190,96,52
"737","2020-04-21",571,9,243,1025,7654,0.962633916906193,0,0,740,743,85,2375,23,1213,76,23
"738","2020-04-22",501,9,259,888,7654,0.962633916906193,0,0,740,743,77,2452,14,1227,70,14
"739","2020-04-23",435,9,253,730,7654,0.962633916906193,0,0,740,743,71,2523,25,1252,67,25
"740","2020-04-24",382,9,223,597,7654,0.962633916906193,0,0,740,743,77,2600,42,1294,68,42
"741","2020-04-25",330,9,233,512,7654,0.962633916906193,0,0,740,743,60,2660,63,1357,56,63
"742","2020-04-26",288,9,213,442,7654,0.962633916906193,0,0,740,743,53,2713,46,1403,50,46
"743","2020-04-27",245,9,231,368,7654,0.962633916906193,0,0,740,743,60,2773,34,1437,56,34
"744","2020-04-28",197,9,257,314,7654,0.962633916906193,0,0,740,743,54,2827,32,1469,52,32
"745","2020-04-29",162,9,220,254,7654,0.962633916906193,0,0,740,743,64,2891,40,1509,56,40
"746","2020-04-30",133,9,191,216,7654,0.962633916906193,0,0,740,743,57,2948,32,1541,53,32
"747","2020-05-01",114,9,177,168,7654,0.962633916906193,0,0,740,743,59,3007,46,1587,54,46
"748","2020-05-02",87,9,182,138,7654,0.962633916906193,0,0,740,743,48,3055,23,1610,42,23
"749","2020-05-03",69,9,197,118,7654,0.962633916906193,0,0,740,743,29,3084,20,1630,25,20
"750","2020-05-04",54,9,189,93,7654,0.962633916906193,0,0,740,743,63,3147,59,1689,54,59
"751","2020-05-05",47,9,200,81,7654,0.962633916906193,0,0,740,743,57,3204,78,1767,56,78
"752","2020-05-06",45,9,197,73,7654,0.962633916906193,0,0,740,743,53,3257,37,1804,50,37
"753","2020-05-07",42,9,200,63,7654,0.962633916906193,0,0,740,743,52,3309,67,1871,48,67
"754","2020-05-08",37,9,181,55,7654,0.962633916906193,0,0,740,743,42,3351,54,1925,39,54
"755","2020-05-09",31,9,170,50,7654,0.962633916906193,0,0,740,743,34,3385,49,1974,30,49
"756","2020-05-10",26,9,202,45,7654,0.962633916906193,0,0,740,743,43,3428,28,2002,36,28
"757","2020-05-11",21,9,191,40,7654,0.962633916906193,0,0,740,743,49,3477,54,2056,46,54
"758","2020-05-12",17,9,212,37,7654,0.962633916906193,0,0,740,743,42,3519,31,2087,39,31
"759","2020-05-13",15,9,239,35,7654,0.962633916906193,0,0,740,743,49,3568,27,2114,44,27
"760","2020-05-14",10,9,235,32,7654,0.962633916906193,0,0,740,743,41,3609,28,2142,37,28
"761","2020-05-15",9,9,223,31,7654,0.962633916906193,0,0,740,743,43,3652,28,2170,34,28
"762","2020-05-16",9,9,218,28,7654,0.962633916906193,0,0,740,743,37,3689,22,2192,33,22
"763","2020-05-17",9,9,202,27,7654,0.962633916906193,0,0,740,743,30,3719,9,2201,28,9
"764","2020-05-18",8,9,193,25,7654,0.962633916906193,0,0,740,743,20,3739,17,2218,18,17
"765","2020-05-19",8,9,180,24,7654,0.962633916906193,0,0,740,743,45,3784,43,2261,39,43
"766","2020-05-20",6,9,172,22,7654,0.962633916906193,0,0,740,743,35,3819,19,2280,31,19
"767","2020-05-21",6,9,159,19,7654,0.962633916906193,0,0,740,743,34,3853,50,2330,32,50
"768","2020-05-22",4,9,145,19,7654,0.962633916906193,0,0,740,743,26,3879,46,2376,23,46
"769","2020-05-23",3,9,138,19,7654,0.962633916906193,0,0,740,743,18,3897,52,2428,14,52
"770","2020-05-24",3,9,121,19,7654,0.962633916906193,0,0,740,743,20,3917,38,2466,19,38
"771","2020-05-25",3,9,112,23,7654,0.962633916906193,0,0,740,743,22,3939,50,2516,18,50
"772","2020-05-26",3,9,125,24,7654,0.962633916906193,0,0,740,743,26,3965,68,2584,25,68
"773","2020-05-27",4,9,114,23,7654,0.962633916906193,0,0,740,743,17,3982,35,2619,12,35
"774","2020-05-28",4,9,106,22,7654,0.962633916906193,0,0,740,743,31,4013,22,2641,26,22
"775","2020-05-29",4,9,86,22,7654,0.962633916906193,0,0,740,743,15,4028,22,2663,14,22
"776","2020-05-30",5,9,102,23,7654,0.962633916906193,0,0,740,743,14,4042,11,2674,12,11
"777","2020-05-31",5,9,100,24,7654,0.962633916906193,0,0,740,743,16,4058,41,2715,15,41
"778","2020-06-01",8,9,100,26,7654,0.962633916906193,0,0,740,743,25,4083,21,2736,23,21
"779","2020-06-02",9,9,101,26,7654,0.962633916906193,0,0,740,743,20,4103,25,2761,17,25
"780","2020-06-03",8,9,116,25,7654,0.962633916906193,0,0,740,743,19,4122,19,2780,18,19
"781","2020-06-04",8,9,108,27,7654,0.962633916906193,0,0,740,743,22,4144,21,2801,20,21
"782","2020-06-05",8,9,109,24,7654,0.962633916906193,0,0,740,743,16,4160,43,2844,14,43
"783","2020-06-06",8,9,121,25,7654,0.962633916906193,0,0,740,743,21,4181,25,2869,19,25
"784","2020-06-07",8,9,136,24,7654,0.962633916906193,0,0,740,743,12,4193,22,2891,12,22
"785","2020-03-13",1,10,52,22,1991,0.61225514816675,0,0,166,828,28,81,14,36,5,14
"786","2020-03-14",3,10,58,35,1991,0.61225514816675,0,0,166,828,39,120,21,57,13,21
"787","2020-03-15",3,10,59,50,1991,0.61225514816675,0,0,166,828,38,158,13,70,10,13
"788","2020-03-16",4,10,67,65,1991,0.61225514816675,0,0,166,828,38,196,3,73,20,3
"789","2020-03-17",7,10,77,84,1991,0.61225514816675,0,0,166,828,34,230,16,89,14,16
"790","2020-03-18",11,10,77,106,1991,0.61225514816675,0,0,166,828,53,283,8,97,29,8
"791","2020-03-19",13,10,82,122,1991,0.61225514816675,0,0,166,828,54,337,3,100,31,3
"792","2020-03-20",20,10,90,140,1991,0.61225514816675,0,0,166,828,51,388,7,107,33,7
"793","2020-03-21",26,10,105,162,1991,0.61225514816675,0,0,166,828,72,460,6,113,40,6
"794","2020-03-22",28,10,111,173,1991,0.61225514816675,0,0,166,828,74,534,6,119,49,6
"795","2020-03-23",35,10,113,193,1991,0.61225514816675,0,0,166,828,47,581,2,121,28,2
"796","2020-03-24",41,10,144,210,1991,0.61225514816675,0,0,166,828,68,649,5,126,45,5
"797","2020-03-25",44,10,165,231,1991,0.61225514816675,0,0,166,828,67,716,1,127,49,1
"798","2020-03-26",48,10,179,241,1991,0.61225514816675,0,0,166,828,103,819,4,131,74,4
"799","2020-03-27",55,10,203,250,1991,0.61225514816675,0,0,166,828,74,893,5,136,52,5
"800","2020-03-28",60,10,214,255,1991,0.61225514816675,0,0,166,828,109,1002,11,147,82,11
"801","2020-03-29",67,10,197,269,1991,0.61225514816675,0,0,166,828,84,1086,15,162,63,15
"802","2020-03-30",68,10,187,271,1991,0.61225514816675,0,0,166,828,105,1191,9,171,89,9
"803","2020-03-31",74,10,155,272,1991,0.61225514816675,0,0,166,828,84,1275,9,180,65,9
"804","2020-04-01",79,10,157,263,1991,0.61225514816675,0,0,166,828,78,1353,11,191,62,11
"805","2020-04-02",85,10,156,271,1991,0.61225514816675,0,0,166,828,110,1463,11,202,92,11
"806","2020-04-03",84,10,138,273,1991,0.61225514816675,0,0,166,828,89,1552,12,214,71,12
"807","2020-04-04",84,10,125,264,1991,0.61225514816675,0,0,166,828,100,1652,37,251,82,37
"808","2020-04-05",85,10,153,272,1991,0.61225514816675,0,0,166,828,88,1740,14,265,69,14
"809","2020-04-06",83,10,162,255,1991,0.61225514816675,0,0,166,828,98,1838,14,279,74,14
"810","2020-04-07",77,10,144,245,1991,0.61225514816675,0,0,166,828,76,1914,24,303,57,24
"811","2020-04-08",77,10,159,248,1991,0.61225514816675,0,0,166,828,99,2013,16,319,81,16
"812","2020-04-09",71,10,162,259,1991,0.61225514816675,0,0,166,828,87,2100,5,324,62,5
"813","2020-04-10",65,10,145,252,1991,0.61225514816675,0,0,166,828,99,2199,10,334,78,10
"814","2020-04-11",59,10,146,243,1991,0.61225514816675,0,0,166,828,80,2279,25,359,57,25
"815","2020-04-12",61,10,132,248,1991,0.61225514816675,0,0,166,828,94,2373,7,366,74,7
"816","2020-04-13",70,10,122,242,1991,0.61225514816675,0,0,166,828,71,2444,8,374,53,8
"817","2020-04-14",70,10,108,241,1991,0.61225514816675,0,0,166,828,83,2527,10,384,53,10
"818","2020-04-15",67,10,101,246,1991,0.61225514816675,0,0,166,828,90,2617,38,422,63,38
"819","2020-04-16",76,10,96,258,1991,0.61225514816675,0,0,166,828,86,2703,30,452,65,30
"820","2020-04-17",80,10,100,251,1991,0.61225514816675,0,0,166,828,74,2777,19,471,50,19
"821","2020-04-18",83,10,120,257,1991,0.61225514816675,0,0,166,828,66,2843,32,503,41,32
"822","2020-04-19",79,10,148,268,1991,0.61225514816675,0,0,166,828,68,2911,23,526,48,23
"823","2020-04-20",73,10,161,266,1991,0.61225514816675,0,0,166,828,71,2982,22,548,51,22
"824","2020-04-21",78,10,156,272,1991,0.61225514816675,0,0,166,828,71,3053,35,583,44,35
"825","2020-04-22",77,10,158,283,1991,0.61225514816675,0,0,166,828,56,3109,21,604,36,21
"826","2020-04-23",76,10,165,274,1991,0.61225514816675,0,0,166,828,56,3165,12,616,30,12
"827","2020-04-24",78,10,155,272,1991,0.61225514816675,0,0,166,828,59,3224,40,656,40,40
"828","2020-04-25",80,10,165,275,1991,0.61225514816675,0,0,166,828,59,3283,15,671,38,15
"829","2020-04-26",76,10,175,279,1991,0.61225514816675,0,0,166,828,58,3341,6,677,37,6
"830","2020-04-27",76,10,155,278,1991,0.61225514816675,0,0,166,828,47,3388,9,686,28,9
"831","2020-04-28",72,10,152,270,1991,0.61225514816675,0,0,166,828,52,3440,10,696,35,10
"832","2020-04-29",81,10,146,270,1991,0.61225514816675,0,0,166,828,60,3500,15,711,40,15
"833","2020-04-30",79,10,138,278,1991,0.61225514816675,0,0,166,828,51,3551,24,735,31,24
"834","2020-05-01",69,10,127,282,1991,0.61225514816675,0,0,166,828,38,3589,24,759,22,24
"835","2020-05-02",70,10,119,266,1991,0.61225514816675,0,0,166,828,44,3633,32,791,31,32
"836","2020-05-03",78,10,119,265,1991,0.61225514816675,0,0,166,828,66,3699,36,827,41,36
"837","2020-05-04",80,10,163,274,1991,0.61225514816675,0,0,166,828,42,3741,23,850,24,23
"838","2020-05-05",82,10,166,272,1991,0.61225514816675,0,0,166,828,40,3781,20,870,25,20
"839","2020-05-06",73,10,194,277,1991,0.61225514816675,0,0,166,828,41,3822,13,883,22,13
"840","2020-05-07",70,10,223,273,1991,0.61225514816675,0,0,166,828,41,3863,8,891,31,8
"841","2020-05-08",83,10,210,277,1991,0.61225514816675,0,0,166,828,37,3900,6,897,23,6
"842","2020-05-09",79,10,209,274,1991,0.61225514816675,0,0,166,828,43,3943,33,930,27,33
"843","2020-05-10",78,10,218,266,1991,0.61225514816675,0,0,166,828,55,3998,16,946,32,16
"844","2020-05-11",74,10,193,264,1991,0.61225514816675,0,0,166,828,38,4036,48,994,20,48
"845","2020-05-12",69,10,176,263,1991,0.61225514816675,0,0,166,828,21,4057,22,1016,9,22
"846","2020-05-13",71,10,157,252,1991,0.61225514816675,0,0,166,828,35,4092,17,1033,19,17
"847","2020-05-14",71,10,156,260,1991,0.61225514816675,0,0,166,828,41,4133,26,1059,24,26
"848","2020-05-15",65,10,177,261,1991,0.61225514816675,0,0,166,828,30,4163,16,1075,16,16
"849","2020-05-16",62,10,176,249,1991,0.61225514816675,0,0,166,828,34,4197,8,1083,24,8
"850","2020-05-17",60,10,157,241,1991,0.61225514816675,0,0,166,828,31,4228,16,1099,18,16
"851","2020-05-18",60,10,161,237,1991,0.61225514816675,0,0,166,828,30,4258,24,1123,14,24
"852","2020-05-19",64,10,165,233,1991,0.61225514816675,0,0,166,828,26,4284,12,1135,14,12
"853","2020-05-20",60,10,154,238,1991,0.61225514816675,0,0,166,828,35,4319,6,1141,21,6
"854","2020-05-21",56,10,145,248,1991,0.61225514816675,0,0,166,828,26,4345,8,1149,12,8
"855","2020-05-22",57,10,131,245,1991,0.61225514816675,0,0,166,828,33,4378,13,1162,21,13
"856","2020-05-23",56,10,122,246,1991,0.61225514816675,0,0,166,828,20,4398,12,1174,9,12
"857","2020-05-24",58,10,130,238,1991,0.61225514816675,0,0,166,828,13,4411,28,1202,8,28
"858","2020-05-25",58,10,143,238,1991,0.61225514816675,0,0,166,828,25,4436,17,1219,18,17
"859","2020-05-26",65,10,137,245,1991,0.61225514816675,0,0,166,828,21,4457,19,1238,11,19
"860","2020-05-27",68,10,149,237,1991,0.61225514816675,0,0,166,828,24,4481,20,1258,10,20
"861","2020-05-28",71,10,149,231,1991,0.61225514816675,0,0,166,828,15,4496,24,1282,7,24
"862","2020-05-29",65,10,166,225,1991,0.61225514816675,0,0,166,828,15,4511,13,1295,8,13
"863","2020-05-30",73,10,145,232,1991,0.61225514816675,0,0,166,828,21,4532,7,1302,11,7
"864","2020-05-31",72,10,129,220,1991,0.61225514816675,0,0,166,828,23,4555,7,1309,18,7
"865","2020-06-01",73,10,120,219,1991,0.61225514816675,0,0,166,828,14,4569,6,1315,6,6
"866","2020-06-02",65,10,125,218,1991,0.61225514816675,0,0,166,828,19,4588,18,1333,10,18
"867","2020-06-03",64,10,125,226,1991,0.61225514816675,0,0,166,828,15,4603,7,1340,5,7
"868","2020-06-04",60,10,124,218,1991,0.61225514816675,0,0,166,828,9,4612,8,1348,5,8
"869","2020-06-05",65,10,130,213,1991,0.61225514816675,0,0,166,828,15,4627,14,1362,7,14
"870","2020-06-06",63,10,139,202,1991,0.61225514816675,0,0,166,828,6,4633,7,1369,4,7
"871","2020-06-07",66,10,147,191,1991,0.61225514816675,0,0,166,828,13,4646,19,1388,9,19
"872","2020-03-14",4,11,95,138,4197,0.406957350488444,0,0,348,747,41,157,18,46,6,18
"873","2020-03-15",9,11,85,172,4197,0.406957350488444,0,0,348,747,57,214,25,71,16,25
"874","2020-03-16",12,11,102,215,4197,0.406957350488444,0,0,348,747,62,276,26,97,23,26
"875","2020-03-17",24,11,128,254,4197,0.406957350488444,0,0,348,747,57,333,40,137,23,40
"876","2020-03-18",31,11,136,289,4197,0.406957350488444,0,0,348,747,69,402,40,177,35,40
"877","2020-03-19",42,11,130,326,4197,0.406957350488444,0,0,348,747,59,461,65,242,25,65
"878","2020-03-20",57,11,107,362,4197,0.406957350488444,0,0,348,747,61,522,52,294,30,52
"879","2020-03-21",60,11,94,399,4197,0.406957350488444,0,0,348,747,74,596,44,338,33,44
"880","2020-03-22",71,11,122,430,4197,0.406957350488444,0,0,348,747,102,698,67,405,49,67
"881","2020-03-23",88,11,110,483,4197,0.406957350488444,0,0,348,747,77,775,54,459,43,54
"882","2020-03-24",100,11,101,516,4197,0.406957350488444,0,0,348,747,69,844,44,503,28,44
"883","2020-03-25",121,11,99,556,4197,0.406957350488444,0,0,348,747,69,913,49,552,28,49
"884","2020-03-26",134,11,132,593,4197,0.406957350488444,0,0,348,747,77,990,47,599,35,47
"885","2020-03-27",148,11,128,607,4197,0.406957350488444,0,0,348,747,67,1057,52,651,28,52
"886","2020-03-28",168,11,118,616,4197,0.406957350488444,0,0,348,747,87,1144,41,692,52,41
"887","2020-03-29",176,11,101,642,4197,0.406957350488444,0,0,348,747,68,1212,40,732,30,40
"888","2020-03-30",185,11,102,659,4197,0.406957350488444,0,0,348,747,88,1300,31,763,44,31
"889","2020-03-31",185,11,97,662,4197,0.406957350488444,0,0,348,747,64,1364,49,812,29,49
"890","2020-04-01",185,11,84,671,4197,0.406957350488444,0,0,348,747,77,1441,47,859,32,47
"891","2020-04-02",188,11,85,689,4197,0.406957350488444,0,0,348,747,71,1512,43,902,40,43
"892","2020-04-03",187,11,97,707,4197,0.406957350488444,0,0,348,747,83,1595,33,935,38,33
"893","2020-04-04",184,11,132,716,4197,0.406957350488444,0,0,348,747,82,1677,45,980,35,45
"894","2020-04-05",188,11,161,711,4197,0.406957350488444,0,0,348,747,72,1749,47,1027,33,47
"895","2020-04-06",185,11,180,699,4197,0.406957350488444,0,0,348,747,87,1836,57,1084,53,57
"896","2020-04-07",186,11,174,696,4197,0.406957350488444,0,0,348,747,60,1896,70,1154,27,70
"897","2020-04-08",183,11,173,707,4197,0.406957350488444,0,0,348,747,84,1980,39,1193,31,39
"898","2020-04-09",187,11,165,700,4197,0.406957350488444,0,0,348,747,73,2053,42,1235,29,42
"899","2020-04-10",192,11,171,688,4197,0.406957350488444,0,0,348,747,73,2126,34,1269,33,34
"900","2020-04-11",205,11,196,712,4197,0.406957350488444,0,0,348,747,80,2206,41,1310,31,41
"901","2020-04-12",207,11,239,721,4197,0.406957350488444,0,0,348,747,54,2260,44,1354,20,44
"902","2020-04-13",208,11,227,716,4197,0.406957350488444,0,0,348,747,67,2327,27,1381,29,27
"903","2020-04-14",203,11,193,735,4197,0.406957350488444,0,0,348,747,62,2389,45,1426,26,45
"904","2020-04-15",204,11,167,735,4197,0.406957350488444,0,0,348,747,72,2461,60,1486,22,60
"905","2020-04-16",208,11,153,723,4197,0.406957350488444,0,0,348,747,71,2532,62,1548,33,62
"906","2020-04-17",195,11,139,708,4197,0.406957350488444,0,0,348,747,66,2598,52,1600,29,52
"907","2020-04-18",188,11,175,715,4197,0.406957350488444,0,0,348,747,66,2664,34,1634,32,34
"908","2020-04-19",192,11,168,689,4197,0.406957350488444,0,0,348,747,66,2730,40,1674,22,40
"909","2020-04-20",206,11,155,679,4197,0.406957350488444,0,0,348,747,62,2792,45,1719,25,45
"910","2020-04-21",204,11,145,694,4197,0.406957350488444,0,0,348,747,76,2868,41,1760,29,41
"911","2020-04-22",207,11,151,689,4197,0.406957350488444,0,0,348,747,74,2942,30,1790,31,30
"912","2020-04-23",206,11,158,682,4197,0.406957350488444,0,0,348,747,63,3005,37,1827,19,37
"913","2020-04-24",218,11,193,674,4197,0.406957350488444,0,0,348,747,87,3092,57,1884,28,57
"914","2020-04-25",218,11,214,664,4197,0.406957350488444,0,0,348,747,69,3161,43,1927,30,43
"915","2020-04-26",211,11,234,645,4197,0.406957350488444,0,0,348,747,59,3220,35,1962,28,35
"916","2020-04-27",187,11,256,628,4197,0.406957350488444,0,0,348,747,59,3279,32,1994,18,32
"917","2020-04-28",203,11,280,607,4197,0.406957350488444,0,0,348,747,65,3344,40,2034,24,40
"918","2020-04-29",203,11,261,593,4197,0.406957350488444,0,0,348,747,60,3404,52,2086,26,52
"919","2020-04-30",189,11,234,581,4197,0.406957350488444,0,0,348,747,54,3458,69,2155,23,69
"920","2020-05-01",183,11,200,590,4197,0.406957350488444,0,0,348,747,64,3522,66,2221,20,66
"921","2020-05-02",173,11,203,573,4197,0.406957350488444,0,0,348,747,46,3568,49,2270,19,49
"922","2020-05-03",169,11,213,568,4197,0.406957350488444,0,0,348,747,55,3623,40,2310,19,40
"923","2020-05-04",176,11,252,576,4197,0.406957350488444,0,0,348,747,52,3675,44,2354,16,44
"924","2020-05-05",170,11,261,546,4197,0.406957350488444,0,0,348,747,59,3734,49,2403,19,49
"925","2020-05-06",158,11,260,519,4197,0.406957350488444,0,0,348,747,39,3773,50,2453,9,50
"926","2020-05-07",159,11,230,523,4197,0.406957350488444,0,0,348,747,46,3819,37,2490,19,37
"927","2020-05-08",148,11,193,491,4197,0.406957350488444,0,0,348,747,39,3858,44,2534,12,44
"928","2020-05-09",147,11,188,482,4197,0.406957350488444,0,0,348,747,48,3906,53,2587,13,53
"929","2020-05-10",136,11,201,460,4197,0.406957350488444,0,0,348,747,60,3966,41,2628,26,41
"930","2020-05-11",134,11,171,445,4197,0.406957350488444,0,0,348,747,39,4005,36,2664,17,36
"931","2020-05-12",126,11,171,436,4197,0.406957350488444,0,0,348,747,46,4051,47,2711,16,47
"932","2020-05-13",124,11,197,424,4197,0.406957350488444,0,0,348,747,40,4091,34,2745,8,34
"933","2020-05-14",121,11,196,424,4197,0.406957350488444,0,0,348,747,39,4130,33,2778,17,33
"934","2020-05-15",118,11,195,422,4197,0.406957350488444,0,0,348,747,46,4176,45,2823,13,45
"935","2020-05-16",122,11,196,418,4197,0.406957350488444,0,0,348,747,44,4220,29,2852,18,29
"936","2020-05-17",129,11,240,405,4197,0.406957350488444,0,0,348,747,27,4247,42,2894,10,42
"937","2020-05-18",122,11,258,389,4197,0.406957350488444,0,0,348,747,29,4276,42,2936,10,42
"938","2020-05-19",113,11,239,379,4197,0.406957350488444,0,0,348,747,27,4303,61,2997,14,61
"939","2020-05-20",109,11,237,357,4197,0.406957350488444,0,0,348,747,22,4325,50,3047,6,50
"940","2020-05-21",108,11,220,343,4197,0.406957350488444,0,0,348,747,35,4360,46,3093,12,46
"941","2020-05-22",115,11,191,338,4197,0.406957350488444,0,0,348,747,32,4392,37,3130,8,37
"942","2020-05-23",106,11,177,321,4197,0.406957350488444,0,0,348,747,34,4426,44,3174,12,44
"943","2020-05-24",99,11,184,309,4197,0.406957350488444,0,0,348,747,31,4457,47,3221,9,47
"944","2020-05-25",98,11,180,294,4197,0.406957350488444,0,0,348,747,36,4493,40,3261,14,40
"945","2020-05-26",100,11,186,282,4197,0.406957350488444,0,0,348,747,17,4510,62,3323,7,62
"946","2020-05-27",99,11,175,270,4197,0.406957350488444,0,0,348,747,32,4542,80,3403,10,80
"947","2020-05-28",93,11,152,258,4197,0.406957350488444,0,0,348,747,24,4566,67,3470,9,67
"948","2020-05-29",86,11,134,254,4197,0.406957350488444,0,0,348,747,25,4591,57,3527,8,57
"949","2020-05-30",87,11,132,247,4197,0.406957350488444,0,0,348,747,26,4617,55,3582,8,55
"950","2020-05-31",87,11,132,246,4197,0.406957350488444,0,0,348,747,20,4637,54,3636,10,54
"951","2020-06-01",80,11,118,257,4197,0.406957350488444,0,0,348,747,20,4657,60,3696,8,60
"952","2020-06-02",79,11,113,257,4197,0.406957350488444,0,0,348,747,17,4674,53,3749,7,53
"953","2020-06-03",78,11,121,251,4197,0.406957350488444,0,0,348,747,23,4697,44,3793,4,44
"954","2020-06-04",78,11,135,244,4197,0.406957350488444,0,0,348,747,17,4714,36,3829,6,36
"955","2020-06-05",79,11,147,241,4197,0.406957350488444,0,0,348,747,21,4735,44,3873,10,44
"956","2020-06-06",74,11,173,233,4197,0.406957350488444,0,0,348,747,26,4761,30,3903,8,30
"957","2020-06-07",65,11,181,223,4197,0.406957350488444,0,0,348,747,24,4785,32,3935,7,32
"958","2020-03-13",1,12,40,118,4482,0.302766622043731,0,0,342,600,23,53,6,22,4,6
"959","2020-03-14",4,12,64,168,4482,0.302766622043731,0,0,342,600,19,72,17,39,4,17
"960","2020-03-15",9,12,78,218,4482,0.302766622043731,0,0,342,600,32,104,5,44,12,5
"961","2020-03-16",14,12,91,262,4482,0.302766622043731,0,0,342,600,33,137,6,50,14,6
"962","2020-03-17",27,12,89,326,4482,0.302766622043731,0,0,342,600,33,170,6,56,19,6
"963","2020-03-18",44,12,107,382,4482,0.302766622043731,0,0,342,600,33,203,6,62,18,6
"964","2020-03-19",54,12,119,418,4482,0.302766622043731,0,0,342,600,49,252,3,65,31,3
"965","2020-03-20",74,12,116,461,4482,0.302766622043731,0,0,342,600,40,292,27,92,26,27
"966","2020-03-21",83,12,114,505,4482,0.302766622043731,0,0,342,600,40,332,21,113,30,21
"967","2020-03-22",98,12,126,530,4482,0.302766622043731,0,0,342,600,63,395,6,119,37,6
"968","2020-03-23",122,12,140,568,4482,0.302766622043731,0,0,342,600,43,438,44,163,22,44
"969","2020-03-24",139,12,140,579,4482,0.302766622043731,0,0,342,600,65,503,31,194,44,31
"970","2020-03-25",148,12,148,579,4482,0.302766622043731,0,0,342,600,65,568,36,230,44,36
"971","2020-03-26",167,12,147,599,4482,0.302766622043731,0,0,342,600,64,632,21,251,47,21
"972","2020-03-27",178,12,138,622,4482,0.302766622043731,0,0,342,600,63,695,14,265,40,14
"973","2020-03-28",188,12,150,623,4482,0.302766622043731,0,0,342,600,77,772,13,278,56,13
"974","2020-03-29",195,12,146,610,4482,0.302766622043731,0,0,342,600,68,840,19,297,45,19
"975","2020-03-30",188,12,141,620,4482,0.302766622043731,0,0,342,600,85,925,45,342,56,45
"976","2020-03-31",173,12,136,627,4482,0.302766622043731,0,0,342,600,55,980,33,375,41,33
"977","2020-04-01",173,12,133,637,4482,0.302766622043731,0,0,342,600,73,1053,26,401,50,26
"978","2020-04-02",175,12,140,623,4482,0.302766622043731,0,0,342,600,60,1113,12,413,46,12
"979","2020-04-03",176,12,133,629,4482,0.302766622043731,0,0,342,600,80,1193,7,420,61,7
"980","2020-04-04",178,12,124,620,4482,0.302766622043731,0,0,342,600,79,1272,17,437,53,17
"981","2020-04-05",166,12,118,633,4482,0.302766622043731,0,0,342,600,76,1348,38,475,54,38
"982","2020-04-06",171,12,124,629,4482,0.302766622043731,0,0,342,600,60,1408,39,514,43,39
"983","2020-04-07",179,12,123,652,4482,0.302766622043731,0,0,342,600,88,1496,22,536,67,22
"984","2020-04-08",174,12,137,656,4482,0.302766622043731,0,0,342,600,75,1571,20,556,54,20
"985","2020-04-09",171,12,159,653,4482,0.302766622043731,0,0,342,600,82,1653,17,573,62,17
"986","2020-04-10",157,12,164,642,4482,0.302766622043731,0,0,342,600,73,1726,38,611,56,38
"987","2020-04-11",157,12,182,656,4482,0.302766622043731,0,0,342,600,92,1818,41,652,71,41
"988","2020-04-12",172,12,171,680,4482,0.302766622043731,0,0,342,600,59,1877,26,678,47,26
"989","2020-04-13",167,12,174,688,4482,0.302766622043731,0,0,342,600,93,1970,19,697,65,19
"990","2020-04-14",171,12,158,685,4482,0.302766622043731,0,0,342,600,72,2042,20,717,56,20
"991","2020-04-15",173,12,152,682,4482,0.302766622043731,0,0,342,600,97,2139,34,751,69,34
"992","2020-04-16",173,12,156,691,4482,0.302766622043731,0,0,342,600,66,2205,35,786,44,35
"993","2020-04-17",179,12,162,700,4482,0.302766622043731,0,0,342,600,80,2285,24,810,59,24
"994","2020-04-18",176,12,166,724,4482,0.302766622043731,0,0,342,600,71,2356,46,856,56,46
"995","2020-04-19",174,12,175,710,4482,0.302766622043731,0,0,342,600,59,2415,31,887,37,31
"996","2020-04-20",180,12,169,694,4482,0.302766622043731,0,0,342,600,83,2498,39,926,57,39
"997","2020-04-21",176,12,162,684,4482,0.302766622043731,0,0,342,600,63,2561,60,986,45,60
"998","2020-04-22",171,12,159,672,4482,0.302766622043731,0,0,342,600,63,2624,49,1035,44,49
"999","2020-04-23",166,12,166,666,4482,0.302766622043731,0,0,342,600,70,2694,56,1091,55,56
"1000","2020-04-24",161,12,160,652,4482,0.302766622043731,0,0,342,600,54,2748,77,1168,39,77
"1001","2020-04-25",165,12,166,662,4482,0.302766622043731,0,0,342,600,69,2817,60,1228,50,60
"1002","2020-04-26",168,12,169,661,4482,0.302766622043731,0,0,342,600,71,2888,33,1261,52,33
"1003","2020-04-27",166,12,175,652,4482,0.302766622043731,0,0,342,600,66,2954,22,1283,48,22
"1004","2020-04-28",170,12,188,658,4482,0.302766622043731,0,0,342,600,58,3012,11,1294,36,11
"1005","2020-04-29",182,12,205,648,4482,0.302766622043731,0,0,342,600,65,3077,42,1336,47,42
"1006","2020-04-30",184,12,234,658,4482,0.302766622043731,0,0,342,600,53,3130,27,1363,33,27
"1007","2020-05-01",183,12,212,643,4482,0.302766622043731,0,0,342,600,67,3197,44,1407,48,44
"1008","2020-05-02",186,12,227,622,4482,0.302766622043731,0,0,342,600,58,3255,26,1433,48,26
"1009","2020-05-03",178,12,213,627,4482,0.302766622043731,0,0,342,600,53,3308,56,1489,40,56
"1010","2020-05-04",174,12,227,615,4482,0.302766622043731,0,0,342,600,68,3376,32,1521,42,32
"1011","2020-05-05",179,12,243,609,4482,0.302766622043731,0,0,342,600,37,3413,20,1541,22,20
"1012","2020-05-06",172,12,246,600,4482,0.302766622043731,0,0,342,600,42,3455,21,1562,22,21
"1013","2020-05-07",172,12,245,582,4482,0.302766622043731,0,0,342,600,42,3497,45,1607,25,45
"1014","2020-05-08",173,12,236,553,4482,0.302766622043731,0,0,342,600,41,3538,18,1625,30,18
"1015","2020-05-09",168,12,236,557,4482,0.302766622043731,0,0,342,600,57,3595,24,1649,44,24
"1016","2020-05-10",160,12,232,551,4482,0.302766622043731,0,0,342,600,57,3652,34,1683,39,34
"1017","2020-05-11",145,12,243,527,4482,0.302766622043731,0,0,342,600,39,3691,44,1727,25,44
"1018","2020-05-12",136,12,254,511,4482,0.302766622043731,0,0,342,600,49,3740,40,1767,33,40
"1019","2020-05-13",132,12,267,490,4482,0.302766622043731,0,0,342,600,42,3782,45,1812,30,45
"1020","2020-05-14",130,12,272,464,4482,0.302766622043731,0,0,342,600,45,3827,31,1843,30,31
"1021","2020-05-15",128,12,267,456,4482,0.302766622043731,0,0,342,600,39,3866,34,1877,18,34
"1022","2020-05-16",120,12,246,454,4482,0.302766622043731,0,0,342,600,38,3904,26,1903,22,26
"1023","2020-05-17",125,12,202,453,4482,0.302766622043731,0,0,342,600,24,3928,33,1936,19,33
"1024","2020-05-18",133,12,186,443,4482,0.302766622043731,0,0,342,600,28,3956,26,1962,22,26
"1025","2020-05-19",132,12,195,423,4482,0.302766622043731,0,0,342,600,24,3980,20,1982,16,20
"1026","2020-05-20",131,12,211,409,4482,0.302766622043731,0,0,342,600,37,4017,13,1995,25,13
"1027","2020-05-21",126,12,214,407,4482,0.302766622043731,0,0,342,600,38,4055,15,2010,26,15
"1028","2020-05-22",116,12,210,397,4482,0.302766622043731,0,0,342,600,27,4082,40,2050,19,40
"1029","2020-05-23",113,12,205,365,4482,0.302766622043731,0,0,342,600,30,4112,29,2079,18,29
"1030","2020-05-24",108,12,189,364,4482,0.302766622043731,0,0,342,600,31,4143,15,2094,20,15
"1031","2020-05-25",108,12,201,365,4482,0.302766622043731,0,0,342,600,24,4167,19,2113,16,19
"1032","2020-05-26",98,12,207,344,4482,0.302766622043731,0,0,342,600,21,4188,4,2117,13,4
"1033","2020-05-27",93,12,198,351,4482,0.302766622043731,0,0,342,600,21,4209,9,2126,15,9
"1034","2020-05-28",86,12,199,330,4482,0.302766622043731,0,0,342,600,27,4236,5,2131,15,5
"1035","2020-05-29",90,12,199,316,4482,0.302766622043731,0,0,342,600,14,4250,28,2159,8,28
"1036","2020-05-30",98,12,219,303,4482,0.302766622043731,0,0,342,600,18,4268,31,2190,13,31
"1037","2020-05-31",99,12,184,309,4482,0.302766622043731,0,0,342,600,28,4296,38,2228,17,38
"1038","2020-06-01",97,12,175,302,4482,0.302766622043731,0,0,342,600,13,4309,33,2261,10,33
"1039","2020-06-02",90,12,178,299,4482,0.302766622043731,0,0,342,600,22,4331,37,2298,15,37
"1040","2020-06-03",85,12,165,287,4482,0.302766622043731,0,0,342,600,16,4347,13,2311,13,13
"1041","2020-06-04",91,12,160,279,4482,0.302766622043731,0,0,342,600,15,4362,19,2330,9,19
"1042","2020-06-05",83,12,146,270,4482,0.302766622043731,0,0,342,600,18,4380,30,2360,15,30
"1043","2020-06-06",70,12,148,262,4482,0.302766622043731,0,0,342,600,14,4394,22,2382,9,22
"1044","2020-06-07",63,12,137,239,4482,0.302766622043731,0,0,342,600,9,4403,16,2398,4,16
"1045","2020-03-15",4,13,46,66,2340,0.54017094017094,0,0,223,461,29,132,13,48,12,13
"1046","2020-03-16",6,13,41,92,2340,0.54017094017094,0,0,223,461,33,165,2,50,10,2
"1047","2020-03-17",8,13,61,120,2340,0.54017094017094,0,0,223,461,39,204,12,62,19,12
"1048","2020-03-18",18,13,79,143,2340,0.54017094017094,0,0,223,461,51,255,9,71,23,9
"1049","2020-03-19",23,13,83,154,2340,0.54017094017094,0,0,223,461,43,298,10,81,22,10
"1050","2020-03-20",31,13,74,173,2340,0.54017094017094,0,0,223,461,48,346,10,91,21,10
"1051","2020-03-21",39,13,84,193,2340,0.54017094017094,0,0,223,461,61,407,6,97,27,6
"1052","2020-03-22",40,13,86,219,2340,0.54017094017094,0,0,223,461,44,451,9,106,25,9
"1053","2020-03-23",44,13,98,241,2340,0.54017094017094,0,0,223,461,46,497,5,111,24,5
"1054","2020-03-24",57,13,98,260,2340,0.54017094017094,0,0,223,461,63,560,10,121,31,10
"1055","2020-03-25",61,13,104,277,2340,0.54017094017094,0,0,223,461,63,623,11,132,30,11
"1056","2020-03-26",68,13,104,305,2340,0.54017094017094,0,0,223,461,76,699,21,153,50,21
"1057","2020-03-27",69,13,119,322,2340,0.54017094017094,0,0,223,461,59,758,29,182,37,29
"1058","2020-03-28",70,13,117,332,2340,0.54017094017094,0,0,223,461,59,817,11,193,35,11
"1059","2020-03-29",74,13,116,343,2340,0.54017094017094,0,0,223,461,67,884,7,200,39,7
"1060","2020-03-30",80,13,124,363,2340,0.54017094017094,0,0,223,461,77,961,7,207,47,7
"1061","2020-03-31",82,13,110,386,2340,0.54017094017094,0,0,223,461,67,1028,14,221,39,14
"1062","2020-04-01",82,13,109,394,2340,0.54017094017094,0,0,223,461,71,1099,9,230,40,9
"1063","2020-04-02",83,13,107,413,2340,0.54017094017094,0,0,223,461,68,1167,33,263,48,33
"1064","2020-04-03",84,13,103,424,2340,0.54017094017094,0,0,223,461,48,1215,29,292,29,29
"1065","2020-04-04",93,13,99,433,2340,0.54017094017094,0,0,223,461,63,1278,13,305,37,13
"1066","2020-04-05",99,13,96,452,2340,0.54017094017094,0,0,223,461,58,1336,19,324,29,19
"1067","2020-04-06",109,13,96,476,2340,0.54017094017094,0,0,223,461,64,1400,13,337,35,13
"1068","2020-04-07",107,13,114,479,2340,0.54017094017094,0,0,223,461,57,1457,36,373,35,36
"1069","2020-04-08",111,13,119,488,2340,0.54017094017094,0,0,223,461,54,1511,27,400,30,27
"1070","2020-04-09",119,13,134,498,2340,0.54017094017094,0,0,223,461,86,1597,35,435,53,35
"1071","2020-04-10",134,13,155,512,2340,0.54017094017094,0,0,223,461,50,1647,21,456,16,21
"1072","2020-04-11",132,13,169,512,2340,0.54017094017094,0,0,223,461,69,1716,18,474,38,18
"1073","2020-04-12",148,13,187,501,2340,0.54017094017094,0,0,223,461,60,1776,20,494,28,20
"1074","2020-04-13",154,13,206,503,2340,0.54017094017094,0,0,223,461,48,1824,13,507,14,13
"1075","2020-04-14",154,13,207,479,2340,0.54017094017094,0,0,223,461,47,1871,25,532,20,25
"1076","2020-04-15",162,13,205,464,2340,0.54017094017094,0,0,223,461,57,1928,30,562,29,30
"1077","2020-04-16",154,13,236,457,2340,0.54017094017094,0,0,223,461,49,1977,16,578,16,16
"1078","2020-04-17",143,13,240,460,2340,0.54017094017094,0,0,223,461,51,2028,9,587,29,9
"1079","2020-04-18",147,13,249,450,2340,0.54017094017094,0,0,223,461,49,2077,22,609,15,22
"1080","2020-04-19",129,13,256,435,2340,0.54017094017094,0,0,223,461,57,2134,28,637,23,28
"1081","2020-04-20",119,13,262,415,2340,0.54017094017094,0,0,223,461,49,2183,21,658,28,21
"1082","2020-04-21",122,13,259,372,2340,0.54017094017094,0,0,223,461,51,2234,18,676,18,18
"1083","2020-04-22",109,13,243,350,2340,0.54017094017094,0,0,223,461,43,2277,29,705,15,29
"1084","2020-04-23",104,13,258,330,2340,0.54017094017094,0,0,223,461,50,2327,24,729,23,24
"1085","2020-04-24",117,13,264,320,2340,0.54017094017094,0,0,223,461,56,2383,25,754,20,25
"1086","2020-04-25",104,13,262,306,2340,0.54017094017094,0,0,223,461,44,2427,29,783,23,29
"1087","2020-04-26",103,13,257,308,2340,0.54017094017094,0,0,223,461,53,2480,22,805,22,22
"1088","2020-04-27",98,13,262,298,2340,0.54017094017094,0,0,223,461,42,2522,17,822,16,17
"1089","2020-04-28",88,13,235,294,2340,0.54017094017094,0,0,223,461,48,2570,21,843,20,21
"1090","2020-04-29",91,13,216,287,2340,0.54017094017094,0,0,223,461,51,2621,38,881,18,38
"1091","2020-04-30",93,13,248,282,2340,0.54017094017094,0,0,223,461,49,2670,32,913,24,32
"1092","2020-05-01",81,13,262,273,2340,0.54017094017094,0,0,223,461,55,2725,25,938,16,25
"1093","2020-05-02",84,13,272,268,2340,0.54017094017094,0,0,223,461,53,2778,14,952,22,14
"1094","2020-05-03",76,13,277,262,2340,0.54017094017094,0,0,223,461,41,2819,38,990,15,38
"1095","2020-05-04",74,13,280,268,2340,0.54017094017094,0,0,223,461,47,2866,48,1038,19,48
"1096","2020-05-05",78,13,263,273,2340,0.54017094017094,0,0,223,461,54,2920,37,1075,20,37
"1097","2020-05-06",70,13,264,272,2340,0.54017094017094,0,0,223,461,48,2968,22,1097,22,22
"1098","2020-05-07",80,13,239,260,2340,0.54017094017094,0,0,223,461,43,3011,16,1113,17,16
"1099","2020-05-08",79,13,245,256,2340,0.54017094017094,0,0,223,461,46,3057,18,1131,21,18
"1100","2020-05-09",79,13,245,257,2340,0.54017094017094,0,0,223,461,54,3111,17,1148,29,17
"1101","2020-05-10",84,13,244,245,2340,0.54017094017094,0,0,223,461,49,3160,26,1174,22,26
"1102","2020-05-11",81,13,244,241,2340,0.54017094017094,0,0,223,461,38,3198,33,1207,14,33
"1103","2020-05-12",82,13,251,230,2340,0.54017094017094,0,0,223,461,37,3235,20,1227,14,20
"1104","2020-05-13",84,13,253,224,2340,0.54017094017094,0,0,223,461,40,3275,34,1261,11,34
"1105","2020-05-14",76,13,252,227,2340,0.54017094017094,0,0,223,461,37,3312,20,1281,15,20
"1106","2020-05-15",68,13,256,216,2340,0.54017094017094,0,0,223,461,42,3354,31,1312,9,31
"1107","2020-05-16",65,13,239,217,2340,0.54017094017094,0,0,223,461,43,3397,27,1339,18,27
"1108","2020-05-17",61,13,245,218,2340,0.54017094017094,0,0,223,461,32,3429,27,1366,12,27
"1109","2020-05-18",61,13,229,218,2340,0.54017094017094,0,0,223,461,30,3459,27,1393,12,27
"1110","2020-05-19",54,13,217,217,2340,0.54017094017094,0,0,223,461,24,3483,18,1411,13,18
"1111","2020-05-20",51,13,235,221,2340,0.54017094017094,0,0,223,461,30,3513,24,1435,14,24
"1112","2020-05-21",53,13,229,225,2340,0.54017094017094,0,0,223,461,30,3543,13,1448,9,13
"1113","2020-05-22",57,13,223,234,2340,0.54017094017094,0,0,223,461,32,3575,17,1465,13,17
"1114","2020-05-23",57,13,230,237,2340,0.54017094017094,0,0,223,461,17,3592,20,1485,8,20
"1115","2020-05-24",61,13,243,231,2340,0.54017094017094,0,0,223,461,28,3620,23,1508,11,23
"1116","2020-05-25",64,13,250,218,2340,0.54017094017094,0,0,223,461,28,3648,19,1527,10,19
"1117","2020-05-26",72,13,249,209,2340,0.54017094017094,0,0,223,461,14,3662,16,1543,7,16
"1118","2020-05-27",73,13,232,203,2340,0.54017094017094,0,0,223,461,19,3681,16,1559,5,16
"1119","2020-05-28",67,13,226,196,2340,0.54017094017094,0,0,223,461,27,3708,14,1573,10,14
"1120","2020-05-29",67,13,244,188,2340,0.54017094017094,0,0,223,461,22,3730,15,1588,14,15
"1121","2020-05-30",65,13,247,175,2340,0.54017094017094,0,0,223,461,22,3752,20,1608,7,20
"1122","2020-05-31",67,13,245,165,2340,0.54017094017094,0,0,223,461,23,3775,26,1634,11,26
"1123","2020-06-01",61,13,259,150,2340,0.54017094017094,0,0,223,461,20,3795,13,1647,9,13
"1124","2020-06-02",56,13,235,142,2340,0.54017094017094,0,0,223,461,21,3816,14,1661,14,14
"1125","2020-06-03",54,13,238,123,2340,0.54017094017094,0,0,223,461,20,3836,7,1668,9,7
"1126","2020-06-04",52,13,240,114,2340,0.54017094017094,0,0,223,461,12,3848,13,1681,7,13
"1127","2020-06-05",49,13,233,115,2340,0.54017094017094,0,0,223,461,6,3854,16,1697,1,16
"1128","2020-06-06",48,13,226,107,2340,0.54017094017094,0,0,223,461,17,3871,20,1717,10,20
"1129","2020-06-07",43,13,218,103,2340,0.54017094017094,0,0,223,461,20,3891,14,1731,11,14
"1130","2020-03-12",1,14,54,35,6400,0.87703125,0,0,566,609,30,52,28,47,6,28
"1131","2020-03-13",2,14,81,54,6400,0.87703125,0,0,566,609,33,85,41,88,13,41
"1132","2020-03-14",5,14,86,82,6400,0.87703125,0,0,566,609,33,118,43,131,19,43
"1133","2020-03-15",7,14,84,109,6400,0.87703125,0,0,566,609,57,175,17,148,41,17
"1134","2020-03-16",9,14,95,143,6400,0.87703125,0,0,566,609,80,255,20,168,60,20
"1135","2020-03-17",13,14,116,182,6400,0.87703125,0,0,566,609,94,349,29,197,69,29
"1136","2020-03-18",17,14,117,232,6400,0.87703125,0,0,566,609,111,460,15,212,96,15
"1137","2020-03-19",23,14,127,279,6400,0.87703125,0,0,566,609,149,609,34,246,126,34
"1138","2020-03-20",36,14,115,336,6400,0.87703125,0,0,566,609,169,778,50,296,153,50
"1139","2020-03-21",46,14,120,390,6400,0.87703125,0,0,566,609,265,1043,25,321,250,25
"1140","2020-03-22",60,14,144,446,6400,0.87703125,0,0,566,609,271,1314,31,352,255,31
"1141","2020-03-23",79,14,154,509,6400,0.87703125,0,0,566,609,361,1675,18,370,348,18
"1142","2020-03-24",96,14,157,584,6400,0.87703125,0,0,566,609,401,2076,16,386,382,16
"1143","2020-03-25",110,14,150,663,6400,0.87703125,0,0,566,609,438,2514,13,399,424,13
"1144","2020-03-26",140,14,153,738,6400,0.87703125,0,0,566,609,425,2939,8,407,405,8
"1145","2020-03-27",154,14,173,838,6400,0.87703125,0,0,566,609,642,3581,9,416,630,9
"1146","2020-03-28",164,14,173,896,6400,0.87703125,0,0,566,609,434,4015,8,424,420,8
"1147","2020-03-29",180,14,173,1008,6400,0.87703125,0,0,566,609,451,4466,36,460,442,36
"1148","2020-03-30",199,14,162,1103,6400,0.87703125,0,0,566,609,453,4919,22,482,442,22
"1149","2020-03-31",228,14,149,1184,6400,0.87703125,0,0,566,609,378,5297,10,492,372,10
"1150","2020-04-01",269,14,138,1271,6400,0.87703125,0,0,566,609,331,5628,13,505,326,13
"1151","2020-04-02",282,14,129,1396,6400,0.87703125,0,0,566,609,285,5913,28,533,283,28
"1152","2020-04-03",301,14,152,1485,6400,0.87703125,0,0,566,609,256,6169,19,552,249,19
"1153","2020-04-04",331,14,154,1562,6400,0.87703125,0,0,566,609,284,6453,11,563,282,11
"1154","2020-04-05",360,14,154,1630,6400,0.87703125,0,0,566,609,193,6646,25,588,188,25
"1155","2020-04-06",396,14,164,1675,6400,0.87703125,0,0,566,609,166,6812,7,595,162,7
"1156","2020-04-07",417,14,189,1717,6400,0.87703125,0,0,566,609,116,6928,25,620,114,25
"1157","2020-04-08",438,14,224,1809,6400,0.87703125,0,0,566,609,132,7060,38,658,129,38
"1158","2020-04-09",455,14,224,1879,6400,0.87703125,0,0,566,609,97,7157,33,691,93,33
"1159","2020-04-10",482,14,225,1912,6400,0.87703125,0,0,566,609,79,7236,55,746,77,55
"1160","2020-04-11",525,14,216,1930,6400,0.87703125,0,0,566,609,42,7278,30,776,40,30
"1161","2020-04-12",545,14,205,1922,6400,0.87703125,0,0,566,609,40,7318,57,833,39,57
"1162","2020-04-13",547,14,197,1957,6400,0.87703125,0,0,566,609,29,7347,33,866,26,33
"1163","2020-04-14",555,14,187,1954,6400,0.87703125,0,0,566,609,33,7380,17,883,30,17
"1164","2020-04-15",558,14,186,1929,6400,0.87703125,0,0,566,609,29,7409,12,895,28,12
"1165","2020-04-16",572,14,191,1878,6400,0.87703125,0,0,566,609,29,7438,19,914,28,19
"1166","2020-04-17",562,14,201,1826,6400,0.87703125,0,0,566,609,22,7460,10,924,22,10
"1167","2020-04-18",542,14,223,1819,6400,0.87703125,0,0,566,609,17,7477,38,962,14,38
"1168","2020-04-19",535,14,210,1772,6400,0.87703125,0,0,566,609,13,7490,45,1007,11,45
"1169","2020-04-20",534,14,197,1685,6400,0.87703125,0,0,566,609,9,7499,60,1067,9,60
"1170","2020-04-21",533,14,204,1616,6400,0.87703125,0,0,566,609,9,7508,24,1091,7,24
"1171","2020-04-22",514,14,193,1508,6400,0.87703125,0,0,566,609,9,7517,42,1133,5,42
"1172","2020-04-23",491,14,187,1424,6400,0.87703125,0,0,566,609,10,7527,37,1170,9,37
"1173","2020-04-24",485,14,168,1359,6400,0.87703125,0,0,566,609,4,7531,29,1199,2,29
"1174","2020-04-25",454,14,165,1274,6400,0.87703125,0,0,566,609,4,7535,50,1249,2,50
"1175","2020-04-26",440,14,160,1195,6400,0.87703125,0,0,566,609,9,7544,27,1276,9,27
"1176","2020-04-27",417,14,150,1088,6400,0.87703125,0,0,566,609,2,7546,23,1299,2,23
"1177","2020-04-28",381,14,171,1018,6400,0.87703125,0,0,566,609,5,7551,12,1311,3,12
"1178","2020-04-29",353,14,185,929,6400,0.87703125,0,0,566,609,2,7553,8,1319,1,8
"1179","2020-04-30",335,14,205,866,6400,0.87703125,0,0,566,609,3,7556,14,1333,NA,14
"1180","2020-05-01",315,14,223,788,6400,0.87703125,0,0,566,609,1,7557,11,1344,1,11
"1181","2020-05-02",301,14,228,718,6400,0.87703125,0,0,566,609,2,7559,4,1348,NA,4
"1182","2020-05-03",268,14,219,655,6400,0.87703125,0,0,566,609,6,7565,3,1351,1,3
"1183","2020-05-04",242,14,232,591,6400,0.87703125,0,0,566,609,5,7570,8,1359,3,8
"1184","2020-05-05",227,14,218,555,6400,0.87703125,0,0,566,609,5,7575,47,1406,1,47
"1185","2020-05-06",210,14,217,507,6400,0.87703125,0,0,566,609,3,7578,63,1469,2,63
"1186","2020-05-07",191,14,215,476,6400,0.87703125,0,0,566,609,2,7580,32,1501,1,32
"1187","2020-05-08",178,14,228,433,6400,0.87703125,0,0,566,609,1,7581,16,1517,1,16
"1188","2020-05-09",167,14,224,395,6400,0.87703125,0,0,566,609,4,7585,12,1529,3,12
"1189","2020-05-10",158,14,238,372,6400,0.87703125,0,0,566,609,1,7586,11,1540,1,11
"1190","2020-05-11",143,14,215,353,6400,0.87703125,0,0,566,609,4,7590,12,1552,3,12
"1191","2020-05-12",129,14,201,329,6400,0.87703125,0,0,566,609,4,7594,8,1560,2,8
"1192","2020-05-13",120,14,218,308,6400,0.87703125,0,0,566,609,NA,NA,9,1569,NA,9
"1193","2020-05-14",111,14,207,283,6400,0.87703125,0,0,566,609,7,7601,9,1578,3,9
"1194","2020-05-15",96,14,188,270,6400,0.87703125,0,0,566,609,5,7606,6,1584,1,6
"1195","2020-05-16",88,14,192,250,6400,0.87703125,0,0,566,609,3,7609,9,1593,3,9
"1196","2020-05-17",85,14,180,236,6400,0.87703125,0,0,566,609,1,7610,51,1644,1,51
"1197","2020-05-18",82,14,183,223,6400,0.87703125,0,0,566,609,4,7614,22,1666,2,22
"1198","2020-05-19",79,14,191,210,6400,0.87703125,0,0,566,609,1,7615,26,1692,1,26
"1199","2020-05-20",78,14,170,202,6400,0.87703125,0,0,566,609,4,7619,43,1735,2,43
"1200","2020-05-21",76,14,168,185,6400,0.87703125,0,0,566,609,2,7621,54,1789,2,54
"1201","2020-05-22",74,14,161,172,6400,0.87703125,0,0,566,609,2,7623,31,1820,2,31
"1202","2020-05-23",67,14,166,161,6400,0.87703125,0,0,566,609,3,7626,60,1880,2,60
"1203","2020-05-24",54,14,144,141,6400,0.87703125,0,0,566,609,1,7627,47,1927,NA,47
"1204","2020-05-25",54,14,134,135,6400,0.87703125,0,0,566,609,1,7628,38,1965,NA,38
"1205","2020-05-26",48,14,135,128,6400,0.87703125,0,0,566,609,1,7629,36,2001,1,36
"1206","2020-05-27",45,14,119,130,6400,0.87703125,0,0,566,609,3,7632,33,2034,1,33
"1207","2020-05-28",43,14,113,118,6400,0.87703125,0,0,566,609,2,7634,23,2057,2,23
"1208","2020-05-29",38,14,129,117,6400,0.87703125,0,0,566,609,2,7636,19,2076,1,19
"1209","2020-05-30",40,14,132,106,6400,0.87703125,0,0,566,609,1,7637,23,2099,1,23
"1210","2020-05-31",43,14,140,96,6400,0.87703125,0,0,566,609,2,7639,32,2131,1,32
"1211","2020-06-01",40,14,142,89,6400,0.87703125,0,0,566,609,2,7641,33,2164,2,33
"1212","2020-06-02",40,14,155,89,6400,0.87703125,0,0,566,609,1,7642,36,2200,1,36
"1213","2020-06-03",39,14,163,86,6400,0.87703125,0,0,566,609,2,7644,36,2236,1,36
"1214","2020-06-04",36,14,149,83,6400,0.87703125,0,0,566,609,1,7645,16,2252,NA,16
"1215","2020-06-05",37,14,152,80,6400,0.87703125,0,0,566,609,1,7646,18,2270,1,18
"1216","2020-06-06",30,14,159,68,6400,0.87703125,0,0,566,609,1,7647,16,2286,1,16
"1217","2020-06-07",27,14,151,67,6400,0.87703125,0,0,566,609,NA,NA,31,2317,NA,31
"1218","2020-03-13",1,15,126,165,8638,0.832947441537393,0,0,772,1027,53,140,17,30,4,17
"1219","2020-03-14",3,15,117,234,8638,0.832947441537393,0,0,772,1027,64,204,5,35,9,5
"1220","2020-03-15",10,15,103,326,8638,0.832947441537393,0,0,772,1027,65,269,7,42,13,7
"1221","2020-03-16",19,15,139,433,8638,0.832947441537393,0,0,772,1027,60,329,20,62,18,20
"1222","2020-03-17",35,15,149,574,8638,0.832947441537393,0,0,772,1027,58,387,5,67,23,5
"1223","2020-03-18",54,15,190,764,8638,0.832947441537393,0,0,772,1027,67,454,19,86,23,19
"1224","2020-03-19",81,15,188,1016,8638,0.832947441537393,0,0,772,1027,60,514,11,97,24,11
"1225","2020-03-20",122,15,180,1315,8638,0.832947441537393,0,0,772,1027,78,592,11,108,26,11
"1226","2020-03-21",157,15,140,1684,8638,0.832947441537393,0,0,772,1027,54,646,11,119,16,11
"1227","2020-03-22",203,15,146,2008,8638,0.832947441537393,0,0,772,1027,64,710,6,125,23,6
"1228","2020-03-23",255,15,200,2483,8638,0.832947441537393,0,0,772,1027,65,775,18,143,25,18
"1229","2020-03-24",317,15,192,2912,8638,0.832947441537393,0,0,772,1027,79,854,19,162,36,19
"1230","2020-03-25",409,15,203,3414,8638,0.832947441537393,0,0,772,1027,80,934,13,175,34,13
"1231","2020-03-26",503,15,228,3857,8638,0.832947441537393,0,0,772,1027,80,1014,12,187,29,12
"1232","2020-03-27",616,15,215,4300,8638,0.832947441537393,0,0,772,1027,83,1097,10,197,36,10
"1233","2020-03-28",750,15,177,4687,8638,0.832947441537393,0,0,772,1027,78,1175,10,207,37,10
"1234","2020-03-29",881,15,173,4893,8638,0.832947441537393,0,0,772,1027,67,1242,25,232,21,25
"1235","2020-03-30",1028,15,246,4949,8638,0.832947441537393,0,0,772,1027,69,1311,25,257,23,25
"1236","2020-03-31",1154,15,265,4963,8638,0.832947441537393,0,0,772,1027,73,1384,16,273,29,16
"1237","2020-04-01",1302,15,259,4914,8638,0.832947441537393,0,0,772,1027,87,1471,19,292,36,19
"1238","2020-04-02",1378,15,231,4733,8638,0.832947441537393,0,0,772,1027,97,1568,12,304,37,12
"1239","2020-04-03",1426,15,210,4450,8638,0.832947441537393,0,0,772,1027,81,1649,16,320,27,16
"1240","2020-04-04",1475,15,193,4133,8638,0.832947441537393,0,0,772,1027,90,1739,18,338,30,18
"1241","2020-04-05",1451,15,180,3729,8638,0.832947441537393,0,0,772,1027,74,1813,36,374,25,36
"1242","2020-04-06",1382,15,177,3309,8638,0.832947441537393,0,0,772,1027,95,1908,27,401,37,27
"1243","2020-04-07",1316,15,179,2901,8638,0.832947441537393,0,0,772,1027,61,1969,12,413,26,12
"1244","2020-04-08",1160,15,230,2433,8638,0.832947441537393,0,0,772,1027,70,2039,10,423,27,10
"1245","2020-04-09",1043,15,217,2048,8638,0.832947441537393,0,0,772,1027,69,2108,11,434,19,11
"1246","2020-04-10",902,15,185,1693,8638,0.832947441537393,0,0,772,1027,66,2174,8,442,28,8
"1247","2020-04-11",757,15,169,1425,8638,0.832947441537393,0,0,772,1027,73,2247,11,453,16,11
"1248","2020-04-12",646,15,215,1178,8638,0.832947441537393,0,0,772,1027,82,2329,32,485,26,32
"1249","2020-04-13",543,15,219,978,8638,0.832947441537393,0,0,772,1027,66,2395,39,524,22,39
"1250","2020-04-14",447,15,201,784,8638,0.832947441537393,0,0,772,1027,75,2470,37,561,28,37
"1251","2020-04-15",368,15,198,623,8638,0.832947441537393,0,0,772,1027,68,2538,31,592,16,31
"1252","2020-04-16",309,15,227,520,8638,0.832947441537393,0,0,772,1027,68,2606,41,633,24,41
"1253","2020-04-17",264,15,240,428,8638,0.832947441537393,0,0,772,1027,63,2669,32,665,21,32
"1254","2020-04-18",196,15,212,343,8638,0.832947441537393,0,0,772,1027,74,2743,34,699,19,34
"1255","2020-04-19",159,15,196,311,8638,0.832947441537393,0,0,772,1027,61,2804,32,731,16,32
"1256","2020-04-20",133,15,186,256,8638,0.832947441537393,0,0,772,1027,68,2872,35,766,15,35
"1257","2020-04-21",97,15,222,217,8638,0.832947441537393,0,0,772,1027,58,2930,32,798,17,32
"1258","2020-04-22",79,15,240,193,8638,0.832947441537393,0,0,772,1027,53,2983,40,838,9,40
"1259","2020-04-23",67,15,257,163,8638,0.832947441537393,0,0,772,1027,63,3046,55,893,10,55
"1260","2020-04-24",53,15,269,142,8638,0.832947441537393,0,0,772,1027,67,3113,22,915,22,22
"1261","2020-04-25",50,15,270,120,8638,0.832947441537393,0,0,772,1027,65,3178,26,941,15,26
"1262","2020-04-26",38,15,264,105,8638,0.832947441537393,0,0,772,1027,49,3227,17,958,11,17
"1263","2020-04-27",28,15,224,93,8638,0.832947441537393,0,0,772,1027,53,3280,14,972,12,14
"1264","2020-04-28",24,15,201,80,8638,0.832947441537393,0,0,772,1027,50,3330,18,990,12,18
"1265","2020-04-29",20,15,218,75,8638,0.832947441537393,0,0,772,1027,53,3383,14,1004,13,14
"1266","2020-04-30",11,15,222,66,8638,0.832947441537393,0,0,772,1027,45,3428,14,1018,13,14
"1267","2020-05-01",11,15,258,60,8638,0.832947441537393,0,0,772,1027,49,3477,10,1028,13,10
"1268","2020-05-02",9,15,258,55,8638,0.832947441537393,0,0,772,1027,58,3535,10,1038,12,10
"1269","2020-05-03",10,15,246,54,8638,0.832947441537393,0,0,772,1027,56,3591,7,1045,13,7
"1270","2020-05-04",11,15,213,48,8638,0.832947441537393,0,0,772,1027,66,3657,13,1058,16,13
"1271","2020-05-05",10,15,189,45,8638,0.832947441537393,0,0,772,1027,54,3711,8,1066,17,8
"1272","2020-05-06",9,15,225,44,8638,0.832947441537393,0,0,772,1027,43,3754,8,1074,11,8
"1273","2020-05-07",12,15,222,47,8638,0.832947441537393,0,0,772,1027,48,3802,13,1087,20,13
"1274","2020-05-08",10,15,204,44,8638,0.832947441537393,0,0,772,1027,41,3843,38,1125,13,38
"1275","2020-05-09",9,15,244,38,8638,0.832947441537393,0,0,772,1027,43,3886,23,1148,14,23
"1276","2020-05-10",9,15,283,34,8638,0.832947441537393,0,0,772,1027,60,3946,12,1160,19,12
"1277","2020-05-11",10,15,256,29,8638,0.832947441537393,0,0,772,1027,36,3982,18,1178,8,18
"1278","2020-05-12",10,15,239,30,8638,0.832947441537393,0,0,772,1027,42,4024,19,1197,17,19
"1279","2020-05-13",9,15,271,26,8638,0.832947441537393,0,0,772,1027,40,4064,15,1212,10,15
"1280","2020-05-14",7,15,261,24,8638,0.832947441537393,0,0,772,1027,41,4105,20,1232,9,20
"1281","2020-05-15",6,15,292,26,8638,0.832947441537393,0,0,772,1027,56,4161,24,1256,14,24
"1282","2020-05-16",6,15,292,25,8638,0.832947441537393,0,0,772,1027,48,4209,14,1270,13,14
"1283","2020-05-17",6,15,280,27,8638,0.832947441537393,0,0,772,1027,40,4249,11,1281,10,11
"1284","2020-05-18",5,15,267,32,8638,0.832947441537393,0,0,772,1027,37,4286,8,1289,14,8
"1285","2020-05-19",6,15,251,31,8638,0.832947441537393,0,0,772,1027,40,4326,6,1295,11,6
"1286","2020-05-20",8,15,209,32,8638,0.832947441537393,0,0,772,1027,27,4353,10,1305,6,10
"1287","2020-05-21",9,15,182,32,8638,0.832947441537393,0,0,772,1027,30,4383,4,1309,8,4
"1288","2020-05-22",10,15,171,31,8638,0.832947441537393,0,0,772,1027,21,4404,24,1333,3,24
"1289","2020-05-23",12,15,162,28,8638,0.832947441537393,0,0,772,1027,22,4426,21,1354,4,21
"1290","2020-05-24",12,15,143,27,8638,0.832947441537393,0,0,772,1027,33,4459,20,1374,8,20
"1291","2020-05-25",11,15,140,24,8638,0.832947441537393,0,0,772,1027,41,4500,6,1380,10,6
"1292","2020-05-26",10,15,148,24,8638,0.832947441537393,0,0,772,1027,15,4515,10,1390,3,10
"1293","2020-05-27",8,15,138,24,8638,0.832947441537393,0,0,772,1027,18,4533,11,1401,5,11
"1294","2020-05-28",7,15,124,25,8638,0.832947441537393,0,0,772,1027,20,4553,12,1413,6,12
"1295","2020-05-29",6,15,123,19,8638,0.832947441537393,0,0,772,1027,29,4582,4,1417,6,4
"1296","2020-05-30",4,15,122,20,8638,0.832947441537393,0,0,772,1027,20,4602,9,1426,6,9
"1297","2020-05-31",6,15,140,16,8638,0.832947441537393,0,0,772,1027,25,4627,15,1441,10,15
"1298","2020-06-01",6,15,152,15,8638,0.832947441537393,0,0,772,1027,20,4647,6,1447,4,6
"1299","2020-06-02",5,15,163,14,8638,0.832947441537393,0,0,772,1027,15,4662,24,1471,2,24
"1300","2020-06-03",5,15,144,15,8638,0.832947441537393,0,0,772,1027,23,4685,12,1483,7,12
"1301","2020-06-04",6,15,128,14,8638,0.832947441537393,0,0,772,1027,21,4706,13,1496,2,13
"1302","2020-06-05",8,15,113,14,8638,0.832947441537393,0,0,772,1027,20,4726,8,1504,10,8
"1303","2020-06-06",7,15,124,12,8638,0.832947441537393,0,0,772,1027,20,4746,11,1515,5,11
"1304","2020-06-07",4,15,150,11,8638,0.832947441537393,0,0,772,1027,10,4756,13,1528,4,13
"1305","2020-03-14",1,16,77,47,2787,0.545389307499103,0,0,235,963,43,125,29,140,2,29
"1306","2020-03-15",2,16,91,55,2787,0.545389307499103,0,0,235,963,39,164,26,166,12,26
"1307","2020-03-16",4,16,106,69,2787,0.545389307499103,0,0,235,963,48,212,43,209,13,43
"1308","2020-03-17",9,16,140,88,2787,0.545389307499103,0,0,235,963,44,256,39,248,14,39
"1309","2020-03-18",11,16,167,114,2787,0.545389307499103,0,0,235,963,61,317,27,275,35,27
"1310","2020-03-19",15,16,163,132,2787,0.545389307499103,0,0,235,963,47,364,24,299,21,24
"1311","2020-03-20",20,16,163,151,2787,0.545389307499103,0,0,235,963,53,417,29,328,19,29
"1312","2020-03-21",22,16,169,173,2787,0.545389307499103,0,0,235,963,55,472,52,380,24,52
"1313","2020-03-22",28,16,176,199,2787,0.545389307499103,0,0,235,963,71,543,41,421,36,41
"1314","2020-03-23",33,16,170,224,2787,0.545389307499103,0,0,235,963,65,608,23,444,32,23
"1315","2020-03-24",38,16,165,230,2787,0.545389307499103,0,0,235,963,56,664,30,474,25,30
"1316","2020-03-25",44,16,152,244,2787,0.545389307499103,0,0,235,963,65,729,40,514,32,40
"1317","2020-03-26",52,16,161,255,2787,0.545389307499103,0,0,235,963,51,780,50,564,30,50
"1318","2020-03-27",56,16,142,276,2787,0.545389307499103,0,0,235,963,61,841,29,593,36,29
"1319","2020-03-28",63,16,135,294,2787,0.545389307499103,0,0,235,963,56,897,52,645,25,52
"1320","2020-03-29",68,16,139,294,2787,0.545389307499103,0,0,235,963,62,959,56,701,37,56
"1321","2020-03-30",76,16,162,327,2787,0.545389307499103,0,0,235,963,71,1030,42,743,29,42
"1322","2020-03-31",73,16,157,348,2787,0.545389307499103,0,0,235,963,69,1099,62,805,39,62
"1323","2020-04-01",82,16,162,357,2787,0.545389307499103,0,0,235,963,72,1171,44,849,27,44
"1324","2020-04-02",86,16,182,375,2787,0.545389307499103,0,0,235,963,61,1232,41,890,21,41
"1325","2020-04-03",90,16,204,394,2787,0.545389307499103,0,0,235,963,61,1293,31,921,28,31
"1326","2020-04-04",102,16,195,396,2787,0.545389307499103,0,0,235,963,61,1354,52,973,31,52
"1327","2020-04-05",110,16,185,401,2787,0.545389307499103,0,0,235,963,64,1418,41,1014,32,41
"1328","2020-04-06",104,16,180,404,2787,0.545389307499103,0,0,235,963,71,1489,34,1048,37,34
"1329","2020-04-07",113,16,177,412,2787,0.545389307499103,0,0,235,963,75,1564,19,1067,33,19
"1330","2020-04-08",107,16,175,417,2787,0.545389307499103,0,0,235,963,75,1639,54,1121,34,54
"1331","2020-04-09",106,16,182,420,2787,0.545389307499103,0,0,235,963,59,1698,32,1153,26,32
"1332","2020-04-10",116,16,163,426,2787,0.545389307499103,0,0,235,963,62,1760,39,1192,32,39
"1333","2020-04-11",108,16,149,440,2787,0.545389307499103,0,0,235,963,62,1822,27,1219,23,27
"1334","2020-04-12",102,16,136,435,2787,0.545389307499103,0,0,235,963,63,1885,32,1251,27,32
"1335","2020-04-13",110,16,131,453,2787,0.545389307499103,0,0,235,963,54,1939,28,1279,29,28
"1336","2020-04-14",107,16,152,478,2787,0.545389307499103,0,0,235,963,72,2011,25,1304,30,25
"1337","2020-04-15",119,16,192,487,2787,0.545389307499103,0,0,235,963,65,2076,24,1328,29,24
"1338","2020-04-16",121,16,203,507,2787,0.545389307499103,0,0,235,963,47,2123,35,1363,18,35
"1339","2020-04-17",125,16,221,508,2787,0.545389307499103,0,0,235,963,72,2195,47,1410,29,47
"1340","2020-04-18",135,16,234,506,2787,0.545389307499103,0,0,235,963,71,2266,40,1450,23,40
"1341","2020-04-19",142,16,258,506,2787,0.545389307499103,0,0,235,963,76,2342,41,1491,33,41
"1342","2020-04-20",142,16,259,507,2787,0.545389307499103,0,0,235,963,76,2418,43,1534,25,43
"1343","2020-04-21",145,16,270,513,2787,0.545389307499103,0,0,235,963,66,2484,31,1565,30,31
"1344","2020-04-22",139,16,270,500,2787,0.545389307499103,0,0,235,963,46,2530,14,1579,22,14
"1345","2020-04-23",146,16,265,484,2787,0.545389307499103,0,0,235,963,63,2593,25,1604,22,25
"1346","2020-04-24",135,16,251,469,2787,0.545389307499103,0,0,235,963,60,2653,23,1627,24,23
"1347","2020-04-25",133,16,241,469,2787,0.545389307499103,0,0,235,963,78,2731,22,1649,41,22
"1348","2020-04-26",135,16,229,453,2787,0.545389307499103,0,0,235,963,52,2783,33,1682,21,33
"1349","2020-04-27",140,16,199,441,2787,0.545389307499103,0,0,235,963,73,2856,28,1710,36,28
"1350","2020-04-28",136,16,182,425,2787,0.545389307499103,0,0,235,963,50,2906,29,1739,24,29
"1351","2020-04-29",138,16,179,400,2787,0.545389307499103,0,0,235,963,56,2962,64,1803,21,64
"1352","2020-04-30",137,16,217,397,2787,0.545389307499103,0,0,235,963,50,3012,59,1862,26,59
"1353","2020-05-01",138,16,224,402,2787,0.545389307499103,0,0,235,963,58,3070,55,1917,21,55
"1354","2020-05-02",134,16,222,388,2787,0.545389307499103,0,0,235,963,56,3126,58,1975,30,58
"1355","2020-05-03",131,16,215,376,2787,0.545389307499103,0,0,235,963,52,3178,61,2036,16,61
"1356","2020-05-04",123,16,256,374,2787,0.545389307499103,0,0,235,963,36,3214,44,2080,16,44
"1357","2020-05-05",124,16,259,378,2787,0.545389307499103,0,0,235,963,52,3266,36,2116,23,36
"1358","2020-05-06",118,16,269,393,2787,0.545389307499103,0,0,235,963,35,3301,49,2165,17,49
"1359","2020-05-07",108,16,267,385,2787,0.545389307499103,0,0,235,963,37,3338,51,2216,15,51
"1360","2020-05-08",102,16,247,378,2787,0.545389307499103,0,0,235,963,45,3383,35,2251,15,35
"1361","2020-05-09",101,16,237,361,2787,0.545389307499103,0,0,235,963,42,3425,48,2299,14,48
"1362","2020-05-10",97,16,233,349,2787,0.545389307499103,0,0,235,963,42,3467,36,2335,18,36
"1363","2020-05-11",98,16,214,339,2787,0.545389307499103,0,0,235,963,50,3517,33,2368,17,33
"1364","2020-05-12",97,16,230,340,2787,0.545389307499103,0,0,235,963,47,3564,57,2425,17,57
"1365","2020-05-13",93,16,218,339,2787,0.545389307499103,0,0,235,963,34,3598,48,2473,18,48
"1366","2020-05-14",91,16,218,335,2787,0.545389307499103,0,0,235,963,51,3649,56,2529,15,56
"1367","2020-05-15",100,16,212,339,2787,0.545389307499103,0,0,235,963,37,3686,38,2567,18,38
"1368","2020-05-16",101,16,197,323,2787,0.545389307499103,0,0,235,963,28,3714,48,2615,9,48
"1369","2020-05-17",90,16,182,314,2787,0.545389307499103,0,0,235,963,53,3767,58,2673,23,58
"1370","2020-05-18",95,16,184,318,2787,0.545389307499103,0,0,235,963,36,3803,41,2714,13,41
"1371","2020-05-19",92,16,203,312,2787,0.545389307499103,0,0,235,963,38,3841,33,2747,19,33
"1372","2020-05-20",91,16,215,303,2787,0.545389307499103,0,0,235,963,23,3864,55,2802,11,55
"1373","2020-05-21",100,16,202,299,2787,0.545389307499103,0,0,235,963,39,3903,54,2856,18,54
"1374","2020-05-22",96,16,195,301,2787,0.545389307499103,0,0,235,963,17,3920,45,2901,2,45
"1375","2020-05-23",83,16,190,302,2787,0.545389307499103,0,0,235,963,25,3945,29,2930,11,29
"1376","2020-05-24",84,16,211,284,2787,0.545389307499103,0,0,235,963,23,3968,58,2988,10,58
"1377","2020-05-25",80,16,241,283,2787,0.545389307499103,0,0,235,963,28,3996,43,3031,12,43
"1378","2020-05-26",78,16,247,277,2787,0.545389307499103,0,0,235,963,32,4028,62,3093,17,62
"1379","2020-05-27",81,16,249,278,2787,0.545389307499103,0,0,235,963,19,4047,38,3131,8,38
"1380","2020-05-28",73,16,236,273,2787,0.545389307499103,0,0,235,963,23,4070,36,3167,8,36
"1381","2020-05-29",65,16,226,266,2787,0.545389307499103,0,0,235,963,18,4088,58,3225,4,58
"1382","2020-05-30",73,16,223,250,2787,0.545389307499103,0,0,235,963,32,4120,42,3267,9,42
"1383","2020-05-31",82,16,222,247,2787,0.545389307499103,0,0,235,963,10,4130,32,3299,6,32
"1384","2020-06-01",75,16,203,239,2787,0.545389307499103,0,0,235,963,21,4151,38,3337,12,38
"1385","2020-06-02",76,16,233,225,2787,0.545389307499103,0,0,235,963,18,4169,39,3376,5,39
"1386","2020-06-03",76,16,227,214,2787,0.545389307499103,0,0,235,963,19,4188,41,3417,7,41
"1387","2020-06-04",67,16,232,206,2787,0.545389307499103,0,0,235,963,13,4201,41,3458,2,41
"1388","2020-06-05",66,16,215,205,2787,0.545389307499103,0,0,235,963,19,4220,42,3500,6,42
"1389","2020-06-06",65,16,192,199,2787,0.545389307499103,0,0,235,963,16,4236,37,3537,1,37
"1390","2020-06-07",64,16,186,198,2787,0.545389307499103,0,0,235,963,16,4252,38,3575,7,38
"1391","2020-03-13",1,17,103,78,3463,0.319665030320531,0,0,291,690,11,26,33,68,9,33
"1392","2020-03-14",3,17,144,110,3463,0.319665030320531,0,0,291,690,20,46,17,85,17,17
"1393","2020-03-15",8,17,154,137,3463,0.319665030320531,0,0,291,690,25,71,27,112,20,27
"1394","2020-03-16",10,17,161,175,3463,0.319665030320531,0,0,291,690,37,108,15,127,30,15
"1395","2020-03-17",17,17,147,220,3463,0.319665030320531,0,0,291,690,45,153,10,137,38,10
"1396","2020-03-18",28,17,134,252,3463,0.319665030320531,0,0,291,690,47,200,29,166,44,29
"1397","2020-03-19",36,17,146,275,3463,0.319665030320531,0,0,291,690,68,268,36,202,61,36
"1398","2020-03-20",43,17,133,309,3463,0.319665030320531,0,0,291,690,88,356,20,222,83,20
"1399","2020-03-21",56,17,149,342,3463,0.319665030320531,0,0,291,690,103,459,19,241,98,19
"1400","2020-03-22",61,17,156,364,3463,0.319665030320531,0,0,291,690,140,599,22,263,135,22
"1401","2020-03-23",72,17,163,387,3463,0.319665030320531,0,0,291,690,135,734,22,285,134,22
"1402","2020-03-24",84,17,167,401,3463,0.319665030320531,0,0,291,690,162,896,39,324,156,39
"1403","2020-03-25",92,17,162,428,3463,0.319665030320531,0,0,291,690,198,1094,28,352,190,28
"1404","2020-03-26",103,17,176,427,3463,0.319665030320531,0,0,291,690,229,1323,21,373,225,21
"1405","2020-03-27",109,17,162,430,3463,0.319665030320531,0,0,291,690,348,1671,10,383,340,10
"1406","2020-03-28",113,17,187,442,3463,0.319665030320531,0,0,291,690,263,1934,8,391,259,8
"1407","2020-03-29",120,17,208,442,3463,0.319665030320531,0,0,291,690,318,2252,26,417,310,26
"1408","2020-03-30",121,17,189,454,3463,0.319665030320531,0,0,291,690,373,2625,34,451,370,34
"1409","2020-03-31",118,17,191,464,3463,0.319665030320531,0,0,291,690,311,2936,35,486,301,35
"1410","2020-04-01",123,17,179,485,3463,0.319665030320531,0,0,291,690,439,3375,37,523,436,37
"1411","2020-04-02",121,17,173,476,3463,0.319665030320531,0,0,291,690,426,3801,43,566,417,43
"1412","2020-04-03",125,17,181,483,3463,0.319665030320531,0,0,291,690,374,4175,19,585,370,19
"1413","2020-04-04",125,17,162,480,3463,0.319665030320531,0,0,291,690,427,4602,21,606,424,21
"1414","2020-04-05",126,17,148,499,3463,0.319665030320531,0,0,291,690,326,4928,53,659,323,53
"1415","2020-04-06",130,17,141,523,3463,0.319665030320531,0,0,291,690,357,5285,57,716,356,57
"1416","2020-04-07",139,17,164,533,3463,0.319665030320531,0,0,291,690,282,5567,47,763,280,47
"1417","2020-04-08",141,17,218,529,3463,0.319665030320531,0,0,291,690,285,5852,46,809,281,46
"1418","2020-04-09",140,17,206,536,3463,0.319665030320531,0,0,291,690,274,6126,55,864,273,55
"1419","2020-04-10",146,17,195,543,3463,0.319665030320531,0,0,291,690,213,6339,29,893,206,29
"1420","2020-04-11",151,17,185,553,3463,0.319665030320531,0,0,291,690,182,6521,24,917,178,24
"1421","2020-04-12",156,17,174,565,3463,0.319665030320531,0,0,291,690,128,6649,17,934,126,17
"1422","2020-04-13",157,17,166,555,3463,0.319665030320531,0,0,291,690,119,6768,19,953,119,19
"1423","2020-04-14",150,17,200,548,3463,0.319665030320531,0,0,291,690,99,6867,16,969,99,16
"1424","2020-04-15",150,17,195,559,3463,0.319665030320531,0,0,291,690,80,6947,49,1018,80,49
"1425","2020-04-16",148,17,182,568,3463,0.319665030320531,0,0,291,690,72,7019,44,1062,70,44
"1426","2020-04-17",141,17,162,564,3463,0.319665030320531,0,0,291,690,54,7073,40,1102,54,40
"1427","2020-04-18",142,17,152,569,3463,0.319665030320531,0,0,291,690,57,7130,31,1133,56,31
"1428","2020-04-19",150,17,144,573,3463,0.319665030320531,0,0,291,690,44,7174,18,1151,42,18
"1429","2020-04-20",143,17,135,573,3463,0.319665030320531,0,0,291,690,35,7209,53,1204,35,53
"1430","2020-04-21",164,17,134,561,3463,0.319665030320531,0,0,291,690,29,7238,57,1261,29,57
"1431","2020-04-22",166,17,128,563,3463,0.319665030320531,0,0,291,690,21,7259,57,1318,20,57
"1432","2020-04-23",168,17,124,570,3463,0.319665030320531,0,0,291,690,13,7272,33,1351,11,33
"1433","2020-04-24",178,17,127,576,3463,0.319665030320531,0,0,291,690,13,7285,30,1381,12,30
"1434","2020-04-25",181,17,175,569,3463,0.319665030320531,0,0,291,690,17,7302,46,1427,17,46
"1435","2020-04-26",176,17,225,568,3463,0.319665030320531,0,0,291,690,17,7319,32,1459,14,32
"1436","2020-04-27",179,17,255,558,3463,0.319665030320531,0,0,291,690,7,7326,54,1513,5,54
"1437","2020-04-28",160,17,246,553,3463,0.319665030320531,0,0,291,690,8,7334,59,1572,7,59
"1438","2020-04-29",152,17,266,561,3463,0.319665030320531,0,0,291,690,9,7343,20,1592,9,20
"1439","2020-04-30",162,17,266,550,3463,0.319665030320531,0,0,291,690,6,7349,13,1605,5,13
"1440","2020-05-01",153,17,261,529,3463,0.319665030320531,0,0,291,690,2,7351,19,1624,2,19
"1441","2020-05-02",149,17,238,523,3463,0.319665030320531,0,0,291,690,4,7355,32,1656,3,32
"1442","2020-05-03",142,17,259,530,3463,0.319665030320531,0,0,291,690,6,7361,44,1700,5,44
"1443","2020-05-04",147,17,261,509,3463,0.319665030320531,0,0,291,690,1,7362,22,1722,1,22
"1444","2020-05-05",153,17,256,494,3463,0.319665030320531,0,0,291,690,5,7367,44,1766,5,44
"1445","2020-05-06",149,17,244,483,3463,0.319665030320531,0,0,291,690,3,7370,44,1810,2,45
"1446","2020-05-07",137,17,230,472,3463,0.319665030320531,0,0,291,690,3,7373,33,1843,3,33
"1447","2020-05-08",135,17,199,452,3463,0.319665030320531,0,0,291,690,2,7375,20,1863,1,20
"1448","2020-05-09",136,17,241,451,3463,0.319665030320531,0,0,291,690,5,7380,18,1881,5,18
"1449","2020-05-10",135,17,265,429,3463,0.319665030320531,0,0,291,690,2,7382,43,1924,NA,43
"1450","2020-05-11",134,17,249,413,3463,0.319665030320531,0,0,291,690,2,7384,34,1958,2,34
"1451","2020-05-12",126,17,211,389,3463,0.319665030320531,0,0,291,690,3,7387,56,2014,2,56
"1452","2020-05-13",128,17,196,388,3463,0.319665030320531,0,0,291,690,3,7390,47,2061,2,47
"1453","2020-05-14",130,17,181,378,3463,0.319665030320531,0,0,291,690,2,7392,41,2102,2,41
"1454","2020-05-15",128,17,192,373,3463,0.319665030320531,0,0,291,690,NA,NA,25,2127,NA,25
"1455","2020-05-16",118,17,190,368,3463,0.319665030320531,0,0,291,690,3,7395,28,2155,3,28
"1456","2020-05-17",116,17,233,364,3463,0.319665030320531,0,0,291,690,2,7397,25,2180,1,25
"1457","2020-05-18",113,17,239,358,3463,0.319665030320531,0,0,291,690,NA,NA,23,2203,NA,23
"1458","2020-05-19",110,17,226,344,3463,0.319665030320531,0,0,291,690,1,7398,19,2222,1,19
"1459","2020-05-20",110,17,235,336,3463,0.319665030320531,0,0,291,690,2,7400,18,2240,2,18
"1460","2020-05-21",106,17,252,329,3463,0.319665030320531,0,0,291,690,2,7402,22,2262,2,22
"1461","2020-05-22",109,17,254,310,3463,0.319665030320531,0,0,291,690,2,7404,13,2275,1,13
"1462","2020-05-23",102,17,247,303,3463,0.319665030320531,0,0,291,690,1,7405,17,2292,NA,17
"1463","2020-05-24",96,17,223,288,3463,0.319665030320531,0,0,291,690,2,7407,8,2300,2,8
"1464","2020-05-25",96,17,205,281,3463,0.319665030320531,0,0,291,690,4,7411,11,2311,4,11
"1465","2020-05-26",94,17,199,283,3463,0.319665030320531,0,0,291,690,4,7415,26,2337,3,26
"1466","2020-05-27",86,17,210,266,3463,0.319665030320531,0,0,291,690,NA,NA,10,2347,NA,10
"1467","2020-05-28",84,17,199,251,3463,0.319665030320531,0,0,291,690,2,7417,4,2351,1,4
"1468","2020-05-29",75,17,186,249,3463,0.319665030320531,0,0,291,690,2,7419,6,2357,NA,6
"1469","2020-05-30",74,17,154,243,3463,0.319665030320531,0,0,291,690,3,7422,23,2380,3,23
"1470","2020-05-31",74,17,142,234,3463,0.319665030320531,0,0,291,690,3,7425,13,2393,1,13
"1471","2020-06-01",69,17,133,220,3463,0.319665030320531,0,0,291,690,3,7428,14,2407,3,14
"1472","2020-06-02",63,17,121,207,3463,0.319665030320531,0,0,291,690,3,7431,6,2413,3,6
"1473","2020-06-03",64,17,103,197,3463,0.319665030320531,0,0,291,690,3,7434,30,2443,3,30
"1474","2020-06-04",65,17,132,195,3463,0.319665030320531,0,0,291,690,3,7437,18,2461,2,18
"1475","2020-06-05",63,17,147,207,3463,0.319665030320531,0,0,291,690,NA,NA,15,2476,NA,15
"1476","2020-06-06",62,17,170,206,3463,0.319665030320531,0,0,291,690,2,7439,27,2503,2,27
"1477","2020-06-07",58,17,178,196,3463,0.319665030320531,0,0,291,690,1,7440,33,2536,1,33
"1478","2020-03-14",2,18,71,61,3198,0.605065666041276,0,0,283,1072,13,35,10,45,2,10
"1479","2020-03-15",3,18,60,86,3198,0.605065666041276,0,0,283,1072,15,50,7,52,8,7
"1480","2020-03-16",4,18,74,120,3198,0.605065666041276,0,0,283,1072,15,65,5,57,8,5
"1481","2020-03-17",8,18,108,147,3198,0.605065666041276,0,0,283,1072,19,84,15,72,12,15
"1482","2020-03-18",13,18,128,177,3198,0.605065666041276,0,0,283,1072,22,106,12,84,14,12
"1483","2020-03-19",26,18,112,209,3198,0.605065666041276,0,0,283,1072,16,122,12,96,15,12
"1484","2020-03-20",32,18,121,228,3198,0.605065666041276,0,0,283,1072,21,143,11,107,12,11
"1485","2020-03-21",39,18,157,264,3198,0.605065666041276,0,0,283,1072,25,168,32,139,13,32
"1486","2020-03-22",42,18,154,287,3198,0.605065666041276,0,0,283,1072,17,185,19,158,14,19
"1487","2020-03-23",50,18,183,303,3198,0.605065666041276,0,0,283,1072,31,216,27,185,27,27
"1488","2020-03-24",60,18,195,322,3198,0.605065666041276,0,0,283,1072,30,246,39,224,23,39
"1489","2020-03-25",78,18,162,331,3198,0.605065666041276,0,0,283,1072,28,274,41,265,22,41
"1490","2020-03-26",82,18,161,342,3198,0.605065666041276,0,0,283,1072,25,299,39,304,22,39
"1491","2020-03-27",89,18,178,347,3198,0.605065666041276,0,0,283,1072,29,328,45,349,21,45
"1492","2020-03-28",88,18,203,362,3198,0.605065666041276,0,0,283,1072,21,349,52,401,16,52
"1493","2020-03-29",98,18,213,364,3198,0.605065666041276,0,0,283,1072,29,378,29,430,12,29
"1494","2020-03-30",107,18,249,369,3198,0.605065666041276,0,0,283,1072,22,400,19,449,13,19
"1495","2020-03-31",105,18,232,374,3198,0.605065666041276,0,0,283,1072,17,417,11,460,8,11
"1496","2020-04-01",88,18,204,378,3198,0.605065666041276,0,0,283,1072,12,429,17,477,6,17
"1497","2020-04-02",92,18,216,405,3198,0.605065666041276,0,0,283,1072,30,459,21,498,17,21
"1498","2020-04-03",95,18,199,402,3198,0.605065666041276,0,0,283,1072,22,481,16,514,11,16
"1499","2020-04-04",93,18,204,400,3198,0.605065666041276,0,0,283,1072,20,501,10,524,13,10
"1500","2020-04-05",96,18,188,414,3198,0.605065666041276,0,0,283,1072,37,538,35,559,27,35
"1501","2020-04-06",90,18,202,420,3198,0.605065666041276,0,0,283,1072,17,555,25,584,10,25
"1502","2020-04-07",91,18,182,418,3198,0.605065666041276,0,0,283,1072,18,573,15,599,12,15
"1503","2020-04-08",105,18,190,415,3198,0.605065666041276,0,0,283,1072,22,595,29,628,15,29
"1504","2020-04-09",102,18,219,434,3198,0.605065666041276,0,0,283,1072,30,625,27,655,15,27
"1505","2020-04-10",110,18,221,427,3198,0.605065666041276,0,0,283,1072,22,647,15,670,10,15
"1506","2020-04-11",125,18,204,442,3198,0.605065666041276,0,0,283,1072,16,663,25,695,6,25
"1507","2020-04-12",121,18,179,453,3198,0.605065666041276,0,0,283,1072,23,686,16,711,14,16
"1508","2020-04-13",132,18,197,459,3198,0.605065666041276,0,0,283,1072,17,703,6,717,12,6
"1509","2020-04-14",138,18,209,453,3198,0.605065666041276,0,0,283,1072,26,729,4,721,14,4
"1510","2020-04-15",138,18,231,477,3198,0.605065666041276,0,0,283,1072,31,760,5,726,23,5
"1511","2020-04-16",141,18,244,473,3198,0.605065666041276,0,0,283,1072,28,788,7,733,15,7
"1512","2020-04-17",134,18,266,483,3198,0.605065666041276,0,0,283,1072,23,811,3,736,16,3
"1513","2020-04-18",131,18,262,503,3198,0.605065666041276,0,0,283,1072,24,835,31,767,18,31
"1514","2020-04-19",137,18,258,511,3198,0.605065666041276,0,0,283,1072,28,863,40,807,18,40
"1515","2020-04-20",141,18,255,511,3198,0.605065666041276,0,0,283,1072,23,886,22,829,13,22
"1516","2020-04-21",142,18,241,520,3198,0.605065666041276,0,0,283,1072,30,916,23,852,14,23
"1517","2020-04-22",141,18,240,514,3198,0.605065666041276,0,0,283,1072,29,945,26,878,19,26
"1518","2020-04-23",144,18,214,517,3198,0.605065666041276,0,0,283,1072,20,965,18,896,9,18
"1519","2020-04-24",152,18,214,506,3198,0.605065666041276,0,0,283,1072,26,991,16,912,16,16
"1520","2020-04-25",154,18,203,510,3198,0.605065666041276,0,0,283,1072,22,1013,32,944,11,32
"1521","2020-04-26",150,18,167,500,3198,0.605065666041276,0,0,283,1072,25,1038,24,968,16,24
"1522","2020-04-27",143,18,151,488,3198,0.605065666041276,0,0,283,1072,27,1065,20,988,13,20
"1523","2020-04-28",145,18,186,477,3198,0.605065666041276,0,0,283,1072,22,1087,8,996,9,8
"1524","2020-04-29",142,18,184,485,3198,0.605065666041276,0,0,283,1072,30,1117,9,1005,22,9
"1525","2020-04-30",135,18,198,470,3198,0.605065666041276,0,0,283,1072,31,1148,9,1014,17,9
"1526","2020-05-01",130,18,235,460,3198,0.605065666041276,0,0,283,1072,24,1172,2,1016,12,2
"1527","2020-05-02",130,18,245,470,3198,0.605065666041276,0,0,283,1072,11,1183,10,1026,6,10
"1528","2020-05-03",132,18,235,481,3198,0.605065666041276,0,0,283,1072,26,1209,10,1036,18,10
"1529","2020-05-04",140,18,227,465,3198,0.605065666041276,0,0,283,1072,39,1248,45,1081,24,45
"1530","2020-05-05",144,18,206,486,3198,0.605065666041276,0,0,283,1072,23,1271,36,1117,8,36
"1531","2020-05-06",148,18,201,483,3198,0.605065666041276,0,0,283,1072,30,1301,47,1164,17,47
"1532","2020-05-07",152,18,165,475,3198,0.605065666041276,0,0,283,1072,16,1317,48,1212,10,48
"1533","2020-05-08",151,18,138,466,3198,0.605065666041276,0,0,283,1072,33,1350,26,1238,21,26
"1534","2020-05-09",152,18,127,465,3198,0.605065666041276,0,0,283,1072,15,1365,26,1264,10,26
"1535","2020-05-10",157,18,120,467,3198,0.605065666041276,0,0,283,1072,17,1382,34,1298,11,34
"1536","2020-05-11",141,18,123,460,3198,0.605065666041276,0,0,283,1072,19,1401,13,1311,10,13
"1537","2020-05-12",132,18,100,459,3198,0.605065666041276,0,0,283,1072,23,1424,15,1326,16,15
"1538","2020-05-13",123,18,108,461,3198,0.605065666041276,0,0,283,1072,20,1444,10,1336,9,10
"1539","2020-05-14",115,18,114,439,3198,0.605065666041276,0,0,283,1072,36,1480,23,1359,23,23
"1540","2020-05-15",113,18,123,427,3198,0.605065666041276,0,0,283,1072,20,1500,41,1400,11,41
"1541","2020-05-16",109,18,164,430,3198,0.605065666041276,0,0,283,1072,27,1527,23,1423,14,23
"1542","2020-05-17",109,18,209,424,3198,0.605065666041276,0,0,283,1072,20,1547,18,1441,11,18
"1543","2020-05-18",105,18,249,409,3198,0.605065666041276,0,0,283,1072,18,1565,28,1469,9,28
"1544","2020-05-19",108,18,254,403,3198,0.605065666041276,0,0,283,1072,21,1586,28,1497,10,28
"1545","2020-05-20",116,18,219,382,3198,0.605065666041276,0,0,283,1072,20,1606,16,1513,11,16
"1546","2020-05-21",126,18,188,376,3198,0.605065666041276,0,0,283,1072,30,1636,13,1526,21,13
"1547","2020-05-22",122,18,214,372,3198,0.605065666041276,0,0,283,1072,16,1652,6,1532,12,6
"1548","2020-05-23",121,18,196,365,3198,0.605065666041276,0,0,283,1072,22,1674,14,1546,16,14
"1549","2020-05-24",120,18,171,361,3198,0.605065666041276,0,0,283,1072,19,1693,21,1567,14,21
"1550","2020-05-25",125,18,165,356,3198,0.605065666041276,0,0,283,1072,23,1716,30,1597,18,30
"1551","2020-05-26",121,18,165,355,3198,0.605065666041276,0,0,283,1072,26,1742,22,1619,13,22
"1552","2020-05-27",114,18,170,338,3198,0.605065666041276,0,0,283,1072,21,1763,27,1646,18,27
"1553","2020-05-28",103,18,175,310,3198,0.605065666041276,0,0,283,1072,16,1779,29,1675,11,29
"1554","2020-05-29",104,18,158,304,3198,0.605065666041276,0,0,283,1072,18,1797,31,1706,15,31
"1555","2020-05-30",97,18,157,277,3198,0.605065666041276,0,0,283,1072,22,1819,17,1723,17,17
"1556","2020-05-31",89,18,170,269,3198,0.605065666041276,0,0,283,1072,11,1830,12,1735,8,12
"1557","2020-06-01",84,18,167,257,3198,0.605065666041276,0,0,283,1072,17,1847,12,1747,11,12
"1558","2020-06-02",81,18,200,251,3198,0.605065666041276,0,0,283,1072,18,1865,20,1767,15,20
"1559","2020-06-03",83,18,206,253,3198,0.605065666041276,0,0,283,1072,22,1887,9,1776,19,9
"1560","2020-06-04",82,18,204,245,3198,0.605065666041276,0,0,283,1072,17,1904,13,1789,12,13
"1561","2020-06-05",76,18,187,235,3198,0.605065666041276,0,0,283,1072,19,1923,24,1813,14,24
"1562","2020-06-06",81,18,165,219,3198,0.605065666041276,0,0,283,1072,17,1940,32,1845,13,32
"1563","2020-06-07",77,18,151,206,3198,0.605065666041276,0,0,283,1072,13,1953,31,1876,9,31
"1564","2020-03-13",3,19,63,97,3434,0.275480489225393,0,0,318,565,36,101,17,98,7,17
"1565","2020-03-14",6,19,79,125,3434,0.275480489225393,0,0,318,565,37,138,10,108,10,10
"1566","2020-03-15",9,19,73,160,3434,0.275480489225393,0,0,318,565,34,172,8,116,5,8
"1567","2020-03-16",17,19,66,199,3434,0.275480489225393,0,0,318,565,43,215,32,148,20,32
"1568","2020-03-17",20,19,80,231,3434,0.275480489225393,0,0,318,565,41,256,33,181,11,33
"1569","2020-03-18",29,19,88,253,3434,0.275480489225393,0,0,318,565,45,301,25,206,18,25
"1570","2020-03-19",36,19,104,280,3434,0.275480489225393,0,0,318,565,48,349,12,218,19,12
"1571","2020-03-20",40,19,107,312,3434,0.275480489225393,0,0,318,565,52,401,7,225,20,7
"1572","2020-03-21",50,19,125,334,3434,0.275480489225393,0,0,318,565,56,457,7,232,27,7
"1573","2020-03-22",62,19,141,352,3434,0.275480489225393,0,0,318,565,49,506,39,271,26,39
"1574","2020-03-23",69,19,138,367,3434,0.275480489225393,0,0,318,565,67,573,14,285,33,14
"1575","2020-03-24",74,19,124,380,3434,0.275480489225393,0,0,318,565,56,629,14,299,29,14
"1576","2020-03-25",77,19,122,394,3434,0.275480489225393,0,0,318,565,71,700,12,311,45,12
"1577","2020-03-26",80,19,120,396,3434,0.275480489225393,0,0,318,565,72,772,43,354,26,43
"1578","2020-03-27",90,19,118,413,3434,0.275480489225393,0,0,318,565,65,837,14,368,30,14
"1579","2020-03-28",94,19,107,437,3434,0.275480489225393,0,0,318,565,60,897,15,383,31,15
"1580","2020-03-29",104,19,104,433,3434,0.275480489225393,0,0,318,565,62,959,17,400,35,17
"1581","2020-03-30",110,19,92,455,3434,0.275480489225393,0,0,318,565,66,1025,12,412,37,12
"1582","2020-03-31",120,19,85,482,3434,0.275480489225393,0,0,318,565,53,1078,11,423,30,11
"1583","2020-04-01",126,19,102,478,3434,0.275480489225393,0,0,318,565,58,1136,10,433,33,10
"1584","2020-04-02",143,19,108,487,3434,0.275480489225393,0,0,318,565,65,1201,10,443,34,10
"1585","2020-04-03",148,19,108,514,3434,0.275480489225393,0,0,318,565,71,1272,12,455,34,12
"1586","2020-04-04",150,19,108,524,3434,0.275480489225393,0,0,318,565,75,1347,42,497,47,42
"1587","2020-04-05",144,19,125,547,3434,0.275480489225393,0,0,318,565,48,1395,46,543,26,46
"1588","2020-04-06",149,19,146,562,3434,0.275480489225393,0,0,318,565,56,1451,50,593,30,50
"1589","2020-04-07",147,19,157,585,3434,0.275480489225393,0,0,318,565,70,1521,25,618,29,25
"1590","2020-04-08",152,19,172,588,3434,0.275480489225393,0,0,318,565,76,1597,25,643,44,25
"1591","2020-04-09",146,19,169,595,3434,0.275480489225393,0,0,318,565,48,1645,17,660,28,17
"1592","2020-04-10",143,19,159,589,3434,0.275480489225393,0,0,318,565,60,1705,35,695,24,35
"1593","2020-04-11",143,19,179,585,3434,0.275480489225393,0,0,318,565,77,1782,55,750,45,55
"1594","2020-04-12",143,19,204,568,3434,0.275480489225393,0,0,318,565,70,1852,61,811,33,61
"1595","2020-04-13",148,19,218,566,3434,0.275480489225393,0,0,318,565,55,1907,30,841,23,30
"1596","2020-04-14",154,19,204,561,3434,0.275480489225393,0,0,318,565,65,1972,16,857,40,16
"1597","2020-04-15",150,19,162,546,3434,0.275480489225393,0,0,318,565,77,2049,15,872,40,15
"1598","2020-04-16",155,19,148,546,3434,0.275480489225393,0,0,318,565,58,2107,9,881,21,9
"1599","2020-04-17",162,19,157,549,3434,0.275480489225393,0,0,318,565,61,2168,13,894,28,13
"1600","2020-04-18",161,19,146,546,3434,0.275480489225393,0,0,318,565,61,2229,52,946,29,52
"1601","2020-04-19",161,19,148,539,3434,0.275480489225393,0,0,318,565,59,2288,23,969,28,23
"1602","2020-04-20",155,19,136,529,3434,0.275480489225393,0,0,318,565,55,2343,17,986,26,17
"1603","2020-04-21",155,19,123,546,3434,0.275480489225393,0,0,318,565,61,2404,18,1004,35,18
"1604","2020-04-22",154,19,159,535,3434,0.275480489225393,0,0,318,565,60,2464,26,1030,28,26
"1605","2020-04-23",145,19,147,555,3434,0.275480489225393,0,0,318,565,55,2519,23,1053,20,23
"1606","2020-04-24",149,19,173,555,3434,0.275480489225393,0,0,318,565,45,2564,48,1101,20,48
"1607","2020-04-25",156,19,158,551,3434,0.275480489225393,0,0,318,565,53,2617,51,1152,24,51
"1608","2020-04-26",165,19,144,562,3434,0.275480489225393,0,0,318,565,48,2665,56,1208,18,56
"1609","2020-04-27",162,19,170,552,3434,0.275480489225393,0,0,318,565,57,2722,60,1268,22,60
"1610","2020-04-28",160,19,201,560,3434,0.275480489225393,0,0,318,565,52,2774,61,1329,27,61
"1611","2020-04-29",163,19,230,543,3434,0.275480489225393,0,0,318,565,47,2821,32,1361,14,32
"1612","2020-04-30",170,19,216,521,3434,0.275480489225393,0,0,318,565,52,2873,22,1383,19,22
"1613","2020-05-01",165,19,237,497,3434,0.275480489225393,0,0,318,565,51,2924,12,1395,11,12
"1614","2020-05-02",164,19,230,502,3434,0.275480489225393,0,0,318,565,41,2965,50,1445,9,50
"1615","2020-05-03",158,19,218,486,3434,0.275480489225393,0,0,318,565,46,3011,33,1478,16,33
"1616","2020-05-04",153,19,197,473,3434,0.275480489225393,0,0,318,565,57,3068,76,1554,23,76
"1617","2020-05-05",152,19,201,463,3434,0.275480489225393,0,0,318,565,33,3101,45,1599,8,45
"1618","2020-05-06",144,19,196,433,3434,0.275480489225393,0,0,318,565,33,3134,41,1640,7,41
"1619","2020-05-07",138,19,183,418,3434,0.275480489225393,0,0,318,565,52,3186,23,1663,14,23
"1620","2020-05-08",132,19,178,412,3434,0.275480489225393,0,0,318,565,29,3215,19,1682,4,19
"1621","2020-05-09",126,19,158,413,3434,0.275480489225393,0,0,318,565,39,3254,13,1695,19,13
"1622","2020-05-10",127,19,135,391,3434,0.275480489225393,0,0,318,565,27,3281,43,1738,9,43
"1623","2020-05-11",124,19,156,381,3434,0.275480489225393,0,0,318,565,26,3307,16,1754,9,16
"1624","2020-05-12",120,19,169,371,3434,0.275480489225393,0,0,318,565,33,3340,24,1778,9,24
"1625","2020-05-13",120,19,178,371,3434,0.275480489225393,0,0,318,565,37,3377,45,1823,17,45
"1626","2020-05-14",111,19,167,366,3434,0.275480489225393,0,0,318,565,40,3417,37,1860,12,37
"1627","2020-05-15",105,19,153,358,3434,0.275480489225393,0,0,318,565,40,3457,37,1897,12,37
"1628","2020-05-16",101,19,147,357,3434,0.275480489225393,0,0,318,565,33,3490,42,1939,13,42
"1629","2020-05-17",90,19,144,353,3434,0.275480489225393,0,0,318,565,27,3517,66,2005,15,66
"1630","2020-05-18",93,19,147,345,3434,0.275480489225393,0,0,318,565,31,3548,59,2064,12,59
"1631","2020-05-19",93,19,144,345,3434,0.275480489225393,0,0,318,565,25,3573,21,2085,10,21
"1632","2020-05-20",94,19,151,336,3434,0.275480489225393,0,0,318,565,22,3595,47,2132,4,47
"1633","2020-05-21",99,19,145,315,3434,0.275480489225393,0,0,318,565,25,3620,23,2155,12,23
"1634","2020-05-22",103,19,138,295,3434,0.275480489225393,0,0,318,565,22,3642,23,2178,8,23
"1635","2020-05-23",105,19,144,280,3434,0.275480489225393,0,0,318,565,24,3666,11,2189,5,11
"1636","2020-05-24",108,19,126,269,3434,0.275480489225393,0,0,318,565,21,3687,34,2223,6,34
"1637","2020-05-25",96,19,144,265,3434,0.275480489225393,0,0,318,565,19,3706,22,2245,6,22
"1638","2020-05-26",101,19,162,262,3434,0.275480489225393,0,0,318,565,18,3724,34,2279,6,34
"1639","2020-05-27",91,19,161,253,3434,0.275480489225393,0,0,318,565,27,3751,15,2294,9,15
"1640","2020-05-28",90,19,149,243,3434,0.275480489225393,0,0,318,565,20,3771,8,2302,6,8
"1641","2020-05-29",84,19,155,238,3434,0.275480489225393,0,0,318,565,17,3788,6,2308,5,6
"1642","2020-05-30",79,19,147,232,3434,0.275480489225393,0,0,318,565,19,3807,14,2322,6,14
"1643","2020-05-31",69,19,133,221,3434,0.275480489225393,0,0,318,565,24,3831,17,2339,13,17
"1644","2020-06-01",75,19,128,216,3434,0.275480489225393,0,0,318,565,28,3859,6,2345,11,6
"1645","2020-06-02",63,19,110,208,3434,0.275480489225393,0,0,318,565,24,3883,7,2352,7,7
"1646","2020-06-03",70,19,115,203,3434,0.275480489225393,0,0,318,565,18,3901,28,2380,10,28
"1647","2020-06-04",63,19,105,205,3434,0.275480489225393,0,0,318,565,18,3919,30,2410,12,30
"1648","2020-06-05",62,19,102,205,3434,0.275480489225393,0,0,318,565,17,3936,35,2445,8,35
"1649","2020-06-06",56,19,97,197,3434,0.275480489225393,0,0,318,565,12,3948,50,2495,6,50
"1650","2020-06-07",58,19,80,192,3434,0.275480489225393,0,0,318,565,14,3962,36,2531,8,36
"1651","2020-03-14",1,20,43,34,4284,0.881185807656396,0,0,451,708,6,39,13,34,3,13
"1652","2020-03-15",2,20,69,51,4284,0.881185807656396,0,0,451,708,27,66,7,41,12,7
"1653","2020-03-16",4,20,85,68,4284,0.881185807656396,0,0,451,708,26,92,4,45,13,4
"1654","2020-03-17",7,20,102,82,4284,0.881185807656396,0,0,451,708,28,120,15,60,17,15
"1655","2020-03-18",12,20,104,96,4284,0.881185807656396,0,0,451,708,24,144,28,88,11,28
"1656","2020-03-19",18,20,113,119,4284,0.881185807656396,0,0,451,708,15,159,15,103,10,15
"1657","2020-03-20",21,20,123,144,4284,0.881185807656396,0,0,451,708,25,184,14,117,16,14
"1658","2020-03-21",27,20,150,173,4284,0.881185807656396,0,0,451,708,25,209,23,140,14,23
"1659","2020-03-22",35,20,163,211,4284,0.881185807656396,0,0,451,708,31,240,15,155,16,15
"1660","2020-03-23",41,20,157,237,4284,0.881185807656396,0,0,451,708,30,270,15,170,20,15
"1661","2020-03-24",46,20,172,279,4284,0.881185807656396,0,0,451,708,32,302,18,188,19,18
"1662","2020-03-25",51,20,201,312,4284,0.881185807656396,0,0,451,708,33,335,20,208,20,20
"1663","2020-03-26",55,20,200,339,4284,0.881185807656396,0,0,451,708,45,380,19,227,31,19
"1664","2020-03-27",67,20,202,369,4284,0.881185807656396,0,0,451,708,37,417,32,259,25,32
"1665","2020-03-28",77,20,222,411,4284,0.881185807656396,0,0,451,708,38,455,25,284,32,25
"1666","2020-03-29",86,20,229,438,4284,0.881185807656396,0,0,451,708,36,491,20,304,22,20
"1667","2020-03-30",93,20,218,470,4284,0.881185807656396,0,0,451,708,41,532,22,326,28,22
"1668","2020-03-31",108,20,196,510,4284,0.881185807656396,0,0,451,708,43,575,17,343,30,17
"1669","2020-04-01",114,20,194,540,4284,0.881185807656396,0,0,451,708,39,614,14,357,32,14
"1670","2020-04-02",124,20,182,570,4284,0.881185807656396,0,0,451,708,46,660,21,378,36,21
"1671","2020-04-03",132,20,193,606,4284,0.881185807656396,0,0,451,708,38,698,12,390,23,12
"1672","2020-04-04",141,20,178,643,4284,0.881185807656396,0,0,451,708,47,745,15,405,35,15
"1673","2020-04-05",151,20,146,673,4284,0.881185807656396,0,0,451,708,49,794,13,418,36,13
"1674","2020-04-06",165,20,127,674,4284,0.881185807656396,0,0,451,708,59,853,10,428,43,10
"1675","2020-04-07",168,20,104,696,4284,0.881185807656396,0,0,451,708,40,893,26,454,28,26
"1676","2020-04-08",186,20,110,725,4284,0.881185807656396,0,0,451,708,48,941,33,487,32,33
"1677","2020-04-09",196,20,142,764,4284,0.881185807656396,0,0,451,708,52,993,27,514,35,27
"1678","2020-04-10",215,20,135,796,4284,0.881185807656396,0,0,451,708,56,1049,37,551,35,37
"1679","2020-04-11",232,20,118,832,4284,0.881185807656396,0,0,451,708,41,1090,37,588,28,37
"1680","2020-04-12",239,20,122,830,4284,0.881185807656396,0,0,451,708,34,1124,33,621,24,33
"1681","2020-04-13",243,20,108,835,4284,0.881185807656396,0,0,451,708,42,1166,53,674,26,53
"1682","2020-04-14",251,20,184,840,4284,0.881185807656396,0,0,451,708,24,1190,37,711,12,37
"1683","2020-04-15",249,20,228,853,4284,0.881185807656396,0,0,451,708,35,1225,43,754,20,43
"1684","2020-04-16",246,20,252,878,4284,0.881185807656396,0,0,451,708,37,1262,56,810,26,56
"1685","2020-04-17",232,20,272,910,4284,0.881185807656396,0,0,451,708,44,1306,38,848,24,38
"1686","2020-04-18",219,20,260,924,4284,0.881185807656396,0,0,451,708,35,1341,51,899,18,51
"1687","2020-04-19",223,20,231,914,4284,0.881185807656396,0,0,451,708,27,1368,46,945,14,46
"1688","2020-04-20",221,20,258,934,4284,0.881185807656396,0,0,451,708,24,1392,53,998,16,53
"1689","2020-04-21",227,20,242,939,4284,0.881185807656396,0,0,451,708,22,1414,42,1040,9,42
"1690","2020-04-22",236,20,225,939,4284,0.881185807656396,0,0,451,708,17,1431,26,1066,6,26
"1691","2020-04-23",246,20,210,914,4284,0.881185807656396,0,0,451,708,30,1461,48,1114,16,48
"1692","2020-04-24",265,20,209,889,4284,0.881185807656396,0,0,451,708,21,1482,54,1168,9,54
"1693","2020-04-25",274,20,258,873,4284,0.881185807656396,0,0,451,708,31,1513,43,1211,13,43
"1694","2020-04-26",275,20,276,861,4284,0.881185807656396,0,0,451,708,29,1542,46,1257,16,46
"1695","2020-04-27",271,20,270,821,4284,0.881185807656396,0,0,451,708,20,1562,51,1308,10,51
"1696","2020-04-28",267,20,252,790,4284,0.881185807656396,0,0,451,708,35,1597,33,1341,11,33
"1697","2020-04-29",260,20,231,768,4284,0.881185807656396,0,0,451,708,24,1621,25,1366,10,25
"1698","2020-04-30",254,20,223,745,4284,0.881185807656396,0,0,451,708,18,1639,59,1425,9,59
"1699","2020-05-01",237,20,238,720,4284,0.881185807656396,0,0,451,708,25,1664,56,1481,9,56
"1700","2020-05-02",234,20,226,690,4284,0.881185807656396,0,0,451,708,22,1686,48,1529,8,48
"1701","2020-05-03",226,20,212,642,4284,0.881185807656396,0,0,451,708,21,1707,50,1579,9,50
"1702","2020-05-04",226,20,237,643,4284,0.881185807656396,0,0,451,708,27,1734,60,1639,10,60
"1703","2020-05-05",212,20,285,630,4284,0.881185807656396,0,0,451,708,23,1757,37,1676,10,37
"1704","2020-05-06",201,20,271,604,4284,0.881185807656396,0,0,451,708,25,1782,36,1712,9,36
"1705","2020-05-07",197,20,300,594,4284,0.881185807656396,0,0,451,708,18,1800,28,1740,8,28
"1706","2020-05-08",188,20,306,575,4284,0.881185807656396,0,0,451,708,21,1821,40,1780,11,40
"1707","2020-05-09",170,20,301,554,4284,0.881185807656396,0,0,451,708,25,1846,44,1824,10,44
"1708","2020-05-10",162,20,282,543,4284,0.881185807656396,0,0,451,708,15,1861,41,1865,6,41
"1709","2020-05-11",150,20,279,541,4284,0.881185807656396,0,0,451,708,19,1880,38,1903,5,38
"1710","2020-05-12",152,20,257,531,4284,0.881185807656396,0,0,451,708,16,1896,35,1938,9,35
"1711","2020-05-13",147,20,227,532,4284,0.881185807656396,0,0,451,708,18,1914,46,1984,3,46
"1712","2020-05-14",144,20,226,514,4284,0.881185807656396,0,0,451,708,25,1939,44,2028,7,44
"1713","2020-05-15",141,20,217,498,4284,0.881185807656396,0,0,451,708,15,1954,48,2076,3,48
"1714","2020-05-16",147,20,196,487,4284,0.881185807656396,0,0,451,708,20,1974,31,2107,10,31
"1715","2020-05-17",141,20,156,466,4284,0.881185807656396,0,0,451,708,21,1995,40,2147,6,40
"1716","2020-05-18",141,20,149,443,4284,0.881185807656396,0,0,451,708,18,2013,31,2178,7,31
"1717","2020-05-19",144,20,185,441,4284,0.881185807656396,0,0,451,708,26,2039,27,2205,9,27
"1718","2020-05-20",143,20,178,436,4284,0.881185807656396,0,0,451,708,23,2062,37,2242,11,37
"1719","2020-05-21",137,20,211,424,4284,0.881185807656396,0,0,451,708,25,2087,31,2273,14,31
"1720","2020-05-22",141,20,223,400,4284,0.881185807656396,0,0,451,708,27,2114,34,2307,14,34
"1721","2020-05-23",129,20,233,380,4284,0.881185807656396,0,0,451,708,23,2137,40,2347,13,40
"1722","2020-05-24",129,20,230,362,4284,0.881185807656396,0,0,451,708,12,2149,40,2387,5,40
"1723","2020-05-25",126,20,241,341,4284,0.881185807656396,0,0,451,708,14,2163,49,2436,10,49
"1724","2020-05-26",112,20,275,330,4284,0.881185807656396,0,0,451,708,7,2170,37,2473,4,37
"1725","2020-05-27",106,20,257,304,4284,0.881185807656396,0,0,451,708,18,2188,24,2497,9,24
"1726","2020-05-28",100,20,225,303,4284,0.881185807656396,0,0,451,708,12,2200,31,2528,6,31
"1727","2020-05-29",88,20,199,281,4284,0.881185807656396,0,0,451,708,14,2214,50,2578,6,50
"1728","2020-05-30",87,20,171,262,4284,0.881185807656396,0,0,451,708,6,2220,35,2613,2,35
"1729","2020-05-31",75,20,194,249,4284,0.881185807656396,0,0,451,708,12,2232,32,2645,5,32
"1730","2020-06-01",76,20,194,239,4284,0.881185807656396,0,0,451,708,5,2237,42,2687,3,42
"1731","2020-06-02",74,20,179,227,4284,0.881185807656396,0,0,451,708,8,2245,31,2718,4,31
"1732","2020-06-03",70,20,165,215,4284,0.881185807656396,0,0,451,708,11,2256,45,2763,2,45
"1733","2020-06-04",65,20,154,215,4284,0.881185807656396,0,0,451,708,7,2263,42,2805,3,42
"1734","2020-06-05",61,20,183,211,4284,0.881185807656396,0,0,451,708,11,2274,31,2836,2,31
"1735","2020-06-06",59,20,173,217,4284,0.881185807656396,0,0,451,708,8,2282,37,2873,3,37
"1736","2020-06-07",65,20,157,211,4284,0.881185807656396,0,0,451,708,7,2289,24,2897,7,24
