"","Date","Absents","Paramset","Infections_or_Exposed_per_day_Patient","Infections_or_Exposed_per_day_HCW","total_infections","nosocomial_proportion","PCR_pooled","LFD_pooled","HCW_symp_test","patient_symp_test","new_hcw_infs","cumulative_hcw_infs","new_pat_infs","cumulative_pats_infs","new_nosocomial_hcw_infs","new_nosocomial_pat_infs"
"1","2020-03-13",1,1,15,32,2345,0.522388059701492,8355,20532,136,220,10,32,3,9,1,3
"2","2020-03-14",4,1,26,45,2345,0.522388059701492,8355,20532,136,220,13,45,9,18,5,9
"3","2020-03-15",6,1,33,58,2345,0.522388059701492,8355,20532,136,220,13,58,10,28,2,10
"4","2020-03-16",6,1,34,76,2345,0.522388059701492,8355,20532,136,220,18,76,5,33,2,5
"5","2020-03-17",5,1,39,97,2345,0.522388059701492,8355,20532,136,220,22,98,9,42,7,9
"6","2020-03-18",8,1,39,110,2345,0.522388059701492,8355,20532,136,220,14,112,8,50,9,8
"7","2020-03-19",14,1,41,131,2345,0.522388059701492,8355,20532,136,220,25,137,7,57,14,7
"8","2020-03-20",25,1,44,160,2345,0.522388059701492,8355,20532,136,220,35,172,11,68,18,11
"9","2020-03-21",34,1,34,173,2345,0.522388059701492,8355,20532,136,220,20,192,3,71,11,3
"10","2020-03-22",41,1,32,199,2345,0.522388059701492,8355,20532,136,220,30,222,6,77,18,6
"11","2020-03-23",44,1,34,213,2345,0.522388059701492,8355,20532,136,220,25,247,5,82,14,5
"12","2020-03-24",54,1,26,235,2345,0.522388059701492,8355,20532,136,220,29,276,3,85,16,3
"13","2020-03-25",68,1,20,252,2345,0.522388059701492,8355,20532,136,220,29,305,1,86,17,1
"14","2020-03-26",75,1,26,273,2345,0.522388059701492,8355,20532,136,220,32,337,5,91,24,5
"15","2020-03-27",95,1,23,294,2345,0.522388059701492,8355,20532,136,220,40,377,4,95,21,4
"16","2020-03-28",101,1,21,289,2345,0.522388059701492,8355,20532,136,220,21,398,2,97,15,2
"17","2020-03-29",88,1,22,289,2345,0.522388059701492,8355,20532,136,220,24,422,6,103,15,6
"18","2020-03-30",91,1,21,308,2345,0.522388059701492,8355,20532,136,220,42,464,4,107,29,4
"19","2020-03-31",91,1,22,314,2345,0.522388059701492,8355,20532,136,220,27,491,5,112,12,5
"20","2020-04-01",90,1,18,323,2345,0.522388059701492,8355,20532,136,220,31,522,1,113,17,1
"21","2020-04-02",88,1,19,326,2345,0.522388059701492,8355,20532,136,220,25,547,2,115,12,2
"22","2020-04-03",87,1,17,330,2345,0.522388059701492,8355,20532,136,220,32,579,3,118,19,3
"23","2020-04-04",87,1,22,319,2345,0.522388059701492,8355,20532,136,220,28,607,3,121,14,3
"24","2020-04-05",104,1,35,320,2345,0.522388059701492,8355,20532,136,220,27,634,12,133,15,12
"25","2020-04-06",104,1,31,308,2345,0.522388059701492,8355,20532,136,220,26,660,4,137,18,4
"26","2020-04-07",103,1,31,310,2345,0.522388059701492,8355,20532,136,220,29,689,6,143,16,6
"27","2020-04-08",99,1,37,307,2345,0.522388059701492,8355,20532,136,220,29,718,11,154,13,11
"28","2020-04-09",99,1,41,304,2345,0.522388059701492,8355,20532,136,220,24,742,9,163,13,9
"29","2020-04-10",110,1,43,308,2345,0.522388059701492,8355,20532,136,220,35,777,8,171,13,8
"30","2020-04-11",105,1,35,313,2345,0.522388059701492,8355,20532,136,220,28,805,1,172,13,1
"31","2020-04-12",96,1,35,314,2345,0.522388059701492,8355,20532,136,220,37,842,4,176,17,4
"32","2020-04-13",97,1,39,305,2345,0.522388059701492,8355,20532,136,220,20,862,11,187,10,11
"33","2020-04-14",89,1,42,312,2345,0.522388059701492,8355,20532,136,220,29,891,7,194,15,7
"34","2020-04-15",86,1,54,306,2345,0.522388059701492,8355,20532,136,220,24,915,14,208,17,14
"35","2020-04-16",87,1,50,310,2345,0.522388059701492,8355,20532,136,220,34,949,9,217,17,9
"36","2020-04-17",85,1,43,308,2345,0.522388059701492,8355,20532,136,220,25,974,7,224,8,7
"37","2020-04-18",98,1,50,308,2345,0.522388059701492,8355,20532,136,220,28,1002,9,233,10,9
"38","2020-04-19",93,1,49,307,2345,0.522388059701492,8355,20532,136,220,29,1031,7,240,13,7
"39","2020-04-20",96,1,52,309,2345,0.522388059701492,8355,20532,136,220,36,1067,11,251,14,11
"40","2020-04-21",102,1,46,323,2345,0.522388059701492,8355,20532,136,220,34,1101,4,255,15,4
"41","2020-04-22",99,1,49,317,2345,0.522388059701492,8355,20532,136,220,31,1132,13,268,16,13
"42","2020-04-23",96,1,49,322,2345,0.522388059701492,8355,20532,136,220,29,1161,7,275,15,7
"43","2020-04-24",114,1,53,333,2345,0.522388059701492,8355,20532,136,220,35,1196,15,290,18,15
"44","2020-04-25",104,1,71,340,2345,0.522388059701492,8355,20532,136,220,30,1226,20,310,21,20
"45","2020-04-26",109,1,66,342,2345,0.522388059701492,8355,20532,136,220,33,1259,15,325,22,15
"46","2020-04-27",103,1,65,348,2345,0.522388059701492,8355,20532,136,220,40,1299,8,333,16,8
"47","2020-04-28",96,1,57,350,2345,0.522388059701492,8355,20532,136,220,37,1336,5,338,24,5
"48","2020-04-29",100,1,62,361,2345,0.522388059701492,8355,20532,136,220,34,1370,15,353,17,15
"49","2020-04-30",105,1,53,357,2345,0.522388059701492,8355,20532,136,220,23,1393,2,355,11,2
"50","2020-05-01",103,1,56,356,2345,0.522388059701492,8355,20532,136,220,35,1428,9,364,21,9
"51","2020-05-02",112,1,52,349,2345,0.522388059701492,8355,20532,136,220,31,1459,12,376,16,12
"52","2020-05-03",96,1,58,345,2345,0.522388059701492,8355,20532,136,220,30,1489,8,384,12,8
"53","2020-05-04",91,1,53,344,2345,0.522388059701492,8355,20532,136,220,32,1521,8,392,20,8
"54","2020-05-05",93,1,51,347,2345,0.522388059701492,8355,20532,136,220,26,1547,10,402,15,10
"55","2020-05-06",94,1,55,337,2345,0.522388059701492,8355,20532,136,220,32,1579,10,412,17,10
"56","2020-05-07",97,1,53,347,2345,0.522388059701492,8355,20532,136,220,35,1614,6,418,23,6
"57","2020-05-08",97,1,64,338,2345,0.522388059701492,8355,20532,136,220,26,1640,15,433,16,15
"58","2020-05-09",114,1,70,345,2345,0.522388059701492,8355,20532,136,220,37,1677,18,451,24,18
"59","2020-05-10",116,1,64,335,2345,0.522388059701492,8355,20532,136,220,24,1701,9,460,12,9
"60","2020-05-11",109,1,57,333,2345,0.522388059701492,8355,20532,136,220,32,1733,6,466,12,6
"61","2020-05-12",105,1,60,329,2345,0.522388059701492,8355,20532,136,220,29,1762,13,479,17,13
"62","2020-05-13",107,1,54,326,2345,0.522388059701492,8355,20532,136,220,26,1788,7,486,17,7
"63","2020-05-14",105,1,48,328,2345,0.522388059701492,8355,20532,136,220,26,1814,5,491,16,5
"64","2020-05-15",118,1,57,324,2345,0.522388059701492,8355,20532,136,220,28,1842,17,508,16,17
"65","2020-05-16",102,1,53,324,2345,0.522388059701492,8355,20532,136,220,27,1869,9,517,11,9
"66","2020-05-17",106,1,53,319,2345,0.522388059701492,8355,20532,136,220,25,1894,9,526,10,9
"67","2020-05-18",109,1,54,312,2345,0.522388059701492,8355,20532,136,220,27,1921,9,535,17,9
"68","2020-05-19",104,1,53,306,2345,0.522388059701492,8355,20532,136,220,30,1951,6,541,19,6
"69","2020-05-20",103,1,50,301,2345,0.522388059701492,8355,20532,136,220,21,1972,10,551,11,10
"70","2020-05-21",102,1,54,293,2345,0.522388059701492,8355,20532,136,220,22,1994,9,560,16,9
"71","2020-05-22",106,1,51,289,2345,0.522388059701492,8355,20532,136,220,23,2017,7,567,16,7
"72","2020-05-23",107,1,40,278,2345,0.522388059701492,8355,20532,136,220,22,2039,4,571,15,4
"73","2020-05-24",99,1,43,276,2345,0.522388059701492,8355,20532,136,220,19,2058,7,578,14,7
"74","2020-05-25",97,1,48,271,2345,0.522388059701492,8355,20532,136,220,22,2080,10,588,12,10
"75","2020-05-26",104,1,59,266,2345,0.522388059701492,8355,20532,136,220,21,2101,18,606,11,18
"76","2020-05-27",99,1,51,246,2345,0.522388059701492,8355,20532,136,220,14,2115,6,612,8,6
"77","2020-05-28",90,1,54,238,2345,0.522388059701492,8355,20532,136,220,17,2132,10,622,12,10
"78","2020-05-29",79,1,50,226,2345,0.522388059701492,8355,20532,136,220,19,2151,7,629,14,7
"79","2020-05-30",82,1,47,217,2345,0.522388059701492,8355,20532,136,220,14,2165,7,636,10,7
"80","2020-05-31",77,1,38,207,2345,0.522388059701492,8355,20532,136,220,14,2179,4,640,10,4
"81","2020-06-01",77,1,36,198,2345,0.522388059701492,8355,20532,136,220,20,2199,3,643,10,3
"82","2020-06-02",61,1,38,188,2345,0.522388059701492,8355,20532,136,220,11,2210,7,650,3,7
"83","2020-06-03",57,1,43,188,2345,0.522388059701492,8355,20532,136,220,20,2230,11,661,10,11
"84","2020-06-04",61,1,37,183,2345,0.522388059701492,8355,20532,136,220,9,2239,6,667,7,6
"85","2020-06-05",66,1,54,176,2345,0.522388059701492,8355,20532,136,220,12,2251,16,683,6,16
"86","2020-06-06",61,1,54,161,2345,0.522388059701492,8355,20532,136,220,9,2260,12,695,5,12
"87","2020-06-07",58,1,55,161,2345,0.522388059701492,8355,20532,136,220,18,2278,8,703,7,8
"88","2020-03-15",1,2,32,27,3844,0.865244536940687,8370,27706,180,150,20,57,7,30,7,7
"89","2020-03-16",1,2,39,38,3844,0.865244536940687,8370,27706,180,150,12,69,3,33,5,3
"90","2020-03-17",2,2,41,57,3844,0.865244536940687,8370,27706,180,150,12,81,3,36,3,3
"91","2020-03-18",6,2,40,71,3844,0.865244536940687,8370,27706,180,150,16,97,5,41,7,5
"92","2020-03-19",7,2,30,80,3844,0.865244536940687,8370,27706,180,150,15,112,6,47,7,6
"93","2020-03-20",10,2,35,88,3844,0.865244536940687,8370,27706,180,150,18,130,4,51,5,4
"94","2020-03-21",17,2,31,101,3844,0.865244536940687,8370,27706,180,150,15,145,3,54,3,3
"95","2020-03-22",18,2,31,116,3844,0.865244536940687,8370,27706,180,150,18,163,1,55,13,1
"96","2020-03-23",18,2,30,127,3844,0.865244536940687,8370,27706,180,150,31,194,1,56,15,1
"97","2020-03-24",20,2,24,140,3844,0.865244536940687,8370,27706,180,150,24,218,5,61,15,5
"98","2020-03-25",19,2,21,160,3844,0.865244536940687,8370,27706,180,150,19,237,5,66,7,5
"99","2020-03-26",20,2,16,172,3844,0.865244536940687,8370,27706,180,150,22,259,8,74,14,8
"100","2020-03-27",30,2,18,180,3844,0.865244536940687,8370,27706,180,150,30,289,8,82,13,8
"101","2020-03-28",31,2,24,209,3844,0.865244536940687,8370,27706,180,150,33,322,4,86,23,4
"102","2020-03-29",37,2,29,231,3844,0.865244536940687,8370,27706,180,150,26,348,5,91,19,5
"103","2020-03-30",52,2,33,251,3844,0.865244536940687,8370,27706,180,150,29,377,10,101,18,10
"104","2020-03-31",53,2,31,281,3844,0.865244536940687,8370,27706,180,150,36,413,8,109,27,8
"105","2020-04-01",65,2,34,300,3844,0.865244536940687,8370,27706,180,150,32,445,1,110,21,1
"106","2020-04-02",71,2,30,328,3844,0.865244536940687,8370,27706,180,150,33,478,5,115,19,5
"107","2020-04-03",75,2,41,361,3844,0.865244536940687,8370,27706,180,150,29,507,6,121,22,6
"108","2020-04-04",92,2,39,378,3844,0.865244536940687,8370,27706,180,150,33,540,6,127,24,6
"109","2020-04-05",101,2,38,423,3844,0.865244536940687,8370,27706,180,150,38,578,8,135,32,8
"110","2020-04-06",104,2,30,458,3844,0.865244536940687,8370,27706,180,150,19,597,4,139,12,4
"111","2020-04-07",121,2,26,507,3844,0.865244536940687,8370,27706,180,150,32,629,9,148,22,9
"112","2020-04-08",126,2,17,528,3844,0.865244536940687,8370,27706,180,150,37,666,11,159,24,11
"113","2020-04-09",138,2,27,572,3844,0.865244536940687,8370,27706,180,150,35,701,13,172,23,13
"114","2020-04-10",164,2,37,594,3844,0.865244536940687,8370,27706,180,150,24,725,9,181,8,9
"115","2020-04-11",191,2,44,631,3844,0.865244536940687,8370,27706,180,150,33,758,16,197,17,16
"116","2020-04-12",208,2,46,645,3844,0.865244536940687,8370,27706,180,150,29,787,19,216,25,19
"117","2020-04-13",201,2,44,665,3844,0.865244536940687,8370,27706,180,150,28,815,15,231,15,15
"118","2020-04-14",195,2,48,684,3844,0.865244536940687,8370,27706,180,150,37,852,18,249,27,18
"119","2020-04-15",200,2,49,696,3844,0.865244536940687,8370,27706,180,150,30,882,21,270,21,21
"120","2020-04-16",205,2,55,710,3844,0.865244536940687,8370,27706,180,150,29,911,7,277,19,7
"121","2020-04-17",238,2,59,684,3844,0.865244536940687,8370,27706,180,150,33,944,12,289,20,12
"122","2020-04-18",238,2,67,704,3844,0.865244536940687,8370,27706,180,150,24,968,10,299,17,10
"123","2020-04-19",226,2,66,726,3844,0.865244536940687,8370,27706,180,150,36,1004,16,315,17,16
"124","2020-04-20",231,2,62,728,3844,0.865244536940687,8370,27706,180,150,20,1024,22,337,14,22
"125","2020-04-21",236,2,48,729,3844,0.865244536940687,8370,27706,180,150,25,1049,27,364,15,27
"126","2020-04-22",241,2,39,749,3844,0.865244536940687,8370,27706,180,150,26,1075,13,377,15,13
"127","2020-04-23",248,2,36,747,3844,0.865244536940687,8370,27706,180,150,38,1113,14,391,25,14
"128","2020-04-24",268,2,34,732,3844,0.865244536940687,8370,27706,180,150,40,1153,21,412,26,21
"129","2020-04-25",296,2,34,731,3844,0.865244536940687,8370,27706,180,150,28,1181,12,424,23,12
"130","2020-04-26",269,2,33,722,3844,0.865244536940687,8370,27706,180,150,45,1226,21,445,27,21
"131","2020-04-27",253,2,35,729,3844,0.865244536940687,8370,27706,180,150,32,1258,17,462,17,17
"132","2020-04-28",247,2,30,733,3844,0.865244536940687,8370,27706,180,150,32,1290,16,478,23,16
"133","2020-04-29",243,2,22,732,3844,0.865244536940687,8370,27706,180,150,30,1320,17,495,23,17
"134","2020-04-30",232,2,23,726,3844,0.865244536940687,8370,27706,180,150,41,1361,22,517,27,22
"135","2020-05-01",250,2,22,720,3844,0.865244536940687,8370,27706,180,150,52,1413,19,536,31,19
"136","2020-05-02",234,2,22,710,3844,0.865244536940687,8370,27706,180,150,34,1447,18,554,21,18
"137","2020-05-03",231,2,25,718,3844,0.865244536940687,8370,27706,180,150,28,1475,19,573,21,19
"138","2020-05-04",230,2,33,711,3844,0.865244536940687,8370,27706,180,150,49,1524,22,595,30,22
"139","2020-05-05",233,2,39,712,3844,0.865244536940687,8370,27706,180,150,39,1563,24,619,26,24
"140","2020-05-06",229,2,45,709,3844,0.865244536940687,8370,27706,180,150,32,1595,21,640,26,21
"141","2020-05-07",228,2,44,680,3844,0.865244536940687,8370,27706,180,150,36,1631,16,656,27,16
"142","2020-05-08",235,2,47,664,3844,0.865244536940687,8370,27706,180,150,40,1671,19,675,25,19
"143","2020-05-09",243,2,45,655,3844,0.865244536940687,8370,27706,180,150,39,1710,15,690,29,15
"144","2020-05-10",224,2,51,658,3844,0.865244536940687,8370,27706,180,150,37,1747,25,715,26,25
"145","2020-05-11",211,2,51,622,3844,0.865244536940687,8370,27706,180,150,39,1786,21,736,26,21
"146","2020-05-12",214,2,51,619,3844,0.865244536940687,8370,27706,180,150,29,1815,15,751,19,15
"147","2020-05-13",213,2,58,601,3844,0.865244536940687,8370,27706,180,150,30,1845,19,770,19,19
"148","2020-05-14",214,2,55,591,3844,0.865244536940687,8370,27706,180,150,46,1891,15,785,40,15
"149","2020-05-15",214,2,63,576,3844,0.865244536940687,8370,27706,180,150,32,1923,19,804,16,19
"150","2020-05-16",199,2,57,546,3844,0.865244536940687,8370,27706,180,150,32,1955,12,816,24,12
"151","2020-05-17",178,2,48,541,3844,0.865244536940687,8370,27706,180,150,37,1992,17,833,24,17
"152","2020-05-18",185,2,45,540,3844,0.865244536940687,8370,27706,180,150,38,2030,14,847,31,14
"153","2020-05-19",178,2,35,504,3844,0.865244536940687,8370,27706,180,150,41,2071,11,858,32,11
"154","2020-05-20",185,2,35,486,3844,0.865244536940687,8370,27706,180,150,30,2101,17,875,22,17
"155","2020-05-21",179,2,37,467,3844,0.865244536940687,8370,27706,180,150,30,2131,17,892,23,17
"156","2020-05-22",174,2,44,457,3844,0.865244536940687,8370,27706,180,150,24,2155,11,903,20,11
"157","2020-05-23",186,2,48,447,3844,0.865244536940687,8370,27706,180,150,33,2188,22,925,22,22
"158","2020-05-24",178,2,44,441,3844,0.865244536940687,8370,27706,180,150,26,2214,17,942,19,17
"159","2020-05-25",164,2,39,425,3844,0.865244536940687,8370,27706,180,150,29,2243,13,955,21,13
"160","2020-05-26",159,2,31,418,3844,0.865244536940687,8370,27706,180,150,23,2266,13,968,15,13
"161","2020-05-27",141,2,27,408,3844,0.865244536940687,8370,27706,180,150,20,2286,12,980,12,12
"162","2020-05-28",140,2,27,384,3844,0.865244536940687,8370,27706,180,150,24,2310,14,994,16,14
"163","2020-05-29",135,2,40,362,3844,0.865244536940687,8370,27706,180,150,21,2331,7,1001,18,7
"164","2020-05-30",133,2,33,352,3844,0.865244536940687,8370,27706,180,150,26,2357,8,1009,16,8
"165","2020-05-31",132,2,32,338,3844,0.865244536940687,8370,27706,180,150,20,2377,10,1019,17,10
"166","2020-06-01",122,2,31,325,3844,0.865244536940687,8370,27706,180,150,21,2398,18,1037,18,18
"167","2020-06-02",117,2,23,314,3844,0.865244536940687,8370,27706,180,150,18,2416,12,1049,14,12
"168","2020-06-03",120,2,21,286,3844,0.865244536940687,8370,27706,180,150,14,2430,12,1061,12,12
"169","2020-06-04",118,2,19,267,3844,0.865244536940687,8370,27706,180,150,11,2441,7,1068,7,7
"170","2020-06-05",117,2,18,263,3844,0.865244536940687,8370,27706,180,150,12,2453,10,1078,9,10
"171","2020-06-06",113,2,21,252,3844,0.865244536940687,8370,27706,180,150,17,2470,17,1095,11,17
"172","2020-06-07",91,2,21,237,3844,0.865244536940687,8370,27706,180,150,11,2481,14,1109,9,14
"173","2020-03-08",1,3,0,0,3678,0.747688961392061,8340,27205,230,623,NA,NA,NA,NA,NA,NA
"174","2020-03-09",1,3,0,0,3678,0.747688961392061,8340,27205,230,623,NA,NA,NA,NA,NA,NA
"175","2020-03-10",0,3,0,0,3678,0.747688961392061,8340,27205,230,623,NA,NA,NA,NA,NA,NA
"176","2020-03-11",0,3,0,0,3678,0.747688961392061,8340,27205,230,623,4,4,1,1,1,1
"177","2020-03-12",0,3,0,0,3678,0.747688961392061,8340,27205,230,623,6,10,4,5,2,4
"178","2020-03-13",2,3,32,34,3678,0.747688961392061,8340,27205,230,623,1,11,4,9,NA,4
"179","2020-03-14",3,3,36,49,3678,0.747688961392061,8340,27205,230,623,7,18,5,14,3,5
"180","2020-03-15",7,3,52,67,3678,0.747688961392061,8340,27205,230,623,4,22,9,23,1,9
"181","2020-03-16",10,3,68,76,3678,0.747688961392061,8340,27205,230,623,6,28,10,33,5,10
"182","2020-03-17",14,3,74,99,3678,0.747688961392061,8340,27205,230,623,8,36,9,42,5,9
"183","2020-03-18",17,3,84,117,3678,0.747688961392061,8340,27205,230,623,7,43,9,51,3,9
"184","2020-03-19",22,3,89,146,3678,0.747688961392061,8340,27205,230,623,8,51,5,56,7,5
"185","2020-03-20",32,3,75,163,3678,0.747688961392061,8340,27205,230,623,16,67,10,66,9,10
"186","2020-03-21",33,3,79,193,3678,0.747688961392061,8340,27205,230,623,18,85,8,74,16,8
"187","2020-03-22",42,3,81,216,3678,0.747688961392061,8340,27205,230,623,23,108,11,85,23,11
"188","2020-03-23",48,3,90,230,3678,0.747688961392061,8340,27205,230,623,14,122,5,90,12,5
"189","2020-03-24",50,3,97,250,3678,0.747688961392061,8340,27205,230,623,36,158,8,98,30,8
"190","2020-03-25",57,3,98,286,3678,0.747688961392061,8340,27205,230,623,24,182,5,103,24,5
"191","2020-03-26",59,3,104,301,3678,0.747688961392061,8340,27205,230,623,29,211,5,108,22,5
"192","2020-03-27",58,3,118,327,3678,0.747688961392061,8340,27205,230,623,33,244,6,114,29,6
"193","2020-03-28",87,3,126,350,3678,0.747688961392061,8340,27205,230,623,38,282,6,120,37,6
"194","2020-03-29",84,3,123,373,3678,0.747688961392061,8340,27205,230,623,32,314,5,125,25,5
"195","2020-03-30",85,3,121,382,3678,0.747688961392061,8340,27205,230,623,47,361,8,133,41,8
"196","2020-03-31",94,3,125,408,3678,0.747688961392061,8340,27205,230,623,46,407,2,135,43,2
"197","2020-04-01",101,3,125,420,3678,0.747688961392061,8340,27205,230,623,40,447,3,138,40,3
"198","2020-04-02",109,3,122,443,3678,0.747688961392061,8340,27205,230,623,60,507,4,142,56,4
"199","2020-04-03",133,3,120,483,3678,0.747688961392061,8340,27205,230,623,67,574,8,150,65,8
"200","2020-04-04",136,3,130,497,3678,0.747688961392061,8340,27205,230,623,67,641,6,156,66,6
"201","2020-04-05",149,3,117,516,3678,0.747688961392061,8340,27205,230,623,65,706,15,171,62,15
"202","2020-04-06",148,3,135,538,3678,0.747688961392061,8340,27205,230,623,88,794,6,177,87,6
"203","2020-04-07",147,3,140,560,3678,0.747688961392061,8340,27205,230,623,73,867,7,184,70,7
"204","2020-04-08",155,3,140,577,3678,0.747688961392061,8340,27205,230,623,87,954,10,194,84,10
"205","2020-04-09",154,3,158,583,3678,0.747688961392061,8340,27205,230,623,84,1038,5,199,78,5
"206","2020-04-10",169,3,155,599,3678,0.747688961392061,8340,27205,230,623,109,1147,10,209,105,10
"207","2020-04-11",178,3,169,607,3678,0.747688961392061,8340,27205,230,623,104,1251,6,215,99,6
"208","2020-04-12",190,3,154,634,3678,0.747688961392061,8340,27205,230,623,83,1334,11,226,79,11
"209","2020-04-13",192,3,171,642,3678,0.747688961392061,8340,27205,230,623,112,1446,10,236,109,10
"210","2020-04-14",200,3,179,645,3678,0.747688961392061,8340,27205,230,623,127,1573,15,251,126,15
"211","2020-04-15",205,3,203,659,3678,0.747688961392061,8340,27205,230,623,88,1661,20,271,87,20
"212","2020-04-16",212,3,188,667,3678,0.747688961392061,8340,27205,230,623,112,1773,9,280,109,9
"213","2020-04-17",231,3,188,673,3678,0.747688961392061,8340,27205,230,623,128,1901,19,299,121,19
"214","2020-04-18",235,3,181,671,3678,0.747688961392061,8340,27205,230,623,132,2033,22,321,127,22
"215","2020-04-19",223,3,189,668,3678,0.747688961392061,8340,27205,230,623,106,2139,16,337,103,16
"216","2020-04-20",219,3,185,675,3678,0.747688961392061,8340,27205,230,623,111,2250,12,349,108,12
"217","2020-04-21",209,3,197,692,3678,0.747688961392061,8340,27205,230,623,115,2365,17,366,113,17
"218","2020-04-22",202,3,184,674,3678,0.747688961392061,8340,27205,230,623,124,2489,11,377,120,11
"219","2020-04-23",206,3,195,656,3678,0.747688961392061,8340,27205,230,623,129,2618,12,389,125,12
"220","2020-04-24",210,3,180,650,3678,0.747688961392061,8340,27205,230,623,126,2744,17,406,125,17
"221","2020-04-25",206,3,182,635,3678,0.747688961392061,8340,27205,230,623,109,2853,12,418,106,12
"222","2020-04-26",228,3,175,629,3678,0.747688961392061,8340,27205,230,623,122,2975,9,427,120,9
"223","2020-04-27",226,3,171,626,3678,0.747688961392061,8340,27205,230,623,104,3079,14,441,101,14
"224","2020-04-28",220,3,155,608,3678,0.747688961392061,8340,27205,230,623,114,3193,8,449,113,8
"225","2020-04-29",226,3,154,602,3678,0.747688961392061,8340,27205,230,623,106,3299,6,455,105,6
"226","2020-04-30",217,3,153,582,3678,0.747688961392061,8340,27205,230,623,92,3391,6,461,88,6
"227","2020-05-01",240,3,161,585,3678,0.747688961392061,8340,27205,230,623,76,3467,12,473,71,12
"228","2020-05-02",241,3,173,567,3678,0.747688961392061,8340,27205,230,623,81,3548,10,483,75,10
"229","2020-05-03",204,3,174,570,3678,0.747688961392061,8340,27205,230,623,72,3620,8,491,69,8
"230","2020-05-04",190,3,175,550,3678,0.747688961392061,8340,27205,230,623,90,3710,9,500,88,9
"231","2020-05-05",186,3,187,533,3678,0.747688961392061,8340,27205,230,623,65,3775,12,512,63,12
"232","2020-05-06",179,3,202,537,3678,0.747688961392061,8340,27205,230,623,72,3847,8,520,69,8
"233","2020-05-07",186,3,219,531,3678,0.747688961392061,8340,27205,230,623,83,3930,7,527,76,7
"234","2020-05-08",187,3,212,507,3678,0.747688961392061,8340,27205,230,623,66,3996,11,538,63,11
"235","2020-05-09",182,3,209,489,3678,0.747688961392061,8340,27205,230,623,54,4050,19,557,53,19
"236","2020-05-10",163,3,184,479,3678,0.747688961392061,8340,27205,230,623,59,4109,18,575,55,18
"237","2020-05-11",169,3,182,470,3678,0.747688961392061,8340,27205,230,623,57,4166,15,590,52,15
"238","2020-05-12",162,3,186,474,3678,0.747688961392061,8340,27205,230,623,62,4228,15,605,58,15
"239","2020-05-13",162,3,194,467,3678,0.747688961392061,8340,27205,230,623,48,4276,10,615,46,10
"240","2020-05-14",154,3,189,467,3678,0.747688961392061,8340,27205,230,623,42,4318,9,624,39,9
"241","2020-05-15",147,3,172,456,3678,0.747688961392061,8340,27205,230,623,35,4353,9,633,34,9
"242","2020-05-16",154,3,168,446,3678,0.747688961392061,8340,27205,230,623,35,4388,8,641,34,8
"243","2020-05-17",152,3,172,451,3678,0.747688961392061,8340,27205,230,623,45,4433,8,649,42,8
"244","2020-05-18",149,3,170,439,3678,0.747688961392061,8340,27205,230,623,36,4469,16,665,33,16
"245","2020-05-19",147,3,160,445,3678,0.747688961392061,8340,27205,230,623,24,4493,8,673,24,8
"246","2020-05-20",145,3,136,444,3678,0.747688961392061,8340,27205,230,623,32,4525,9,682,32,9
"247","2020-05-21",146,3,118,449,3678,0.747688961392061,8340,27205,230,623,37,4562,8,690,34,8
"248","2020-05-22",169,3,122,441,3678,0.747688961392061,8340,27205,230,623,20,4582,11,701,20,11
"249","2020-05-23",166,3,131,439,3678,0.747688961392061,8340,27205,230,623,25,4607,7,708,23,7
"250","2020-05-24",161,3,127,422,3678,0.747688961392061,8340,27205,230,623,18,4625,12,720,17,12
"251","2020-05-25",158,3,137,404,3678,0.747688961392061,8340,27205,230,623,24,4649,19,739,22,19
"252","2020-05-26",148,3,149,390,3678,0.747688961392061,8340,27205,230,623,17,4666,16,755,17,16
"253","2020-05-27",145,3,142,374,3678,0.747688961392061,8340,27205,230,623,15,4681,4,759,14,4
"254","2020-05-28",145,3,133,349,3678,0.747688961392061,8340,27205,230,623,22,4703,13,772,21,13
"255","2020-05-29",129,3,137,336,3678,0.747688961392061,8340,27205,230,623,31,4734,11,783,31,11
"256","2020-05-30",119,3,151,313,3678,0.747688961392061,8340,27205,230,623,16,4750,8,791,13,8
"257","2020-05-31",115,3,143,292,3678,0.747688961392061,8340,27205,230,623,19,4769,16,807,18,16
"258","2020-06-01",107,3,139,273,3678,0.747688961392061,8340,27205,230,623,11,4780,10,817,11,10
"259","2020-06-02",97,3,138,272,3678,0.747688961392061,8340,27205,230,623,17,4797,12,829,15,12
"260","2020-06-03",95,3,143,260,3678,0.747688961392061,8340,27205,230,623,18,4815,14,843,18,14
"261","2020-06-04",85,3,138,247,3678,0.747688961392061,8340,27205,230,623,16,4831,12,855,15,12
"262","2020-06-05",82,3,146,226,3678,0.747688961392061,8340,27205,230,623,19,4850,9,864,18,9
"263","2020-06-06",84,3,147,229,3678,0.747688961392061,8340,27205,230,623,10,4860,14,878,10,14
"264","2020-06-07",78,3,137,221,3678,0.747688961392061,8340,27205,230,623,8,4868,6,884,8,6
"265","2020-03-12",1,4,14,12,2566,0.843335931410756,8460,21918,141,259,18,24,18,37,4,18
"266","2020-03-13",2,4,23,23,2566,0.843335931410756,8460,21918,141,259,13,37,4,41,5,4
"267","2020-03-14",3,4,24,26,2566,0.843335931410756,8460,21918,141,259,25,62,8,49,14,8
"268","2020-03-15",5,4,26,30,2566,0.843335931410756,8460,21918,141,259,24,86,3,52,13,3
"269","2020-03-16",5,4,25,39,2566,0.843335931410756,8460,21918,141,259,12,98,6,58,8,6
"270","2020-03-17",6,4,23,46,2566,0.843335931410756,8460,21918,141,259,19,117,5,63,8,5
"271","2020-03-18",9,4,31,54,2566,0.843335931410756,8460,21918,141,259,17,134,15,78,10,15
"272","2020-03-19",11,4,39,64,2566,0.843335931410756,8460,21918,141,259,23,157,22,100,11,22
"273","2020-03-20",12,4,50,68,2566,0.843335931410756,8460,21918,141,259,31,188,7,107,15,7
"274","2020-03-21",16,4,60,74,2566,0.843335931410756,8460,21918,141,259,19,207,16,123,9,16
"275","2020-03-22",21,4,62,85,2566,0.843335931410756,8460,21918,141,259,27,234,19,142,17,19
"276","2020-03-23",22,4,67,93,2566,0.843335931410756,8460,21918,141,259,22,256,24,166,13,24
"277","2020-03-24",24,4,63,100,2566,0.843335931410756,8460,21918,141,259,34,290,12,178,22,12
"278","2020-03-25",24,4,63,115,2566,0.843335931410756,8460,21918,141,259,37,327,7,185,28,7
"279","2020-03-26",25,4,51,118,2566,0.843335931410756,8460,21918,141,259,22,349,17,202,12,17
"280","2020-03-27",30,4,41,132,2566,0.843335931410756,8460,21918,141,259,39,388,4,206,32,4
"281","2020-03-28",34,4,42,144,2566,0.843335931410756,8460,21918,141,259,41,429,4,210,29,4
"282","2020-03-29",40,4,41,158,2566,0.843335931410756,8460,21918,141,259,40,469,2,212,33,2
"283","2020-03-30",46,4,49,155,2566,0.843335931410756,8460,21918,141,259,43,512,25,237,31,25
"284","2020-03-31",46,4,51,173,2566,0.843335931410756,8460,21918,141,259,29,541,24,261,20,24
"285","2020-04-01",53,4,50,182,2566,0.843335931410756,8460,21918,141,259,26,567,14,275,17,14
"286","2020-04-02",56,4,51,197,2566,0.843335931410756,8460,21918,141,259,39,606,4,279,30,4
"287","2020-04-03",68,4,46,211,2566,0.843335931410756,8460,21918,141,259,33,639,8,287,21,8
"288","2020-04-04",80,4,41,214,2566,0.843335931410756,8460,21918,141,259,30,669,5,292,26,5
"289","2020-04-05",70,4,46,213,2566,0.843335931410756,8460,21918,141,259,43,712,7,299,30,7
"290","2020-04-06",67,4,49,218,2566,0.843335931410756,8460,21918,141,259,41,753,5,304,27,5
"291","2020-04-07",69,4,46,220,2566,0.843335931410756,8460,21918,141,259,39,792,12,316,22,12
"292","2020-04-08",65,4,42,243,2566,0.843335931410756,8460,21918,141,259,29,821,29,345,22,29
"293","2020-04-09",67,4,39,273,2566,0.843335931410756,8460,21918,141,259,53,874,23,368,37,23
"294","2020-04-10",85,4,36,285,2566,0.843335931410756,8460,21918,141,259,48,922,33,401,39,33
"295","2020-04-11",86,4,44,284,2566,0.843335931410756,8460,21918,141,259,40,962,21,422,29,21
"296","2020-04-12",91,4,48,281,2566,0.843335931410756,8460,21918,141,259,49,1011,7,429,33,7
"297","2020-04-13",90,4,45,294,2566,0.843335931410756,8460,21918,141,259,35,1046,10,439,18,10
"298","2020-04-14",90,4,43,314,2566,0.843335931410756,8460,21918,141,259,53,1099,8,447,43,8
"299","2020-04-15",97,4,40,326,2566,0.843335931410756,8460,21918,141,259,46,1145,10,457,29,10
"300","2020-04-16",99,4,45,344,2566,0.843335931410756,8460,21918,141,259,45,1190,25,482,26,25
"301","2020-04-17",101,4,51,349,2566,0.843335931410756,8460,21918,141,259,39,1229,27,509,26,27
"302","2020-04-18",105,4,49,365,2566,0.843335931410756,8460,21918,141,259,54,1283,17,526,36,17
"303","2020-04-19",111,4,52,379,2566,0.843335931410756,8460,21918,141,259,51,1334,18,544,34,18
"304","2020-04-20",120,4,46,391,2566,0.843335931410756,8460,21918,141,259,39,1373,15,559,28,15
"305","2020-04-21",121,4,41,403,2566,0.843335931410756,8460,21918,141,259,44,1417,12,571,33,12
"306","2020-04-22",118,4,42,389,2566,0.843335931410756,8460,21918,141,259,45,1462,8,579,38,8
"307","2020-04-23",117,4,41,389,2566,0.843335931410756,8460,21918,141,259,52,1514,5,584,33,5
"308","2020-04-24",129,4,41,428,2566,0.843335931410756,8460,21918,141,259,37,1551,8,592,25,8
"309","2020-04-25",129,4,37,437,2566,0.843335931410756,8460,21918,141,259,43,1594,15,607,29,15
"310","2020-04-26",125,4,53,453,2566,0.843335931410756,8460,21918,141,259,42,1636,27,634,28,27
"311","2020-04-27",124,4,64,448,2566,0.843335931410756,8460,21918,141,259,43,1679,15,649,21,15
"312","2020-04-28",117,4,60,464,2566,0.843335931410756,8460,21918,141,259,48,1727,19,668,40,19
"313","2020-04-29",131,4,58,473,2566,0.843335931410756,8460,21918,141,259,38,1765,4,672,23,4
"314","2020-04-30",143,4,62,485,2566,0.843335931410756,8460,21918,141,259,43,1808,7,679,22,7
"315","2020-05-01",163,4,57,488,2566,0.843335931410756,8460,21918,141,259,36,1844,10,689,26,10
"316","2020-05-02",161,4,57,494,2566,0.843335931410756,8460,21918,141,259,48,1892,8,697,27,8
"317","2020-05-03",185,4,56,482,2566,0.843335931410756,8460,21918,141,259,42,1934,9,706,25,9
"318","2020-05-04",181,4,52,484,2566,0.843335931410756,8460,21918,141,259,52,1986,29,735,37,29
"319","2020-05-05",179,4,66,494,2566,0.843335931410756,8460,21918,141,259,42,2028,19,754,32,19
"320","2020-05-06",172,4,54,491,2566,0.843335931410756,8460,21918,141,259,45,2073,25,779,25,25
"321","2020-05-07",169,4,45,482,2566,0.843335931410756,8460,21918,141,259,38,2111,11,790,21,11
"322","2020-05-08",189,4,38,469,2566,0.843335931410756,8460,21918,141,259,32,2143,15,805,21,15
"323","2020-05-09",196,4,37,465,2566,0.843335931410756,8460,21918,141,259,43,2186,6,811,32,6
"324","2020-05-10",165,4,34,453,2566,0.843335931410756,8460,21918,141,259,26,2212,11,822,15,11
"325","2020-05-11",166,4,34,453,2566,0.843335931410756,8460,21918,141,259,38,2250,20,842,26,20
"326","2020-05-12",165,4,28,455,2566,0.843335931410756,8460,21918,141,259,27,2277,35,877,19,35
"327","2020-05-13",168,4,30,450,2566,0.843335931410756,8460,21918,141,259,41,2318,12,889,25,12
"328","2020-05-14",164,4,28,452,2566,0.843335931410756,8460,21918,141,259,27,2345,16,905,22,16
"329","2020-05-15",155,4,26,435,2566,0.843335931410756,8460,21918,141,259,30,2375,12,917,24,12
"330","2020-05-16",152,4,28,417,2566,0.843335931410756,8460,21918,141,259,26,2401,34,951,13,34
"331","2020-05-17",137,4,34,412,2566,0.843335931410756,8460,21918,141,259,29,2430,25,976,19,25
"332","2020-05-18",129,4,30,405,2566,0.843335931410756,8460,21918,141,259,20,2450,8,984,15,8
"333","2020-05-19",124,4,39,412,2566,0.843335931410756,8460,21918,141,259,31,2481,22,1006,20,22
"334","2020-05-20",118,4,36,403,2566,0.843335931410756,8460,21918,141,259,21,2502,26,1032,16,26
"335","2020-05-21",123,4,36,389,2566,0.843335931410756,8460,21918,141,259,24,2526,28,1060,17,28
"336","2020-05-22",123,4,41,379,2566,0.843335931410756,8460,21918,141,259,22,2548,46,1106,14,46
"337","2020-05-23",135,4,42,363,2566,0.843335931410756,8460,21918,141,259,35,2583,39,1145,27,39
"338","2020-05-24",127,4,43,366,2566,0.843335931410756,8460,21918,141,259,29,2612,43,1188,19,43
"339","2020-05-25",122,4,47,355,2566,0.843335931410756,8460,21918,141,259,32,2644,23,1211,25,23
"340","2020-05-26",117,4,60,355,2566,0.843335931410756,8460,21918,141,259,21,2665,20,1231,16,20
"341","2020-05-27",118,4,64,340,2566,0.843335931410756,8460,21918,141,259,25,2690,33,1264,21,33
"342","2020-05-28",112,4,61,327,2566,0.843335931410756,8460,21918,141,259,24,2714,33,1297,15,33
"343","2020-05-29",120,4,53,319,2566,0.843335931410756,8460,21918,141,259,31,2745,16,1313,25,16
"344","2020-05-30",126,4,52,306,2566,0.843335931410756,8460,21918,141,259,20,2765,7,1320,15,7
"345","2020-05-31",121,4,52,298,2566,0.843335931410756,8460,21918,141,259,20,2785,24,1344,13,24
"346","2020-06-01",115,4,49,289,2566,0.843335931410756,8460,21918,141,259,29,2814,21,1365,21,21
"347","2020-06-02",113,4,55,271,2566,0.843335931410756,8460,21918,141,259,23,2837,20,1385,17,20
"348","2020-06-03",107,4,61,263,2566,0.843335931410756,8460,21918,141,259,26,2863,22,1407,20,22
"349","2020-06-04",97,4,52,249,2566,0.843335931410756,8460,21918,141,259,14,2877,18,1425,11,18
"350","2020-06-05",92,4,54,251,2566,0.843335931410756,8460,21918,141,259,16,2893,10,1435,13,10
"351","2020-06-06",78,4,45,234,2566,0.843335931410756,8460,21918,141,259,23,2916,22,1457,18,22
"352","2020-06-07",70,4,46,229,2566,0.843335931410756,8460,21918,141,259,22,2938,20,1477,11,20
"353","2020-03-07",1,5,0,0,3503,0.825578075934913,8355,25515,176,150,NA,NA,NA,NA,NA,NA
"354","2020-03-08",1,5,0,0,3503,0.825578075934913,8355,25515,176,150,NA,NA,NA,NA,NA,NA
"355","2020-03-09",0,5,0,0,3503,0.825578075934913,8355,25515,176,150,NA,NA,NA,NA,NA,NA
"356","2020-03-10",0,5,0,0,3503,0.825578075934913,8355,25515,176,150,NA,NA,NA,NA,NA,NA
"357","2020-03-11",0,5,0,0,3503,0.825578075934913,8355,25515,176,150,4,4,1,1,NA,1
"358","2020-03-12",0,5,0,0,3503,0.825578075934913,8355,25515,176,150,2,6,4,5,NA,4
"359","2020-03-13",0,5,0,0,3503,0.825578075934913,8355,25515,176,150,2,8,3,8,NA,3
"360","2020-03-14",1,5,16,21,3503,0.825578075934913,8355,25515,176,150,4,12,1,9,1,1
"361","2020-03-15",2,5,16,29,3503,0.825578075934913,8355,25515,176,150,2,14,2,11,1,2
"362","2020-03-16",2,5,20,36,3503,0.825578075934913,8355,25515,176,150,6,20,2,13,3,2
"363","2020-03-17",2,5,21,48,3503,0.825578075934913,8355,25515,176,150,7,27,2,15,5,2
"364","2020-03-18",3,5,22,59,3503,0.825578075934913,8355,25515,176,150,9,36,3,18,7,3
"365","2020-03-19",5,5,28,73,3503,0.825578075934913,8355,25515,176,150,3,39,2,20,2,2
"366","2020-03-20",13,5,24,90,3503,0.825578075934913,8355,25515,176,150,7,46,2,22,3,2
"367","2020-03-21",15,5,28,105,3503,0.825578075934913,8355,25515,176,150,12,58,NA,NA,8,NA
"368","2020-03-22",16,5,25,115,3503,0.825578075934913,8355,25515,176,150,15,73,7,29,13,7
"369","2020-03-23",21,5,19,130,3503,0.825578075934913,8355,25515,176,150,8,81,13,42,8,13
"370","2020-03-24",25,5,18,155,3503,0.825578075934913,8355,25515,176,150,15,96,11,53,10,11
"371","2020-03-25",31,5,19,171,3503,0.825578075934913,8355,25515,176,150,21,117,12,65,19,12
"372","2020-03-26",33,5,14,185,3503,0.825578075934913,8355,25515,176,150,17,134,11,76,15,11
"373","2020-03-27",37,5,16,191,3503,0.825578075934913,8355,25515,176,150,21,155,16,92,19,16
"374","2020-03-28",42,5,24,218,3503,0.825578075934913,8355,25515,176,150,23,178,15,107,16,15
"375","2020-03-29",44,5,36,236,3503,0.825578075934913,8355,25515,176,150,33,211,8,115,24,8
"376","2020-03-30",50,5,43,257,3503,0.825578075934913,8355,25515,176,150,32,243,11,126,28,11
"377","2020-03-31",58,5,45,285,3503,0.825578075934913,8355,25515,176,150,31,274,10,136,29,10
"378","2020-04-01",63,5,42,315,3503,0.825578075934913,8355,25515,176,150,34,308,7,143,30,7
"379","2020-04-02",78,5,45,329,3503,0.825578075934913,8355,25515,176,150,43,351,19,162,39,19
"380","2020-04-03",90,5,39,346,3503,0.825578075934913,8355,25515,176,150,58,409,7,169,52,7
"381","2020-04-04",93,5,40,363,3503,0.825578075934913,8355,25515,176,150,65,474,10,179,63,10
"382","2020-04-05",108,5,42,400,3503,0.825578075934913,8355,25515,176,150,43,517,16,195,40,16
"383","2020-04-06",113,5,41,421,3503,0.825578075934913,8355,25515,176,150,75,592,19,214,70,19
"384","2020-04-07",120,5,45,467,3503,0.825578075934913,8355,25515,176,150,76,668,29,243,70,29
"385","2020-04-08",124,5,47,487,3503,0.825578075934913,8355,25515,176,150,72,740,20,263,70,20
"386","2020-04-09",123,5,50,500,3503,0.825578075934913,8355,25515,176,150,94,834,15,278,89,15
"387","2020-04-10",138,5,49,552,3503,0.825578075934913,8355,25515,176,150,85,919,16,294,81,16
"388","2020-04-11",177,5,54,558,3503,0.825578075934913,8355,25515,176,150,94,1013,30,324,92,30
"389","2020-04-12",191,5,48,574,3503,0.825578075934913,8355,25515,176,150,98,1111,41,365,95,41
"390","2020-04-13",185,5,48,598,3503,0.825578075934913,8355,25515,176,150,107,1218,27,392,101,27
"391","2020-04-14",176,5,47,609,3503,0.825578075934913,8355,25515,176,150,130,1348,23,415,127,23
"392","2020-04-15",182,5,48,614,3503,0.825578075934913,8355,25515,176,150,121,1469,15,430,117,15
"393","2020-04-16",185,5,46,610,3503,0.825578075934913,8355,25515,176,150,130,1599,25,455,129,25
"394","2020-04-17",223,5,51,622,3503,0.825578075934913,8355,25515,176,150,142,1741,17,472,139,17
"395","2020-04-18",215,5,52,641,3503,0.825578075934913,8355,25515,176,150,143,1884,13,485,141,13
"396","2020-04-19",191,5,46,660,3503,0.825578075934913,8355,25515,176,150,142,2026,19,504,136,19
"397","2020-04-20",199,5,51,675,3503,0.825578075934913,8355,25515,176,150,167,2193,15,519,162,15
"398","2020-04-21",204,5,58,682,3503,0.825578075934913,8355,25515,176,150,162,2355,14,533,153,14
"399","2020-04-22",207,5,60,678,3503,0.825578075934913,8355,25515,176,150,151,2506,18,551,148,18
"400","2020-04-23",225,5,56,668,3503,0.825578075934913,8355,25515,176,150,175,2681,21,572,171,21
"401","2020-04-24",209,5,54,667,3503,0.825578075934913,8355,25515,176,150,149,2830,30,602,142,30
"402","2020-04-25",228,5,56,686,3503,0.825578075934913,8355,25515,176,150,156,2986,29,631,149,29
"403","2020-04-26",253,5,54,696,3503,0.825578075934913,8355,25515,176,150,148,3134,28,659,146,28
"404","2020-04-27",242,5,50,674,3503,0.825578075934913,8355,25515,176,150,159,3293,32,691,158,32
"405","2020-04-28",240,5,51,687,3503,0.825578075934913,8355,25515,176,150,164,3457,26,717,161,26
"406","2020-04-29",245,5,56,683,3503,0.825578075934913,8355,25515,176,150,132,3589,29,746,128,29
"407","2020-04-30",228,5,63,674,3503,0.825578075934913,8355,25515,176,150,119,3708,23,769,115,23
"408","2020-05-01",250,5,64,667,3503,0.825578075934913,8355,25515,176,150,134,3842,25,794,132,25
"409","2020-05-02",255,5,73,666,3503,0.825578075934913,8355,25515,176,150,121,3963,26,820,119,26
"410","2020-05-03",238,5,64,673,3503,0.825578075934913,8355,25515,176,150,100,4063,25,845,99,25
"411","2020-05-04",234,5,63,660,3503,0.825578075934913,8355,25515,176,150,101,4164,24,869,99,24
"412","2020-05-05",230,5,57,651,3503,0.825578075934913,8355,25515,176,150,98,4262,21,890,96,21
"413","2020-05-06",221,5,62,649,3503,0.825578075934913,8355,25515,176,150,88,4350,19,909,85,19
"414","2020-05-07",225,5,58,624,3503,0.825578075934913,8355,25515,176,150,109,4459,25,934,108,25
"415","2020-05-08",241,5,49,596,3503,0.825578075934913,8355,25515,176,150,109,4568,30,964,107,30
"416","2020-05-09",219,5,51,583,3503,0.825578075934913,8355,25515,176,150,88,4656,22,986,84,22
"417","2020-05-10",193,5,49,568,3503,0.825578075934913,8355,25515,176,150,68,4724,39,1025,67,39
"418","2020-05-11",194,5,59,577,3503,0.825578075934913,8355,25515,176,150,59,4783,29,1054,57,29
"419","2020-05-12",190,5,59,553,3503,0.825578075934913,8355,25515,176,150,66,4849,21,1075,62,21
"420","2020-05-13",184,5,60,543,3503,0.825578075934913,8355,25515,176,150,43,4892,22,1097,42,22
"421","2020-05-14",185,5,53,527,3503,0.825578075934913,8355,25515,176,150,51,4943,21,1118,50,21
"422","2020-05-15",181,5,48,515,3503,0.825578075934913,8355,25515,176,150,53,4996,16,1134,53,16
"423","2020-05-16",196,5,44,508,3503,0.825578075934913,8355,25515,176,150,40,5036,23,1157,39,23
"424","2020-05-17",185,5,39,497,3503,0.825578075934913,8355,25515,176,150,32,5068,18,1175,29,18
"425","2020-05-18",170,5,35,472,3503,0.825578075934913,8355,25515,176,150,39,5107,20,1195,37,20
"426","2020-05-19",167,5,33,466,3503,0.825578075934913,8355,25515,176,150,37,5144,17,1212,37,17
"427","2020-05-20",175,5,38,427,3503,0.825578075934913,8355,25515,176,150,29,5173,28,1240,27,28
"428","2020-05-21",165,5,39,425,3503,0.825578075934913,8355,25515,176,150,30,5203,20,1260,30,20
"429","2020-05-22",169,5,38,412,3503,0.825578075934913,8355,25515,176,150,21,5224,18,1278,20,18
"430","2020-05-23",166,5,38,394,3503,0.825578075934913,8355,25515,176,150,24,5248,22,1300,24,22
"431","2020-05-24",149,5,40,362,3503,0.825578075934913,8355,25515,176,150,20,5268,24,1324,20,24
"432","2020-05-25",135,5,34,343,3503,0.825578075934913,8355,25515,176,150,13,5281,18,1342,11,18
"433","2020-05-26",123,5,35,339,3503,0.825578075934913,8355,25515,176,150,16,5297,13,1355,14,13
"434","2020-05-27",112,5,35,321,3503,0.825578075934913,8355,25515,176,150,11,5308,19,1374,10,19
"435","2020-05-28",103,5,27,305,3503,0.825578075934913,8355,25515,176,150,15,5323,23,1397,15,23
"436","2020-05-29",98,5,29,281,3503,0.825578075934913,8355,25515,176,150,17,5340,13,1410,16,13
"437","2020-05-30",86,5,30,266,3503,0.825578075934913,8355,25515,176,150,8,5348,13,1423,8,13
"438","2020-05-31",75,5,25,257,3503,0.825578075934913,8355,25515,176,150,10,5358,16,1439,10,16
"439","2020-06-01",80,5,21,249,3503,0.825578075934913,8355,25515,176,150,8,5366,9,1448,8,9
"440","2020-06-02",78,5,19,248,3503,0.825578075934913,8355,25515,176,150,8,5374,22,1470,8,22
"441","2020-06-03",75,5,22,250,3503,0.825578075934913,8355,25515,176,150,10,5384,11,1481,10,11
"442","2020-06-04",77,5,19,256,3503,0.825578075934913,8355,25515,176,150,7,5391,12,1493,7,12
"443","2020-06-05",78,5,22,237,3503,0.825578075934913,8355,25515,176,150,9,5400,11,1504,9,11
"444","2020-06-06",85,5,27,231,3503,0.825578075934913,8355,25515,176,150,5,5405,7,1511,5,7
"445","2020-06-07",80,5,30,219,3503,0.825578075934913,8355,25515,176,150,6,5411,9,1520,5,9
"446","2020-03-07",1,6,0,0,2762,0.840695148443157,8205,22215,181,335,NA,NA,NA,NA,NA,NA
"447","2020-03-08",1,6,0,0,2762,0.840695148443157,8205,22215,181,335,NA,NA,NA,NA,NA,NA
"448","2020-03-09",0,6,0,0,2762,0.840695148443157,8205,22215,181,335,NA,NA,NA,NA,NA,NA
"449","2020-03-10",0,6,0,0,2762,0.840695148443157,8205,22215,181,335,NA,NA,NA,NA,NA,NA
"450","2020-03-11",0,6,0,0,2762,0.840695148443157,8205,22215,181,335,6,6,3,3,NA,3
"451","2020-03-12",1,6,8,13,2762,0.840695148443157,8205,22215,181,335,4,10,7,10,NA,7
"452","2020-03-13",1,6,15,17,2762,0.840695148443157,8205,22215,181,335,6,16,2,12,2,2
"453","2020-03-14",1,6,16,23,2762,0.840695148443157,8205,22215,181,335,8,24,11,23,1,11
"454","2020-03-15",2,6,21,30,2762,0.840695148443157,8205,22215,181,335,9,33,4,27,4,4
"455","2020-03-16",3,6,18,38,2762,0.840695148443157,8205,22215,181,335,10,43,4,31,3,4
"456","2020-03-17",6,6,15,48,2762,0.840695148443157,8205,22215,181,335,5,48,4,35,4,4
"457","2020-03-18",10,6,15,54,2762,0.840695148443157,8205,22215,181,335,15,63,3,38,7,3
"458","2020-03-19",9,6,23,67,2762,0.840695148443157,8205,22215,181,335,19,82,9,47,9,9
"459","2020-03-20",13,6,32,83,2762,0.840695148443157,8205,22215,181,335,14,96,6,53,9,6
"460","2020-03-21",19,6,42,95,2762,0.840695148443157,8205,22215,181,335,18,114,4,57,12,4
"461","2020-03-22",24,6,44,109,2762,0.840695148443157,8205,22215,181,335,16,130,4,61,10,4
"462","2020-03-23",26,6,37,129,2762,0.840695148443157,8205,22215,181,335,18,148,1,62,11,1
"463","2020-03-24",29,6,33,141,2762,0.840695148443157,8205,22215,181,335,15,163,5,67,11,5
"464","2020-03-25",30,6,30,168,2762,0.840695148443157,8205,22215,181,335,32,195,7,74,22,7
"465","2020-03-26",37,6,38,181,2762,0.840695148443157,8205,22215,181,335,23,218,8,82,15,8
"466","2020-03-27",43,6,38,197,2762,0.840695148443157,8205,22215,181,335,30,248,5,87,26,5
"467","2020-03-28",65,6,38,208,2762,0.840695148443157,8205,22215,181,335,34,282,7,94,26,7
"468","2020-03-29",66,6,48,237,2762,0.840695148443157,8205,22215,181,335,26,308,9,103,19,9
"469","2020-03-30",66,6,64,244,2762,0.840695148443157,8205,22215,181,335,34,342,16,119,24,16
"470","2020-03-31",66,6,67,266,2762,0.840695148443157,8205,22215,181,335,28,370,15,134,20,15
"471","2020-04-01",78,6,65,272,2762,0.840695148443157,8205,22215,181,335,28,398,25,159,21,25
"472","2020-04-02",85,6,75,281,2762,0.840695148443157,8205,22215,181,335,47,445,13,172,39,13
"473","2020-04-03",105,6,72,295,2762,0.840695148443157,8205,22215,181,335,42,487,16,188,33,16
"474","2020-04-04",102,6,67,320,2762,0.840695148443157,8205,22215,181,335,55,542,11,199,41,11
"475","2020-04-05",95,6,66,336,2762,0.840695148443157,8205,22215,181,335,49,591,14,213,43,14
"476","2020-04-06",94,6,58,344,2762,0.840695148443157,8205,22215,181,335,57,648,14,227,47,14
"477","2020-04-07",102,6,53,364,2762,0.840695148443157,8205,22215,181,335,46,694,10,237,39,10
"478","2020-04-08",102,6,56,378,2762,0.840695148443157,8205,22215,181,335,52,746,12,249,47,12
"479","2020-04-09",99,6,54,385,2762,0.840695148443157,8205,22215,181,335,59,805,11,260,50,11
"480","2020-04-10",110,6,51,396,2762,0.840695148443157,8205,22215,181,335,58,863,7,267,50,7
"481","2020-04-11",117,6,51,397,2762,0.840695148443157,8205,22215,181,335,68,931,6,273,60,6
"482","2020-04-12",130,6,52,413,2762,0.840695148443157,8205,22215,181,335,48,979,16,289,37,16
"483","2020-04-13",136,6,55,428,2762,0.840695148443157,8205,22215,181,335,56,1035,16,305,49,16
"484","2020-04-14",133,6,51,434,2762,0.840695148443157,8205,22215,181,335,69,1104,10,315,55,10
"485","2020-04-15",129,6,61,434,2762,0.840695148443157,8205,22215,181,335,56,1160,9,324,45,9
"486","2020-04-16",129,6,63,442,2762,0.840695148443157,8205,22215,181,335,72,1232,14,338,60,14
"487","2020-04-17",142,6,64,441,2762,0.840695148443157,8205,22215,181,335,65,1297,15,353,56,15
"488","2020-04-18",145,6,60,467,2762,0.840695148443157,8205,22215,181,335,57,1354,16,369,47,16
"489","2020-04-19",144,6,57,490,2762,0.840695148443157,8205,22215,181,335,62,1416,10,379,49,10
"490","2020-04-20",137,6,58,512,2762,0.840695148443157,8205,22215,181,335,65,1481,15,394,55,15
"491","2020-04-21",136,6,47,510,2762,0.840695148443157,8205,22215,181,335,58,1539,8,402,50,8
"492","2020-04-22",153,6,48,515,2762,0.840695148443157,8205,22215,181,335,63,1602,23,425,59,23
"493","2020-04-23",158,6,64,519,2762,0.840695148443157,8205,22215,181,335,71,1673,17,442,62,17
"494","2020-04-24",158,6,75,523,2762,0.840695148443157,8205,22215,181,335,84,1757,23,465,73,23
"495","2020-04-25",158,6,67,520,2762,0.840695148443157,8205,22215,181,335,76,1833,29,494,67,29
"496","2020-04-26",163,6,82,507,2762,0.840695148443157,8205,22215,181,335,76,1909,38,532,69,38
"497","2020-04-27",174,6,95,525,2762,0.840695148443157,8205,22215,181,335,59,1968,24,556,47,24
"498","2020-04-28",167,6,91,534,2762,0.840695148443157,8205,22215,181,335,64,2032,22,578,54,22
"499","2020-04-29",164,6,82,542,2762,0.840695148443157,8205,22215,181,335,79,2111,12,590,71,12
"500","2020-04-30",167,6,75,551,2762,0.840695148443157,8205,22215,181,335,57,2168,9,599,49,9
"501","2020-05-01",170,6,72,543,2762,0.840695148443157,8205,22215,181,335,57,2225,8,607,50,8
"502","2020-05-02",189,6,69,521,2762,0.840695148443157,8205,22215,181,335,77,2302,10,617,67,10
"503","2020-05-03",185,6,76,526,2762,0.840695148443157,8205,22215,181,335,66,2368,17,634,57,17
"504","2020-05-04",183,6,76,526,2762,0.840695148443157,8205,22215,181,335,52,2420,21,655,44,21
"505","2020-05-05",185,6,65,518,2762,0.840695148443157,8205,22215,181,335,52,2472,12,667,43,12
"506","2020-05-06",183,6,72,535,2762,0.840695148443157,8205,22215,181,335,58,2530,26,693,51,26
"507","2020-05-07",188,6,63,536,2762,0.840695148443157,8205,22215,181,335,59,2589,13,706,55,13
"508","2020-05-08",215,6,58,512,2762,0.840695148443157,8205,22215,181,335,52,2641,15,721,39,15
"509","2020-05-09",198,6,61,509,2762,0.840695148443157,8205,22215,181,335,53,2694,12,733,48,12
"510","2020-05-10",205,6,68,512,2762,0.840695148443157,8205,22215,181,335,54,2748,14,747,45,14
"511","2020-05-11",190,6,69,503,2762,0.840695148443157,8205,22215,181,335,54,2802,13,760,47,13
"512","2020-05-12",192,6,68,493,2762,0.840695148443157,8205,22215,181,335,78,2880,16,776,71,16
"513","2020-05-13",184,6,66,464,2762,0.840695148443157,8205,22215,181,335,64,2944,24,800,52,24
"514","2020-05-14",176,6,64,435,2762,0.840695148443157,8205,22215,181,335,38,2982,16,816,36,16
"515","2020-05-15",155,6,74,411,2762,0.840695148443157,8205,22215,181,335,59,3041,20,836,50,20
"516","2020-05-16",166,6,72,397,2762,0.840695148443157,8205,22215,181,335,41,3082,25,861,35,25
"517","2020-05-17",148,6,64,373,2762,0.840695148443157,8205,22215,181,335,43,3125,20,881,36,20
"518","2020-05-18",145,6,71,360,2762,0.840695148443157,8205,22215,181,335,27,3152,12,893,25,12
"519","2020-05-19",131,6,63,328,2762,0.840695148443157,8205,22215,181,335,39,3191,15,908,32,15
"520","2020-05-20",125,6,58,318,2762,0.840695148443157,8205,22215,181,335,33,3224,12,920,32,12
"521","2020-05-21",122,6,70,294,2762,0.840695148443157,8205,22215,181,335,41,3265,20,940,37,20
"522","2020-05-22",115,6,76,291,2762,0.840695148443157,8205,22215,181,335,38,3303,7,947,35,7
"523","2020-05-23",111,6,73,268,2762,0.840695148443157,8205,22215,181,335,38,3341,9,956,37,9
"524","2020-05-24",105,6,83,248,2762,0.840695148443157,8205,22215,181,335,45,3386,7,963,40,7
"525","2020-05-25",101,6,81,239,2762,0.840695148443157,8205,22215,181,335,28,3414,7,970,23,7
"526","2020-05-26",102,6,79,229,2762,0.840695148443157,8205,22215,181,335,28,3442,6,976,24,6
"527","2020-05-27",98,6,64,229,2762,0.840695148443157,8205,22215,181,335,39,3481,6,982,31,6
"528","2020-05-28",99,6,68,224,2762,0.840695148443157,8205,22215,181,335,33,3514,9,991,29,9
"529","2020-05-29",95,6,69,218,2762,0.840695148443157,8205,22215,181,335,24,3538,14,1005,22,14
"530","2020-05-30",84,6,65,214,2762,0.840695148443157,8205,22215,181,335,31,3569,21,1026,29,21
"531","2020-05-31",76,6,65,216,2762,0.840695148443157,8205,22215,181,335,26,3595,4,1030,23,4
"532","2020-06-01",74,6,57,212,2762,0.840695148443157,8205,22215,181,335,25,3620,8,1038,23,8
"533","2020-06-02",68,6,60,209,2762,0.840695148443157,8205,22215,181,335,22,3642,7,1045,18,7
"534","2020-06-03",71,6,58,211,2762,0.840695148443157,8205,22215,181,335,13,3655,4,1049,13,4
"535","2020-06-04",68,6,57,213,2762,0.840695148443157,8205,22215,181,335,14,3669,14,1063,13,14
"536","2020-06-05",78,6,58,204,2762,0.840695148443157,8205,22215,181,335,16,3685,13,1076,13,13
"537","2020-06-06",82,6,49,184,2762,0.840695148443157,8205,22215,181,335,15,3700,12,1088,13,12
"538","2020-06-07",75,6,39,185,2762,0.840695148443157,8205,22215,181,335,12,3712,9,1097,11,9
"539","2020-03-13",1,7,10,33,2352,0.511054421768708,8355,20653,129,153,5,12,14,25,NA,14
"540","2020-03-14",4,7,14,42,2352,0.511054421768708,8355,20653,129,153,8,20,16,41,5,16
"541","2020-03-15",5,7,11,54,2352,0.511054421768708,8355,20653,129,153,6,26,9,50,2,9
"542","2020-03-16",7,7,15,71,2352,0.511054421768708,8355,20653,129,153,8,34,4,54,4,4
"543","2020-03-17",10,7,14,82,2352,0.511054421768708,8355,20653,129,153,7,41,8,62,6,8
"544","2020-03-18",15,7,23,100,2352,0.511054421768708,8355,20653,129,153,10,51,3,65,9,3
"545","2020-03-19",18,7,25,116,2352,0.511054421768708,8355,20653,129,153,6,57,11,76,5,11
"546","2020-03-20",24,7,20,131,2352,0.511054421768708,8355,20653,129,153,11,68,17,93,8,17
"547","2020-03-21",28,7,18,158,2352,0.511054421768708,8355,20653,129,153,13,81,11,104,12,11
"548","2020-03-22",38,7,16,171,2352,0.511054421768708,8355,20653,129,153,19,100,7,111,13,7
"549","2020-03-23",43,7,17,193,2352,0.511054421768708,8355,20653,129,153,15,115,5,116,12,5
"550","2020-03-24",39,7,15,208,2352,0.511054421768708,8355,20653,129,153,15,130,3,119,12,3
"551","2020-03-25",43,7,13,237,2352,0.511054421768708,8355,20653,129,153,19,149,3,122,16,3
"552","2020-03-26",51,7,16,246,2352,0.511054421768708,8355,20653,129,153,18,167,3,125,14,3
"553","2020-03-27",64,7,14,259,2352,0.511054421768708,8355,20653,129,153,22,189,NA,NA,18,NA
"554","2020-03-28",74,7,13,268,2352,0.511054421768708,8355,20653,129,153,27,216,3,128,23,3
"555","2020-03-29",85,7,12,280,2352,0.511054421768708,8355,20653,129,153,16,232,3,131,14,3
"556","2020-03-30",86,7,12,293,2352,0.511054421768708,8355,20653,129,153,34,266,1,132,31,1
"557","2020-03-31",87,7,14,302,2352,0.511054421768708,8355,20653,129,153,24,290,NA,NA,21,NA
"558","2020-04-01",86,7,17,307,2352,0.511054421768708,8355,20653,129,153,42,332,1,133,37,1
"559","2020-04-02",86,7,20,306,2352,0.511054421768708,8355,20653,129,153,37,369,NA,NA,32,NA
"560","2020-04-03",100,7,21,307,2352,0.511054421768708,8355,20653,129,153,39,408,NA,NA,36,NA
"561","2020-04-04",110,7,20,303,2352,0.511054421768708,8355,20653,129,153,46,454,1,134,41,1
"562","2020-04-05",91,7,21,327,2352,0.511054421768708,8355,20653,129,153,43,497,6,140,40,6
"563","2020-04-06",94,7,27,331,2352,0.511054421768708,8355,20653,129,153,54,551,4,144,51,4
"564","2020-04-07",101,7,32,326,2352,0.511054421768708,8355,20653,129,153,53,604,17,161,48,17
"565","2020-04-08",104,7,29,321,2352,0.511054421768708,8355,20653,129,153,65,669,11,172,63,11
"566","2020-04-09",106,7,36,329,2352,0.511054421768708,8355,20653,129,153,62,731,15,187,59,15
"567","2020-04-10",117,7,41,337,2352,0.511054421768708,8355,20653,129,153,60,791,22,209,52,22
"568","2020-04-11",112,7,46,341,2352,0.511054421768708,8355,20653,129,153,63,854,14,223,54,14
"569","2020-04-12",112,7,43,352,2352,0.511054421768708,8355,20653,129,153,51,905,16,239,49,16
"570","2020-04-13",109,7,38,349,2352,0.511054421768708,8355,20653,129,153,76,981,5,244,71,5
"571","2020-04-14",104,7,40,357,2352,0.511054421768708,8355,20653,129,153,84,1065,9,253,78,9
"572","2020-04-15",102,7,47,347,2352,0.511054421768708,8355,20653,129,153,63,1128,9,262,57,9
"573","2020-04-16",99,7,49,343,2352,0.511054421768708,8355,20653,129,153,68,1196,10,272,63,10
"574","2020-04-17",96,7,55,343,2352,0.511054421768708,8355,20653,129,153,65,1261,10,282,64,10
"575","2020-04-18",91,7,55,356,2352,0.511054421768708,8355,20653,129,153,99,1360,3,285,94,3
"576","2020-04-19",103,7,47,348,2352,0.511054421768708,8355,20653,129,153,117,1477,1,286,109,1
"577","2020-04-20",104,7,50,368,2352,0.511054421768708,8355,20653,129,153,81,1558,5,291,75,5
"578","2020-04-21",99,7,44,360,2352,0.511054421768708,8355,20653,129,153,119,1677,13,304,118,13
"579","2020-04-22",105,7,39,358,2352,0.511054421768708,8355,20653,129,153,90,1767,9,313,84,9
"580","2020-04-23",110,7,47,357,2352,0.511054421768708,8355,20653,129,153,113,1880,15,328,108,15
"581","2020-04-24",138,7,53,363,2352,0.511054421768708,8355,20653,129,153,85,1965,11,339,79,11
"582","2020-04-25",133,7,47,375,2352,0.511054421768708,8355,20653,129,153,116,2081,18,357,112,18
"583","2020-04-26",121,7,49,369,2352,0.511054421768708,8355,20653,129,153,94,2175,20,377,87,20
"584","2020-04-27",119,7,46,376,2352,0.511054421768708,8355,20653,129,153,100,2275,10,387,96,10
"585","2020-04-28",118,7,37,374,2352,0.511054421768708,8355,20653,129,153,99,2374,11,398,95,11
"586","2020-04-29",116,7,38,365,2352,0.511054421768708,8355,20653,129,153,119,2493,11,409,114,11
"587","2020-04-30",115,7,43,362,2352,0.511054421768708,8355,20653,129,153,78,2571,9,418,76,9
"588","2020-05-01",104,7,42,372,2352,0.511054421768708,8355,20653,129,153,115,2686,3,421,115,3
"589","2020-05-02",123,7,42,370,2352,0.511054421768708,8355,20653,129,153,115,2801,2,423,109,2
"590","2020-05-03",117,7,53,366,2352,0.511054421768708,8355,20653,129,153,84,2885,17,440,82,17
"591","2020-05-04",124,7,53,367,2352,0.511054421768708,8355,20653,129,153,89,2974,27,467,87,27
"592","2020-05-05",122,7,51,374,2352,0.511054421768708,8355,20653,129,153,113,3087,23,490,111,23
"593","2020-05-06",122,7,56,366,2352,0.511054421768708,8355,20653,129,153,98,3185,13,503,94,13
"594","2020-05-07",121,7,47,362,2352,0.511054421768708,8355,20653,129,153,111,3296,12,515,109,12
"595","2020-05-08",133,7,42,356,2352,0.511054421768708,8355,20653,129,153,77,3373,10,525,74,10
"596","2020-05-09",130,7,48,364,2352,0.511054421768708,8355,20653,129,153,110,3483,20,545,104,20
"597","2020-05-10",131,7,39,351,2352,0.511054421768708,8355,20653,129,153,76,3559,14,559,76,14
"598","2020-05-11",119,7,43,345,2352,0.511054421768708,8355,20653,129,153,71,3630,10,569,69,10
"599","2020-05-12",118,7,34,346,2352,0.511054421768708,8355,20653,129,153,81,3711,2,571,77,2
"600","2020-05-13",120,7,29,347,2352,0.511054421768708,8355,20653,129,153,76,3787,8,579,70,8
"601","2020-05-14",118,7,30,346,2352,0.511054421768708,8355,20653,129,153,80,3867,9,588,75,9
"602","2020-05-15",108,7,36,335,2352,0.511054421768708,8355,20653,129,153,53,3920,4,592,51,4
"603","2020-05-16",109,7,34,324,2352,0.511054421768708,8355,20653,129,153,52,3972,5,597,49,5
"604","2020-05-17",104,7,39,321,2352,0.511054421768708,8355,20653,129,153,59,4031,9,606,58,9
"605","2020-05-18",105,7,36,317,2352,0.511054421768708,8355,20653,129,153,53,4084,18,624,52,18
"606","2020-05-19",99,7,41,315,2352,0.511054421768708,8355,20653,129,153,49,4133,4,628,45,4
"607","2020-05-20",97,7,42,301,2352,0.511054421768708,8355,20653,129,153,44,4177,13,641,42,13
"608","2020-05-21",96,7,41,287,2352,0.511054421768708,8355,20653,129,153,44,4221,12,653,44,12
"609","2020-05-22",107,7,39,275,2352,0.511054421768708,8355,20653,129,153,41,4262,17,670,39,17
"610","2020-05-23",98,7,36,263,2352,0.511054421768708,8355,20653,129,153,34,4296,10,680,32,10
"611","2020-05-24",103,7,49,249,2352,0.511054421768708,8355,20653,129,153,41,4337,8,688,40,8
"612","2020-05-25",97,7,53,246,2352,0.511054421768708,8355,20653,129,153,30,4367,20,708,29,20
"613","2020-05-26",99,7,51,237,2352,0.511054421768708,8355,20653,129,153,36,4403,15,723,35,15
"614","2020-05-27",97,7,45,218,2352,0.511054421768708,8355,20653,129,153,36,4439,11,734,34,11
"615","2020-05-28",95,7,39,209,2352,0.511054421768708,8355,20653,129,153,30,4469,17,751,30,17
"616","2020-05-29",90,7,38,207,2352,0.511054421768708,8355,20653,129,153,26,4495,9,760,25,9
"617","2020-05-30",91,7,37,196,2352,0.511054421768708,8355,20653,129,153,24,4519,12,772,23,12
"618","2020-05-31",81,7,40,191,2352,0.511054421768708,8355,20653,129,153,27,4546,2,774,25,2
"619","2020-06-01",81,7,43,182,2352,0.511054421768708,8355,20653,129,153,15,4561,6,780,15,6
"620","2020-06-02",72,7,38,179,2352,0.511054421768708,8355,20653,129,153,17,4578,1,781,16,1
"621","2020-06-03",69,7,30,178,2352,0.511054421768708,8355,20653,129,153,14,4592,2,783,14,2
"622","2020-06-04",68,7,27,172,2352,0.511054421768708,8355,20653,129,153,17,4609,7,790,16,7
"623","2020-06-05",58,7,27,169,2352,0.511054421768708,8355,20653,129,153,20,4629,3,793,20,3
"624","2020-06-06",58,7,28,167,2352,0.511054421768708,8355,20653,129,153,12,4641,2,795,12,2
"625","2020-06-07",55,7,24,152,2352,0.511054421768708,8355,20653,129,153,10,4651,4,799,9,4
"626","2020-03-14",1,8,48,34,3563,0.789503227617177,8475,27164,218,573,9,25,2,12,1,2
"627","2020-03-15",2,8,51,46,3563,0.789503227617177,8475,27164,218,573,10,35,3,15,4,3
"628","2020-03-16",4,8,55,57,3563,0.789503227617177,8475,27164,218,573,11,46,2,17,3,2
"629","2020-03-17",6,8,64,73,3563,0.789503227617177,8475,27164,218,573,9,55,3,20,3,3
"630","2020-03-18",7,8,68,92,3563,0.789503227617177,8475,27164,218,573,9,64,2,22,3,2
"631","2020-03-19",12,8,63,110,3563,0.789503227617177,8475,27164,218,573,13,77,NA,NA,7,NA
"632","2020-03-20",14,8,60,119,3563,0.789503227617177,8475,27164,218,573,16,93,4,26,13,4
"633","2020-03-21",19,8,63,146,3563,0.789503227617177,8475,27164,218,573,16,109,4,30,9,4
"634","2020-03-22",34,8,73,165,3563,0.789503227617177,8475,27164,218,573,11,120,12,42,5,12
"635","2020-03-23",36,8,82,181,3563,0.789503227617177,8475,27164,218,573,13,133,9,51,8,9
"636","2020-03-24",31,8,76,199,3563,0.789503227617177,8475,27164,218,573,12,145,4,55,8,4
"637","2020-03-25",41,8,88,217,3563,0.789503227617177,8475,27164,218,573,22,167,6,61,19,6
"638","2020-03-26",43,8,100,239,3563,0.789503227617177,8475,27164,218,573,14,181,9,70,9,9
"639","2020-03-27",52,8,112,259,3563,0.789503227617177,8475,27164,218,573,17,198,10,80,9,10
"640","2020-03-28",62,8,107,287,3563,0.789503227617177,8475,27164,218,573,18,216,7,87,11,7
"641","2020-03-29",63,8,110,316,3563,0.789503227617177,8475,27164,218,573,26,242,6,93,14,6
"642","2020-03-30",76,8,105,345,3563,0.789503227617177,8475,27164,218,573,15,257,10,103,11,10
"643","2020-03-31",88,8,90,368,3563,0.789503227617177,8475,27164,218,573,28,285,5,108,19,5
"644","2020-04-01",88,8,88,388,3563,0.789503227617177,8475,27164,218,573,28,313,9,117,14,9
"645","2020-04-02",91,8,100,420,3563,0.789503227617177,8475,27164,218,573,20,333,11,128,11,11
"646","2020-04-03",106,8,97,434,3563,0.789503227617177,8475,27164,218,573,23,356,7,135,15,7
"647","2020-04-04",121,8,109,454,3563,0.789503227617177,8475,27164,218,573,24,380,2,137,19,2
"648","2020-04-05",138,8,104,478,3563,0.789503227617177,8475,27164,218,573,25,405,4,141,19,4
"649","2020-04-06",130,8,112,509,3563,0.789503227617177,8475,27164,218,573,27,432,10,151,19,10
"650","2020-04-07",125,8,115,522,3563,0.789503227617177,8475,27164,218,573,32,464,12,163,25,12
"651","2020-04-08",143,8,125,549,3563,0.789503227617177,8475,27164,218,573,32,496,15,178,20,15
"652","2020-04-09",154,8,117,560,3563,0.789503227617177,8475,27164,218,573,26,522,6,184,18,6
"653","2020-04-10",190,8,111,572,3563,0.789503227617177,8475,27164,218,573,32,554,6,190,24,6
"654","2020-04-11",181,8,115,579,3563,0.789503227617177,8475,27164,218,573,28,582,12,202,21,12
"655","2020-04-12",178,8,141,584,3563,0.789503227617177,8475,27164,218,573,25,607,22,224,12,22
"656","2020-04-13",183,8,147,595,3563,0.789503227617177,8475,27164,218,573,32,639,12,236,19,12
"657","2020-04-14",193,8,169,617,3563,0.789503227617177,8475,27164,218,573,25,664,10,246,18,10
"658","2020-04-15",190,8,167,635,3563,0.789503227617177,8475,27164,218,573,21,685,11,257,13,11
"659","2020-04-16",198,8,162,658,3563,0.789503227617177,8475,27164,218,573,32,717,7,264,24,7
"660","2020-04-17",210,8,152,664,3563,0.789503227617177,8475,27164,218,573,30,747,10,274,20,10
"661","2020-04-18",220,8,158,660,3563,0.789503227617177,8475,27164,218,573,26,773,9,283,19,9
"662","2020-04-19",215,8,163,663,3563,0.789503227617177,8475,27164,218,573,22,795,10,293,19,10
"663","2020-04-20",228,8,160,651,3563,0.789503227617177,8475,27164,218,573,27,822,10,303,19,10
"664","2020-04-21",226,8,150,652,3563,0.789503227617177,8475,27164,218,573,22,844,13,316,17,13
"665","2020-04-22",224,8,157,660,3563,0.789503227617177,8475,27164,218,573,33,877,14,330,25,14
"666","2020-04-23",226,8,151,638,3563,0.789503227617177,8475,27164,218,573,28,905,13,343,16,13
"667","2020-04-24",230,8,155,636,3563,0.789503227617177,8475,27164,218,573,32,937,14,357,23,14
"668","2020-04-25",230,8,146,639,3563,0.789503227617177,8475,27164,218,573,28,965,13,370,13,13
"669","2020-04-26",226,8,141,622,3563,0.789503227617177,8475,27164,218,573,33,998,12,382,25,12
"670","2020-04-27",213,8,144,620,3563,0.789503227617177,8475,27164,218,573,20,1018,12,394,13,12
"671","2020-04-28",202,8,160,629,3563,0.789503227617177,8475,27164,218,573,32,1050,11,405,18,11
"672","2020-04-29",193,8,151,624,3563,0.789503227617177,8475,27164,218,573,26,1076,15,420,19,15
"673","2020-04-30",188,8,161,637,3563,0.789503227617177,8475,27164,218,573,31,1107,10,430,18,10
"674","2020-05-01",201,8,149,623,3563,0.789503227617177,8475,27164,218,573,28,1135,14,444,20,14
"675","2020-05-02",222,8,150,620,3563,0.789503227617177,8475,27164,218,573,29,1164,10,454,21,10
"676","2020-05-03",210,8,148,624,3563,0.789503227617177,8475,27164,218,573,28,1192,5,459,18,5
"677","2020-05-04",211,8,135,643,3563,0.789503227617177,8475,27164,218,573,34,1226,16,475,25,16
"678","2020-05-05",211,8,136,626,3563,0.789503227617177,8475,27164,218,573,25,1251,15,490,15,15
"679","2020-05-06",213,8,139,629,3563,0.789503227617177,8475,27164,218,573,34,1285,16,506,29,16
"680","2020-05-07",210,8,135,633,3563,0.789503227617177,8475,27164,218,573,21,1306,18,524,16,18
"681","2020-05-08",202,8,120,622,3563,0.789503227617177,8475,27164,218,573,24,1330,17,541,19,17
"682","2020-05-09",199,8,135,608,3563,0.789503227617177,8475,27164,218,573,24,1354,10,551,19,10
"683","2020-05-10",192,8,145,594,3563,0.789503227617177,8475,27164,218,573,30,1384,11,562,19,11
"684","2020-05-11",194,8,134,590,3563,0.789503227617177,8475,27164,218,573,32,1416,10,572,20,10
"685","2020-05-12",189,8,128,563,3563,0.789503227617177,8475,27164,218,573,17,1433,9,581,9,9
"686","2020-05-13",186,8,129,553,3563,0.789503227617177,8475,27164,218,573,25,1458,4,585,20,4
"687","2020-05-14",187,8,115,546,3563,0.789503227617177,8475,27164,218,573,25,1483,8,593,20,8
"688","2020-05-15",223,8,116,528,3563,0.789503227617177,8475,27164,218,573,29,1512,12,605,21,12
"689","2020-05-16",208,8,127,507,3563,0.789503227617177,8475,27164,218,573,26,1538,11,616,20,11
"690","2020-05-17",190,8,131,476,3563,0.789503227617177,8475,27164,218,573,24,1562,9,625,15,9
"691","2020-05-18",180,8,131,452,3563,0.789503227617177,8475,27164,218,573,17,1579,10,635,13,10
"692","2020-05-19",169,8,138,440,3563,0.789503227617177,8475,27164,218,573,36,1615,5,640,22,5
"693","2020-05-20",176,8,128,422,3563,0.789503227617177,8475,27164,218,573,18,1633,4,644,12,4
"694","2020-05-21",170,8,136,413,3563,0.789503227617177,8475,27164,218,573,29,1662,5,649,18,5
"695","2020-05-22",143,8,139,380,3563,0.789503227617177,8475,27164,218,573,23,1685,6,655,19,6
"696","2020-05-23",142,8,156,368,3563,0.789503227617177,8475,27164,218,573,21,1706,13,668,15,13
"697","2020-05-24",134,8,180,360,3563,0.789503227617177,8475,27164,218,573,19,1725,13,681,15,13
"698","2020-05-25",128,8,169,354,3563,0.789503227617177,8475,27164,218,573,12,1737,9,690,10,9
"699","2020-05-26",130,8,164,337,3563,0.789503227617177,8475,27164,218,573,21,1758,10,700,17,10
"700","2020-05-27",124,8,165,332,3563,0.789503227617177,8475,27164,218,573,20,1778,9,709,15,9
"701","2020-05-28",121,8,167,304,3563,0.789503227617177,8475,27164,218,573,13,1791,6,715,8,6
"702","2020-05-29",118,8,170,294,3563,0.789503227617177,8475,27164,218,573,19,1810,7,722,16,7
"703","2020-05-30",118,8,151,287,3563,0.789503227617177,8475,27164,218,573,11,1821,7,729,11,7
"704","2020-05-31",107,8,143,269,3563,0.789503227617177,8475,27164,218,573,10,1831,3,732,7,3
"705","2020-06-01",100,8,139,253,3563,0.789503227617177,8475,27164,218,573,6,1837,9,741,5,9
"706","2020-06-02",93,8,135,228,3563,0.789503227617177,8475,27164,218,573,8,1845,8,749,4,8
"707","2020-06-03",84,8,133,226,3563,0.789503227617177,8475,27164,218,573,15,1860,4,753,10,4
"708","2020-06-04",71,8,120,207,3563,0.789503227617177,8475,27164,218,573,10,1870,3,756,6,3
"709","2020-06-05",73,8,118,193,3563,0.789503227617177,8475,27164,218,573,17,1887,NA,NA,13,NA
"710","2020-06-06",68,8,120,173,3563,0.789503227617177,8475,27164,218,573,13,1900,1,757,9,1
"711","2020-06-07",57,8,125,160,3563,0.789503227617177,8475,27164,218,573,11,1911,NA,NA,6,NA
"712","2020-03-14",1,9,17,11,5317,0.975173970283995,8235,30992,291,244,10,23,6,29,8,6
"713","2020-03-15",1,9,18,14,5317,0.975173970283995,8235,30992,291,244,7,30,7,36,6,7
"714","2020-03-16",3,9,23,18,5317,0.975173970283995,8235,30992,291,244,8,38,5,41,8,5
"715","2020-03-17",3,9,36,24,5317,0.975173970283995,8235,30992,291,244,7,45,10,51,6,10
"716","2020-03-18",3,9,31,32,5317,0.975173970283995,8235,30992,291,244,8,53,12,63,7,12
"717","2020-03-19",4,9,28,41,5317,0.975173970283995,8235,30992,291,244,11,64,1,64,8,1
"718","2020-03-20",6,9,41,48,5317,0.975173970283995,8235,30992,291,244,20,84,6,70,19,6
"719","2020-03-21",7,9,45,61,5317,0.975173970283995,8235,30992,291,244,19,103,2,72,17,2
"720","2020-03-22",10,9,44,74,5317,0.975173970283995,8235,30992,291,244,16,119,1,73,15,1
"721","2020-03-23",10,9,41,93,5317,0.975173970283995,8235,30992,291,244,17,136,1,74,16,1
"722","2020-03-24",13,9,44,112,5317,0.975173970283995,8235,30992,291,244,25,161,3,77,24,3
"723","2020-03-25",16,9,53,128,5317,0.975173970283995,8235,30992,291,244,27,188,10,87,24,10
"724","2020-03-26",19,9,55,151,5317,0.975173970283995,8235,30992,291,244,36,224,4,91,34,4
"725","2020-03-27",28,9,58,174,5317,0.975173970283995,8235,30992,291,244,34,258,1,92,32,1
"726","2020-03-28",39,9,62,197,5317,0.975173970283995,8235,30992,291,244,36,294,13,105,34,13
"727","2020-03-29",54,9,72,205,5317,0.975173970283995,8235,30992,291,244,29,323,3,108,29,3
"728","2020-03-30",57,9,65,238,5317,0.975173970283995,8235,30992,291,244,47,370,7,115,46,7
"729","2020-03-31",52,9,53,259,5317,0.975173970283995,8235,30992,291,244,40,410,15,130,40,15
"730","2020-04-01",61,9,49,289,5317,0.975173970283995,8235,30992,291,244,72,482,12,142,69,12
"731","2020-04-02",75,9,53,315,5317,0.975173970283995,8235,30992,291,244,69,551,15,157,65,15
"732","2020-04-03",102,9,55,349,5317,0.975173970283995,8235,30992,291,244,56,607,14,171,56,14
"733","2020-04-04",110,9,45,389,5317,0.975173970283995,8235,30992,291,244,69,676,11,182,68,11
"734","2020-04-05",113,9,40,426,5317,0.975173970283995,8235,30992,291,244,70,746,11,193,70,11
"735","2020-04-06",111,9,35,466,5317,0.975173970283995,8235,30992,291,244,73,819,9,202,72,9
"736","2020-04-07",123,9,34,521,5317,0.975173970283995,8235,30992,291,244,82,901,6,208,80,6
"737","2020-04-08",130,9,25,543,5317,0.975173970283995,8235,30992,291,244,85,986,10,218,84,10
"738","2020-04-09",130,9,23,612,5317,0.975173970283995,8235,30992,291,244,97,1083,16,234,96,16
"739","2020-04-10",181,9,18,645,5317,0.975173970283995,8235,30992,291,244,84,1167,13,247,84,13
"740","2020-04-11",198,9,23,698,5317,0.975173970283995,8235,30992,291,244,109,1276,9,256,104,9
"741","2020-04-12",193,9,37,754,5317,0.975173970283995,8235,30992,291,244,104,1380,7,263,104,7
"742","2020-04-13",206,9,49,811,5317,0.975173970283995,8235,30992,291,244,110,1490,1,264,109,1
"743","2020-04-14",206,9,49,874,5317,0.975173970283995,8235,30992,291,244,84,1574,16,280,84,16
"744","2020-04-15",218,9,49,925,5317,0.975173970283995,8235,30992,291,244,102,1676,9,289,99,9
"745","2020-04-16",230,9,45,993,5317,0.975173970283995,8235,30992,291,244,104,1780,12,301,102,12
"746","2020-04-17",261,9,56,1043,5317,0.975173970283995,8235,30992,291,244,124,1904,13,314,124,13
"747","2020-04-18",291,9,53,1108,5317,0.975173970283995,8235,30992,291,244,113,2017,3,317,110,3
"748","2020-04-19",339,9,41,1181,5317,0.975173970283995,8235,30992,291,244,126,2143,3,320,124,3
"749","2020-04-20",352,9,40,1199,5317,0.975173970283995,8235,30992,291,244,97,2240,3,323,96,3
"750","2020-04-21",354,9,44,1237,5317,0.975173970283995,8235,30992,291,244,100,2340,3,326,98,3
"751","2020-04-22",370,9,41,1261,5317,0.975173970283995,8235,30992,291,244,110,2450,5,331,108,5
"752","2020-04-23",384,9,41,1304,5317,0.975173970283995,8235,30992,291,244,113,2563,20,351,110,20
"753","2020-04-24",488,9,41,1336,5317,0.975173970283995,8235,30992,291,244,130,2693,17,368,129,17
"754","2020-04-25",479,9,43,1366,5317,0.975173970283995,8235,30992,291,244,123,2816,15,383,119,15
"755","2020-04-26",438,9,54,1367,5317,0.975173970283995,8235,30992,291,244,103,2919,9,392,102,9
"756","2020-04-27",444,9,65,1381,5317,0.975173970283995,8235,30992,291,244,107,3026,5,397,107,5
"757","2020-04-28",450,9,79,1384,5317,0.975173970283995,8235,30992,291,244,129,3155,5,402,129,5
"758","2020-04-29",458,9,62,1399,5317,0.975173970283995,8235,30992,291,244,111,3266,9,411,110,9
"759","2020-04-30",463,9,63,1409,5317,0.975173970283995,8235,30992,291,244,106,3372,13,424,106,13
"760","2020-05-01",487,9,56,1409,5317,0.975173970283995,8235,30992,291,244,110,3482,23,447,108,23
"761","2020-05-02",496,9,57,1399,5317,0.975173970283995,8235,30992,291,244,120,3602,7,454,118,7
"762","2020-05-03",449,9,58,1401,5317,0.975173970283995,8235,30992,291,244,78,3680,7,461,76,7
"763","2020-05-04",434,9,53,1359,5317,0.975173970283995,8235,30992,291,244,93,3773,12,473,92,12
"764","2020-05-05",436,9,47,1328,5317,0.975173970283995,8235,30992,291,244,82,3855,8,481,79,8
"765","2020-05-06",447,9,59,1303,5317,0.975173970283995,8235,30992,291,244,88,3943,11,492,87,11
"766","2020-05-07",449,9,55,1279,5317,0.975173970283995,8235,30992,291,244,69,4012,14,506,68,14
"767","2020-05-08",432,9,54,1235,5317,0.975173970283995,8235,30992,291,244,73,4085,20,526,72,20
"768","2020-05-09",412,9,75,1198,5317,0.975173970283995,8235,30992,291,244,114,4199,11,537,113,11
"769","2020-05-10",417,9,72,1129,5317,0.975173970283995,8235,30992,291,244,41,4240,9,546,40,9
"770","2020-05-11",424,9,68,1071,5317,0.975173970283995,8235,30992,291,244,75,4315,7,553,75,7
"771","2020-05-12",403,9,72,1028,5317,0.975173970283995,8235,30992,291,244,61,4376,11,564,59,11
"772","2020-05-13",383,9,61,986,5317,0.975173970283995,8235,30992,291,244,55,4431,24,588,54,24
"773","2020-05-14",356,9,66,920,5317,0.975173970283995,8235,30992,291,244,54,4485,24,612,54,24
"774","2020-05-15",365,9,61,842,5317,0.975173970283995,8235,30992,291,244,56,4541,14,626,56,14
"775","2020-05-16",362,9,59,779,5317,0.975173970283995,8235,30992,291,244,61,4602,14,640,60,14
"776","2020-05-17",327,9,72,723,5317,0.975173970283995,8235,30992,291,244,39,4641,11,651,39,11
"777","2020-05-18",315,9,70,697,5317,0.975173970283995,8235,30992,291,244,35,4676,10,661,34,10
"778","2020-05-19",289,9,65,643,5317,0.975173970283995,8235,30992,291,244,36,4712,7,668,34,7
"779","2020-05-20",271,9,78,599,5317,0.975173970283995,8235,30992,291,244,37,4749,8,676,36,8
"780","2020-05-21",277,9,74,559,5317,0.975173970283995,8235,30992,291,244,22,4771,5,681,21,5
"781","2020-05-22",245,9,81,513,5317,0.975173970283995,8235,30992,291,244,31,4802,2,683,29,2
"782","2020-05-23",238,9,84,470,5317,0.975173970283995,8235,30992,291,244,19,4821,11,694,19,11
"783","2020-05-24",203,9,85,435,5317,0.975173970283995,8235,30992,291,244,28,4849,2,696,28,2
"784","2020-05-25",181,9,84,417,5317,0.975173970283995,8235,30992,291,244,19,4868,9,705,19,9
"785","2020-05-26",163,9,77,386,5317,0.975173970283995,8235,30992,291,244,18,4886,13,718,18,13
"786","2020-05-27",150,9,64,358,5317,0.975173970283995,8235,30992,291,244,23,4909,13,731,23,13
"787","2020-05-28",134,9,58,329,5317,0.975173970283995,8235,30992,291,244,22,4931,3,734,22,3
"788","2020-05-29",115,9,46,305,5317,0.975173970283995,8235,30992,291,244,22,4953,8,742,22,8
"789","2020-05-30",111,9,41,283,5317,0.975173970283995,8235,30992,291,244,17,4970,3,745,16,3
"790","2020-05-31",98,9,33,271,5317,0.975173970283995,8235,30992,291,244,11,4981,9,754,11,9
"791","2020-06-01",99,9,25,245,5317,0.975173970283995,8235,30992,291,244,13,4994,16,770,13,16
"792","2020-06-02",95,9,24,228,5317,0.975173970283995,8235,30992,291,244,17,5011,11,781,17,11
"793","2020-06-03",96,9,24,209,5317,0.975173970283995,8235,30992,291,244,10,5021,5,786,9,5
"794","2020-06-04",93,9,30,191,5317,0.975173970283995,8235,30992,291,244,12,5033,9,795,12,9
"795","2020-06-05",81,9,27,179,5317,0.975173970283995,8235,30992,291,244,7,5040,13,808,7,13
"796","2020-06-06",70,9,28,155,5317,0.975173970283995,8235,30992,291,244,8,5048,5,813,8,5
"797","2020-06-07",63,9,35,136,5317,0.975173970283995,8235,30992,291,244,11,5059,4,817,11,4
"798","2020-03-15",1,10,26,12,5297,0.967717575986407,8460,31405,293,317,5,27,10,36,2,10
"799","2020-03-16",1,10,21,19,5297,0.967717575986407,8460,31405,293,317,11,38,11,47,8,11
"800","2020-03-17",1,10,16,24,5297,0.967717575986407,8460,31405,293,317,19,57,7,54,12,7
"801","2020-03-18",1,10,16,27,5297,0.967717575986407,8460,31405,293,317,15,72,5,59,9,5
"802","2020-03-19",3,10,15,29,5297,0.967717575986407,8460,31405,293,317,13,85,NA,NA,8,NA
"803","2020-03-20",4,10,16,35,5297,0.967717575986407,8460,31405,293,317,11,96,6,65,8,6
"804","2020-03-21",10,10,18,46,5297,0.967717575986407,8460,31405,293,317,17,113,3,68,14,3
"805","2020-03-22",12,10,17,59,5297,0.967717575986407,8460,31405,293,317,18,131,3,71,14,3
"806","2020-03-23",10,10,18,71,5297,0.967717575986407,8460,31405,293,317,15,146,2,73,10,2
"807","2020-03-24",13,10,22,87,5297,0.967717575986407,8460,31405,293,317,19,165,NA,NA,14,NA
"808","2020-03-25",16,10,27,98,5297,0.967717575986407,8460,31405,293,317,28,193,3,76,22,3
"809","2020-03-26",19,10,36,108,5297,0.967717575986407,8460,31405,293,317,20,213,1,77,16,1
"810","2020-03-27",27,10,39,136,5297,0.967717575986407,8460,31405,293,317,21,234,6,83,18,6
"811","2020-03-28",33,10,50,161,5297,0.967717575986407,8460,31405,293,317,38,272,6,89,31,6
"812","2020-03-29",37,10,56,181,5297,0.967717575986407,8460,31405,293,317,37,309,8,97,34,8
"813","2020-03-30",39,10,54,205,5297,0.967717575986407,8460,31405,293,317,36,345,8,105,32,8
"814","2020-03-31",42,10,50,228,5297,0.967717575986407,8460,31405,293,317,47,392,5,110,36,5
"815","2020-04-01",50,10,52,263,5297,0.967717575986407,8460,31405,293,317,39,431,6,116,34,6
"816","2020-04-02",61,10,48,298,5297,0.967717575986407,8460,31405,293,317,45,476,2,118,35,2
"817","2020-04-03",80,10,54,342,5297,0.967717575986407,8460,31405,293,317,53,529,12,130,46,12
"818","2020-04-04",85,10,64,371,5297,0.967717575986407,8460,31405,293,317,41,570,5,135,37,5
"819","2020-04-05",98,10,72,407,5297,0.967717575986407,8460,31405,293,317,68,638,5,140,60,5
"820","2020-04-06",109,10,64,421,5297,0.967717575986407,8460,31405,293,317,57,695,3,143,47,3
"821","2020-04-07",115,10,59,460,5297,0.967717575986407,8460,31405,293,317,76,771,2,145,67,2
"822","2020-04-08",120,10,66,492,5297,0.967717575986407,8460,31405,293,317,52,823,4,149,42,4
"823","2020-04-09",128,10,57,534,5297,0.967717575986407,8460,31405,293,317,68,891,10,159,57,10
"824","2020-04-10",171,10,67,567,5297,0.967717575986407,8460,31405,293,317,58,949,9,168,55,9
"825","2020-04-11",229,10,73,615,5297,0.967717575986407,8460,31405,293,317,79,1028,13,181,73,13
"826","2020-04-12",210,10,67,664,5297,0.967717575986407,8460,31405,293,317,66,1094,6,187,61,6
"827","2020-04-13",192,10,61,695,5297,0.967717575986407,8460,31405,293,317,65,1159,10,197,57,10
"828","2020-04-14",193,10,86,725,5297,0.967717575986407,8460,31405,293,317,64,1223,10,207,53,10
"829","2020-04-15",203,10,93,750,5297,0.967717575986407,8460,31405,293,317,64,1287,13,220,59,13
"830","2020-04-16",199,10,98,800,5297,0.967717575986407,8460,31405,293,317,67,1354,13,233,60,13
"831","2020-04-17",255,10,89,853,5297,0.967717575986407,8460,31405,293,317,46,1400,16,249,43,16
"832","2020-04-18",252,10,101,911,5297,0.967717575986407,8460,31405,293,317,77,1477,16,265,67,16
"833","2020-04-19",254,10,97,960,5297,0.967717575986407,8460,31405,293,317,82,1559,11,276,77,11
"834","2020-04-20",260,10,122,1002,5297,0.967717575986407,8460,31405,293,317,68,1627,8,284,64,8
"835","2020-04-21",281,10,101,1054,5297,0.967717575986407,8460,31405,293,317,79,1706,4,288,70,4
"836","2020-04-22",305,10,114,1102,5297,0.967717575986407,8460,31405,293,317,72,1778,3,291,68,3
"837","2020-04-23",315,10,112,1187,5297,0.967717575986407,8460,31405,293,317,69,1847,2,293,63,2
"838","2020-04-24",339,10,112,1234,5297,0.967717575986407,8460,31405,293,317,54,1901,3,296,49,3
"839","2020-04-25",368,10,113,1273,5297,0.967717575986407,8460,31405,293,317,58,1959,6,302,48,6
"840","2020-04-26",389,10,119,1300,5297,0.967717575986407,8460,31405,293,317,72,2031,10,312,66,10
"841","2020-04-27",393,10,106,1327,5297,0.967717575986407,8460,31405,293,317,64,2095,7,319,54,7
"842","2020-04-28",393,10,111,1355,5297,0.967717575986407,8460,31405,293,317,66,2161,2,321,60,2
"843","2020-04-29",395,10,108,1419,5297,0.967717575986407,8460,31405,293,317,66,2227,1,322,62,1
"844","2020-04-30",421,10,104,1401,5297,0.967717575986407,8460,31405,293,317,64,2291,6,328,61,6
"845","2020-05-01",497,10,103,1389,5297,0.967717575986407,8460,31405,293,317,64,2355,1,329,57,1
"846","2020-05-02",475,10,108,1424,5297,0.967717575986407,8460,31405,293,317,69,2424,6,335,61,6
"847","2020-05-03",473,10,120,1444,5297,0.967717575986407,8460,31405,293,317,75,2499,5,340,67,5
"848","2020-05-04",480,10,124,1443,5297,0.967717575986407,8460,31405,293,317,60,2559,12,352,52,12
"849","2020-05-05",480,10,127,1438,5297,0.967717575986407,8460,31405,293,317,53,2612,12,364,47,12
"850","2020-05-06",479,10,120,1379,5297,0.967717575986407,8460,31405,293,317,59,2671,9,373,53,9
"851","2020-05-07",486,10,115,1363,5297,0.967717575986407,8460,31405,293,317,58,2729,6,379,54,6
"852","2020-05-08",492,10,112,1309,5297,0.967717575986407,8460,31405,293,317,51,2780,9,388,46,9
"853","2020-05-09",512,10,108,1279,5297,0.967717575986407,8460,31405,293,317,49,2829,8,396,43,8
"854","2020-05-10",445,10,109,1224,5297,0.967717575986407,8460,31405,293,317,64,2893,13,409,55,13
"855","2020-05-11",429,10,113,1173,5297,0.967717575986407,8460,31405,293,317,48,2941,12,421,44,12
"856","2020-05-12",424,10,105,1126,5297,0.967717575986407,8460,31405,293,317,61,3002,11,432,57,11
"857","2020-05-13",422,10,99,1069,5297,0.967717575986407,8460,31405,293,317,41,3043,16,448,37,16
"858","2020-05-14",401,10,89,1025,5297,0.967717575986407,8460,31405,293,317,45,3088,9,457,39,9
"859","2020-05-15",371,10,92,967,5297,0.967717575986407,8460,31405,293,317,40,3128,16,473,34,16
"860","2020-05-16",372,10,102,896,5297,0.967717575986407,8460,31405,293,317,32,3160,8,481,29,8
"861","2020-05-17",345,10,97,842,5297,0.967717575986407,8460,31405,293,317,44,3204,5,486,41,5
"862","2020-05-18",335,10,91,774,5297,0.967717575986407,8460,31405,293,317,42,3246,2,488,37,2
"863","2020-05-19",309,10,81,741,5297,0.967717575986407,8460,31405,293,317,35,3281,NA,NA,30,NA
"864","2020-05-20",282,10,70,696,5297,0.967717575986407,8460,31405,293,317,42,3323,8,496,37,8
"865","2020-05-21",265,10,78,642,5297,0.967717575986407,8460,31405,293,317,42,3365,10,506,35,10
"866","2020-05-22",253,10,75,605,5297,0.967717575986407,8460,31405,293,317,36,3401,15,521,31,15
"867","2020-05-23",244,10,68,560,5297,0.967717575986407,8460,31405,293,317,36,3437,11,532,32,11
"868","2020-05-24",224,10,62,508,5297,0.967717575986407,8460,31405,293,317,36,3473,6,538,31,6
"869","2020-05-25",206,10,60,470,5297,0.967717575986407,8460,31405,293,317,31,3504,6,544,25,6
"870","2020-05-26",200,10,57,445,5297,0.967717575986407,8460,31405,293,317,28,3532,1,545,24,1
"871","2020-05-27",197,10,53,423,5297,0.967717575986407,8460,31405,293,317,39,3571,4,549,36,4
"872","2020-05-28",196,10,52,391,5297,0.967717575986407,8460,31405,293,317,21,3592,4,553,17,4
"873","2020-05-29",172,10,52,370,5297,0.967717575986407,8460,31405,293,317,22,3614,12,565,22,12
"874","2020-05-30",157,10,55,334,5297,0.967717575986407,8460,31405,293,317,24,3638,4,569,20,4
"875","2020-05-31",148,10,48,317,5297,0.967717575986407,8460,31405,293,317,30,3668,3,572,28,3
"876","2020-06-01",140,10,45,291,5297,0.967717575986407,8460,31405,293,317,20,3688,1,573,17,1
"877","2020-06-02",128,10,49,271,5297,0.967717575986407,8460,31405,293,317,16,3704,2,575,14,2
"878","2020-06-03",121,10,52,260,5297,0.967717575986407,8460,31405,293,317,19,3723,8,583,18,8
"879","2020-06-04",107,10,41,235,5297,0.967717575986407,8460,31405,293,317,18,3741,NA,NA,15,NA
"880","2020-06-05",104,10,35,221,5297,0.967717575986407,8460,31405,293,317,20,3761,6,589,19,6
"881","2020-06-06",87,10,45,218,5297,0.967717575986407,8460,31405,293,317,23,3784,5,594,21,5
"882","2020-06-07",81,10,44,195,5297,0.967717575986407,8460,31405,293,317,13,3797,5,599,13,5
"883","2020-03-13",1,11,33,29,5419,0.892231038937073,8415,32425,290,319,14,34,15,26,2,15
"884","2020-03-14",5,11,36,38,5419,0.892231038937073,8415,32425,290,319,15,49,6,32,4,6
"885","2020-03-15",5,11,32,53,5419,0.892231038937073,8415,32425,290,319,18,67,15,47,7,15
"886","2020-03-16",6,11,38,75,5419,0.892231038937073,8415,32425,290,319,9,76,19,66,3,19
"887","2020-03-17",8,11,31,93,5419,0.892231038937073,8415,32425,290,319,23,99,12,78,15,12
"888","2020-03-18",10,11,22,113,5419,0.892231038937073,8415,32425,290,319,20,119,22,100,9,22
"889","2020-03-19",15,11,24,128,5419,0.892231038937073,8415,32425,290,319,35,154,21,121,25,21
"890","2020-03-20",28,11,14,148,5419,0.892231038937073,8415,32425,290,319,21,175,14,135,11,14
"891","2020-03-21",33,11,15,182,5419,0.892231038937073,8415,32425,290,319,33,208,15,150,19,15
"892","2020-03-22",42,11,13,203,5419,0.892231038937073,8415,32425,290,319,26,234,19,169,20,19
"893","2020-03-23",45,11,13,236,5419,0.892231038937073,8415,32425,290,319,23,257,18,187,15,18
"894","2020-03-24",50,11,16,258,5419,0.892231038937073,8415,32425,290,319,35,292,20,207,27,20
"895","2020-03-25",58,11,23,293,5419,0.892231038937073,8415,32425,290,319,49,341,21,228,35,21
"896","2020-03-26",64,11,36,330,5419,0.892231038937073,8415,32425,290,319,32,373,18,246,25,18
"897","2020-03-27",74,11,37,368,5419,0.892231038937073,8415,32425,290,319,51,424,29,275,41,29
"898","2020-03-28",83,11,38,413,5419,0.892231038937073,8415,32425,290,319,43,467,29,304,32,29
"899","2020-03-29",91,11,41,447,5419,0.892231038937073,8415,32425,290,319,42,509,24,328,32,24
"900","2020-03-30",94,11,52,488,5419,0.892231038937073,8415,32425,290,319,41,550,25,353,31,25
"901","2020-03-31",103,11,51,530,5419,0.892231038937073,8415,32425,290,319,59,609,31,384,43,31
"902","2020-04-01",111,11,53,560,5419,0.892231038937073,8415,32425,290,319,45,654,27,411,35,27
"903","2020-04-02",125,11,52,618,5419,0.892231038937073,8415,32425,290,319,56,710,23,434,43,23
"904","2020-04-03",172,11,66,709,5419,0.892231038937073,8415,32425,290,319,69,779,22,456,54,22
"905","2020-04-04",201,11,67,751,5419,0.892231038937073,8415,32425,290,319,54,833,26,482,42,26
"906","2020-04-05",203,11,64,813,5419,0.892231038937073,8415,32425,290,319,53,886,12,494,39,12
"907","2020-04-06",220,11,52,852,5419,0.892231038937073,8415,32425,290,319,52,938,29,523,45,29
"908","2020-04-07",234,11,53,913,5419,0.892231038937073,8415,32425,290,319,58,996,31,554,41,31
"909","2020-04-08",248,11,48,960,5419,0.892231038937073,8415,32425,290,319,64,1060,28,582,54,28
"910","2020-04-09",258,11,46,1008,5419,0.892231038937073,8415,32425,290,319,52,1112,36,618,37,36
"911","2020-04-10",334,11,47,1054,5419,0.892231038937073,8415,32425,290,319,61,1173,34,652,52,34
"912","2020-04-11",337,11,54,1108,5419,0.892231038937073,8415,32425,290,319,64,1237,38,690,46,38
"913","2020-04-12",337,11,51,1179,5419,0.892231038937073,8415,32425,290,319,80,1317,27,717,65,27
"914","2020-04-13",352,11,58,1213,5419,0.892231038937073,8415,32425,290,319,69,1386,38,755,59,38
"915","2020-04-14",345,11,70,1263,5419,0.892231038937073,8415,32425,290,319,48,1434,39,794,33,39
"916","2020-04-15",354,11,83,1307,5419,0.892231038937073,8415,32425,290,319,70,1504,58,852,59,58
"917","2020-04-16",377,11,92,1365,5419,0.892231038937073,8415,32425,290,319,65,1569,25,877,52,25
"918","2020-04-17",462,11,79,1383,5419,0.892231038937073,8415,32425,290,319,55,1624,33,910,46,33
"919","2020-04-18",482,11,69,1409,5419,0.892231038937073,8415,32425,290,319,54,1678,32,942,42,32
"920","2020-04-19",463,11,67,1386,5419,0.892231038937073,8415,32425,290,319,53,1731,31,973,40,31
"921","2020-04-20",459,11,72,1411,5419,0.892231038937073,8415,32425,290,319,75,1806,26,999,64,26
"922","2020-04-21",461,11,76,1391,5419,0.892231038937073,8415,32425,290,319,72,1878,44,1043,62,44
"923","2020-04-22",462,11,86,1390,5419,0.892231038937073,8415,32425,290,319,41,1919,38,1081,27,38
"924","2020-04-23",448,11,96,1409,5419,0.892231038937073,8415,32425,290,319,47,1966,46,1127,34,46
"925","2020-04-24",465,11,92,1379,5419,0.892231038937073,8415,32425,290,319,61,2027,28,1155,47,28
"926","2020-04-25",470,11,88,1327,5419,0.892231038937073,8415,32425,290,319,56,2083,24,1179,41,24
"927","2020-04-26",439,11,83,1314,5419,0.892231038937073,8415,32425,290,319,51,2134,21,1200,44,21
"928","2020-04-27",450,11,92,1314,5419,0.892231038937073,8415,32425,290,319,59,2193,31,1231,50,31
"929","2020-04-28",453,11,73,1237,5419,0.892231038937073,8415,32425,290,319,41,2234,22,1253,33,22
"930","2020-04-29",449,11,79,1202,5419,0.892231038937073,8415,32425,290,319,52,2286,27,1280,40,27
"931","2020-04-30",442,11,82,1157,5419,0.892231038937073,8415,32425,290,319,43,2329,28,1308,34,28
"932","2020-05-01",425,11,82,1145,5419,0.892231038937073,8415,32425,290,319,52,2381,28,1336,41,28
"933","2020-05-02",424,11,72,1110,5419,0.892231038937073,8415,32425,290,319,43,2424,39,1375,29,39
"934","2020-05-03",395,11,66,1090,5419,0.892231038937073,8415,32425,290,319,58,2482,25,1400,43,25
"935","2020-05-04",371,11,56,1057,5419,0.892231038937073,8415,32425,290,319,39,2521,28,1428,34,28
"936","2020-05-05",343,11,58,1029,5419,0.892231038937073,8415,32425,290,319,46,2567,41,1469,34,41
"937","2020-05-06",343,11,61,966,5419,0.892231038937073,8415,32425,290,319,44,2611,34,1503,32,34
"938","2020-05-07",341,11,68,924,5419,0.892231038937073,8415,32425,290,319,50,2661,53,1556,44,53
"939","2020-05-08",351,11,75,883,5419,0.892231038937073,8415,32425,290,319,34,2695,42,1598,27,42
"940","2020-05-09",341,11,81,837,5419,0.892231038937073,8415,32425,290,319,36,2731,30,1628,28,30
"941","2020-05-10",325,11,65,798,5419,0.892231038937073,8415,32425,290,319,36,2767,24,1652,28,24
"942","2020-05-11",309,11,62,741,5419,0.892231038937073,8415,32425,290,319,33,2800,29,1681,25,29
"943","2020-05-12",292,11,63,681,5419,0.892231038937073,8415,32425,290,319,55,2855,40,1721,39,40
"944","2020-05-13",272,11,65,649,5419,0.892231038937073,8415,32425,290,319,35,2890,32,1753,23,32
"945","2020-05-14",259,11,66,627,5419,0.892231038937073,8415,32425,290,319,48,2938,24,1777,37,24
"946","2020-05-15",223,11,75,572,5419,0.892231038937073,8415,32425,290,319,41,2979,25,1802,32,25
"947","2020-05-16",214,11,79,531,5419,0.892231038937073,8415,32425,290,319,36,3015,35,1837,28,35
"948","2020-05-17",194,11,75,497,5419,0.892231038937073,8415,32425,290,319,41,3056,36,1873,28,36
"949","2020-05-18",182,11,65,466,5419,0.892231038937073,8415,32425,290,319,33,3089,31,1904,24,31
"950","2020-05-19",173,11,54,438,5419,0.892231038937073,8415,32425,290,319,39,3128,15,1919,32,15
"951","2020-05-20",174,11,59,407,5419,0.892231038937073,8415,32425,290,319,36,3164,14,1933,28,14
"952","2020-05-21",170,11,59,372,5419,0.892231038937073,8415,32425,290,319,44,3208,13,1946,33,13
"953","2020-05-22",160,11,64,350,5419,0.892231038937073,8415,32425,290,319,33,3241,19,1965,29,19
"954","2020-05-23",146,11,52,329,5419,0.892231038937073,8415,32425,290,319,29,3270,27,1992,25,27
"955","2020-05-24",139,11,55,307,5419,0.892231038937073,8415,32425,290,319,32,3302,19,2011,28,19
"956","2020-05-25",130,11,61,286,5419,0.892231038937073,8415,32425,290,319,25,3327,24,2035,21,24
"957","2020-05-26",120,11,68,247,5419,0.892231038937073,8415,32425,290,319,27,3354,30,2065,21,30
"958","2020-05-27",112,11,50,228,5419,0.892231038937073,8415,32425,290,319,25,3379,18,2083,21,18
"959","2020-05-28",107,11,45,213,5419,0.892231038937073,8415,32425,290,319,21,3400,12,2095,16,12
"960","2020-05-29",87,11,43,189,5419,0.892231038937073,8415,32425,290,319,22,3422,25,2120,16,25
"961","2020-05-30",83,11,37,167,5419,0.892231038937073,8415,32425,290,319,23,3445,33,2153,16,33
"962","2020-05-31",72,11,46,153,5419,0.892231038937073,8415,32425,290,319,18,3463,21,2174,14,21
"963","2020-06-01",63,11,52,131,5419,0.892231038937073,8415,32425,290,319,20,3483,24,2198,12,24
"964","2020-06-02",59,11,62,118,5419,0.892231038937073,8415,32425,290,319,19,3502,22,2220,13,22
"965","2020-06-03",55,11,63,112,5419,0.892231038937073,8415,32425,290,319,23,3525,30,2250,18,30
"966","2020-06-04",48,11,58,97,5419,0.892231038937073,8415,32425,290,319,21,3546,27,2277,16,27
"967","2020-06-05",53,11,50,89,5419,0.892231038937073,8415,32425,290,319,17,3563,29,2306,13,29
"968","2020-06-06",52,11,48,79,5419,0.892231038937073,8415,32425,290,319,22,3585,24,2330,17,24
"969","2020-06-07",38,11,50,68,5419,0.892231038937073,8415,32425,290,319,19,3604,18,2348,14,18
"970","2020-03-08",1,12,0,0,2541,0.638724911452184,8310,22046,156,295,NA,NA,NA,NA,NA,NA
"971","2020-03-09",1,12,0,0,2541,0.638724911452184,8310,22046,156,295,NA,NA,NA,NA,NA,NA
"972","2020-03-10",0,12,0,0,2541,0.638724911452184,8310,22046,156,295,NA,NA,1,1,NA,1
"973","2020-03-11",0,12,0,0,2541,0.638724911452184,8310,22046,156,295,4,4,2,3,NA,2
"974","2020-03-12",0,12,0,0,2541,0.638724911452184,8310,22046,156,295,8,12,8,11,3,8
"975","2020-03-13",1,12,20,28,2541,0.638724911452184,8310,22046,156,295,11,23,6,17,3,6
"976","2020-03-14",2,12,19,37,2541,0.638724911452184,8310,22046,156,295,3,26,5,22,1,5
"977","2020-03-15",3,12,23,56,2541,0.638724911452184,8310,22046,156,295,4,30,5,27,2,5
"978","2020-03-16",2,12,21,68,2541,0.638724911452184,8310,22046,156,295,9,39,3,30,3,3
"979","2020-03-17",6,12,16,80,2541,0.638724911452184,8310,22046,156,295,8,47,3,33,2,3
"980","2020-03-18",10,12,23,94,2541,0.638724911452184,8310,22046,156,295,8,55,6,39,4,6
"981","2020-03-19",17,12,25,108,2541,0.638724911452184,8310,22046,156,295,12,67,15,54,8,15
"982","2020-03-20",22,12,26,123,2541,0.638724911452184,8310,22046,156,295,8,75,14,68,5,14
"983","2020-03-21",33,12,22,130,2541,0.638724911452184,8310,22046,156,295,11,86,16,84,8,16
"984","2020-03-22",37,12,16,142,2541,0.638724911452184,8310,22046,156,295,14,100,13,97,12,13
"985","2020-03-23",38,12,15,168,2541,0.638724911452184,8310,22046,156,295,12,112,15,112,7,15
"986","2020-03-24",38,12,20,179,2541,0.638724911452184,8310,22046,156,295,13,125,7,119,10,7
"987","2020-03-25",40,12,21,184,2541,0.638724911452184,8310,22046,156,295,21,146,7,126,14,7
"988","2020-03-26",39,12,30,197,2541,0.638724911452184,8310,22046,156,295,11,157,3,129,9,3
"989","2020-03-27",48,12,38,203,2541,0.638724911452184,8310,22046,156,295,20,177,4,133,16,4
"990","2020-03-28",46,12,33,228,2541,0.638724911452184,8310,22046,156,295,17,194,9,142,9,9
"991","2020-03-29",60,12,28,245,2541,0.638724911452184,8310,22046,156,295,22,216,9,151,18,9
"992","2020-03-30",64,12,37,256,2541,0.638724911452184,8310,22046,156,295,14,230,12,163,13,12
"993","2020-03-31",73,12,37,274,2541,0.638724911452184,8310,22046,156,295,26,256,14,177,20,14
"994","2020-04-01",78,12,28,293,2541,0.638724911452184,8310,22046,156,295,19,275,8,185,16,8
"995","2020-04-02",78,12,28,302,2541,0.638724911452184,8310,22046,156,295,28,303,7,192,21,7
"996","2020-04-03",88,12,34,308,2541,0.638724911452184,8310,22046,156,295,27,330,5,197,22,5
"997","2020-04-04",101,12,32,322,2541,0.638724911452184,8310,22046,156,295,18,348,4,201,14,4
"998","2020-04-05",89,12,33,338,2541,0.638724911452184,8310,22046,156,295,21,369,4,205,18,4
"999","2020-04-06",97,12,30,326,2541,0.638724911452184,8310,22046,156,295,22,391,10,215,18,10
"1000","2020-04-07",96,12,35,337,2541,0.638724911452184,8310,22046,156,295,21,412,7,222,16,7
"1001","2020-04-08",98,12,48,339,2541,0.638724911452184,8310,22046,156,295,38,450,8,230,32,8
"1002","2020-04-09",118,12,52,345,2541,0.638724911452184,8310,22046,156,295,41,491,6,236,32,6
"1003","2020-04-10",131,12,56,340,2541,0.638724911452184,8310,22046,156,295,29,520,7,243,25,7
"1004","2020-04-11",146,12,65,342,2541,0.638724911452184,8310,22046,156,295,24,544,11,254,21,11
"1005","2020-04-12",140,12,73,337,2541,0.638724911452184,8310,22046,156,295,30,574,6,260,22,6
"1006","2020-04-13",127,12,77,333,2541,0.638724911452184,8310,22046,156,295,34,608,5,265,28,5
"1007","2020-04-14",122,12,75,340,2541,0.638724911452184,8310,22046,156,295,40,648,7,272,33,7
"1008","2020-04-15",122,12,78,337,2541,0.638724911452184,8310,22046,156,295,35,683,5,277,27,5
"1009","2020-04-16",109,12,72,337,2541,0.638724911452184,8310,22046,156,295,39,722,9,286,30,9
"1010","2020-04-17",112,12,72,342,2541,0.638724911452184,8310,22046,156,295,31,753,12,298,24,12
"1011","2020-04-18",107,12,61,335,2541,0.638724911452184,8310,22046,156,295,41,794,7,305,29,7
"1012","2020-04-19",110,12,70,349,2541,0.638724911452184,8310,22046,156,295,32,826,11,316,28,11
"1013","2020-04-20",111,12,81,340,2541,0.638724911452184,8310,22046,156,295,40,866,8,324,33,8
"1014","2020-04-21",107,12,98,331,2541,0.638724911452184,8310,22046,156,295,42,908,7,331,38,7
"1015","2020-04-22",109,12,89,331,2541,0.638724911452184,8310,22046,156,295,28,936,7,338,23,7
"1016","2020-04-23",103,12,93,349,2541,0.638724911452184,8310,22046,156,295,40,976,5,343,33,5
"1017","2020-04-24",107,12,95,346,2541,0.638724911452184,8310,22046,156,295,74,1050,3,346,69,3
"1018","2020-04-25",119,12,91,345,2541,0.638724911452184,8310,22046,156,295,44,1094,3,349,36,3
"1019","2020-04-26",115,12,100,356,2541,0.638724911452184,8310,22046,156,295,49,1143,15,364,43,15
"1020","2020-04-27",110,12,102,348,2541,0.638724911452184,8310,22046,156,295,32,1175,18,382,28,18
"1021","2020-04-28",117,12,103,359,2541,0.638724911452184,8310,22046,156,295,48,1223,7,389,46,7
"1022","2020-04-29",111,12,100,357,2541,0.638724911452184,8310,22046,156,295,47,1270,9,398,44,9
"1023","2020-04-30",113,12,97,362,2541,0.638724911452184,8310,22046,156,295,46,1316,14,412,40,14
"1024","2020-05-01",120,12,100,386,2541,0.638724911452184,8310,22046,156,295,50,1366,11,423,48,11
"1025","2020-05-02",116,12,98,384,2541,0.638724911452184,8310,22046,156,295,45,1411,5,428,38,5
"1026","2020-05-03",103,12,102,377,2541,0.638724911452184,8310,22046,156,295,33,1444,13,441,29,13
"1027","2020-05-04",105,12,101,399,2541,0.638724911452184,8310,22046,156,295,39,1483,7,448,33,7
"1028","2020-05-05",105,12,115,398,2541,0.638724911452184,8310,22046,156,295,49,1532,17,465,46,17
"1029","2020-05-06",113,12,112,400,2541,0.638724911452184,8310,22046,156,295,38,1570,5,470,30,5
"1030","2020-05-07",121,12,103,404,2541,0.638724911452184,8310,22046,156,295,44,1614,5,475,37,5
"1031","2020-05-08",127,12,88,415,2541,0.638724911452184,8310,22046,156,295,43,1657,7,482,33,7
"1032","2020-05-09",135,12,93,411,2541,0.638724911452184,8310,22046,156,295,42,1699,10,492,41,10
"1033","2020-05-10",152,12,101,411,2541,0.638724911452184,8310,22046,156,295,30,1729,2,494,26,2
"1034","2020-05-11",145,12,110,410,2541,0.638724911452184,8310,22046,156,295,42,1771,3,497,38,3
"1035","2020-05-12",144,12,93,400,2541,0.638724911452184,8310,22046,156,295,47,1818,2,499,43,2
"1036","2020-05-13",140,12,95,388,2541,0.638724911452184,8310,22046,156,295,37,1855,9,508,36,9
"1037","2020-05-14",137,12,93,394,2541,0.638724911452184,8310,22046,156,295,37,1892,3,511,31,3
"1038","2020-05-15",148,12,93,392,2541,0.638724911452184,8310,22046,156,295,29,1921,2,513,27,2
"1039","2020-05-16",140,12,81,393,2541,0.638724911452184,8310,22046,156,295,35,1956,7,520,31,7
"1040","2020-05-17",127,12,82,388,2541,0.638724911452184,8310,22046,156,295,33,1989,8,528,27,8
"1041","2020-05-18",125,12,79,401,2541,0.638724911452184,8310,22046,156,295,37,2026,2,530,34,2
"1042","2020-05-19",117,12,81,408,2541,0.638724911452184,8310,22046,156,295,43,2069,6,536,40,6
"1043","2020-05-20",120,12,80,396,2541,0.638724911452184,8310,22046,156,295,33,2102,3,539,31,3
"1044","2020-05-21",120,12,82,394,2541,0.638724911452184,8310,22046,156,295,32,2134,3,542,30,3
"1045","2020-05-22",121,12,76,375,2541,0.638724911452184,8310,22046,156,295,30,2164,13,555,29,13
"1046","2020-05-23",121,12,87,370,2541,0.638724911452184,8310,22046,156,295,27,2191,10,565,23,10
"1047","2020-05-24",125,12,83,364,2541,0.638724911452184,8310,22046,156,295,35,2226,8,573,33,8
"1048","2020-05-25",133,12,74,353,2541,0.638724911452184,8310,22046,156,295,26,2252,15,588,24,15
"1049","2020-05-26",133,12,75,341,2541,0.638724911452184,8310,22046,156,295,27,2279,17,605,25,17
"1050","2020-05-27",126,12,73,318,2541,0.638724911452184,8310,22046,156,295,26,2305,11,616,25,11
"1051","2020-05-28",125,12,70,304,2541,0.638724911452184,8310,22046,156,295,20,2325,10,626,18,10
"1052","2020-05-29",119,12,61,301,2541,0.638724911452184,8310,22046,156,295,32,2357,4,630,29,4
"1053","2020-05-30",118,12,61,296,2541,0.638724911452184,8310,22046,156,295,21,2378,9,639,20,9
"1054","2020-05-31",110,12,56,282,2541,0.638724911452184,8310,22046,156,295,27,2405,8,647,24,8
"1055","2020-06-01",100,12,64,271,2541,0.638724911452184,8310,22046,156,295,21,2426,7,654,20,7
"1056","2020-06-02",97,12,64,264,2541,0.638724911452184,8310,22046,156,295,10,2436,15,669,10,15
"1057","2020-06-03",96,12,67,254,2541,0.638724911452184,8310,22046,156,295,23,2459,12,681,21,12
"1058","2020-06-04",95,12,69,233,2541,0.638724911452184,8310,22046,156,295,23,2482,3,684,21,3
"1059","2020-06-05",91,12,74,219,2541,0.638724911452184,8310,22046,156,295,24,2506,9,693,21,9
"1060","2020-06-06",87,12,77,209,2541,0.638724911452184,8310,22046,156,295,20,2526,1,694,18,1
"1061","2020-06-07",81,12,78,191,2541,0.638724911452184,8310,22046,156,295,15,2541,9,703,15,9
"1062","2020-03-12",1,13,4,5,5155,0.953443258971872,8355,30217,287,201,5,12,3,7,NA,3
"1063","2020-03-13",2,13,5,8,5155,0.953443258971872,8355,30217,287,201,4,16,4,11,1,4
"1064","2020-03-14",2,13,10,9,5155,0.953443258971872,8355,30217,287,201,5,21,3,14,2,3
"1065","2020-03-15",2,13,18,16,5155,0.953443258971872,8355,30217,287,201,8,29,3,17,2,3
"1066","2020-03-16",2,13,24,20,5155,0.953443258971872,8355,30217,287,201,7,36,7,24,2,7
"1067","2020-03-17",2,13,27,24,5155,0.953443258971872,8355,30217,287,201,12,48,4,28,6,4
"1068","2020-03-18",3,13,27,29,5155,0.953443258971872,8355,30217,287,201,14,62,4,32,4,4
"1069","2020-03-19",4,13,31,38,5155,0.953443258971872,8355,30217,287,201,17,79,7,39,10,7
"1070","2020-03-20",5,13,29,45,5155,0.953443258971872,8355,30217,287,201,18,97,2,41,12,2
"1071","2020-03-21",10,13,38,56,5155,0.953443258971872,8355,30217,287,201,16,113,8,49,12,8
"1072","2020-03-22",13,13,46,66,5155,0.953443258971872,8355,30217,287,201,14,127,4,53,6,4
"1073","2020-03-23",16,13,44,85,5155,0.953443258971872,8355,30217,287,201,17,144,NA,NA,11,NA
"1074","2020-03-24",19,13,37,92,5155,0.953443258971872,8355,30217,287,201,30,174,3,56,23,3
"1075","2020-03-25",18,13,33,100,5155,0.953443258971872,8355,30217,287,201,24,198,2,58,11,2
"1076","2020-03-26",21,13,30,120,5155,0.953443258971872,8355,30217,287,201,23,221,3,61,17,3
"1077","2020-03-27",26,13,30,129,5155,0.953443258971872,8355,30217,287,201,25,246,4,65,20,4
"1078","2020-03-28",32,13,31,141,5155,0.953443258971872,8355,30217,287,201,41,287,10,75,32,10
"1079","2020-03-29",33,13,39,160,5155,0.953443258971872,8355,30217,287,201,32,319,14,89,23,14
"1080","2020-03-30",30,13,41,183,5155,0.953443258971872,8355,30217,287,201,34,353,10,99,24,10
"1081","2020-03-31",32,13,46,199,5155,0.953443258971872,8355,30217,287,201,38,391,11,110,33,11
"1082","2020-04-01",41,13,45,233,5155,0.953443258971872,8355,30217,287,201,45,436,6,116,39,6
"1083","2020-04-02",50,13,46,264,5155,0.953443258971872,8355,30217,287,201,34,470,7,123,24,7
"1084","2020-04-03",67,13,50,296,5155,0.953443258971872,8355,30217,287,201,45,515,1,124,37,1
"1085","2020-04-04",81,13,59,322,5155,0.953443258971872,8355,30217,287,201,38,553,8,132,29,8
"1086","2020-04-05",77,13,63,395,5155,0.953443258971872,8355,30217,287,201,56,609,9,141,53,9
"1087","2020-04-06",87,13,71,441,5155,0.953443258971872,8355,30217,287,201,47,656,9,150,41,9
"1088","2020-04-07",98,13,82,504,5155,0.953443258971872,8355,30217,287,201,68,724,16,166,57,16
"1089","2020-04-08",103,13,68,558,5155,0.953443258971872,8355,30217,287,201,54,778,7,173,43,7
"1090","2020-04-09",109,13,69,637,5155,0.953443258971872,8355,30217,287,201,47,825,10,183,37,10
"1091","2020-04-10",142,13,67,692,5155,0.953443258971872,8355,30217,287,201,87,912,7,190,75,7
"1092","2020-04-11",174,13,62,754,5155,0.953443258971872,8355,30217,287,201,49,961,11,201,37,11
"1093","2020-04-12",196,13,48,839,5155,0.953443258971872,8355,30217,287,201,54,1015,5,206,49,5
"1094","2020-04-13",207,13,51,898,5155,0.953443258971872,8355,30217,287,201,68,1083,6,212,63,6
"1095","2020-04-14",220,13,62,933,5155,0.953443258971872,8355,30217,287,201,60,1143,9,221,50,9
"1096","2020-04-15",235,13,71,994,5155,0.953443258971872,8355,30217,287,201,59,1202,9,230,52,9
"1097","2020-04-16",257,13,67,1097,5155,0.953443258971872,8355,30217,287,201,49,1251,7,237,39,7
"1098","2020-04-17",308,13,67,1165,5155,0.953443258971872,8355,30217,287,201,64,1315,13,250,58,13
"1099","2020-04-18",386,13,63,1209,5155,0.953443258971872,8355,30217,287,201,71,1386,5,255,60,5
"1100","2020-04-19",371,13,67,1275,5155,0.953443258971872,8355,30217,287,201,65,1451,2,257,56,2
"1101","2020-04-20",352,13,63,1322,5155,0.953443258971872,8355,30217,287,201,72,1523,17,274,58,17
"1102","2020-04-21",368,13,75,1365,5155,0.953443258971872,8355,30217,287,201,63,1586,8,282,56,8
"1103","2020-04-22",384,13,72,1385,5155,0.953443258971872,8355,30217,287,201,53,1639,11,293,46,11
"1104","2020-04-23",407,13,71,1451,5155,0.953443258971872,8355,30217,287,201,55,1694,9,302,51,9
"1105","2020-04-24",531,13,84,1447,5155,0.953443258971872,8355,30217,287,201,60,1754,8,310,51,8
"1106","2020-04-25",486,13,95,1449,5155,0.953443258971872,8355,30217,287,201,77,1831,7,317,65,7
"1107","2020-04-26",488,13,95,1480,5155,0.953443258971872,8355,30217,287,201,58,1889,7,324,46,7
"1108","2020-04-27",497,13,89,1467,5155,0.953443258971872,8355,30217,287,201,45,1934,10,334,38,10
"1109","2020-04-28",506,13,95,1459,5155,0.953443258971872,8355,30217,287,201,70,2004,5,339,59,5
"1110","2020-04-29",520,13,96,1450,5155,0.953443258971872,8355,30217,287,201,63,2067,10,349,55,10
"1111","2020-04-30",502,13,98,1446,5155,0.953443258971872,8355,30217,287,201,50,2117,15,364,49,15
"1112","2020-05-01",540,13,93,1409,5155,0.953443258971872,8355,30217,287,201,52,2169,14,378,46,14
"1113","2020-05-02",529,13,78,1382,5155,0.953443258971872,8355,30217,287,201,63,2232,13,391,59,13
"1114","2020-05-03",484,13,82,1335,5155,0.953443258971872,8355,30217,287,201,64,2296,8,399,60,8
"1115","2020-05-04",482,13,71,1310,5155,0.953443258971872,8355,30217,287,201,53,2349,13,412,47,13
"1116","2020-05-05",472,13,67,1297,5155,0.953443258971872,8355,30217,287,201,52,2401,10,422,45,10
"1117","2020-05-06",456,13,72,1275,5155,0.953443258971872,8355,30217,287,201,58,2459,10,432,53,10
"1118","2020-05-07",468,13,65,1232,5155,0.953443258971872,8355,30217,287,201,43,2502,7,439,35,7
"1119","2020-05-08",430,13,71,1179,5155,0.953443258971872,8355,30217,287,201,49,2551,5,444,44,5
"1120","2020-05-09",431,13,79,1122,5155,0.953443258971872,8355,30217,287,201,50,2601,9,453,42,9
"1121","2020-05-10",414,13,86,1075,5155,0.953443258971872,8355,30217,287,201,46,2647,3,456,39,3
"1122","2020-05-11",405,13,87,996,5155,0.953443258971872,8355,30217,287,201,56,2703,16,472,51,16
"1123","2020-05-12",375,13,84,944,5155,0.953443258971872,8355,30217,287,201,55,2758,11,483,48,11
"1124","2020-05-13",352,13,84,870,5155,0.953443258971872,8355,30217,287,201,41,2799,8,491,37,8
"1125","2020-05-14",327,13,82,805,5155,0.953443258971872,8355,30217,287,201,38,2837,6,497,35,6
"1126","2020-05-15",299,13,95,735,5155,0.953443258971872,8355,30217,287,201,32,2869,5,502,27,5
"1127","2020-05-16",285,13,84,680,5155,0.953443258971872,8355,30217,287,201,40,2909,4,506,35,4
"1128","2020-05-17",247,13,90,616,5155,0.953443258971872,8355,30217,287,201,38,2947,3,509,35,3
"1129","2020-05-18",240,13,74,555,5155,0.953443258971872,8355,30217,287,201,31,2978,5,514,25,5
"1130","2020-05-19",225,13,76,516,5155,0.953443258971872,8355,30217,287,201,36,3014,6,520,31,6
"1131","2020-05-20",226,13,70,472,5155,0.953443258971872,8355,30217,287,201,21,3035,9,529,17,9
"1132","2020-05-21",210,13,66,424,5155,0.953443258971872,8355,30217,287,201,42,3077,4,533,34,4
"1133","2020-05-22",181,13,64,397,5155,0.953443258971872,8355,30217,287,201,28,3105,9,542,23,9
"1134","2020-05-23",176,13,58,361,5155,0.953443258971872,8355,30217,287,201,24,3129,6,548,23,6
"1135","2020-05-24",141,13,50,328,5155,0.953443258971872,8355,30217,287,201,29,3158,9,557,25,9
"1136","2020-05-25",120,13,44,291,5155,0.953443258971872,8355,30217,287,201,25,3183,2,559,21,2
"1137","2020-05-26",111,13,42,274,5155,0.953443258971872,8355,30217,287,201,28,3211,5,564,24,5
"1138","2020-05-27",100,13,47,267,5155,0.953443258971872,8355,30217,287,201,24,3235,7,571,23,7
"1139","2020-05-28",99,13,46,241,5155,0.953443258971872,8355,30217,287,201,22,3257,1,572,19,1
"1140","2020-05-29",85,13,46,231,5155,0.953443258971872,8355,30217,287,201,23,3280,4,576,19,4
"1141","2020-05-30",77,13,39,208,5155,0.953443258971872,8355,30217,287,201,18,3298,4,580,13,4
"1142","2020-05-31",80,13,45,197,5155,0.953443258971872,8355,30217,287,201,22,3320,2,582,17,2
"1143","2020-06-01",74,13,51,184,5155,0.953443258971872,8355,30217,287,201,21,3341,2,584,17,2
"1144","2020-06-02",70,13,49,171,5155,0.953443258971872,8355,30217,287,201,20,3361,2,586,15,2
"1145","2020-06-03",63,13,50,157,5155,0.953443258971872,8355,30217,287,201,26,3387,5,591,22,5
"1146","2020-06-04",52,13,56,147,5155,0.953443258971872,8355,30217,287,201,28,3415,3,594,24,3
"1147","2020-06-05",56,13,52,141,5155,0.953443258971872,8355,30217,287,201,14,3429,3,597,13,3
"1148","2020-06-06",57,13,56,131,5155,0.953443258971872,8355,30217,287,201,12,3441,7,604,11,7
"1149","2020-06-07",50,13,56,125,5155,0.953443258971872,8355,30217,287,201,16,3457,4,608,14,4
"1150","2020-03-13",2,14,15,11,4912,0.947679153094462,8325,30317,306,331,4,17,2,8,1,2
"1151","2020-03-14",2,14,19,18,4912,0.947679153094462,8325,30317,306,331,6,23,1,9,NA,1
"1152","2020-03-15",3,14,28,22,4912,0.947679153094462,8325,30317,306,331,7,30,4,13,3,4
"1153","2020-03-16",4,14,36,27,4912,0.947679153094462,8325,30317,306,331,8,38,4,17,3,4
"1154","2020-03-17",3,14,40,35,4912,0.947679153094462,8325,30317,306,331,11,49,3,20,5,3
"1155","2020-03-18",4,14,47,41,4912,0.947679153094462,8325,30317,306,331,7,56,1,21,5,1
"1156","2020-03-19",8,14,47,48,4912,0.947679153094462,8325,30317,306,331,14,70,8,29,10,8
"1157","2020-03-20",8,14,49,64,4912,0.947679153094462,8325,30317,306,331,17,87,14,43,9,14
"1158","2020-03-21",12,14,50,81,4912,0.947679153094462,8325,30317,306,331,16,103,9,52,11,9
"1159","2020-03-22",13,14,48,102,4912,0.947679153094462,8325,30317,306,331,17,120,14,66,15,14
"1160","2020-03-23",18,14,45,111,4912,0.947679153094462,8325,30317,306,331,25,145,6,72,18,6
"1161","2020-03-24",21,14,43,143,4912,0.947679153094462,8325,30317,306,331,17,162,1,73,11,1
"1162","2020-03-25",25,14,38,162,4912,0.947679153094462,8325,30317,306,331,31,193,1,74,23,1
"1163","2020-03-26",25,14,34,184,4912,0.947679153094462,8325,30317,306,331,23,216,9,83,22,9
"1164","2020-03-27",28,14,35,209,4912,0.947679153094462,8325,30317,306,331,21,237,3,86,18,3
"1165","2020-03-28",42,14,35,240,4912,0.947679153094462,8325,30317,306,331,21,258,7,93,17,7
"1166","2020-03-29",60,14,35,260,4912,0.947679153094462,8325,30317,306,331,38,296,9,102,32,9
"1167","2020-03-30",61,14,38,289,4912,0.947679153094462,8325,30317,306,331,28,324,18,120,23,18
"1168","2020-03-31",62,14,38,315,4912,0.947679153094462,8325,30317,306,331,39,363,17,137,36,17
"1169","2020-04-01",67,14,37,340,4912,0.947679153094462,8325,30317,306,331,27,390,5,142,21,5
"1170","2020-04-02",78,14,38,380,4912,0.947679153094462,8325,30317,306,331,26,416,16,158,26,16
"1171","2020-04-03",103,14,41,422,4912,0.947679153094462,8325,30317,306,331,29,445,18,176,24,18
"1172","2020-04-04",105,14,44,467,4912,0.947679153094462,8325,30317,306,331,46,491,10,186,37,10
"1173","2020-04-05",124,14,47,504,4912,0.947679153094462,8325,30317,306,331,37,528,7,193,35,7
"1174","2020-04-06",126,14,45,560,4912,0.947679153094462,8325,30317,306,331,34,562,1,194,27,1
"1175","2020-04-07",126,14,46,604,4912,0.947679153094462,8325,30317,306,331,48,610,10,204,33,10
"1176","2020-04-08",140,14,52,656,4912,0.947679153094462,8325,30317,306,331,40,650,13,217,31,13
"1177","2020-04-09",150,14,48,709,4912,0.947679153094462,8325,30317,306,331,41,691,10,227,34,10
"1178","2020-04-10",198,14,51,773,4912,0.947679153094462,8325,30317,306,331,41,732,5,232,35,5
"1179","2020-04-11",220,14,48,832,4912,0.947679153094462,8325,30317,306,331,34,766,10,242,31,10
"1180","2020-04-12",233,14,50,851,4912,0.947679153094462,8325,30317,306,331,42,808,8,250,36,8
"1181","2020-04-13",249,14,52,910,4912,0.947679153094462,8325,30317,306,331,54,862,12,262,43,12
"1182","2020-04-14",273,14,65,980,4912,0.947679153094462,8325,30317,306,331,50,912,10,272,41,10
"1183","2020-04-15",286,14,72,1009,4912,0.947679153094462,8325,30317,306,331,35,947,15,287,34,15
"1184","2020-04-16",293,14,73,1052,4912,0.947679153094462,8325,30317,306,331,42,989,9,296,34,9
"1185","2020-04-17",350,14,81,1094,4912,0.947679153094462,8325,30317,306,331,41,1030,5,301,32,5
"1186","2020-04-18",359,14,90,1140,4912,0.947679153094462,8325,30317,306,331,55,1085,11,312,46,11
"1187","2020-04-19",355,14,91,1148,4912,0.947679153094462,8325,30317,306,331,51,1136,12,324,44,12
"1188","2020-04-20",352,14,88,1167,4912,0.947679153094462,8325,30317,306,331,55,1191,10,334,53,10
"1189","2020-04-21",332,14,91,1191,4912,0.947679153094462,8325,30317,306,331,49,1240,5,339,40,5
"1190","2020-04-22",335,14,86,1220,4912,0.947679153094462,8325,30317,306,331,49,1289,6,345,45,6
"1191","2020-04-23",340,14,82,1235,4912,0.947679153094462,8325,30317,306,331,45,1334,19,364,35,19
"1192","2020-04-24",381,14,87,1258,4912,0.947679153094462,8325,30317,306,331,48,1382,16,380,44,16
"1193","2020-04-25",384,14,85,1261,4912,0.947679153094462,8325,30317,306,331,47,1429,8,388,47,8
"1194","2020-04-26",366,14,81,1269,4912,0.947679153094462,8325,30317,306,331,39,1468,24,412,35,24
"1195","2020-04-27",379,14,81,1257,4912,0.947679153094462,8325,30317,306,331,55,1523,21,433,52,21
"1196","2020-04-28",379,14,70,1250,4912,0.947679153094462,8325,30317,306,331,52,1575,10,443,44,10
"1197","2020-04-29",385,14,63,1248,4912,0.947679153094462,8325,30317,306,331,57,1632,6,449,52,6
"1198","2020-04-30",398,14,59,1232,4912,0.947679153094462,8325,30317,306,331,51,1683,10,459,43,10
"1199","2020-05-01",419,14,64,1196,4912,0.947679153094462,8325,30317,306,331,45,1728,9,468,42,9
"1200","2020-05-02",443,14,61,1157,4912,0.947679153094462,8325,30317,306,331,39,1767,9,477,35,9
"1201","2020-05-03",434,14,56,1115,4912,0.947679153094462,8325,30317,306,331,49,1816,14,491,45,14
"1202","2020-05-04",424,14,55,1091,4912,0.947679153094462,8325,30317,306,331,52,1868,10,501,47,10
"1203","2020-05-05",423,14,65,1026,4912,0.947679153094462,8325,30317,306,331,41,1909,10,511,38,10
"1204","2020-05-06",411,14,64,999,4912,0.947679153094462,8325,30317,306,331,52,1961,15,526,45,15
"1205","2020-05-07",396,14,58,981,4912,0.947679153094462,8325,30317,306,331,45,2006,10,536,39,10
"1206","2020-05-08",386,14,62,933,4912,0.947679153094462,8325,30317,306,331,34,2040,5,541,31,5
"1207","2020-05-09",361,14,73,864,4912,0.947679153094462,8325,30317,306,331,47,2087,14,555,42,14
"1208","2020-05-10",316,14,81,824,4912,0.947679153094462,8325,30317,306,331,43,2130,10,565,39,10
"1209","2020-05-11",305,14,79,794,4912,0.947679153094462,8325,30317,306,331,41,2171,11,576,40,11
"1210","2020-05-12",285,14,82,773,4912,0.947679153094462,8325,30317,306,331,31,2202,10,586,25,10
"1211","2020-05-13",280,14,74,746,4912,0.947679153094462,8325,30317,306,331,31,2233,6,592,25,6
"1212","2020-05-14",265,14,70,701,4912,0.947679153094462,8325,30317,306,331,21,2254,9,601,18,9
"1213","2020-05-15",249,14,70,649,4912,0.947679153094462,8325,30317,306,331,25,2279,18,619,21,18
"1214","2020-05-16",262,14,63,611,4912,0.947679153094462,8325,30317,306,331,31,2310,9,628,29,9
"1215","2020-05-17",233,14,55,590,4912,0.947679153094462,8325,30317,306,331,25,2335,14,642,23,14
"1216","2020-05-18",222,14,62,550,4912,0.947679153094462,8325,30317,306,331,26,2361,10,652,23,10
"1217","2020-05-19",209,14,64,506,4912,0.947679153094462,8325,30317,306,331,19,2380,7,659,15,7
"1218","2020-05-20",199,14,60,482,4912,0.947679153094462,8325,30317,306,331,28,2408,9,668,22,9
"1219","2020-05-21",205,14,51,445,4912,0.947679153094462,8325,30317,306,331,13,2421,15,683,11,15
"1220","2020-05-22",191,14,61,409,4912,0.947679153094462,8325,30317,306,331,23,2444,14,697,19,14
"1221","2020-05-23",163,14,57,382,4912,0.947679153094462,8325,30317,306,331,13,2457,11,708,9,11
"1222","2020-05-24",151,14,57,352,4912,0.947679153094462,8325,30317,306,331,21,2478,23,731,18,23
"1223","2020-05-25",138,14,66,330,4912,0.947679153094462,8325,30317,306,331,23,2501,15,746,22,15
"1224","2020-05-26",127,14,72,315,4912,0.947679153094462,8325,30317,306,331,18,2519,13,759,15,13
"1225","2020-05-27",118,14,58,289,4912,0.947679153094462,8325,30317,306,331,18,2537,8,767,12,8
"1226","2020-05-28",109,14,63,277,4912,0.947679153094462,8325,30317,306,331,20,2557,17,784,16,17
"1227","2020-05-29",96,14,57,272,4912,0.947679153094462,8325,30317,306,331,17,2574,7,791,15,7
"1228","2020-05-30",87,14,58,255,4912,0.947679153094462,8325,30317,306,331,20,2594,9,800,17,9
"1229","2020-05-31",78,14,63,241,4912,0.947679153094462,8325,30317,306,331,19,2613,13,813,14,13
"1230","2020-06-01",75,14,69,225,4912,0.947679153094462,8325,30317,306,331,15,2628,9,822,12,9
"1231","2020-06-02",73,14,73,211,4912,0.947679153094462,8325,30317,306,331,18,2646,8,830,12,8
"1232","2020-06-03",72,14,70,202,4912,0.947679153094462,8325,30317,306,331,21,2667,7,837,19,7
"1233","2020-06-04",62,14,69,201,4912,0.947679153094462,8325,30317,306,331,20,2687,8,845,19,8
"1234","2020-06-05",68,14,64,197,4912,0.947679153094462,8325,30317,306,331,9,2696,8,853,9,8
"1235","2020-06-06",69,14,64,180,4912,0.947679153094462,8325,30317,306,331,11,2707,3,856,9,3
"1236","2020-06-07",71,14,60,174,4912,0.947679153094462,8325,30317,306,331,20,2727,7,863,17,7
"1237","2020-03-07",1,15,0,0,3025,0.659504132231405,8295,24339,150,461,NA,NA,NA,NA,NA,NA
"1238","2020-03-08",1,15,0,0,3025,0.659504132231405,8295,24339,150,461,NA,NA,NA,NA,NA,NA
"1239","2020-03-09",0,15,0,0,3025,0.659504132231405,8295,24339,150,461,NA,NA,NA,NA,NA,NA
"1240","2020-03-10",0,15,0,0,3025,0.659504132231405,8295,24339,150,461,NA,NA,NA,NA,NA,NA
"1241","2020-03-11",0,15,0,0,3025,0.659504132231405,8295,24339,150,461,10,10,2,2,NA,2
"1242","2020-03-12",0,15,0,0,3025,0.659504132231405,8295,24339,150,461,11,21,5,7,NA,5
"1243","2020-03-13",1,15,43,37,3025,0.659504132231405,8295,24339,150,461,12,33,NA,NA,1,NA
"1244","2020-03-14",9,15,40,62,3025,0.659504132231405,8295,24339,150,461,9,42,1,8,4,1
"1245","2020-03-15",9,15,35,86,3025,0.659504132231405,8295,24339,150,461,12,54,1,9,3,1
"1246","2020-03-16",10,15,33,98,3025,0.659504132231405,8295,24339,150,461,17,71,3,12,4,3
"1247","2020-03-17",12,15,36,113,3025,0.659504132231405,8295,24339,150,461,12,83,5,17,3,5
"1248","2020-03-18",13,15,44,129,3025,0.659504132231405,8295,24339,150,461,20,103,6,23,9,6
"1249","2020-03-19",20,15,57,148,3025,0.659504132231405,8295,24339,150,461,22,125,7,30,6,7
"1250","2020-03-20",31,15,52,176,3025,0.659504132231405,8295,24339,150,461,20,145,3,33,11,3
"1251","2020-03-21",39,15,62,185,3025,0.659504132231405,8295,24339,150,461,30,175,1,34,10,1
"1252","2020-03-22",40,15,73,198,3025,0.659504132231405,8295,24339,150,461,17,192,2,36,7,2
"1253","2020-03-23",46,15,83,215,3025,0.659504132231405,8295,24339,150,461,26,218,5,41,9,5
"1254","2020-03-24",51,15,82,242,3025,0.659504132231405,8295,24339,150,461,27,245,2,43,10,2
"1255","2020-03-25",55,15,69,259,3025,0.659504132231405,8295,24339,150,461,38,283,1,44,21,1
"1256","2020-03-26",60,15,66,265,3025,0.659504132231405,8295,24339,150,461,22,305,8,52,12,8
"1257","2020-03-27",77,15,59,288,3025,0.659504132231405,8295,24339,150,461,27,332,NA,NA,19,NA
"1258","2020-03-28",90,15,52,312,3025,0.659504132231405,8295,24339,150,461,26,358,3,55,15,3
"1259","2020-03-29",101,15,54,328,3025,0.659504132231405,8295,24339,150,461,34,392,2,57,22,2
"1260","2020-03-30",93,15,63,345,3025,0.659504132231405,8295,24339,150,461,29,421,3,60,14,3
"1261","2020-03-31",100,15,77,345,3025,0.659504132231405,8295,24339,150,461,32,453,1,61,14,1
"1262","2020-04-01",107,15,73,345,3025,0.659504132231405,8295,24339,150,461,31,484,6,67,17,6
"1263","2020-04-02",105,15,57,356,3025,0.659504132231405,8295,24339,150,461,28,512,4,71,12,4
"1264","2020-04-03",121,15,56,361,3025,0.659504132231405,8295,24339,150,461,26,538,4,75,23,4
"1265","2020-04-04",123,15,52,361,3025,0.659504132231405,8295,24339,150,461,22,560,5,80,12,5
"1266","2020-04-05",112,15,57,383,3025,0.659504132231405,8295,24339,150,461,42,602,3,83,20,3
"1267","2020-04-06",115,15,48,389,3025,0.659504132231405,8295,24339,150,461,34,636,6,89,14,6
"1268","2020-04-07",121,15,54,399,3025,0.659504132231405,8295,24339,150,461,29,665,8,97,18,8
"1269","2020-04-08",125,15,77,398,3025,0.659504132231405,8295,24339,150,461,28,693,3,100,13,3
"1270","2020-04-09",130,15,92,413,3025,0.659504132231405,8295,24339,150,461,35,728,8,108,23,8
"1271","2020-04-10",123,15,120,417,3025,0.659504132231405,8295,24339,150,461,34,762,11,119,19,11
"1272","2020-04-11",137,15,122,423,3025,0.659504132231405,8295,24339,150,461,32,794,7,126,13,7
"1273","2020-04-12",140,15,105,430,3025,0.659504132231405,8295,24339,150,461,38,832,8,134,22,8
"1274","2020-04-13",139,15,90,438,3025,0.659504132231405,8295,24339,150,461,30,862,4,138,11,4
"1275","2020-04-14",133,15,76,451,3025,0.659504132231405,8295,24339,150,461,29,891,7,145,12,7
"1276","2020-04-15",132,15,76,459,3025,0.659504132231405,8295,24339,150,461,31,922,9,154,19,9
"1277","2020-04-16",133,15,95,471,3025,0.659504132231405,8295,24339,150,461,32,954,10,164,16,10
"1278","2020-04-17",151,15,113,463,3025,0.659504132231405,8295,24339,150,461,36,990,14,178,17,14
"1279","2020-04-18",136,15,109,471,3025,0.659504132231405,8295,24339,150,461,40,1030,10,188,25,10
"1280","2020-04-19",137,15,100,479,3025,0.659504132231405,8295,24339,150,461,36,1066,8,196,22,8
"1281","2020-04-20",131,15,98,487,3025,0.659504132231405,8295,24339,150,461,48,1114,12,208,32,12
"1282","2020-04-21",129,15,94,483,3025,0.659504132231405,8295,24339,150,461,25,1139,5,213,13,5
"1283","2020-04-22",137,15,85,489,3025,0.659504132231405,8295,24339,150,461,30,1169,1,214,15,1
"1284","2020-04-23",141,15,72,494,3025,0.659504132231405,8295,24339,150,461,35,1204,10,224,19,10
"1285","2020-04-24",144,15,71,490,3025,0.659504132231405,8295,24339,150,461,34,1238,7,231,19,7
"1286","2020-04-25",152,15,74,483,3025,0.659504132231405,8295,24339,150,461,38,1276,6,237,21,6
"1287","2020-04-26",150,15,95,470,3025,0.659504132231405,8295,24339,150,461,30,1306,6,243,14,6
"1288","2020-04-27",158,15,106,473,3025,0.659504132231405,8295,24339,150,461,40,1346,1,244,18,1
"1289","2020-04-28",161,15,104,480,3025,0.659504132231405,8295,24339,150,461,33,1379,2,246,22,2
"1290","2020-04-29",157,15,85,481,3025,0.659504132231405,8295,24339,150,461,39,1418,4,250,22,4
"1291","2020-04-30",159,15,82,485,3025,0.659504132231405,8295,24339,150,461,25,1443,11,261,16,11
"1292","2020-05-01",168,15,78,476,3025,0.659504132231405,8295,24339,150,461,33,1476,5,266,23,5
"1293","2020-05-02",175,15,77,477,3025,0.659504132231405,8295,24339,150,461,35,1511,6,272,20,6
"1294","2020-05-03",176,15,78,477,3025,0.659504132231405,8295,24339,150,461,28,1539,15,287,17,15
"1295","2020-05-04",161,15,94,479,3025,0.659504132231405,8295,24339,150,461,36,1575,9,296,20,9
"1296","2020-05-05",149,15,102,476,3025,0.659504132231405,8295,24339,150,461,35,1610,7,303,19,7
"1297","2020-05-06",149,15,102,471,3025,0.659504132231405,8295,24339,150,461,32,1642,11,314,15,11
"1298","2020-05-07",145,15,103,462,3025,0.659504132231405,8295,24339,150,461,30,1672,6,320,15,6
"1299","2020-05-08",145,15,95,451,3025,0.659504132231405,8295,24339,150,461,26,1698,3,323,16,3
"1300","2020-05-09",154,15,83,452,3025,0.659504132231405,8295,24339,150,461,36,1734,8,331,29,8
"1301","2020-05-10",147,15,81,436,3025,0.659504132231405,8295,24339,150,461,23,1757,2,333,12,2
"1302","2020-05-11",145,15,89,427,3025,0.659504132231405,8295,24339,150,461,27,1784,9,342,14,9
"1303","2020-05-12",141,15,104,414,3025,0.659504132231405,8295,24339,150,461,34,1818,1,343,19,1
"1304","2020-05-13",135,15,105,419,3025,0.659504132231405,8295,24339,150,461,36,1854,2,345,19,2
"1305","2020-05-14",134,15,98,407,3025,0.659504132231405,8295,24339,150,461,30,1884,7,352,17,7
"1306","2020-05-15",141,15,87,388,3025,0.659504132231405,8295,24339,150,461,24,1908,7,359,10,7
"1307","2020-05-16",136,15,107,384,3025,0.659504132231405,8295,24339,150,461,22,1930,5,364,12,5
"1308","2020-05-17",128,15,113,376,3025,0.659504132231405,8295,24339,150,461,25,1955,8,372,14,8
"1309","2020-05-18",118,15,95,354,3025,0.659504132231405,8295,24339,150,461,28,1983,4,376,10,4
"1310","2020-05-19",114,15,101,341,3025,0.659504132231405,8295,24339,150,461,24,2007,6,382,13,6
"1311","2020-05-20",123,15,109,322,3025,0.659504132231405,8295,24339,150,461,21,2028,6,388,13,6
"1312","2020-05-21",120,15,119,303,3025,0.659504132231405,8295,24339,150,461,22,2050,5,393,11,5
"1313","2020-05-22",105,15,153,295,3025,0.659504132231405,8295,24339,150,461,18,2068,4,397,14,4
"1314","2020-05-23",106,15,161,293,3025,0.659504132231405,8295,24339,150,461,18,2086,8,405,11,8
"1315","2020-05-24",113,15,174,292,3025,0.659504132231405,8295,24339,150,461,11,2097,16,421,5,16
"1316","2020-05-25",112,15,165,297,3025,0.659504132231405,8295,24339,150,461,23,2120,10,431,13,10
"1317","2020-05-26",109,15,148,298,3025,0.659504132231405,8295,24339,150,461,14,2134,8,439,7,8
"1318","2020-05-27",108,15,150,303,3025,0.659504132231405,8295,24339,150,461,11,2145,4,443,5,4
"1319","2020-05-28",103,15,149,296,3025,0.659504132231405,8295,24339,150,461,18,2163,5,448,9,5
"1320","2020-05-29",109,15,132,294,3025,0.659504132231405,8295,24339,150,461,19,2182,6,454,6,6
"1321","2020-05-30",104,15,115,287,3025,0.659504132231405,8295,24339,150,461,15,2197,5,459,10,5
"1322","2020-05-31",103,15,122,288,3025,0.659504132231405,8295,24339,150,461,20,2217,9,468,11,9
"1323","2020-06-01",100,15,125,289,3025,0.659504132231405,8295,24339,150,461,9,2226,10,478,2,10
"1324","2020-06-02",102,15,116,276,3025,0.659504132231405,8295,24339,150,461,19,2245,6,484,9,6
"1325","2020-06-03",86,15,123,273,3025,0.659504132231405,8295,24339,150,461,14,2259,2,486,9,2
"1326","2020-06-04",90,15,109,256,3025,0.659504132231405,8295,24339,150,461,11,2270,4,490,5,4
"1327","2020-06-05",88,15,88,247,3025,0.659504132231405,8295,24339,150,461,10,2280,3,493,6,3
"1328","2020-06-06",95,15,90,243,3025,0.659504132231405,8295,24339,150,461,13,2293,5,498,6,5
"1329","2020-06-07",87,15,96,235,3025,0.659504132231405,8295,24339,150,461,7,2300,2,500,3,2
"1330","2020-03-15",3,16,17,14,5452,0.951393983859134,8265,30766,290,375,12,46,11,55,7,11
"1331","2020-03-16",3,16,14,20,5452,0.951393983859134,8265,30766,290,375,11,57,17,72,7,17
"1332","2020-03-17",3,16,16,27,5452,0.951393983859134,8265,30766,290,375,16,73,18,90,9,18
"1333","2020-03-18",3,16,20,36,5452,0.951393983859134,8265,30766,290,375,21,94,8,98,13,8
"1334","2020-03-19",4,16,19,37,5452,0.951393983859134,8265,30766,290,375,19,113,16,114,5,16
"1335","2020-03-20",5,16,21,43,5452,0.951393983859134,8265,30766,290,375,14,127,9,123,6,9
"1336","2020-03-21",7,16,16,53,5452,0.951393983859134,8265,30766,290,375,30,157,12,135,23,12
"1337","2020-03-22",6,16,24,65,5452,0.951393983859134,8265,30766,290,375,21,178,23,158,14,23
"1338","2020-03-23",8,16,37,72,5452,0.951393983859134,8265,30766,290,375,25,203,17,175,15,17
"1339","2020-03-24",10,16,43,82,5452,0.951393983859134,8265,30766,290,375,31,234,16,191,23,16
"1340","2020-03-25",12,16,51,96,5452,0.951393983859134,8265,30766,290,375,30,264,20,211,20,20
"1341","2020-03-26",17,16,55,107,5452,0.951393983859134,8265,30766,290,375,33,297,23,234,26,23
"1342","2020-03-27",20,16,54,124,5452,0.951393983859134,8265,30766,290,375,33,330,29,263,27,29
"1343","2020-03-28",29,16,63,141,5452,0.951393983859134,8265,30766,290,375,40,370,14,277,33,14
"1344","2020-03-29",34,16,62,167,5452,0.951393983859134,8265,30766,290,375,42,412,18,295,33,18
"1345","2020-03-30",35,16,59,196,5452,0.951393983859134,8265,30766,290,375,46,458,18,313,37,18
"1346","2020-03-31",39,16,57,223,5452,0.951393983859134,8265,30766,290,375,48,506,12,325,37,12
"1347","2020-04-01",40,16,50,251,5452,0.951393983859134,8265,30766,290,375,47,553,17,342,39,17
"1348","2020-04-02",42,16,60,281,5452,0.951393983859134,8265,30766,290,375,59,612,26,368,52,26
"1349","2020-04-03",64,16,58,323,5452,0.951393983859134,8265,30766,290,375,44,656,23,391,39,23
"1350","2020-04-04",90,16,58,373,5452,0.951393983859134,8265,30766,290,375,53,709,29,420,43,29
"1351","2020-04-05",90,16,65,394,5452,0.951393983859134,8265,30766,290,375,57,766,21,441,46,21
"1352","2020-04-06",95,16,87,443,5452,0.951393983859134,8265,30766,290,375,53,819,24,465,47,24
"1353","2020-04-07",107,16,106,497,5452,0.951393983859134,8265,30766,290,375,49,868,29,494,39,29
"1354","2020-04-08",121,16,111,543,5452,0.951393983859134,8265,30766,290,375,71,939,31,525,59,31
"1355","2020-04-09",131,16,99,605,5452,0.951393983859134,8265,30766,290,375,64,1003,20,545,51,20
"1356","2020-04-10",154,16,100,651,5452,0.951393983859134,8265,30766,290,375,51,1054,21,566,41,21
"1357","2020-04-11",189,16,112,696,5452,0.951393983859134,8265,30766,290,375,62,1116,24,590,48,24
"1358","2020-04-12",207,16,140,753,5452,0.951393983859134,8265,30766,290,375,57,1173,38,628,49,38
"1359","2020-04-13",211,16,142,812,5452,0.951393983859134,8265,30766,290,375,60,1233,23,651,50,23
"1360","2020-04-14",216,16,136,901,5452,0.951393983859134,8265,30766,290,375,64,1297,43,694,57,43
"1361","2020-04-15",230,16,122,968,5452,0.951393983859134,8265,30766,290,375,73,1370,28,722,59,28
"1362","2020-04-16",256,16,123,1036,5452,0.951393983859134,8265,30766,290,375,67,1437,29,751,58,29
"1363","2020-04-17",328,16,119,1106,5452,0.951393983859134,8265,30766,290,375,62,1499,23,774,49,23
"1364","2020-04-18",313,16,109,1185,5452,0.951393983859134,8265,30766,290,375,55,1554,31,805,46,31
"1365","2020-04-19",337,16,110,1238,5452,0.951393983859134,8265,30766,290,375,61,1615,35,840,53,35
"1366","2020-04-20",338,16,100,1326,5452,0.951393983859134,8265,30766,290,375,55,1670,34,874,45,34
"1367","2020-04-21",346,16,95,1388,5452,0.951393983859134,8265,30766,290,375,46,1716,24,898,38,24
"1368","2020-04-22",360,16,98,1439,5452,0.951393983859134,8265,30766,290,375,67,1783,29,927,55,29
"1369","2020-04-23",382,16,96,1518,5452,0.951393983859134,8265,30766,290,375,48,1831,32,959,34,32
"1370","2020-04-24",482,16,121,1570,5452,0.951393983859134,8265,30766,290,375,59,1890,28,987,53,28
"1371","2020-04-25",515,16,133,1613,5452,0.951393983859134,8265,30766,290,375,56,1946,23,1010,48,23
"1372","2020-04-26",489,16,122,1634,5452,0.951393983859134,8265,30766,290,375,58,2004,16,1026,43,16
"1373","2020-04-27",499,16,130,1666,5452,0.951393983859134,8265,30766,290,375,55,2059,31,1057,40,31
"1374","2020-04-28",516,16,142,1673,5452,0.951393983859134,8265,30766,290,375,57,2116,42,1099,43,42
"1375","2020-04-29",538,16,143,1662,5452,0.951393983859134,8265,30766,290,375,60,2176,31,1130,51,31
"1376","2020-04-30",529,16,143,1621,5452,0.951393983859134,8265,30766,290,375,63,2239,35,1165,50,35
"1377","2020-05-01",550,16,130,1593,5452,0.951393983859134,8265,30766,290,375,53,2292,23,1188,45,23
"1378","2020-05-02",556,16,135,1565,5452,0.951393983859134,8265,30766,290,375,54,2346,31,1219,44,31
"1379","2020-05-03",524,16,142,1498,5452,0.951393983859134,8265,30766,290,375,60,2406,29,1248,51,29
"1380","2020-05-04",514,16,128,1458,5452,0.951393983859134,8265,30766,290,375,69,2475,17,1265,50,17
"1381","2020-05-05",505,16,120,1395,5452,0.951393983859134,8265,30766,290,375,48,2523,25,1290,42,25
"1382","2020-05-06",485,16,117,1339,5452,0.951393983859134,8265,30766,290,375,61,2584,25,1315,53,25
"1383","2020-05-07",492,16,127,1313,5452,0.951393983859134,8265,30766,290,375,57,2641,16,1331,46,16
"1384","2020-05-08",473,16,139,1270,5452,0.951393983859134,8265,30766,290,375,57,2698,17,1348,48,17
"1385","2020-05-09",464,16,136,1215,5452,0.951393983859134,8265,30766,290,375,44,2742,24,1372,36,24
"1386","2020-05-10",427,16,145,1146,5452,0.951393983859134,8265,30766,290,375,51,2793,30,1402,43,30
"1387","2020-05-11",428,16,142,1075,5452,0.951393983859134,8265,30766,290,375,47,2840,19,1421,38,19
"1388","2020-05-12",395,16,144,1027,5452,0.951393983859134,8265,30766,290,375,34,2874,19,1440,28,19
"1389","2020-05-13",380,16,138,945,5452,0.951393983859134,8265,30766,290,375,36,2910,24,1464,28,24
"1390","2020-05-14",360,16,126,886,5452,0.951393983859134,8265,30766,290,375,46,2956,21,1485,42,21
"1391","2020-05-15",330,16,116,833,5452,0.951393983859134,8265,30766,290,375,39,2995,20,1505,33,20
"1392","2020-05-16",315,16,108,751,5452,0.951393983859134,8265,30766,290,375,34,3029,31,1536,27,31
"1393","2020-05-17",300,16,107,700,5452,0.951393983859134,8265,30766,290,375,31,3060,31,1567,23,31
"1394","2020-05-18",277,16,101,664,5452,0.951393983859134,8265,30766,290,375,23,3083,24,1591,18,24
"1395","2020-05-19",265,16,101,622,5452,0.951393983859134,8265,30766,290,375,33,3116,27,1618,28,27
"1396","2020-05-20",259,16,110,553,5452,0.951393983859134,8265,30766,290,375,32,3148,18,1636,26,18
"1397","2020-05-21",234,16,106,507,5452,0.951393983859134,8265,30766,290,375,37,3185,24,1660,31,24
"1398","2020-05-22",215,16,104,441,5452,0.951393983859134,8265,30766,290,375,25,3210,33,1693,20,33
"1399","2020-05-23",206,16,114,413,5452,0.951393983859134,8265,30766,290,375,27,3237,36,1729,22,36
"1400","2020-05-24",190,16,123,380,5452,0.951393983859134,8265,30766,290,375,23,3260,43,1772,20,43
"1401","2020-05-25",172,16,110,341,5452,0.951393983859134,8265,30766,290,375,34,3294,28,1800,29,28
"1402","2020-05-26",153,16,102,320,5452,0.951393983859134,8265,30766,290,375,26,3320,28,1828,24,28
"1403","2020-05-27",133,16,105,291,5452,0.951393983859134,8265,30766,290,375,22,3342,35,1863,20,35
"1404","2020-05-28",128,16,104,252,5452,0.951393983859134,8265,30766,290,375,14,3356,30,1893,12,30
"1405","2020-05-29",117,16,99,234,5452,0.951393983859134,8265,30766,290,375,22,3378,23,1916,17,23
"1406","2020-05-30",102,16,93,213,5452,0.951393983859134,8265,30766,290,375,25,3403,21,1937,20,21
"1407","2020-05-31",84,16,95,201,5452,0.951393983859134,8265,30766,290,375,15,3418,16,1953,12,16
"1408","2020-06-01",76,16,89,174,5452,0.951393983859134,8265,30766,290,375,13,3431,24,1977,10,24
"1409","2020-06-02",75,16,95,155,5452,0.951393983859134,8265,30766,290,375,14,3445,20,1997,11,20
"1410","2020-06-03",72,16,88,141,5452,0.951393983859134,8265,30766,290,375,24,3469,24,2021,21,24
"1411","2020-06-04",66,16,82,130,5452,0.951393983859134,8265,30766,290,375,9,3478,13,2034,7,13
"1412","2020-06-05",50,16,83,121,5452,0.951393983859134,8265,30766,290,375,11,3489,23,2057,8,23
"1413","2020-06-06",47,16,74,111,5452,0.951393983859134,8265,30766,290,375,7,3496,20,2077,4,20
"1414","2020-06-07",40,16,73,102,5452,0.951393983859134,8265,30766,290,375,13,3509,25,2102,8,25
"1415","2020-03-15",1,17,28,33,3772,0.82423117709438,8355,27099,235,373,3,14,3,17,3,3
"1416","2020-03-16",2,17,27,43,3772,0.82423117709438,8355,27099,235,373,4,18,6,23,4,6
"1417","2020-03-17",3,17,22,48,3772,0.82423117709438,8355,27099,235,373,6,24,12,35,2,12
"1418","2020-03-18",4,17,20,63,3772,0.82423117709438,8355,27099,235,373,8,32,8,43,6,8
"1419","2020-03-19",5,17,27,79,3772,0.82423117709438,8355,27099,235,373,10,42,3,46,7,3
"1420","2020-03-20",9,17,35,90,3772,0.82423117709438,8355,27099,235,373,8,50,17,63,7,17
"1421","2020-03-21",18,17,28,106,3772,0.82423117709438,8355,27099,235,373,13,63,10,73,8,10
"1422","2020-03-22",25,17,24,121,3772,0.82423117709438,8355,27099,235,373,14,77,6,79,14,6
"1423","2020-03-23",31,17,21,135,3772,0.82423117709438,8355,27099,235,373,24,101,3,82,22,3
"1424","2020-03-24",35,17,23,141,3772,0.82423117709438,8355,27099,235,373,20,121,12,94,19,12
"1425","2020-03-25",42,17,27,169,3772,0.82423117709438,8355,27099,235,373,19,140,12,106,18,12
"1426","2020-03-26",41,17,33,177,3772,0.82423117709438,8355,27099,235,373,30,170,10,116,26,10
"1427","2020-03-27",43,17,31,199,3772,0.82423117709438,8355,27099,235,373,32,202,14,130,31,14
"1428","2020-03-28",46,17,42,223,3772,0.82423117709438,8355,27099,235,373,32,234,10,140,30,10
"1429","2020-03-29",52,17,48,232,3772,0.82423117709438,8355,27099,235,373,17,251,19,159,16,19
"1430","2020-03-30",52,17,57,247,3772,0.82423117709438,8355,27099,235,373,39,290,10,169,38,10
"1431","2020-03-31",52,17,61,265,3772,0.82423117709438,8355,27099,235,373,37,327,7,176,37,7
"1432","2020-04-01",55,17,82,278,3772,0.82423117709438,8355,27099,235,373,40,367,9,185,39,9
"1433","2020-04-02",70,17,72,306,3772,0.82423117709438,8355,27099,235,373,45,412,6,191,42,6
"1434","2020-04-03",87,17,68,330,3772,0.82423117709438,8355,27099,235,373,50,462,15,206,48,15
"1435","2020-04-04",95,17,74,362,3772,0.82423117709438,8355,27099,235,373,54,516,4,210,49,4
"1436","2020-04-05",99,17,72,384,3772,0.82423117709438,8355,27099,235,373,59,575,3,213,57,3
"1437","2020-04-06",105,17,71,413,3772,0.82423117709438,8355,27099,235,373,63,638,2,215,62,2
"1438","2020-04-07",113,17,69,437,3772,0.82423117709438,8355,27099,235,373,79,717,1,216,75,1
"1439","2020-04-08",115,17,60,467,3772,0.82423117709438,8355,27099,235,373,67,784,3,219,64,3
"1440","2020-04-09",123,17,63,495,3772,0.82423117709438,8355,27099,235,373,105,889,2,221,104,2
"1441","2020-04-10",156,17,64,511,3772,0.82423117709438,8355,27099,235,373,83,972,2,223,80,2
"1442","2020-04-11",168,17,56,546,3772,0.82423117709438,8355,27099,235,373,98,1070,4,227,96,4
"1443","2020-04-12",173,17,63,535,3772,0.82423117709438,8355,27099,235,373,96,1166,12,239,92,12
"1444","2020-04-13",170,17,67,554,3772,0.82423117709438,8355,27099,235,373,101,1267,16,255,100,16
"1445","2020-04-14",179,17,63,580,3772,0.82423117709438,8355,27099,235,373,112,1379,8,263,111,8
"1446","2020-04-15",185,17,64,592,3772,0.82423117709438,8355,27099,235,373,102,1481,6,269,101,6
"1447","2020-04-16",178,17,68,618,3772,0.82423117709438,8355,27099,235,373,126,1607,10,279,123,10
"1448","2020-04-17",204,17,70,631,3772,0.82423117709438,8355,27099,235,373,122,1729,13,292,121,13
"1449","2020-04-18",227,17,81,639,3772,0.82423117709438,8355,27099,235,373,139,1868,8,300,138,8
"1450","2020-04-19",224,17,85,653,3772,0.82423117709438,8355,27099,235,373,136,2004,3,303,135,3
"1451","2020-04-20",217,17,85,668,3772,0.82423117709438,8355,27099,235,373,103,2107,6,309,101,6
"1452","2020-04-21",204,17,77,673,3772,0.82423117709438,8355,27099,235,373,131,2238,6,315,131,6
"1453","2020-04-22",212,17,89,673,3772,0.82423117709438,8355,27099,235,373,133,2371,8,323,130,8
"1454","2020-04-23",226,17,92,664,3772,0.82423117709438,8355,27099,235,373,133,2504,4,327,133,4
"1455","2020-04-24",234,17,105,691,3772,0.82423117709438,8355,27099,235,373,128,2632,9,336,127,9
"1456","2020-04-25",234,17,117,705,3772,0.82423117709438,8355,27099,235,373,147,2779,9,345,147,9
"1457","2020-04-26",224,17,135,718,3772,0.82423117709438,8355,27099,235,373,121,2900,15,360,120,15
"1458","2020-04-27",227,17,131,721,3772,0.82423117709438,8355,27099,235,373,144,3044,18,378,143,18
"1459","2020-04-28",225,17,126,735,3772,0.82423117709438,8355,27099,235,373,120,3164,19,397,118,19
"1460","2020-04-29",233,17,118,744,3772,0.82423117709438,8355,27099,235,373,146,3310,11,408,144,11
"1461","2020-04-30",238,17,96,731,3772,0.82423117709438,8355,27099,235,373,132,3442,9,417,131,9
"1462","2020-05-01",250,17,89,714,3772,0.82423117709438,8355,27099,235,373,118,3560,7,424,116,7
"1463","2020-05-02",265,17,83,727,3772,0.82423117709438,8355,27099,235,373,114,3674,3,427,114,3
"1464","2020-05-03",256,17,88,722,3772,0.82423117709438,8355,27099,235,373,133,3807,10,437,133,10
"1465","2020-05-04",244,17,87,715,3772,0.82423117709438,8355,27099,235,373,85,3892,4,441,84,4
"1466","2020-05-05",248,17,86,713,3772,0.82423117709438,8355,27099,235,373,96,3988,3,444,95,3
"1467","2020-05-06",244,17,97,706,3772,0.82423117709438,8355,27099,235,373,109,4097,17,461,107,17
"1468","2020-05-07",231,17,91,693,3772,0.82423117709438,8355,27099,235,373,95,4192,7,468,93,7
"1469","2020-05-08",220,17,86,667,3772,0.82423117709438,8355,27099,235,373,82,4274,6,474,82,6
"1470","2020-05-09",212,17,87,654,3772,0.82423117709438,8355,27099,235,373,111,4385,21,495,109,21
"1471","2020-05-10",228,17,85,654,3772,0.82423117709438,8355,27099,235,373,78,4463,13,508,77,13
"1472","2020-05-11",227,17,79,638,3772,0.82423117709438,8355,27099,235,373,56,4519,10,518,55,10
"1473","2020-05-12",213,17,81,651,3772,0.82423117709438,8355,27099,235,373,65,4584,17,535,64,17
"1474","2020-05-13",207,17,95,654,3772,0.82423117709438,8355,27099,235,373,78,4662,9,544,77,9
"1475","2020-05-14",208,17,99,626,3772,0.82423117709438,8355,27099,235,373,59,4721,14,558,58,14
"1476","2020-05-15",219,17,98,624,3772,0.82423117709438,8355,27099,235,373,46,4767,10,568,45,10
"1477","2020-05-16",226,17,111,598,3772,0.82423117709438,8355,27099,235,373,46,4813,8,576,44,8
"1478","2020-05-17",224,17,107,573,3772,0.82423117709438,8355,27099,235,373,30,4843,17,593,30,17
"1479","2020-05-18",226,17,101,541,3772,0.82423117709438,8355,27099,235,373,47,4890,16,609,45,16
"1480","2020-05-19",228,17,103,533,3772,0.82423117709438,8355,27099,235,373,29,4919,9,618,28,9
"1481","2020-05-20",222,17,97,508,3772,0.82423117709438,8355,27099,235,373,34,4953,16,634,34,16
"1482","2020-05-21",216,17,102,494,3772,0.82423117709438,8355,27099,235,373,34,4987,14,648,34,14
"1483","2020-05-22",219,17,87,485,3772,0.82423117709438,8355,27099,235,373,29,5016,19,667,28,19
"1484","2020-05-23",216,17,79,464,3772,0.82423117709438,8355,27099,235,373,28,5044,17,684,28,17
"1485","2020-05-24",176,17,71,466,3772,0.82423117709438,8355,27099,235,373,20,5064,14,698,19,14
"1486","2020-05-25",161,17,62,447,3772,0.82423117709438,8355,27099,235,373,34,5098,11,709,34,11
"1487","2020-05-26",153,17,53,414,3772,0.82423117709438,8355,27099,235,373,33,5131,11,720,33,11
"1488","2020-05-27",144,17,53,405,3772,0.82423117709438,8355,27099,235,373,28,5159,7,727,28,7
"1489","2020-05-28",136,17,54,397,3772,0.82423117709438,8355,27099,235,373,23,5182,7,734,22,7
"1490","2020-05-29",137,17,60,370,3772,0.82423117709438,8355,27099,235,373,13,5195,3,737,11,3
"1491","2020-05-30",120,17,76,357,3772,0.82423117709438,8355,27099,235,373,13,5208,3,740,12,3
"1492","2020-05-31",123,17,63,352,3772,0.82423117709438,8355,27099,235,373,14,5222,1,741,14,1
"1493","2020-06-01",117,17,51,349,3772,0.82423117709438,8355,27099,235,373,11,5233,1,742,11,1
"1494","2020-06-02",106,17,48,334,3772,0.82423117709438,8355,27099,235,373,9,5242,4,746,8,4
"1495","2020-06-03",103,17,43,307,3772,0.82423117709438,8355,27099,235,373,11,5253,3,749,11,3
"1496","2020-06-04",111,17,53,282,3772,0.82423117709438,8355,27099,235,373,11,5264,10,759,10,10
"1497","2020-06-05",107,17,60,268,3772,0.82423117709438,8355,27099,235,373,6,5270,2,761,6,2
"1498","2020-06-06",110,17,67,247,3772,0.82423117709438,8355,27099,235,373,4,5274,5,766,4,5
"1499","2020-06-07",94,17,65,237,3772,0.82423117709438,8355,27099,235,373,6,5280,8,774,6,8
"1500","2020-03-15",2,18,53,26,4697,0.93314881839472,8220,30198,293,357,2,12,4,30,NA,4
"1501","2020-03-16",3,18,44,34,4697,0.93314881839472,8220,30198,293,357,7,19,3,33,5,3
"1502","2020-03-17",3,18,40,41,4697,0.93314881839472,8220,30198,293,357,5,24,3,36,3,3
"1503","2020-03-18",4,18,40,49,4697,0.93314881839472,8220,30198,293,357,3,27,3,39,1,3
"1504","2020-03-19",7,18,51,53,4697,0.93314881839472,8220,30198,293,357,5,32,NA,NA,5,NA
"1505","2020-03-20",8,18,64,63,4697,0.93314881839472,8220,30198,293,357,6,38,4,43,5,4
"1506","2020-03-21",16,18,57,76,4697,0.93314881839472,8220,30198,293,357,13,51,3,46,9,3
"1507","2020-03-22",21,18,46,92,4697,0.93314881839472,8220,30198,293,357,15,66,1,47,14,1
"1508","2020-03-23",26,18,45,103,4697,0.93314881839472,8220,30198,293,357,13,79,3,50,13,3
"1509","2020-03-24",29,18,38,111,4697,0.93314881839472,8220,30198,293,357,18,97,3,53,17,3
"1510","2020-03-25",30,18,36,126,4697,0.93314881839472,8220,30198,293,357,14,111,4,57,11,4
"1511","2020-03-26",31,18,33,136,4697,0.93314881839472,8220,30198,293,357,13,124,9,66,12,9
"1512","2020-03-27",34,18,30,152,4697,0.93314881839472,8220,30198,293,357,31,155,11,77,27,11
"1513","2020-03-28",40,18,32,168,4697,0.93314881839472,8220,30198,293,357,33,188,16,93,29,16
"1514","2020-03-29",42,18,28,177,4697,0.93314881839472,8220,30198,293,357,24,212,13,106,22,13
"1515","2020-03-30",35,18,23,198,4697,0.93314881839472,8220,30198,293,357,33,245,3,109,31,3
"1516","2020-03-31",34,18,18,212,4697,0.93314881839472,8220,30198,293,357,31,276,5,114,29,5
"1517","2020-04-01",43,18,20,241,4697,0.93314881839472,8220,30198,293,357,47,323,12,126,44,12
"1518","2020-04-02",51,18,19,263,4697,0.93314881839472,8220,30198,293,357,42,365,4,130,39,4
"1519","2020-04-03",73,18,19,275,4697,0.93314881839472,8220,30198,293,357,57,422,11,141,54,11
"1520","2020-04-04",77,18,19,303,4697,0.93314881839472,8220,30198,293,357,46,468,18,159,43,18
"1521","2020-04-05",85,18,22,327,4697,0.93314881839472,8220,30198,293,357,52,520,13,172,50,13
"1522","2020-04-06",91,18,19,364,4697,0.93314881839472,8220,30198,293,357,43,563,7,179,42,7
"1523","2020-04-07",98,18,42,391,4697,0.93314881839472,8220,30198,293,357,70,633,12,191,69,12
"1524","2020-04-08",103,18,49,442,4697,0.93314881839472,8220,30198,293,357,56,689,11,202,55,11
"1525","2020-04-09",106,18,60,477,4697,0.93314881839472,8220,30198,293,357,72,761,9,211,66,9
"1526","2020-04-10",110,18,76,503,4697,0.93314881839472,8220,30198,293,357,71,832,15,226,68,15
"1527","2020-04-11",110,18,82,535,4697,0.93314881839472,8220,30198,293,357,87,919,15,241,83,15
"1528","2020-04-12",150,18,73,562,4697,0.93314881839472,8220,30198,293,357,88,1007,11,252,87,11
"1529","2020-04-13",158,18,59,590,4697,0.93314881839472,8220,30198,293,357,73,1080,10,262,73,10
"1530","2020-04-14",162,18,57,632,4697,0.93314881839472,8220,30198,293,357,71,1151,26,288,69,26
"1531","2020-04-15",168,18,59,646,4697,0.93314881839472,8220,30198,293,357,89,1240,19,307,86,19
"1532","2020-04-16",183,18,63,656,4697,0.93314881839472,8220,30198,293,357,102,1342,23,330,98,23
"1533","2020-04-17",229,18,62,669,4697,0.93314881839472,8220,30198,293,357,109,1451,13,343,109,13
"1534","2020-04-18",242,18,56,728,4697,0.93314881839472,8220,30198,293,357,116,1567,22,365,112,22
"1535","2020-04-19",221,18,38,801,4697,0.93314881839472,8220,30198,293,357,127,1694,18,383,125,18
"1536","2020-04-20",236,18,38,824,4697,0.93314881839472,8220,30198,293,357,112,1806,30,413,109,30
"1537","2020-04-21",232,18,51,880,4697,0.93314881839472,8220,30198,293,357,129,1935,17,430,128,17
"1538","2020-04-22",239,18,57,897,4697,0.93314881839472,8220,30198,293,357,119,2054,26,456,118,26
"1539","2020-04-23",245,18,64,942,4697,0.93314881839472,8220,30198,293,357,158,2212,24,480,156,24
"1540","2020-04-24",273,18,61,965,4697,0.93314881839472,8220,30198,293,357,133,2345,25,505,133,25
"1541","2020-04-25",284,18,75,1010,4697,0.93314881839472,8220,30198,293,357,125,2470,18,523,123,18
"1542","2020-04-26",300,18,82,1016,4697,0.93314881839472,8220,30198,293,357,132,2602,26,549,130,26
"1543","2020-04-27",295,18,74,1037,4697,0.93314881839472,8220,30198,293,357,130,2732,13,562,128,13
"1544","2020-04-28",285,18,68,1034,4697,0.93314881839472,8220,30198,293,357,134,2866,25,587,132,25
"1545","2020-04-29",294,18,66,1075,4697,0.93314881839472,8220,30198,293,357,168,3034,22,609,167,22
"1546","2020-04-30",300,18,62,1066,4697,0.93314881839472,8220,30198,293,357,108,3142,16,625,105,16
"1547","2020-05-01",329,18,56,1080,4697,0.93314881839472,8220,30198,293,357,109,3251,22,647,106,22
"1548","2020-05-02",336,18,47,1086,4697,0.93314881839472,8220,30198,293,357,148,3399,24,671,147,24
"1549","2020-05-03",327,18,60,1072,4697,0.93314881839472,8220,30198,293,357,106,3505,29,700,104,29
"1550","2020-05-04",335,18,78,1063,4697,0.93314881839472,8220,30198,293,357,128,3633,21,721,128,21
"1551","2020-05-05",334,18,90,1080,4697,0.93314881839472,8220,30198,293,357,143,3776,23,744,141,23
"1552","2020-05-06",331,18,92,1090,4697,0.93314881839472,8220,30198,293,357,86,3862,12,756,85,12
"1553","2020-05-07",330,18,84,1102,4697,0.93314881839472,8220,30198,293,357,130,3992,18,774,129,18
"1554","2020-05-08",391,18,74,1089,4697,0.93314881839472,8220,30198,293,357,87,4079,16,790,84,16
"1555","2020-05-09",419,18,79,1089,4697,0.93314881839472,8220,30198,293,357,99,4178,17,807,96,17
"1556","2020-05-10",366,18,74,1067,4697,0.93314881839472,8220,30198,293,357,86,4264,23,830,85,23
"1557","2020-05-11",363,18,79,1014,4697,0.93314881839472,8220,30198,293,357,88,4352,16,846,85,16
"1558","2020-05-12",357,18,61,1005,4697,0.93314881839472,8220,30198,293,357,80,4432,22,868,77,22
"1559","2020-05-13",368,18,54,964,4697,0.93314881839472,8220,30198,293,357,65,4497,14,882,62,14
"1560","2020-05-14",353,18,54,966,4697,0.93314881839472,8220,30198,293,357,72,4569,15,897,70,15
"1561","2020-05-15",340,18,51,928,4697,0.93314881839472,8220,30198,293,357,62,4631,21,918,61,21
"1562","2020-05-16",316,18,50,893,4697,0.93314881839472,8220,30198,293,357,46,4677,24,942,44,24
"1563","2020-05-17",310,18,51,855,4697,0.93314881839472,8220,30198,293,357,56,4733,13,955,55,13
"1564","2020-05-18",297,18,64,822,4697,0.93314881839472,8220,30198,293,357,37,4770,12,967,36,12
"1565","2020-05-19",289,18,56,778,4697,0.93314881839472,8220,30198,293,357,51,4821,14,981,49,14
"1566","2020-05-20",270,18,65,716,4697,0.93314881839472,8220,30198,293,357,39,4860,7,988,38,7
"1567","2020-05-21",267,18,69,666,4697,0.93314881839472,8220,30198,293,357,43,4903,15,1003,40,15
"1568","2020-05-22",239,18,73,628,4697,0.93314881839472,8220,30198,293,357,39,4942,12,1015,38,12
"1569","2020-05-23",222,18,71,593,4697,0.93314881839472,8220,30198,293,357,34,4976,3,1018,33,3
"1570","2020-05-24",205,18,72,559,4697,0.93314881839472,8220,30198,293,357,26,5002,8,1026,25,8
"1571","2020-05-25",194,18,81,519,4697,0.93314881839472,8220,30198,293,357,29,5031,7,1033,27,7
"1572","2020-05-26",180,18,81,491,4697,0.93314881839472,8220,30198,293,357,33,5064,8,1041,33,8
"1573","2020-05-27",176,18,76,466,4697,0.93314881839472,8220,30198,293,357,21,5085,6,1047,20,6
"1574","2020-05-28",169,18,77,430,4697,0.93314881839472,8220,30198,293,357,24,5109,7,1054,23,7
"1575","2020-05-29",163,18,74,410,4697,0.93314881839472,8220,30198,293,357,26,5135,9,1063,25,9
"1576","2020-05-30",157,18,79,395,4697,0.93314881839472,8220,30198,293,357,12,5147,8,1071,12,8
"1577","2020-05-31",136,18,60,359,4697,0.93314881839472,8220,30198,293,357,24,5171,7,1078,23,7
"1578","2020-06-01",131,18,49,345,4697,0.93314881839472,8220,30198,293,357,16,5187,6,1084,16,6
"1579","2020-06-02",122,18,41,324,4697,0.93314881839472,8220,30198,293,357,20,5207,8,1092,20,8
"1580","2020-06-03",115,18,36,302,4697,0.93314881839472,8220,30198,293,357,27,5234,7,1099,27,7
"1581","2020-06-04",111,18,37,274,4697,0.93314881839472,8220,30198,293,357,7,5241,4,1103,6,4
"1582","2020-06-05",107,18,34,261,4697,0.93314881839472,8220,30198,293,357,11,5252,3,1106,10,3
"1583","2020-06-06",100,18,35,241,4697,0.93314881839472,8220,30198,293,357,16,5268,8,1114,15,8
"1584","2020-06-07",94,18,40,221,4697,0.93314881839472,8220,30198,293,357,6,5274,11,1125,6,11
"1585","2020-03-14",1,19,13,25,1940,0.664432989690722,8325,18011,118,226,9,38,6,32,3,6
"1586","2020-03-15",3,19,16,35,1940,0.664432989690722,8325,18011,118,226,15,53,4,36,6,4
"1587","2020-03-16",3,19,12,46,1940,0.664432989690722,8325,18011,118,226,22,75,10,46,13,10
"1588","2020-03-17",8,19,11,55,1940,0.664432989690722,8325,18011,118,226,18,93,2,48,10,2
"1589","2020-03-18",11,19,14,64,1940,0.664432989690722,8325,18011,118,226,20,113,NA,NA,13,NA
"1590","2020-03-19",16,19,13,77,1940,0.664432989690722,8325,18011,118,226,16,129,1,49,13,1
"1591","2020-03-20",18,19,19,91,1940,0.664432989690722,8325,18011,118,226,26,155,NA,NA,20,NA
"1592","2020-03-21",23,19,18,106,1940,0.664432989690722,8325,18011,118,226,37,192,1,50,23,1
"1593","2020-03-22",31,19,31,115,1940,0.664432989690722,8325,18011,118,226,26,218,1,51,22,1
"1594","2020-03-23",34,19,40,119,1940,0.664432989690722,8325,18011,118,226,44,262,1,52,33,1
"1595","2020-03-24",33,19,30,126,1940,0.664432989690722,8325,18011,118,226,39,301,4,56,33,4
"1596","2020-03-25",36,19,34,139,1940,0.664432989690722,8325,18011,118,226,48,349,9,65,44,9
"1597","2020-03-26",37,19,40,144,1940,0.664432989690722,8325,18011,118,226,48,397,13,78,42,13
"1598","2020-03-27",40,19,48,147,1940,0.664432989690722,8325,18011,118,226,54,451,8,86,48,8
"1599","2020-03-28",39,19,48,157,1940,0.664432989690722,8325,18011,118,226,62,513,8,94,61,8
"1600","2020-03-29",45,19,48,170,1940,0.664432989690722,8325,18011,118,226,60,573,5,99,52,5
"1601","2020-03-30",48,19,47,179,1940,0.664432989690722,8325,18011,118,226,59,632,13,112,57,13
"1602","2020-03-31",50,19,40,191,1940,0.664432989690722,8325,18011,118,226,75,707,10,122,66,10
"1603","2020-04-01",55,19,43,202,1940,0.664432989690722,8325,18011,118,226,71,778,10,132,66,10
"1604","2020-04-02",57,19,47,210,1940,0.664432989690722,8325,18011,118,226,91,869,8,140,78,8
"1605","2020-04-03",63,19,43,220,1940,0.664432989690722,8325,18011,118,226,128,997,17,157,122,17
"1606","2020-04-04",70,19,35,230,1940,0.664432989690722,8325,18011,118,226,74,1071,15,172,63,15
"1607","2020-04-05",72,19,36,242,1940,0.664432989690722,8325,18011,118,226,106,1177,12,184,99,12
"1608","2020-04-06",71,19,37,251,1940,0.664432989690722,8325,18011,118,226,108,1285,9,193,101,9
"1609","2020-04-07",67,19,44,266,1940,0.664432989690722,8325,18011,118,226,117,1402,5,198,108,5
"1610","2020-04-08",68,19,49,279,1940,0.664432989690722,8325,18011,118,226,103,1505,3,201,100,3
"1611","2020-04-09",76,19,48,272,1940,0.664432989690722,8325,18011,118,226,109,1614,6,207,103,6
"1612","2020-04-10",101,19,46,280,1940,0.664432989690722,8325,18011,118,226,118,1732,14,221,112,14
"1613","2020-04-11",97,19,51,284,1940,0.664432989690722,8325,18011,118,226,137,1869,12,233,123,12
"1614","2020-04-12",91,19,65,289,1940,0.664432989690722,8325,18011,118,226,140,2009,9,242,128,9
"1615","2020-04-13",95,19,63,305,1940,0.664432989690722,8325,18011,118,226,111,2120,17,259,100,17
"1616","2020-04-14",95,19,60,301,1940,0.664432989690722,8325,18011,118,226,141,2261,20,279,137,20
"1617","2020-04-15",97,19,59,300,1940,0.664432989690722,8325,18011,118,226,137,2398,19,298,133,19
"1618","2020-04-16",99,19,55,309,1940,0.664432989690722,8325,18011,118,226,155,2553,21,319,149,21
"1619","2020-04-17",91,19,58,310,1940,0.664432989690722,8325,18011,118,226,125,2678,11,330,119,11
"1620","2020-04-18",103,19,57,312,1940,0.664432989690722,8325,18011,118,226,133,2811,6,336,130,6
"1621","2020-04-19",102,19,60,305,1940,0.664432989690722,8325,18011,118,226,107,2918,10,346,102,10
"1622","2020-04-20",98,19,56,296,1940,0.664432989690722,8325,18011,118,226,151,3069,15,361,144,15
"1623","2020-04-21",95,19,59,290,1940,0.664432989690722,8325,18011,118,226,104,3173,12,373,100,12
"1624","2020-04-22",92,19,66,288,1940,0.664432989690722,8325,18011,118,226,119,3292,24,397,110,24
"1625","2020-04-23",89,19,67,288,1940,0.664432989690722,8325,18011,118,226,120,3412,28,425,116,28
"1626","2020-04-24",99,19,71,293,1940,0.664432989690722,8325,18011,118,226,112,3524,12,437,106,12
"1627","2020-04-25",111,19,68,294,1940,0.664432989690722,8325,18011,118,226,96,3620,16,453,88,16
"1628","2020-04-26",102,19,71,299,1940,0.664432989690722,8325,18011,118,226,116,3736,9,462,110,9
"1629","2020-04-27",96,19,70,299,1940,0.664432989690722,8325,18011,118,226,119,3855,18,480,111,18
"1630","2020-04-28",96,19,72,300,1940,0.664432989690722,8325,18011,118,226,73,3928,6,486,68,6
"1631","2020-04-29",94,19,68,302,1940,0.664432989690722,8325,18011,118,226,85,4013,12,498,79,12
"1632","2020-04-30",87,19,65,301,1940,0.664432989690722,8325,18011,118,226,77,4090,15,513,72,15
"1633","2020-05-01",90,19,62,306,1940,0.664432989690722,8325,18011,118,226,105,4195,8,521,97,8
"1634","2020-05-02",117,19,60,308,1940,0.664432989690722,8325,18011,118,226,101,4296,12,533,96,12
"1635","2020-05-03",116,19,59,305,1940,0.664432989690722,8325,18011,118,226,96,4392,10,543,91,10
"1636","2020-05-04",106,19,64,316,1940,0.664432989690722,8325,18011,118,226,66,4458,8,551,60,8
"1637","2020-05-05",115,19,70,313,1940,0.664432989690722,8325,18011,118,226,69,4527,5,556,61,5
"1638","2020-05-06",119,19,75,318,1940,0.664432989690722,8325,18011,118,226,61,4588,9,565,54,9
"1639","2020-05-07",127,19,85,303,1940,0.664432989690722,8325,18011,118,226,56,4644,15,580,52,15
"1640","2020-05-08",135,19,86,303,1940,0.664432989690722,8325,18011,118,226,59,4703,13,593,54,13
"1641","2020-05-09",123,19,82,298,1940,0.664432989690722,8325,18011,118,226,50,4753,13,606,45,13
"1642","2020-05-10",118,19,76,309,1940,0.664432989690722,8325,18011,118,226,51,4804,7,613,47,7
"1643","2020-05-11",118,19,71,316,1940,0.664432989690722,8325,18011,118,226,41,4845,11,624,32,11
"1644","2020-05-12",114,19,72,298,1940,0.664432989690722,8325,18011,118,226,43,4888,5,629,37,5
"1645","2020-05-13",107,19,62,290,1940,0.664432989690722,8325,18011,118,226,45,4933,12,641,34,12
"1646","2020-05-14",106,19,57,279,1940,0.664432989690722,8325,18011,118,226,42,4975,14,655,36,14
"1647","2020-05-15",109,19,55,282,1940,0.664432989690722,8325,18011,118,226,30,5005,14,669,27,14
"1648","2020-05-16",108,19,54,281,1940,0.664432989690722,8325,18011,118,226,39,5044,14,683,36,14
"1649","2020-05-17",102,19,57,274,1940,0.664432989690722,8325,18011,118,226,32,5076,10,693,28,10
"1650","2020-05-18",100,19,59,268,1940,0.664432989690722,8325,18011,118,226,30,5106,3,696,26,3
"1651","2020-05-19",90,19,53,289,1940,0.664432989690722,8325,18011,118,226,25,5131,5,701,25,5
"1652","2020-05-20",98,19,47,278,1940,0.664432989690722,8325,18011,118,226,18,5149,9,710,15,9
"1653","2020-05-21",94,19,45,280,1940,0.664432989690722,8325,18011,118,226,18,5167,11,721,15,11
"1654","2020-05-22",101,19,44,276,1940,0.664432989690722,8325,18011,118,226,21,5188,9,730,20,9
"1655","2020-05-23",99,19,46,274,1940,0.664432989690722,8325,18011,118,226,21,5209,7,737,17,7
"1656","2020-05-24",94,19,55,261,1940,0.664432989690722,8325,18011,118,226,23,5232,8,745,17,8
"1657","2020-05-25",90,19,49,248,1940,0.664432989690722,8325,18011,118,226,16,5248,11,756,15,11
"1658","2020-05-26",89,19,53,244,1940,0.664432989690722,8325,18011,118,226,5,5253,15,771,4,15
"1659","2020-05-27",82,19,51,240,1940,0.664432989690722,8325,18011,118,226,10,5263,5,776,10,5
"1660","2020-05-28",77,19,46,224,1940,0.664432989690722,8325,18011,118,226,6,5269,4,780,5,4
"1661","2020-05-29",80,19,44,216,1940,0.664432989690722,8325,18011,118,226,6,5275,11,791,2,11
"1662","2020-05-30",78,19,37,211,1940,0.664432989690722,8325,18011,118,226,11,5286,3,794,8,3
"1663","2020-05-31",81,19,36,198,1940,0.664432989690722,8325,18011,118,226,11,5297,11,805,11,11
"1664","2020-06-01",75,19,46,185,1940,0.664432989690722,8325,18011,118,226,4,5301,12,817,1,12
"1665","2020-06-02",75,19,43,166,1940,0.664432989690722,8325,18011,118,226,4,5305,15,832,2,15
"1666","2020-06-03",72,19,35,161,1940,0.664432989690722,8325,18011,118,226,7,5312,5,837,6,5
"1667","2020-06-04",70,19,29,153,1940,0.664432989690722,8325,18011,118,226,2,5314,9,846,2,9
"1668","2020-06-05",61,19,24,149,1940,0.664432989690722,8325,18011,118,226,3,5317,4,850,3,4
"1669","2020-06-06",61,19,21,142,1940,0.664432989690722,8325,18011,118,226,4,5321,5,855,3,5
"1670","2020-06-07",49,19,18,137,1940,0.664432989690722,8325,18011,118,226,3,5324,9,864,2,9
"1671","2020-03-07",1,20,0,0,5078,0.977156360771957,8415,31597,295,353,NA,NA,NA,NA,NA,NA
"1672","2020-03-08",1,20,0,0,5078,0.977156360771957,8415,31597,295,353,NA,NA,NA,NA,NA,NA
"1673","2020-03-09",0,20,0,0,5078,0.977156360771957,8415,31597,295,353,NA,NA,NA,NA,NA,NA
"1674","2020-03-10",0,20,0,0,5078,0.977156360771957,8415,31597,295,353,NA,NA,NA,NA,NA,NA
"1675","2020-03-11",0,20,0,0,5078,0.977156360771957,8415,31597,295,353,4,4,1,1,NA,1
"1676","2020-03-12",0,20,0,0,5078,0.977156360771957,8415,31597,295,353,1,5,1,2,NA,1
"1677","2020-03-13",0,20,0,0,5078,0.977156360771957,8415,31597,295,353,3,8,NA,NA,NA,NA
"1678","2020-03-14",0,20,0,0,5078,0.977156360771957,8415,31597,295,353,1,9,4,6,NA,4
"1679","2020-03-15",1,20,24,30,5078,0.977156360771957,8415,31597,295,353,7,16,8,14,NA,8
"1680","2020-03-16",4,20,25,38,5078,0.977156360771957,8415,31597,295,353,4,20,9,23,2,9
"1681","2020-03-17",7,20,38,45,5078,0.977156360771957,8415,31597,295,353,4,24,6,29,NA,6
"1682","2020-03-18",8,20,43,53,5078,0.977156360771957,8415,31597,295,353,5,29,6,35,5,6
"1683","2020-03-19",9,20,33,63,5078,0.977156360771957,8415,31597,295,353,11,40,6,41,7,6
"1684","2020-03-20",14,20,34,81,5078,0.977156360771957,8415,31597,295,353,8,48,5,46,4,5
"1685","2020-03-21",20,20,29,98,5078,0.977156360771957,8415,31597,295,353,11,59,11,57,6,11
"1686","2020-03-22",25,20,28,112,5078,0.977156360771957,8415,31597,295,353,12,71,9,66,8,9
"1687","2020-03-23",23,20,23,127,5078,0.977156360771957,8415,31597,295,353,20,91,8,74,15,8
"1688","2020-03-24",22,20,21,141,5078,0.977156360771957,8415,31597,295,353,10,101,5,79,9,5
"1689","2020-03-25",24,20,28,163,5078,0.977156360771957,8415,31597,295,353,11,112,4,83,9,4
"1690","2020-03-26",28,20,27,192,5078,0.977156360771957,8415,31597,295,353,26,138,5,88,21,5
"1691","2020-03-27",31,20,21,214,5078,0.977156360771957,8415,31597,295,353,17,155,5,93,13,5
"1692","2020-03-28",36,20,31,237,5078,0.977156360771957,8415,31597,295,353,15,170,6,99,12,6
"1693","2020-03-29",43,20,31,249,5078,0.977156360771957,8415,31597,295,353,26,196,11,110,20,11
"1694","2020-03-30",49,20,33,284,5078,0.977156360771957,8415,31597,295,353,30,226,11,121,24,11
"1695","2020-03-31",46,20,44,310,5078,0.977156360771957,8415,31597,295,353,33,259,14,135,30,14
"1696","2020-04-01",49,20,49,364,5078,0.977156360771957,8415,31597,295,353,43,302,14,149,39,14
"1697","2020-04-02",57,20,58,408,5078,0.977156360771957,8415,31597,295,353,42,344,10,159,39,10
"1698","2020-04-03",72,20,63,437,5078,0.977156360771957,8415,31597,295,353,46,390,10,169,43,10
"1699","2020-04-04",108,20,65,473,5078,0.977156360771957,8415,31597,295,353,41,431,14,183,41,14
"1700","2020-04-05",114,20,63,525,5078,0.977156360771957,8415,31597,295,353,85,516,11,194,84,11
"1701","2020-04-06",115,20,61,568,5078,0.977156360771957,8415,31597,295,353,65,581,19,213,62,19
"1702","2020-04-07",140,20,45,612,5078,0.977156360771957,8415,31597,295,353,80,661,16,229,75,16
"1703","2020-04-08",160,20,51,667,5078,0.977156360771957,8415,31597,295,353,85,746,6,235,80,6
"1704","2020-04-09",169,20,57,714,5078,0.977156360771957,8415,31597,295,353,102,848,17,252,97,17
"1705","2020-04-10",222,20,64,737,5078,0.977156360771957,8415,31597,295,353,97,945,15,267,96,15
"1706","2020-04-11",224,20,64,814,5078,0.977156360771957,8415,31597,295,353,98,1043,5,272,95,5
"1707","2020-04-12",267,20,60,860,5078,0.977156360771957,8415,31597,295,353,122,1165,6,278,115,6
"1708","2020-04-13",284,20,49,910,5078,0.977156360771957,8415,31597,295,353,113,1278,13,291,108,13
"1709","2020-04-14",262,20,55,941,5078,0.977156360771957,8415,31597,295,353,95,1373,16,307,91,16
"1710","2020-04-15",266,20,57,977,5078,0.977156360771957,8415,31597,295,353,119,1492,14,321,116,14
"1711","2020-04-16",285,20,53,1011,5078,0.977156360771957,8415,31597,295,353,154,1646,12,333,151,12
"1712","2020-04-17",335,20,58,1051,5078,0.977156360771957,8415,31597,295,353,137,1783,10,343,136,10
"1713","2020-04-18",366,20,52,1095,5078,0.977156360771957,8415,31597,295,353,132,1915,11,354,127,11
"1714","2020-04-19",337,20,49,1127,5078,0.977156360771957,8415,31597,295,353,141,2056,14,368,137,14
"1715","2020-04-20",322,20,38,1131,5078,0.977156360771957,8415,31597,295,353,137,2193,10,378,133,10
"1716","2020-04-21",334,20,32,1130,5078,0.977156360771957,8415,31597,295,353,152,2345,16,394,149,16
"1717","2020-04-22",354,20,37,1142,5078,0.977156360771957,8415,31597,295,353,130,2475,15,409,127,15
"1718","2020-04-23",360,20,54,1159,5078,0.977156360771957,8415,31597,295,353,173,2648,11,420,169,11
"1719","2020-04-24",437,20,67,1190,5078,0.977156360771957,8415,31597,295,353,125,2773,24,444,121,24
"1720","2020-04-25",434,20,66,1213,5078,0.977156360771957,8415,31597,295,353,134,2907,21,465,133,21
"1721","2020-04-26",396,20,57,1198,5078,0.977156360771957,8415,31597,295,353,140,3047,16,481,138,16
"1722","2020-04-27",399,20,51,1199,5078,0.977156360771957,8415,31597,295,353,124,3171,14,495,119,14
"1723","2020-04-28",405,20,48,1237,5078,0.977156360771957,8415,31597,295,353,117,3288,27,522,115,27
"1724","2020-04-29",390,20,56,1229,5078,0.977156360771957,8415,31597,295,353,132,3420,19,541,129,19
"1725","2020-04-30",391,20,62,1235,5078,0.977156360771957,8415,31597,295,353,123,3543,20,561,123,20
"1726","2020-05-01",393,20,73,1219,5078,0.977156360771957,8415,31597,295,353,117,3660,16,577,114,16
"1727","2020-05-02",386,20,72,1218,5078,0.977156360771957,8415,31597,295,353,112,3772,10,587,110,10
"1728","2020-05-03",382,20,70,1178,5078,0.977156360771957,8415,31597,295,353,101,3873,17,604,97,17
"1729","2020-05-04",379,20,69,1150,5078,0.977156360771957,8415,31597,295,353,104,3977,10,614,104,10
"1730","2020-05-05",376,20,63,1136,5078,0.977156360771957,8415,31597,295,353,105,4082,13,627,102,13
"1731","2020-05-06",378,20,66,1117,5078,0.977156360771957,8415,31597,295,353,96,4178,14,641,93,14
"1732","2020-05-07",368,20,70,1065,5078,0.977156360771957,8415,31597,295,353,77,4255,9,650,76,9
"1733","2020-05-08",361,20,84,1024,5078,0.977156360771957,8415,31597,295,353,86,4341,17,667,85,17
"1734","2020-05-09",365,20,83,1027,5078,0.977156360771957,8415,31597,295,353,76,4417,18,685,75,18
"1735","2020-05-10",367,20,71,967,5078,0.977156360771957,8415,31597,295,353,66,4483,22,707,65,22
"1736","2020-05-11",359,20,62,938,5078,0.977156360771957,8415,31597,295,353,41,4524,15,722,40,15
"1737","2020-05-12",328,20,60,891,5078,0.977156360771957,8415,31597,295,353,76,4600,18,740,74,18
"1738","2020-05-13",328,20,82,834,5078,0.977156360771957,8415,31597,295,353,54,4654,13,753,53,13
"1739","2020-05-14",313,20,97,787,5078,0.977156360771957,8415,31597,295,353,43,4697,18,771,43,18
"1740","2020-05-15",316,20,93,748,5078,0.977156360771957,8415,31597,295,353,29,4726,21,792,29,21
"1741","2020-05-16",312,20,82,714,5078,0.977156360771957,8415,31597,295,353,37,4763,21,813,37,21
"1742","2020-05-17",277,20,74,678,5078,0.977156360771957,8415,31597,295,353,46,4809,19,832,44,19
"1743","2020-05-18",276,20,68,641,5078,0.977156360771957,8415,31597,295,353,25,4834,6,838,23,6
"1744","2020-05-19",268,20,56,608,5078,0.977156360771957,8415,31597,295,353,25,4859,11,849,22,11
"1745","2020-05-20",252,20,56,597,5078,0.977156360771957,8415,31597,295,353,21,4880,6,855,19,6
"1746","2020-05-21",258,20,47,537,5078,0.977156360771957,8415,31597,295,353,21,4901,10,865,21,10
"1747","2020-05-22",226,20,41,504,5078,0.977156360771957,8415,31597,295,353,22,4923,13,878,21,13
"1748","2020-05-23",218,20,48,456,5078,0.977156360771957,8415,31597,295,353,21,4944,6,884,18,6
"1749","2020-05-24",198,20,46,417,5078,0.977156360771957,8415,31597,295,353,23,4967,6,890,23,6
"1750","2020-05-25",180,20,46,370,5078,0.977156360771957,8415,31597,295,353,12,4979,4,894,11,4
"1751","2020-05-26",166,20,50,342,5078,0.977156360771957,8415,31597,295,353,18,4997,7,901,16,7
"1752","2020-05-27",157,20,50,322,5078,0.977156360771957,8415,31597,295,353,23,5020,11,912,21,11
"1753","2020-05-28",137,20,40,306,5078,0.977156360771957,8415,31597,295,353,8,5028,7,919,7,7
"1754","2020-05-29",124,20,45,286,5078,0.977156360771957,8415,31597,295,353,20,5048,10,929,19,10
"1755","2020-05-30",107,20,41,264,5078,0.977156360771957,8415,31597,295,353,11,5059,4,933,9,4
"1756","2020-05-31",96,20,42,239,5078,0.977156360771957,8415,31597,295,353,14,5073,8,941,14,8
"1757","2020-06-01",87,20,49,219,5078,0.977156360771957,8415,31597,295,353,9,5082,14,955,9,14
"1758","2020-06-02",85,20,56,209,5078,0.977156360771957,8415,31597,295,353,11,5093,7,962,11,7
"1759","2020-06-03",81,20,45,193,5078,0.977156360771957,8415,31597,295,353,5,5098,7,969,4,7
"1760","2020-06-04",78,20,45,175,5078,0.977156360771957,8415,31597,295,353,9,5107,14,983,8,14
"1761","2020-06-05",67,20,47,165,5078,0.977156360771957,8415,31597,295,353,8,5115,8,991,8,8
"1762","2020-06-06",66,20,44,153,5078,0.977156360771957,8415,31597,295,353,6,5121,7,998,6,7
"1763","2020-06-07",61,20,40,148,5078,0.977156360771957,8415,31597,295,353,9,5130,12,1010,9,12
