"","Date","Absents","Paramset","Infections_or_Exposed_per_day_Patient","Infections_or_Exposed_per_day_HCW","total_infections","nosocomial_proportion","PCR_pooled","LFD_pooled","HCW_symp_test","patient_symp_test","new_hcw_infs","cumulative_hcw_infs","new_pat_infs","cumulative_pats_infs","new_nosocomial_hcw_infs","new_nosocomial_pat_infs"
"1","2020-03-12",1,1,18,36,6332,0.729153506001263,0,0,546,344,18,36,3,13,NA,3
"2","2020-03-13",3,1,19,57,6332,0.729153506001263,0,0,546,344,21,57,4,17,6,4
"3","2020-03-14",5,1,33,78,6332,0.729153506001263,0,0,546,344,21,78,15,32,NA,15
"4","2020-03-15",9,1,45,102,6332,0.729153506001263,0,0,546,344,24,102,12,44,6,12
"5","2020-03-16",17,1,49,130,6332,0.729153506001263,0,0,546,344,29,131,10,54,8,10
"6","2020-03-17",24,1,51,159,6332,0.729153506001263,0,0,546,344,30,161,9,63,9,9
"7","2020-03-18",26,1,68,207,6332,0.729153506001263,0,0,546,344,48,209,22,85,20,22
"8","2020-03-19",33,1,64,248,6332,0.729153506001263,0,0,546,344,47,256,9,94,21,9
"9","2020-03-20",37,1,65,293,6332,0.729153506001263,0,0,546,344,47,303,10,104,27,10
"10","2020-03-21",40,1,61,344,6332,0.729153506001263,0,0,546,344,62,365,6,110,41,6
"11","2020-03-22",49,1,73,406,6332,0.729153506001263,0,0,546,344,74,439,18,128,46,18
"12","2020-03-23",59,1,81,448,6332,0.729153506001263,0,0,546,344,55,494,19,147,45,19
"13","2020-03-24",74,1,81,506,6332,0.729153506001263,0,0,546,344,80,574,9,156,54,9
"14","2020-03-25",93,1,87,556,6332,0.729153506001263,0,0,546,344,79,653,17,173,59,17
"15","2020-03-26",99,1,82,621,6332,0.729153506001263,0,0,546,344,95,748,20,193,70,20
"16","2020-03-27",118,1,100,689,6332,0.729153506001263,0,0,546,344,102,850,24,217,81,24
"17","2020-03-28",133,1,104,756,6332,0.729153506001263,0,0,546,344,106,956,22,239,87,22
"18","2020-03-29",158,1,101,825,6332,0.729153506001263,0,0,546,344,119,1075,13,252,89,13
"19","2020-03-30",183,1,104,908,6332,0.729153506001263,0,0,546,344,126,1201,18,270,92,18
"20","2020-03-31",200,1,119,977,6332,0.729153506001263,0,0,546,344,116,1317,29,299,96,29
"21","2020-04-01",216,1,118,1063,6332,0.729153506001263,0,0,546,344,146,1463,14,313,121,14
"22","2020-04-02",245,1,98,1132,6332,0.729153506001263,0,0,546,344,138,1601,17,330,123,17
"23","2020-04-03",256,1,103,1183,6332,0.729153506001263,0,0,546,344,113,1714,26,356,95,26
"24","2020-04-04",279,1,111,1224,6332,0.729153506001263,0,0,546,344,126,1840,29,385,107,29
"25","2020-04-05",289,1,104,1314,6332,0.729153506001263,0,0,546,344,174,2014,19,404,153,19
"26","2020-04-06",293,1,118,1371,6332,0.729153506001263,0,0,546,344,151,2165,26,430,115,26
"27","2020-04-07",302,1,106,1420,6332,0.729153506001263,0,0,546,344,142,2307,17,447,111,17
"28","2020-04-08",311,1,110,1463,6332,0.729153506001263,0,0,546,344,162,2469,15,462,137,15
"29","2020-04-09",325,1,106,1484,6332,0.729153506001263,0,0,546,344,143,2612,16,478,118,16
"30","2020-04-10",365,1,92,1522,6332,0.729153506001263,0,0,546,344,155,2767,14,492,141,14
"31","2020-04-11",389,1,100,1561,6332,0.729153506001263,0,0,546,344,150,2917,29,521,128,29
"32","2020-04-12",408,1,99,1567,6332,0.729153506001263,0,0,546,344,137,3054,16,537,115,16
"33","2020-04-13",427,1,104,1583,6332,0.729153506001263,0,0,546,344,149,3203,21,558,123,21
"34","2020-04-14",445,1,99,1574,6332,0.729153506001263,0,0,546,344,122,3325,20,578,96,20
"35","2020-04-15",463,1,95,1550,6332,0.729153506001263,0,0,546,344,114,3439,15,593,96,15
"36","2020-04-16",472,1,78,1508,6332,0.729153506001263,0,0,546,344,100,3539,9,602,88,9
"37","2020-04-17",450,1,78,1507,6332,0.729153506001263,0,0,546,344,126,3665,13,615,106,13
"38","2020-04-18",448,1,93,1487,6332,0.729153506001263,0,0,546,344,133,3798,17,632,108,17
"39","2020-04-19",439,1,129,1460,6332,0.729153506001263,0,0,546,344,132,3930,38,670,114,38
"40","2020-04-20",441,1,126,1425,6332,0.729153506001263,0,0,546,344,115,4045,20,690,96,20
"41","2020-04-21",443,1,115,1389,6332,0.729153506001263,0,0,546,344,92,4137,16,706,77,16
"42","2020-04-22",441,1,116,1351,6332,0.729153506001263,0,0,546,344,106,4243,28,734,88,28
"43","2020-04-23",430,1,124,1318,6332,0.729153506001263,0,0,546,344,101,4344,28,762,85,28
"44","2020-04-24",431,1,124,1283,6332,0.729153506001263,0,0,546,344,91,4435,19,781,75,19
"45","2020-04-25",422,1,126,1250,6332,0.729153506001263,0,0,546,344,85,4520,23,804,68,23
"46","2020-04-26",422,1,117,1205,6332,0.729153506001263,0,0,546,344,76,4596,15,819,59,15
"47","2020-04-27",403,1,108,1149,6332,0.729153506001263,0,0,546,344,70,4666,19,838,58,19
"48","2020-04-28",394,1,127,1112,6332,0.729153506001263,0,0,546,344,70,4736,29,867,55,29
"49","2020-04-29",365,1,143,1047,6332,0.729153506001263,0,0,546,344,59,4795,26,893,43,26
"50","2020-04-30",347,1,146,996,6332,0.729153506001263,0,0,546,344,74,4869,29,922,55,29
"51","2020-05-01",323,1,127,937,6332,0.729153506001263,0,0,546,344,52,4921,12,934,40,12
"52","2020-05-02",302,1,123,886,6332,0.729153506001263,0,0,546,344,61,4982,20,954,41,20
"53","2020-05-03",273,1,130,836,6332,0.729153506001263,0,0,546,344,66,5048,18,972,52,18
"54","2020-05-04",253,1,122,813,6332,0.729153506001263,0,0,546,344,66,5114,20,992,47,20
"55","2020-05-05",230,1,131,762,6332,0.729153506001263,0,0,546,344,45,5159,26,1018,30,26
"56","2020-05-06",222,1,125,741,6332,0.729153506001263,0,0,546,344,50,5209,17,1035,38,17
"57","2020-05-07",224,1,126,713,6332,0.729153506001263,0,0,546,344,49,5258,21,1056,37,21
"58","2020-05-08",219,1,124,673,6332,0.729153506001263,0,0,546,344,46,5304,17,1073,35,17
"59","2020-05-09",221,1,136,644,6332,0.729153506001263,0,0,546,344,36,5340,30,1103,27,30
"60","2020-05-10",210,1,149,643,6332,0.729153506001263,0,0,546,344,57,5397,28,1131,35,28
"61","2020-05-11",211,1,176,617,6332,0.729153506001263,0,0,546,344,38,5435,46,1177,23,46
"62","2020-05-12",187,1,160,580,6332,0.729153506001263,0,0,546,344,31,5466,23,1200,23,23
"63","2020-05-13",186,1,155,542,6332,0.729153506001263,0,0,546,344,29,5495,27,1227,20,27
"64","2020-05-14",179,1,143,518,6332,0.729153506001263,0,0,546,344,34,5529,12,1239,26,12
"65","2020-05-15",173,1,127,486,6332,0.729153506001263,0,0,546,344,40,5569,12,1251,30,12
"66","2020-05-16",156,1,123,482,6332,0.729153506001263,0,0,546,344,40,5609,13,1264,25,13
"67","2020-05-17",160,1,121,466,6332,0.729153506001263,0,0,546,344,39,5648,14,1278,29,14
"68","2020-05-18",149,1,116,431,6332,0.729153506001263,0,0,546,344,20,5668,16,1294,14,16
"69","2020-05-19",156,1,111,414,6332,0.729153506001263,0,0,546,344,36,5704,17,1311,22,17
"70","2020-05-20",144,1,101,398,6332,0.729153506001263,0,0,546,344,30,5734,8,1319,14,8
"71","2020-05-21",126,1,100,388,6332,0.729153506001263,0,0,546,344,25,5759,10,1329,15,10
"72","2020-05-22",117,1,90,358,6332,0.729153506001263,0,0,546,344,21,5780,7,1336,14,7
"73","2020-05-23",110,1,92,322,6332,0.729153506001263,0,0,546,344,19,5799,20,1356,13,20
"74","2020-05-24",98,1,98,301,6332,0.729153506001263,0,0,546,344,21,5820,16,1372,19,16
"75","2020-05-25",97,1,102,301,6332,0.729153506001263,0,0,546,344,21,5841,24,1396,15,24
"76","2020-05-26",101,1,104,297,6332,0.729153506001263,0,0,546,344,14,5855,18,1414,11,18
"77","2020-05-27",101,1,100,278,6332,0.729153506001263,0,0,546,344,16,5871,18,1432,10,18
"78","2020-05-28",96,1,94,258,6332,0.729153506001263,0,0,546,344,15,5886,9,1441,8,9
"79","2020-05-29",96,1,98,247,6332,0.729153506001263,0,0,546,344,15,5901,12,1453,9,12
"80","2020-05-30",92,1,108,231,6332,0.729153506001263,0,0,546,344,12,5913,22,1475,8,22
"81","2020-05-31",90,1,120,216,6332,0.729153506001263,0,0,546,344,18,5931,19,1494,10,19
"82","2020-06-01",79,1,117,195,6332,0.729153506001263,0,0,546,344,7,5938,16,1510,5,16
"83","2020-06-02",66,1,113,171,6332,0.729153506001263,0,0,546,344,6,5944,15,1525,5,15
"84","2020-06-03",61,1,112,156,6332,0.729153506001263,0,0,546,344,8,5952,17,1542,7,17
"85","2020-06-04",57,1,99,146,6332,0.729153506001263,0,0,546,344,6,5958,7,1549,4,7
"86","2020-06-05",50,1,92,147,6332,0.729153506001263,0,0,546,344,16,5974,11,1560,8,11
"87","2020-06-06",43,1,98,136,6332,0.729153506001263,0,0,546,344,8,5982,14,1574,5,14
"88","2020-06-07",40,1,100,131,6332,0.729153506001263,0,0,546,344,14,5996,16,1590,8,16
"89","2020-03-13",2,2,26,45,4007,0.741452458198153,0,0,382,249,23,61,6,23,2,6
"90","2020-03-14",2,2,28,66,4007,0.741452458198153,0,0,382,249,16,77,17,40,2,17
"91","2020-03-15",5,2,32,86,4007,0.741452458198153,0,0,382,249,18,95,12,52,6,12
"92","2020-03-16",7,2,37,107,4007,0.741452458198153,0,0,382,249,20,115,11,63,10,11
"93","2020-03-17",11,2,35,137,4007,0.741452458198153,0,0,382,249,29,144,11,74,11,11
"94","2020-03-18",17,2,39,175,4007,0.741452458198153,0,0,382,249,32,176,5,79,9,5
"95","2020-03-19",24,2,39,201,4007,0.741452458198153,0,0,382,249,24,200,8,87,9,8
"96","2020-03-20",28,2,25,228,4007,0.741452458198153,0,0,382,249,24,224,6,93,14,6
"97","2020-03-21",40,2,34,262,4007,0.741452458198153,0,0,382,249,24,248,3,96,9,3
"98","2020-03-22",45,2,31,296,4007,0.741452458198153,0,0,382,249,20,268,4,100,8,4
"99","2020-03-23",54,2,25,335,4007,0.741452458198153,0,0,382,249,31,299,2,102,10,2
"100","2020-03-24",72,2,23,365,4007,0.741452458198153,0,0,382,249,39,338,6,108,18,6
"101","2020-03-25",82,2,22,382,4007,0.741452458198153,0,0,382,249,33,371,9,117,11,9
"102","2020-03-26",84,2,25,429,4007,0.741452458198153,0,0,382,249,38,409,9,126,19,9
"103","2020-03-27",96,2,34,457,4007,0.741452458198153,0,0,382,249,35,444,7,133,16,7
"104","2020-03-28",104,2,33,496,4007,0.741452458198153,0,0,382,249,46,490,7,140,26,7
"105","2020-03-29",117,2,47,510,4007,0.741452458198153,0,0,382,249,35,525,11,151,13,11
"106","2020-03-30",129,2,51,533,4007,0.741452458198153,0,0,382,249,32,557,8,159,18,8
"107","2020-03-31",131,2,48,563,4007,0.741452458198153,0,0,382,249,42,599,10,169,22,10
"108","2020-04-01",131,2,48,598,4007,0.741452458198153,0,0,382,249,34,633,16,185,20,16
"109","2020-04-02",143,2,56,607,4007,0.741452458198153,0,0,382,249,38,671,13,198,18,13
"110","2020-04-03",148,2,47,611,4007,0.741452458198153,0,0,382,249,39,710,11,209,19,11
"111","2020-04-04",153,2,44,646,4007,0.741452458198153,0,0,382,249,48,758,7,216,23,7
"112","2020-04-05",157,2,50,677,4007,0.741452458198153,0,0,382,249,40,798,18,234,16,18
"113","2020-04-06",157,2,47,694,4007,0.741452458198153,0,0,382,249,51,849,17,251,26,17
"114","2020-04-07",167,2,50,715,4007,0.741452458198153,0,0,382,249,41,890,17,268,26,17
"115","2020-04-08",180,2,59,725,4007,0.741452458198153,0,0,382,249,51,941,14,282,24,14
"116","2020-04-09",179,2,74,746,4007,0.741452458198153,0,0,382,249,42,983,13,295,19,13
"117","2020-04-10",181,2,76,766,4007,0.741452458198153,0,0,382,249,39,1022,14,309,22,14
"118","2020-04-11",188,2,77,782,4007,0.741452458198153,0,0,382,249,42,1064,19,328,20,19
"119","2020-04-12",199,2,80,755,4007,0.741452458198153,0,0,382,249,39,1103,14,342,18,14
"120","2020-04-13",216,2,75,760,4007,0.741452458198153,0,0,382,249,55,1158,32,374,21,32
"121","2020-04-14",214,2,63,781,4007,0.741452458198153,0,0,382,249,53,1211,20,394,24,20
"122","2020-04-15",220,2,53,799,4007,0.741452458198153,0,0,382,249,44,1255,19,413,29,19
"123","2020-04-16",226,2,38,788,4007,0.741452458198153,0,0,382,249,43,1298,14,427,26,14
"124","2020-04-17",226,2,36,788,4007,0.741452458198153,0,0,382,249,49,1347,10,437,24,10
"125","2020-04-18",231,2,41,779,4007,0.741452458198153,0,0,382,249,42,1389,5,442,21,5
"126","2020-04-19",230,2,64,771,4007,0.741452458198153,0,0,382,249,37,1426,12,454,11,12
"127","2020-04-20",225,2,52,778,4007,0.741452458198153,0,0,382,249,36,1462,25,479,19,25
"128","2020-04-21",228,2,53,795,4007,0.741452458198153,0,0,382,249,38,1500,27,506,17,27
"129","2020-04-22",229,2,60,793,4007,0.741452458198153,0,0,382,249,39,1539,34,540,15,34
"130","2020-04-23",233,2,72,772,4007,0.741452458198153,0,0,382,249,44,1583,22,562,19,22
"131","2020-04-24",238,2,75,755,4007,0.741452458198153,0,0,382,249,40,1623,30,592,15,30
"132","2020-04-25",226,2,71,758,4007,0.741452458198153,0,0,382,249,48,1671,17,609,23,17
"133","2020-04-26",217,2,69,747,4007,0.741452458198153,0,0,382,249,36,1707,13,622,16,13
"134","2020-04-27",201,2,73,749,4007,0.741452458198153,0,0,382,249,44,1751,17,639,12,17
"135","2020-04-28",194,2,73,720,4007,0.741452458198153,0,0,382,249,38,1789,13,652,18,13
"136","2020-04-29",183,2,70,681,4007,0.741452458198153,0,0,382,249,41,1830,13,665,10,13
"137","2020-04-30",185,2,70,688,4007,0.741452458198153,0,0,382,249,53,1883,24,689,26,24
"138","2020-05-01",181,2,66,665,4007,0.741452458198153,0,0,382,249,51,1934,26,715,20,26
"139","2020-05-02",191,2,64,657,4007,0.741452458198153,0,0,382,249,50,1984,30,745,22,30
"140","2020-05-03",191,2,55,628,4007,0.741452458198153,0,0,382,249,51,2035,27,772,27,27
"141","2020-05-04",194,2,48,590,4007,0.741452458198153,0,0,382,249,43,2078,32,804,14,32
"142","2020-05-05",194,2,69,553,4007,0.741452458198153,0,0,382,249,42,2120,22,826,16,22
"143","2020-05-06",189,2,67,534,4007,0.741452458198153,0,0,382,249,39,2159,27,853,20,27
"144","2020-05-07",181,2,60,522,4007,0.741452458198153,0,0,382,249,40,2199,24,877,19,24
"145","2020-05-08",170,2,51,514,4007,0.741452458198153,0,0,382,249,36,2235,26,903,11,26
"146","2020-05-09",155,2,45,508,4007,0.741452458198153,0,0,382,249,27,2262,26,929,10,26
"147","2020-05-10",152,2,60,494,4007,0.741452458198153,0,0,382,249,37,2299,21,950,14,21
"148","2020-05-11",147,2,62,476,4007,0.741452458198153,0,0,382,249,35,2334,24,974,15,24
"149","2020-05-12",140,2,62,457,4007,0.741452458198153,0,0,382,249,30,2364,28,1002,14,28
"150","2020-05-13",141,2,62,443,4007,0.741452458198153,0,0,382,249,30,2394,28,1030,9,28
"151","2020-05-14",132,2,63,421,4007,0.741452458198153,0,0,382,249,31,2425,32,1062,12,32
"152","2020-05-15",126,2,76,413,4007,0.741452458198153,0,0,382,249,21,2446,20,1082,12,20
"153","2020-05-16",124,2,85,391,4007,0.741452458198153,0,0,382,249,28,2474,30,1112,11,30
"154","2020-05-17",112,2,92,387,4007,0.741452458198153,0,0,382,249,19,2493,23,1135,6,23
"155","2020-05-18",107,2,78,388,4007,0.741452458198153,0,0,382,249,23,2516,22,1157,6,22
"156","2020-05-19",108,2,66,373,4007,0.741452458198153,0,0,382,249,25,2541,18,1175,10,18
"157","2020-05-20",107,2,72,363,4007,0.741452458198153,0,0,382,249,13,2554,30,1205,4,30
"158","2020-05-21",98,2,82,354,4007,0.741452458198153,0,0,382,249,27,2581,25,1230,14,25
"159","2020-05-22",105,2,83,341,4007,0.741452458198153,0,0,382,249,19,2600,25,1255,4,25
"160","2020-05-23",99,2,79,319,4007,0.741452458198153,0,0,382,249,24,2624,26,1281,6,26
"161","2020-05-24",103,2,70,307,4007,0.741452458198153,0,0,382,249,20,2644,24,1305,10,24
"162","2020-05-25",101,2,65,288,4007,0.741452458198153,0,0,382,249,23,2667,30,1335,8,30
"163","2020-05-26",90,2,71,278,4007,0.741452458198153,0,0,382,249,19,2686,17,1352,10,17
"164","2020-05-27",81,2,74,261,4007,0.741452458198153,0,0,382,249,23,2709,15,1367,12,15
"165","2020-05-28",89,2,65,252,4007,0.741452458198153,0,0,382,249,14,2723,12,1379,7,12
"166","2020-05-29",83,2,79,229,4007,0.741452458198153,0,0,382,249,15,2738,18,1397,5,18
"167","2020-05-30",72,2,75,223,4007,0.741452458198153,0,0,382,249,20,2758,16,1413,10,16
"168","2020-05-31",62,2,76,217,4007,0.741452458198153,0,0,382,249,23,2781,20,1433,9,20
"169","2020-06-01",54,2,67,206,4007,0.741452458198153,0,0,382,249,19,2800,21,1454,8,21
"170","2020-06-02",54,2,63,197,4007,0.741452458198153,0,0,382,249,20,2820,24,1478,10,24
"171","2020-06-03",50,2,56,190,4007,0.741452458198153,0,0,382,249,20,2840,16,1494,7,16
"172","2020-06-04",51,2,55,178,4007,0.741452458198153,0,0,382,249,10,2850,20,1514,4,20
"173","2020-06-05",48,2,57,172,4007,0.741452458198153,0,0,382,249,18,2868,12,1526,7,12
"174","2020-06-06",57,2,63,167,4007,0.741452458198153,0,0,382,249,20,2888,17,1543,9,17
"175","2020-06-07",59,2,48,153,4007,0.741452458198153,0,0,382,249,14,2902,17,1560,6,17
"176","2020-03-11",1,3,24,18,3603,0.474604496253122,0,0,329,649,8,8,8,10,2,8
"177","2020-03-12",1,3,38,39,3603,0.474604496253122,0,0,329,649,5,13,14,24,1,14
"178","2020-03-13",2,3,67,65,3603,0.474604496253122,0,0,329,649,16,29,3,27,10,3
"179","2020-03-14",5,3,82,88,3603,0.474604496253122,0,0,329,649,13,42,14,41,9,14
"180","2020-03-15",12,3,87,119,3603,0.474604496253122,0,0,329,649,10,52,5,46,10,5
"181","2020-03-16",13,3,95,144,3603,0.474604496253122,0,0,329,649,16,68,8,54,11,8
"182","2020-03-17",21,3,111,171,3603,0.474604496253122,0,0,329,649,24,92,10,64,18,10
"183","2020-03-18",24,3,126,198,3603,0.474604496253122,0,0,329,649,36,128,16,80,29,16
"184","2020-03-19",33,3,139,218,3603,0.474604496253122,0,0,329,649,24,152,11,91,20,11
"185","2020-03-20",38,3,167,246,3603,0.474604496253122,0,0,329,649,32,184,16,107,28,16
"186","2020-03-21",54,3,171,278,3603,0.474604496253122,0,0,329,649,44,228,15,122,40,15
"187","2020-03-22",54,3,190,287,3603,0.474604496253122,0,0,329,649,46,274,26,148,38,26
"188","2020-03-23",71,3,181,308,3603,0.474604496253122,0,0,329,649,47,321,20,168,38,20
"189","2020-03-24",79,3,179,337,3603,0.474604496253122,0,0,329,649,39,360,18,186,37,18
"190","2020-03-25",90,3,168,350,3603,0.474604496253122,0,0,329,649,57,417,12,198,52,12
"191","2020-03-26",89,3,177,378,3603,0.474604496253122,0,0,329,649,52,469,23,221,45,23
"192","2020-03-27",98,3,169,377,3603,0.474604496253122,0,0,329,649,74,543,21,242,64,21
"193","2020-03-28",88,3,186,391,3603,0.474604496253122,0,0,329,649,81,624,19,261,74,19
"194","2020-03-29",96,3,200,404,3603,0.474604496253122,0,0,329,649,70,694,21,282,68,21
"195","2020-03-30",90,3,201,431,3603,0.474604496253122,0,0,329,649,100,794,20,302,94,20
"196","2020-03-31",87,3,189,446,3603,0.474604496253122,0,0,329,649,108,902,21,323,105,21
"197","2020-04-01",89,3,193,457,3603,0.474604496253122,0,0,329,649,112,1014,34,357,99,34
"198","2020-04-02",103,3,182,472,3603,0.474604496253122,0,0,329,649,92,1106,19,376,83,19
"199","2020-04-03",103,3,187,496,3603,0.474604496253122,0,0,329,649,126,1232,17,393,120,17
"200","2020-04-04",120,3,171,497,3603,0.474604496253122,0,0,329,649,144,1376,19,412,137,19
"201","2020-04-05",127,3,176,520,3603,0.474604496253122,0,0,329,649,123,1499,18,430,114,18
"202","2020-04-06",130,3,204,543,3603,0.474604496253122,0,0,329,649,155,1654,8,438,147,8
"203","2020-04-07",148,3,198,554,3603,0.474604496253122,0,0,329,649,129,1783,19,457,121,19
"204","2020-04-08",152,3,193,567,3603,0.474604496253122,0,0,329,649,139,1922,15,472,133,15
"205","2020-04-09",148,3,214,580,3603,0.474604496253122,0,0,329,649,121,2043,16,488,116,16
"206","2020-04-10",151,3,264,599,3603,0.474604496253122,0,0,329,649,133,2176,11,499,125,11
"207","2020-04-11",146,3,259,615,3603,0.474604496253122,0,0,329,649,119,2295,8,507,115,8
"208","2020-04-12",153,3,244,609,3603,0.474604496253122,0,0,329,649,157,2452,5,512,153,5
"209","2020-04-13",156,3,245,624,3603,0.474604496253122,0,0,329,649,141,2593,12,524,135,12
"210","2020-04-14",151,3,249,617,3603,0.474604496253122,0,0,329,649,168,2761,12,536,158,12
"211","2020-04-15",150,3,263,610,3603,0.474604496253122,0,0,329,649,156,2917,20,556,151,20
"212","2020-04-16",156,3,265,603,3603,0.474604496253122,0,0,329,649,132,3049,22,578,127,22
"213","2020-04-17",160,3,270,612,3603,0.474604496253122,0,0,329,649,143,3192,18,596,133,18
"214","2020-04-18",152,3,260,607,3603,0.474604496253122,0,0,329,649,156,3348,17,613,150,17
"215","2020-04-19",145,3,223,607,3603,0.474604496253122,0,0,329,649,146,3494,14,627,140,14
"216","2020-04-20",147,3,230,606,3603,0.474604496253122,0,0,329,649,136,3630,20,647,133,20
"217","2020-04-21",147,3,228,597,3603,0.474604496253122,0,0,329,649,184,3814,16,663,171,16
"218","2020-04-22",149,3,237,586,3603,0.474604496253122,0,0,329,649,138,3952,12,675,134,12
"219","2020-04-23",152,3,249,578,3603,0.474604496253122,0,0,329,649,111,4063,15,690,101,15
"220","2020-04-24",163,3,243,575,3603,0.474604496253122,0,0,329,649,127,4190,16,706,123,16
"221","2020-04-25",179,3,238,567,3603,0.474604496253122,0,0,329,649,103,4293,28,734,97,28
"222","2020-04-26",182,3,213,578,3603,0.474604496253122,0,0,329,649,113,4406,33,767,107,33
"223","2020-04-27",187,3,215,561,3603,0.474604496253122,0,0,329,649,105,4511,29,796,100,29
"224","2020-04-28",192,3,206,563,3603,0.474604496253122,0,0,329,649,88,4599,25,821,81,25
"225","2020-04-29",196,3,190,552,3603,0.474604496253122,0,0,329,649,93,4692,36,857,83,36
"226","2020-04-30",190,3,192,561,3603,0.474604496253122,0,0,329,649,60,4752,25,882,58,25
"227","2020-05-01",172,3,188,553,3603,0.474604496253122,0,0,329,649,77,4829,23,905,70,23
"228","2020-05-02",167,3,185,552,3603,0.474604496253122,0,0,329,649,67,4896,29,934,59,29
"229","2020-05-03",165,3,170,542,3603,0.474604496253122,0,0,329,649,62,4958,23,957,58,23
"230","2020-05-04",155,3,168,534,3603,0.474604496253122,0,0,329,649,66,5024,35,992,63,35
"231","2020-05-05",143,3,186,520,3603,0.474604496253122,0,0,329,649,50,5074,22,1014,46,22
"232","2020-05-06",140,3,203,518,3603,0.474604496253122,0,0,329,649,54,5128,21,1035,49,21
"233","2020-05-07",140,3,242,513,3603,0.474604496253122,0,0,329,649,49,5177,30,1065,47,30
"234","2020-05-08",148,3,231,482,3603,0.474604496253122,0,0,329,649,53,5230,25,1090,48,25
"235","2020-05-09",144,3,249,476,3603,0.474604496253122,0,0,329,649,45,5275,30,1120,43,30
"236","2020-05-10",141,3,261,470,3603,0.474604496253122,0,0,329,649,37,5312,28,1148,34,28
"237","2020-05-11",144,3,251,453,3603,0.474604496253122,0,0,329,649,33,5345,24,1172,32,24
"238","2020-05-12",149,3,241,446,3603,0.474604496253122,0,0,329,649,43,5388,23,1195,42,23
"239","2020-05-13",148,3,245,438,3603,0.474604496253122,0,0,329,649,34,5422,22,1217,30,22
"240","2020-05-14",144,3,242,441,3603,0.474604496253122,0,0,329,649,28,5450,16,1233,27,16
"241","2020-05-15",136,3,252,438,3603,0.474604496253122,0,0,329,649,22,5472,14,1247,22,14
"242","2020-05-16",124,3,279,429,3603,0.474604496253122,0,0,329,649,23,5495,13,1260,20,13
"243","2020-05-17",116,3,301,425,3603,0.474604496253122,0,0,329,649,21,5516,21,1281,19,21
"244","2020-05-18",118,3,309,425,3603,0.474604496253122,0,0,329,649,26,5542,17,1298,25,17
"245","2020-05-19",117,3,309,413,3603,0.474604496253122,0,0,329,649,12,5554,19,1317,8,19
"246","2020-05-20",117,3,291,402,3603,0.474604496253122,0,0,329,649,12,5566,22,1339,9,22
"247","2020-05-21",118,3,298,399,3603,0.474604496253122,0,0,329,649,15,5581,20,1359,14,20
"248","2020-05-22",119,3,283,381,3603,0.474604496253122,0,0,329,649,18,5599,17,1376,15,17
"249","2020-05-23",127,3,277,374,3603,0.474604496253122,0,0,329,649,18,5617,24,1400,14,24
"250","2020-05-24",124,3,246,355,3603,0.474604496253122,0,0,329,649,18,5635,36,1436,15,36
"251","2020-05-25",121,3,244,344,3603,0.474604496253122,0,0,329,649,10,5645,30,1466,9,30
"252","2020-05-26",113,3,233,335,3603,0.474604496253122,0,0,329,649,9,5654,20,1486,9,20
"253","2020-05-27",108,3,211,314,3603,0.474604496253122,0,0,329,649,6,5660,30,1516,4,30
"254","2020-05-28",95,3,203,302,3603,0.474604496253122,0,0,329,649,9,5669,19,1535,6,19
"255","2020-05-29",89,3,196,273,3603,0.474604496253122,0,0,329,649,4,5673,34,1569,3,34
"256","2020-05-30",89,3,190,274,3603,0.474604496253122,0,0,329,649,9,5682,18,1587,8,18
"257","2020-05-31",92,3,195,275,3603,0.474604496253122,0,0,329,649,12,5694,25,1612,9,25
"258","2020-06-01",88,3,202,265,3603,0.474604496253122,0,0,329,649,3,5697,18,1630,3,18
"259","2020-06-02",86,3,231,252,3603,0.474604496253122,0,0,329,649,8,5705,24,1654,7,24
"260","2020-06-03",79,3,221,242,3603,0.474604496253122,0,0,329,649,9,5714,30,1684,9,30
"261","2020-06-04",85,3,189,226,3603,0.474604496253122,0,0,329,649,7,5721,22,1706,7,22
"262","2020-06-05",85,3,181,213,3603,0.474604496253122,0,0,329,649,9,5730,26,1732,8,26
"263","2020-06-06",83,3,177,215,3603,0.474604496253122,0,0,329,649,7,5737,15,1747,7,15
"264","2020-06-07",74,3,160,203,3603,0.474604496253122,0,0,329,649,2,5739,11,1758,1,11
"265","2020-03-13",1,4,48,36,3586,0.776910206358059,0,0,303,315,39,81,19,77,18,19
"266","2020-03-14",1,4,49,48,3586,0.776910206358059,0,0,303,315,44,125,8,85,21,8
"267","2020-03-15",2,4,40,64,3586,0.776910206358059,0,0,303,315,54,179,12,97,30,12
"268","2020-03-16",8,4,32,83,3586,0.776910206358059,0,0,303,315,59,238,8,105,40,8
"269","2020-03-17",16,4,25,103,3586,0.776910206358059,0,0,303,315,74,312,5,110,53,5
"270","2020-03-18",16,4,23,121,3586,0.776910206358059,0,0,303,315,77,389,12,122,54,12
"271","2020-03-19",21,4,26,161,3586,0.776910206358059,0,0,303,315,109,498,3,125,87,3
"272","2020-03-20",26,4,24,193,3586,0.776910206358059,0,0,303,315,118,616,6,131,94,6
"273","2020-03-21",32,4,30,232,3586,0.776910206358059,0,0,303,315,129,745,7,138,108,7
"274","2020-03-22",35,4,28,259,3586,0.776910206358059,0,0,303,315,142,887,3,141,121,3
"275","2020-03-23",37,4,36,269,3586,0.776910206358059,0,0,303,315,161,1048,2,143,142,2
"276","2020-03-24",33,4,36,285,3586,0.776910206358059,0,0,303,315,205,1253,6,149,184,6
"277","2020-03-25",44,4,58,312,3586,0.776910206358059,0,0,303,315,219,1472,30,179,201,30
"278","2020-03-26",54,4,73,326,3586,0.776910206358059,0,0,303,315,232,1704,44,223,213,45
"279","2020-03-27",65,4,67,347,3586,0.776910206358059,0,0,303,315,263,1967,39,262,254,39
"280","2020-03-28",74,4,73,368,3586,0.776910206358059,0,0,303,315,409,2376,25,287,387,25
"281","2020-03-29",83,4,79,388,3586,0.776910206358059,0,0,303,315,355,2731,19,306,337,19
"282","2020-03-30",85,4,92,405,3586,0.776910206358059,0,0,303,315,371,3102,11,317,353,11
"283","2020-03-31",98,4,78,415,3586,0.776910206358059,0,0,303,315,395,3497,10,327,380,10
"284","2020-04-01",98,4,74,434,3586,0.776910206358059,0,0,303,315,394,3891,4,331,376,4
"285","2020-04-02",97,4,82,468,3586,0.776910206358059,0,0,303,315,442,4333,8,339,431,8
"286","2020-04-03",96,4,95,489,3586,0.776910206358059,0,0,303,315,331,4664,9,348,319,9
"287","2020-04-04",97,4,94,505,3586,0.776910206358059,0,0,303,315,282,4946,44,392,274,44
"288","2020-04-05",110,4,96,544,3586,0.776910206358059,0,0,303,315,388,5334,47,439,375,47
"289","2020-04-06",128,4,108,553,3586,0.776910206358059,0,0,303,315,275,5609,25,464,268,25
"290","2020-04-07",130,4,123,569,3586,0.776910206358059,0,0,303,315,273,5882,40,504,260,40
"291","2020-04-08",143,4,132,570,3586,0.776910206358059,0,0,303,315,242,6124,74,578,235,74
"292","2020-04-09",150,4,140,571,3586,0.776910206358059,0,0,303,315,252,6376,35,613,249,35
"293","2020-04-10",151,4,136,605,3586,0.776910206358059,0,0,303,315,188,6564,18,631,184,18
"294","2020-04-11",164,4,116,622,3586,0.776910206358059,0,0,303,315,159,6723,39,670,152,39
"295","2020-04-12",170,4,106,641,3586,0.776910206358059,0,0,303,315,137,6860,28,698,133,28
"296","2020-04-13",165,4,114,662,3586,0.776910206358059,0,0,303,315,92,6952,26,724,86,26
"297","2020-04-14",171,4,114,678,3586,0.776910206358059,0,0,303,315,86,7038,47,771,80,47
"298","2020-04-15",174,4,123,660,3586,0.776910206358059,0,0,303,315,87,7125,58,829,86,58
"299","2020-04-16",184,4,135,667,3586,0.776910206358059,0,0,303,315,56,7181,71,900,53,71
"300","2020-04-17",196,4,133,674,3586,0.776910206358059,0,0,303,315,65,7246,58,958,56,58
"301","2020-04-18",180,4,123,676,3586,0.776910206358059,0,0,303,315,47,7293,34,992,40,34
"302","2020-04-19",169,4,106,660,3586,0.776910206358059,0,0,303,315,38,7331,16,1008,35,16
"303","2020-04-20",176,4,113,662,3586,0.776910206358059,0,0,303,315,36,7367,33,1041,35,33
"304","2020-04-21",179,4,121,654,3586,0.776910206358059,0,0,303,315,21,7388,65,1106,19,65
"305","2020-04-22",181,4,109,666,3586,0.776910206358059,0,0,303,315,32,7420,52,1158,31,52
"306","2020-04-23",173,4,107,656,3586,0.776910206358059,0,0,303,315,13,7433,56,1214,11,56
"307","2020-04-24",177,4,117,649,3586,0.776910206358059,0,0,303,315,20,7453,38,1252,16,38
"308","2020-04-25",190,4,116,648,3586,0.776910206358059,0,0,303,315,19,7472,52,1304,16,52
"309","2020-04-26",199,4,124,630,3586,0.776910206358059,0,0,303,315,15,7487,48,1352,13,48
"310","2020-04-27",198,4,98,616,3586,0.776910206358059,0,0,303,315,11,7498,52,1404,10,52
"311","2020-04-28",199,4,100,606,3586,0.776910206358059,0,0,303,315,7,7505,28,1432,5,28
"312","2020-04-29",200,4,111,585,3586,0.776910206358059,0,0,303,315,11,7516,36,1468,10,36
"313","2020-04-30",209,4,121,560,3586,0.776910206358059,0,0,303,315,8,7524,19,1487,3,19
"314","2020-05-01",193,4,117,555,3586,0.776910206358059,0,0,303,315,11,7535,49,1536,5,49
"315","2020-05-02",194,4,99,556,3586,0.776910206358059,0,0,303,315,6,7541,29,1565,4,29
"316","2020-05-03",184,4,95,558,3586,0.776910206358059,0,0,303,315,5,7546,30,1595,5,30
"317","2020-05-04",183,4,100,541,3586,0.776910206358059,0,0,303,315,7,7553,15,1610,4,15
"318","2020-05-05",170,4,104,530,3586,0.776910206358059,0,0,303,315,5,7558,17,1627,2,17
"319","2020-05-06",164,4,118,538,3586,0.776910206358059,0,0,303,315,4,7562,48,1675,2,48
"320","2020-05-07",147,4,119,512,3586,0.776910206358059,0,0,303,315,2,7564,34,1709,NA,34
"321","2020-05-08",169,4,126,499,3586,0.776910206358059,0,0,303,315,4,7568,64,1773,2,64
"322","2020-05-09",161,4,119,489,3586,0.776910206358059,0,0,303,315,3,7571,55,1828,NA,55
"323","2020-05-10",159,4,113,487,3586,0.776910206358059,0,0,303,315,3,7574,54,1882,1,54
"324","2020-05-11",145,4,125,474,3586,0.776910206358059,0,0,303,315,5,7579,38,1920,3,38
"325","2020-05-12",150,4,127,483,3586,0.776910206358059,0,0,303,315,3,7582,33,1953,NA,33
"326","2020-05-13",144,4,130,475,3586,0.776910206358059,0,0,303,315,2,7584,58,2011,1,58
"327","2020-05-14",142,4,135,463,3586,0.776910206358059,0,0,303,315,2,7586,26,2037,2,26
"328","2020-05-15",123,4,147,463,3586,0.776910206358059,0,0,303,315,4,7590,21,2058,2,21
"329","2020-05-16",119,4,148,461,3586,0.776910206358059,0,0,303,315,1,7591,45,2103,1,45
"330","2020-05-17",115,4,126,446,3586,0.776910206358059,0,0,303,315,1,7592,26,2129,1,26
"331","2020-05-18",127,4,126,423,3586,0.776910206358059,0,0,303,315,2,7594,20,2149,NA,20
"332","2020-05-19",123,4,112,411,3586,0.776910206358059,0,0,303,315,4,7598,26,2175,1,26
"333","2020-05-20",124,4,116,402,3586,0.776910206358059,0,0,303,315,2,7600,36,2211,2,36
"334","2020-05-21",123,4,110,397,3586,0.776910206358059,0,0,303,315,5,7605,58,2269,NA,58
"335","2020-05-22",119,4,122,376,3586,0.776910206358059,0,0,303,315,3,7608,50,2319,2,50
"336","2020-05-23",119,4,124,362,3586,0.776910206358059,0,0,303,315,2,7610,30,2349,1,30
"337","2020-05-24",123,4,112,336,3586,0.776910206358059,0,0,303,315,3,7613,16,2365,1,16
"338","2020-05-25",109,4,102,333,3586,0.776910206358059,0,0,303,315,3,7616,12,2377,1,12
"339","2020-05-26",109,4,98,318,3586,0.776910206358059,0,0,303,315,3,7619,39,2416,1,39
"340","2020-05-27",107,4,93,304,3586,0.776910206358059,0,0,303,315,1,7620,24,2440,1,24
"341","2020-05-28",111,4,82,282,3586,0.776910206358059,0,0,303,315,1,7621,25,2465,NA,25
"342","2020-05-29",102,4,85,273,3586,0.776910206358059,0,0,303,315,3,7624,14,2479,NA,14
"343","2020-05-30",101,4,97,273,3586,0.776910206358059,0,0,303,315,3,7627,19,2498,1,19
"344","2020-05-31",92,4,95,274,3586,0.776910206358059,0,0,303,315,2,7629,41,2539,1,41
"345","2020-06-01",93,4,83,265,3586,0.776910206358059,0,0,303,315,1,7630,38,2577,NA,38
"346","2020-06-02",90,4,67,241,3586,0.776910206358059,0,0,303,315,1,7631,20,2597,NA,20
"347","2020-06-03",81,4,58,231,3586,0.776910206358059,0,0,303,315,1,7632,8,2605,1,8
"348","2020-06-04",70,4,73,220,3586,0.776910206358059,0,0,303,315,1,7633,8,2613,1,8
"349","2020-06-05",71,4,67,199,3586,0.776910206358059,0,0,303,315,1,7634,25,2638,1,25
"350","2020-06-06",64,4,59,195,3586,0.776910206358059,0,0,303,315,NA,NA,13,2651,NA,13
"351","2020-06-07",63,4,46,180,3586,0.776910206358059,0,0,303,315,2,7636,26,2677,1,26
"352","2020-03-14",3,5,28,65,3016,0.595159151193634,0,0,272,249,10,32,9,23,3,9
"353","2020-03-15",7,5,33,78,3016,0.595159151193634,0,0,272,249,15,47,8,31,2,8
"354","2020-03-16",9,5,26,94,3016,0.595159151193634,0,0,272,249,14,61,11,42,10,11
"355","2020-03-17",16,5,27,112,3016,0.595159151193634,0,0,272,249,15,76,9,51,8,9
"356","2020-03-18",19,5,32,137,3016,0.595159151193634,0,0,272,249,13,89,8,59,7,8
"357","2020-03-19",23,5,36,164,3016,0.595159151193634,0,0,272,249,15,104,9,68,12,9
"358","2020-03-20",30,5,38,186,3016,0.595159151193634,0,0,272,249,18,122,29,97,14,29
"359","2020-03-21",37,5,34,217,3016,0.595159151193634,0,0,272,249,24,146,18,115,15,18
"360","2020-03-22",38,5,31,247,3016,0.595159151193634,0,0,272,249,21,167,24,139,14,24
"361","2020-03-23",51,5,27,274,3016,0.595159151193634,0,0,272,249,16,183,27,166,10,27
"362","2020-03-24",52,5,29,291,3016,0.595159151193634,0,0,272,249,30,213,32,198,23,32
"363","2020-03-25",60,5,32,311,3016,0.595159151193634,0,0,272,249,32,245,34,232,25,34
"364","2020-03-26",67,5,33,330,3016,0.595159151193634,0,0,272,249,28,273,21,253,15,21
"365","2020-03-27",70,5,37,341,3016,0.595159151193634,0,0,272,249,26,299,10,263,23,10
"366","2020-03-28",75,5,38,361,3016,0.595159151193634,0,0,272,249,24,323,12,275,18,12
"367","2020-03-29",87,5,45,390,3016,0.595159151193634,0,0,272,249,21,344,18,293,18,18
"368","2020-03-30",88,5,55,404,3016,0.595159151193634,0,0,272,249,31,375,16,309,23,16
"369","2020-03-31",90,5,64,412,3016,0.595159151193634,0,0,272,249,27,402,23,332,19,23
"370","2020-04-01",95,5,68,431,3016,0.595159151193634,0,0,272,249,20,422,15,347,12,15
"371","2020-04-02",104,5,58,444,3016,0.595159151193634,0,0,272,249,37,459,22,369,27,22
"372","2020-04-03",109,5,56,464,3016,0.595159151193634,0,0,272,249,23,482,31,400,16,31
"373","2020-04-04",113,5,47,465,3016,0.595159151193634,0,0,272,249,26,508,23,423,19,23
"374","2020-04-05",126,5,48,476,3016,0.595159151193634,0,0,272,249,29,537,29,452,20,29
"375","2020-04-06",120,5,55,486,3016,0.595159151193634,0,0,272,249,26,563,22,474,20,22
"376","2020-04-07",134,5,72,489,3016,0.595159151193634,0,0,272,249,44,607,23,497,37,23
"377","2020-04-08",127,5,84,489,3016,0.595159151193634,0,0,272,249,39,646,25,522,29,25
"378","2020-04-09",125,5,77,498,3016,0.595159151193634,0,0,272,249,18,664,34,556,13,34
"379","2020-04-10",128,5,76,513,3016,0.595159151193634,0,0,272,249,21,685,26,582,11,26
"380","2020-04-11",128,5,82,526,3016,0.595159151193634,0,0,272,249,33,718,38,620,25,38
"381","2020-04-12",114,5,83,529,3016,0.595159151193634,0,0,272,249,24,742,17,637,16,17
"382","2020-04-13",130,5,94,524,3016,0.595159151193634,0,0,272,249,40,782,36,673,30,36
"383","2020-04-14",129,5,95,538,3016,0.595159151193634,0,0,272,249,36,818,26,699,22,26
"384","2020-04-15",142,5,92,528,3016,0.595159151193634,0,0,272,249,15,833,9,708,11,9
"385","2020-04-16",139,5,69,520,3016,0.595159151193634,0,0,272,249,30,863,13,721,21,13
"386","2020-04-17",146,5,86,526,3016,0.595159151193634,0,0,272,249,38,901,9,730,22,9
"387","2020-04-18",148,5,95,517,3016,0.595159151193634,0,0,272,249,29,930,12,742,22,12
"388","2020-04-19",156,5,100,493,3016,0.595159151193634,0,0,272,249,36,966,28,770,27,28
"389","2020-04-20",155,5,88,478,3016,0.595159151193634,0,0,272,249,35,1001,11,781,29,11
"390","2020-04-21",153,5,85,470,3016,0.595159151193634,0,0,272,249,27,1028,15,796,16,15
"391","2020-04-22",146,5,85,454,3016,0.595159151193634,0,0,272,249,36,1064,15,811,24,15
"392","2020-04-23",141,5,86,448,3016,0.595159151193634,0,0,272,249,29,1093,27,838,20,27
"393","2020-04-24",130,5,87,433,3016,0.595159151193634,0,0,272,249,40,1133,17,855,25,17
"394","2020-04-25",130,5,77,426,3016,0.595159151193634,0,0,272,249,19,1152,36,891,14,36
"395","2020-04-26",119,5,85,431,3016,0.595159151193634,0,0,272,249,36,1188,25,916,21,25
"396","2020-04-27",116,5,86,437,3016,0.595159151193634,0,0,272,249,31,1219,37,953,21,37
"397","2020-04-28",113,5,83,439,3016,0.595159151193634,0,0,272,249,35,1254,21,974,19,21
"398","2020-04-29",119,5,92,407,3016,0.595159151193634,0,0,272,249,29,1283,28,1002,22,28
"399","2020-04-30",123,5,98,403,3016,0.595159151193634,0,0,272,249,25,1308,19,1021,21,19
"400","2020-05-01",124,5,99,401,3016,0.595159151193634,0,0,272,249,24,1332,33,1054,16,33
"401","2020-05-02",109,5,106,402,3016,0.595159151193634,0,0,272,249,25,1357,28,1082,16,28
"402","2020-05-03",114,5,118,382,3016,0.595159151193634,0,0,272,249,25,1382,26,1108,17,26
"403","2020-05-04",114,5,109,382,3016,0.595159151193634,0,0,272,249,27,1409,26,1134,17,26
"404","2020-05-05",116,5,97,378,3016,0.595159151193634,0,0,272,249,37,1446,30,1164,22,30
"405","2020-05-06",117,5,88,369,3016,0.595159151193634,0,0,272,249,38,1484,33,1197,33,33
"406","2020-05-07",119,5,87,371,3016,0.595159151193634,0,0,272,249,18,1502,30,1227,9,30
"407","2020-05-08",126,5,82,366,3016,0.595159151193634,0,0,272,249,30,1532,18,1245,20,18
"408","2020-05-09",134,5,74,355,3016,0.595159151193634,0,0,272,249,34,1566,11,1256,21,11
"409","2020-05-10",130,5,65,337,3016,0.595159151193634,0,0,272,249,13,1579,9,1265,9,9
"410","2020-05-11",122,5,58,337,3016,0.595159151193634,0,0,272,249,42,1621,17,1282,32,17
"411","2020-05-12",111,5,54,337,3016,0.595159151193634,0,0,272,249,32,1653,13,1295,23,13
"412","2020-05-13",103,5,55,334,3016,0.595159151193634,0,0,272,249,23,1676,17,1312,13,17
"413","2020-05-14",97,5,61,325,3016,0.595159151193634,0,0,272,249,28,1704,14,1326,21,14
"414","2020-05-15",84,5,65,326,3016,0.595159151193634,0,0,272,249,23,1727,27,1353,20,27
"415","2020-05-16",80,5,50,318,3016,0.595159151193634,0,0,272,249,33,1760,19,1372,22,19
"416","2020-05-17",82,5,53,327,3016,0.595159151193634,0,0,272,249,33,1793,21,1393,26,21
"417","2020-05-18",84,5,53,325,3016,0.595159151193634,0,0,272,249,19,1812,38,1431,12,38
"418","2020-05-19",85,5,51,325,3016,0.595159151193634,0,0,272,249,27,1839,22,1453,20,22
"419","2020-05-20",92,5,47,310,3016,0.595159151193634,0,0,272,249,24,1863,21,1474,19,21
"420","2020-05-21",98,5,45,315,3016,0.595159151193634,0,0,272,249,21,1884,13,1487,16,13
"421","2020-05-22",98,5,48,325,3016,0.595159151193634,0,0,272,249,26,1910,30,1517,21,30
"422","2020-05-23",97,5,52,319,3016,0.595159151193634,0,0,272,249,23,1933,26,1543,18,26
"423","2020-05-24",96,5,55,315,3016,0.595159151193634,0,0,272,249,24,1957,29,1572,16,29
"424","2020-05-25",96,5,56,309,3016,0.595159151193634,0,0,272,249,27,1984,20,1592,20,20
"425","2020-05-26",99,5,51,305,3016,0.595159151193634,0,0,272,249,39,2023,29,1621,28,29
"426","2020-05-27",88,5,48,294,3016,0.595159151193634,0,0,272,249,30,2053,23,1644,24,23
"427","2020-05-28",85,5,42,295,3016,0.595159151193634,0,0,272,249,16,2069,17,1661,10,17
"428","2020-05-29",99,5,43,292,3016,0.595159151193634,0,0,272,249,26,2095,24,1685,23,24
"429","2020-05-30",99,5,42,262,3016,0.595159151193634,0,0,272,249,24,2119,26,1711,19,26
"430","2020-05-31",89,5,40,258,3016,0.595159151193634,0,0,272,249,19,2138,28,1739,16,28
"431","2020-06-01",84,5,39,252,3016,0.595159151193634,0,0,272,249,25,2163,24,1763,23,24
"432","2020-06-02",86,5,40,247,3016,0.595159151193634,0,0,272,249,30,2193,19,1782,30,19
"433","2020-06-03",82,5,41,247,3016,0.595159151193634,0,0,272,249,29,2222,21,1803,28,21
"434","2020-06-04",73,5,34,251,3016,0.595159151193634,0,0,272,249,21,2243,23,1826,19,23
"435","2020-06-05",65,5,37,252,3016,0.595159151193634,0,0,272,249,27,2270,16,1842,21,16
"436","2020-06-06",68,5,42,247,3016,0.595159151193634,0,0,272,249,32,2302,25,1867,28,25
"437","2020-06-07",74,5,46,227,3016,0.595159151193634,0,0,272,249,16,2318,27,1894,14,27
"438","2020-03-14",2,6,60,58,7669,0.938844699439301,0,0,698,488,17,52,6,43,5,6
"439","2020-03-15",2,6,72,81,7669,0.938844699439301,0,0,698,488,19,71,5,48,3,5
"440","2020-03-16",7,6,65,112,7669,0.938844699439301,0,0,698,488,16,87,5,53,6,5
"441","2020-03-17",13,6,60,159,7669,0.938844699439301,0,0,698,488,22,109,9,62,5,9
"442","2020-03-18",15,6,73,220,7669,0.938844699439301,0,0,698,488,17,126,20,82,10,20
"443","2020-03-19",21,6,58,296,7669,0.938844699439301,0,0,698,488,22,148,14,96,14,14
"444","2020-03-20",28,6,60,391,7669,0.938844699439301,0,0,698,488,26,174,21,117,12,21
"445","2020-03-21",36,6,76,481,7669,0.938844699439301,0,0,698,488,25,199,30,147,10,30
"446","2020-03-22",51,6,90,588,7669,0.938844699439301,0,0,698,488,35,234,18,165,15,18
"447","2020-03-23",65,6,94,727,7669,0.938844699439301,0,0,698,488,30,264,25,190,11,25
"448","2020-03-24",82,6,92,861,7669,0.938844699439301,0,0,698,488,30,294,21,211,9,21
"449","2020-03-25",95,6,81,1053,7669,0.938844699439301,0,0,698,488,22,316,22,233,9,22
"450","2020-03-26",129,6,81,1208,7669,0.938844699439301,0,0,698,488,31,347,20,253,19,20
"451","2020-03-27",173,6,93,1454,7669,0.938844699439301,0,0,698,488,32,379,7,260,22,7
"452","2020-03-28",221,6,92,1679,7669,0.938844699439301,0,0,698,488,30,409,29,289,13,29
"453","2020-03-29",274,6,79,1913,7669,0.938844699439301,0,0,698,488,36,445,26,315,16,26
"454","2020-03-30",329,6,89,2184,7669,0.938844699439301,0,0,698,488,14,459,27,342,9,27
"455","2020-03-31",386,6,95,2457,7669,0.938844699439301,0,0,698,488,29,488,33,375,14,33
"456","2020-04-01",470,6,111,2692,7669,0.938844699439301,0,0,698,488,26,514,41,416,14,41
"457","2020-04-02",536,6,112,2966,7669,0.938844699439301,0,0,698,488,23,537,32,448,8,32
"458","2020-04-03",602,6,98,3111,7669,0.938844699439301,0,0,698,488,28,565,28,476,13,28
"459","2020-04-04",671,6,92,3362,7669,0.938844699439301,0,0,698,488,29,594,13,489,12,13
"460","2020-04-05",721,6,94,3442,7669,0.938844699439301,0,0,698,488,31,625,9,498,15,9
"461","2020-04-06",784,6,92,3669,7669,0.938844699439301,0,0,698,488,37,662,36,534,14,36
"462","2020-04-07",856,6,104,3686,7669,0.938844699439301,0,0,698,488,31,693,21,555,12,21
"463","2020-04-08",907,6,111,3706,7669,0.938844699439301,0,0,698,488,39,732,13,568,17,13
"464","2020-04-09",968,6,116,3597,7669,0.938844699439301,0,0,698,488,39,771,15,583,14,15
"465","2020-04-10",1003,6,130,3444,7669,0.938844699439301,0,0,698,488,36,807,11,594,16,11
"466","2020-04-11",1031,6,166,3302,7669,0.938844699439301,0,0,698,488,39,846,3,597,22,3
"467","2020-04-12",1045,6,163,3140,7669,0.938844699439301,0,0,698,488,38,884,8,605,28,8
"468","2020-04-13",1012,6,155,2933,7669,0.938844699439301,0,0,698,488,46,930,4,609,29,4
"469","2020-04-14",968,6,173,2656,7669,0.938844699439301,0,0,698,488,33,963,7,616,20,7
"470","2020-04-15",944,6,186,2383,7669,0.938844699439301,0,0,698,488,35,998,4,620,21,4
"471","2020-04-16",865,6,186,2157,7669,0.938844699439301,0,0,698,488,40,1038,24,644,17,24
"472","2020-04-17",805,6,175,1929,7669,0.938844699439301,0,0,698,488,47,1085,37,681,30,37
"473","2020-04-18",728,6,185,1736,7669,0.938844699439301,0,0,698,488,32,1117,35,716,19,35
"474","2020-04-19",670,6,195,1519,7669,0.938844699439301,0,0,698,488,35,1152,21,737,13,21
"475","2020-04-20",633,6,219,1296,7669,0.938844699439301,0,0,698,488,32,1184,16,753,11,16
"476","2020-04-21",575,6,220,1123,7669,0.938844699439301,0,0,698,488,34,1218,32,785,19,32
"477","2020-04-22",498,6,201,968,7669,0.938844699439301,0,0,698,488,33,1251,45,830,18,45
"478","2020-04-23",459,6,183,867,7669,0.938844699439301,0,0,698,488,25,1276,44,874,10,44
"479","2020-04-24",406,6,195,727,7669,0.938844699439301,0,0,698,488,33,1309,17,891,16,17
"480","2020-04-25",348,6,180,624,7669,0.938844699439301,0,0,698,488,34,1343,16,907,15,16
"481","2020-04-26",296,6,176,523,7669,0.938844699439301,0,0,698,488,44,1387,33,940,24,33
"482","2020-04-27",248,6,152,436,7669,0.938844699439301,0,0,698,488,33,1420,13,953,18,13
"483","2020-04-28",218,6,128,371,7669,0.938844699439301,0,0,698,488,34,1454,13,966,19,13
"484","2020-04-29",191,6,161,304,7669,0.938844699439301,0,0,698,488,30,1484,14,980,11,14
"485","2020-04-30",154,6,184,251,7669,0.938844699439301,0,0,698,488,32,1516,25,1005,15,25
"486","2020-05-01",127,6,162,218,7669,0.938844699439301,0,0,698,488,32,1548,21,1026,17,21
"487","2020-05-02",111,6,152,186,7669,0.938844699439301,0,0,698,488,36,1584,35,1061,16,35
"488","2020-05-03",96,6,146,165,7669,0.938844699439301,0,0,698,488,22,1606,14,1075,10,14
"489","2020-05-04",84,6,149,139,7669,0.938844699439301,0,0,698,488,34,1640,15,1090,18,15
"490","2020-05-05",66,6,166,113,7669,0.938844699439301,0,0,698,488,32,1672,24,1114,15,24
"491","2020-05-06",49,6,158,99,7669,0.938844699439301,0,0,698,488,32,1704,11,1125,21,11
"492","2020-05-07",41,6,171,86,7669,0.938844699439301,0,0,698,488,38,1742,13,1138,16,13
"493","2020-05-08",35,6,165,78,7669,0.938844699439301,0,0,698,488,39,1781,17,1155,23,17
"494","2020-05-09",33,6,183,71,7669,0.938844699439301,0,0,698,488,27,1808,10,1165,13,10
"495","2020-05-10",27,6,168,66,7669,0.938844699439301,0,0,698,488,33,1841,9,1174,19,9
"496","2020-05-11",23,6,148,56,7669,0.938844699439301,0,0,698,488,30,1871,15,1189,19,15
"497","2020-05-12",21,6,133,53,7669,0.938844699439301,0,0,698,488,39,1910,15,1204,22,15
"498","2020-05-13",19,6,146,46,7669,0.938844699439301,0,0,698,488,28,1938,12,1216,19,12
"499","2020-05-14",16,6,132,43,7669,0.938844699439301,0,0,698,488,34,1972,40,1256,16,40
"500","2020-05-15",15,6,112,40,7669,0.938844699439301,0,0,698,488,30,2002,23,1279,14,23
"501","2020-05-16",14,6,121,36,7669,0.938844699439301,0,0,698,488,29,2031,35,1314,12,35
"502","2020-05-17",15,6,124,32,7669,0.938844699439301,0,0,698,488,29,2060,16,1330,18,16
"503","2020-05-18",15,6,138,29,7669,0.938844699439301,0,0,698,488,24,2084,33,1363,8,33
"504","2020-05-19",16,6,149,28,7669,0.938844699439301,0,0,698,488,19,2103,37,1400,8,37
"505","2020-05-20",14,6,145,26,7669,0.938844699439301,0,0,698,488,22,2125,22,1422,12,22
"506","2020-05-21",16,6,160,23,7669,0.938844699439301,0,0,698,488,23,2148,14,1436,11,14
"507","2020-05-22",13,6,164,25,7669,0.938844699439301,0,0,698,488,18,2166,16,1452,8,16
"508","2020-05-23",15,6,154,24,7669,0.938844699439301,0,0,698,488,24,2190,15,1467,12,15
"509","2020-05-24",13,6,146,20,7669,0.938844699439301,0,0,698,488,21,2211,37,1504,6,37
"510","2020-05-25",10,6,145,23,7669,0.938844699439301,0,0,698,488,16,2227,30,1534,6,30
"511","2020-05-26",10,6,129,24,7669,0.938844699439301,0,0,698,488,13,2240,32,1566,2,32
"512","2020-05-27",9,6,115,24,7669,0.938844699439301,0,0,698,488,18,2258,27,1593,9,27
"513","2020-05-28",8,6,103,25,7669,0.938844699439301,0,0,698,488,17,2275,24,1617,8,24
"514","2020-05-29",6,6,111,26,7669,0.938844699439301,0,0,698,488,18,2293,36,1653,5,36
"515","2020-05-30",4,6,114,26,7669,0.938844699439301,0,0,698,488,8,2301,19,1672,4,19
"516","2020-05-31",6,6,110,27,7669,0.938844699439301,0,0,698,488,15,2316,15,1687,9,15
"517","2020-06-01",9,6,104,27,7669,0.938844699439301,0,0,698,488,8,2324,16,1703,1,16
"518","2020-06-02",8,6,95,23,7669,0.938844699439301,0,0,698,488,10,2334,26,1729,4,26
"519","2020-06-03",9,6,92,21,7669,0.938844699439301,0,0,698,488,16,2350,12,1741,5,12
"520","2020-06-04",8,6,90,20,7669,0.938844699439301,0,0,698,488,8,2358,23,1764,2,23
"521","2020-06-05",9,6,90,19,7669,0.938844699439301,0,0,698,488,6,2364,25,1789,5,25
"522","2020-06-06",8,6,94,19,7669,0.938844699439301,0,0,698,488,14,2378,22,1811,8,22
"523","2020-06-07",7,6,85,17,7669,0.938844699439301,0,0,698,488,9,2387,14,1825,6,14
"524","2020-03-15",2,7,43,116,3484,0.398105625717566,0,0,339,227,11,36,4,30,2,4
"525","2020-03-16",7,7,45,140,3484,0.398105625717566,0,0,339,227,15,51,16,46,6,16
"526","2020-03-17",15,7,48,160,3484,0.398105625717566,0,0,339,227,15,66,10,56,5,10
"527","2020-03-18",23,7,41,186,3484,0.398105625717566,0,0,339,227,20,86,8,64,8,8
"528","2020-03-19",24,7,45,210,3484,0.398105625717566,0,0,339,227,16,102,17,81,10,17
"529","2020-03-20",32,7,38,239,3484,0.398105625717566,0,0,339,227,24,126,1,82,16,1
"530","2020-03-21",43,7,31,264,3484,0.398105625717566,0,0,339,227,16,142,9,91,13,9
"531","2020-03-22",51,7,25,289,3484,0.398105625717566,0,0,339,227,30,172,17,108,13,17
"532","2020-03-23",62,7,27,316,3484,0.398105625717566,0,0,339,227,24,196,15,123,16,15
"533","2020-03-24",72,7,27,340,3484,0.398105625717566,0,0,339,227,23,219,10,133,22,10
"534","2020-03-25",74,7,38,360,3484,0.398105625717566,0,0,339,227,17,236,15,148,11,15
"535","2020-03-26",86,7,50,386,3484,0.398105625717566,0,0,339,227,36,272,20,168,25,20
"536","2020-03-27",95,7,50,393,3484,0.398105625717566,0,0,339,227,29,301,22,190,22,22
"537","2020-03-28",102,7,47,418,3484,0.398105625717566,0,0,339,227,33,334,12,202,23,12
"538","2020-03-29",121,7,51,432,3484,0.398105625717566,0,0,339,227,22,356,12,214,19,12
"539","2020-03-30",122,7,51,444,3484,0.398105625717566,0,0,339,227,35,391,16,230,29,16
"540","2020-03-31",117,7,46,444,3484,0.398105625717566,0,0,339,227,34,425,8,238,25,8
"541","2020-04-01",129,7,52,452,3484,0.398105625717566,0,0,339,227,39,464,11,249,29,11
"542","2020-04-02",137,7,55,455,3484,0.398105625717566,0,0,339,227,36,500,26,275,31,26
"543","2020-04-03",131,7,59,444,3484,0.398105625717566,0,0,339,227,32,532,19,294,23,19
"544","2020-04-04",133,7,60,463,3484,0.398105625717566,0,0,339,227,32,564,13,307,25,13
"545","2020-04-05",122,7,53,468,3484,0.398105625717566,0,0,339,227,30,594,31,338,19,31
"546","2020-04-06",119,7,54,474,3484,0.398105625717566,0,0,339,227,24,618,17,355,17,17
"547","2020-04-07",125,7,62,480,3484,0.398105625717566,0,0,339,227,39,657,43,398,27,43
"548","2020-04-08",117,7,62,488,3484,0.398105625717566,0,0,339,227,34,691,24,422,23,24
"549","2020-04-09",114,7,52,502,3484,0.398105625717566,0,0,339,227,38,729,39,461,32,39
"550","2020-04-10",125,7,49,485,3484,0.398105625717566,0,0,339,227,36,765,33,494,26,33
"551","2020-04-11",122,7,54,491,3484,0.398105625717566,0,0,339,227,37,802,35,529,29,35
"552","2020-04-12",123,7,50,517,3484,0.398105625717566,0,0,339,227,39,841,35,564,30,35
"553","2020-04-13",132,7,55,527,3484,0.398105625717566,0,0,339,227,38,879,34,598,30,34
"554","2020-04-14",135,7,62,555,3484,0.398105625717566,0,0,339,227,26,905,29,627,20,29
"555","2020-04-15",142,7,71,559,3484,0.398105625717566,0,0,339,227,48,953,22,649,34,22
"556","2020-04-16",142,7,65,565,3484,0.398105625717566,0,0,339,227,29,982,11,660,23,11
"557","2020-04-17",143,7,71,573,3484,0.398105625717566,0,0,339,227,39,1021,7,667,27,7
"558","2020-04-18",154,7,71,584,3484,0.398105625717566,0,0,339,227,35,1056,6,673,30,6
"559","2020-04-19",169,7,65,587,3484,0.398105625717566,0,0,339,227,43,1099,9,682,33,9
"560","2020-04-20",167,7,80,606,3484,0.398105625717566,0,0,339,227,39,1138,28,710,22,28
"561","2020-04-21",164,7,77,589,3484,0.398105625717566,0,0,339,227,33,1171,41,751,22,41
"562","2020-04-22",166,7,75,594,3484,0.398105625717566,0,0,339,227,33,1204,35,786,25,35
"563","2020-04-23",170,7,71,588,3484,0.398105625717566,0,0,339,227,43,1247,8,794,26,8
"564","2020-04-24",169,7,64,576,3484,0.398105625717566,0,0,339,227,22,1269,11,805,18,11
"565","2020-04-25",158,7,52,577,3484,0.398105625717566,0,0,339,227,44,1313,10,815,39,10
"566","2020-04-26",145,7,50,561,3484,0.398105625717566,0,0,339,227,38,1351,22,837,31,22
"567","2020-04-27",149,7,44,542,3484,0.398105625717566,0,0,339,227,25,1376,21,858,20,21
"568","2020-04-28",160,7,50,546,3484,0.398105625717566,0,0,339,227,40,1416,7,865,28,7
"569","2020-04-29",164,7,45,557,3484,0.398105625717566,0,0,339,227,37,1453,2,867,24,2
"570","2020-04-30",167,7,45,551,3484,0.398105625717566,0,0,339,227,34,1487,10,877,28,10
"571","2020-05-01",161,7,70,548,3484,0.398105625717566,0,0,339,227,18,1505,17,894,14,17
"572","2020-05-02",168,7,86,536,3484,0.398105625717566,0,0,339,227,45,1550,11,905,35,11
"573","2020-05-03",163,7,96,544,3484,0.398105625717566,0,0,339,227,42,1592,29,934,29,29
"574","2020-05-04",175,7,107,556,3484,0.398105625717566,0,0,339,227,44,1636,29,963,34,29
"575","2020-05-05",163,7,110,540,3484,0.398105625717566,0,0,339,227,36,1672,31,994,32,31
"576","2020-05-06",162,7,121,526,3484,0.398105625717566,0,0,339,227,38,1710,26,1020,30,26
"577","2020-05-07",151,7,112,518,3484,0.398105625717566,0,0,339,227,37,1747,42,1062,29,42
"578","2020-05-08",157,7,107,506,3484,0.398105625717566,0,0,339,227,28,1775,16,1078,22,16
"579","2020-05-09",147,7,123,501,3484,0.398105625717566,0,0,339,227,28,1803,15,1093,22,15
"580","2020-05-10",164,7,123,487,3484,0.398105625717566,0,0,339,227,31,1834,16,1109,23,16
"581","2020-05-11",147,7,123,469,3484,0.398105625717566,0,0,339,227,34,1868,8,1117,26,8
"582","2020-05-12",145,7,113,450,3484,0.398105625717566,0,0,339,227,30,1898,11,1128,21,11
"583","2020-05-13",133,7,109,448,3484,0.398105625717566,0,0,339,227,20,1918,32,1160,19,32
"584","2020-05-14",137,7,112,444,3484,0.398105625717566,0,0,339,227,34,1952,16,1176,24,16
"585","2020-05-15",128,7,127,453,3484,0.398105625717566,0,0,339,227,28,1980,14,1190,24,14
"586","2020-05-16",137,7,127,438,3484,0.398105625717566,0,0,339,227,24,2004,17,1207,17,17
"587","2020-05-17",123,7,127,425,3484,0.398105625717566,0,0,339,227,25,2029,29,1236,22,29
"588","2020-05-18",119,7,116,405,3484,0.398105625717566,0,0,339,227,29,2058,34,1270,21,34
"589","2020-05-19",116,7,105,385,3484,0.398105625717566,0,0,339,227,25,2083,19,1289,20,19
"590","2020-05-20",122,7,95,375,3484,0.398105625717566,0,0,339,227,30,2113,14,1303,21,14
"591","2020-05-21",122,7,96,369,3484,0.398105625717566,0,0,339,227,19,2132,27,1330,12,27
"592","2020-05-22",122,7,85,365,3484,0.398105625717566,0,0,339,227,26,2158,48,1378,21,48
"593","2020-05-23",116,7,86,354,3484,0.398105625717566,0,0,339,227,13,2171,21,1399,9,21
"594","2020-05-24",116,7,87,342,3484,0.398105625717566,0,0,339,227,26,2197,32,1431,21,32
"595","2020-05-25",112,7,96,323,3484,0.398105625717566,0,0,339,227,15,2212,36,1467,9,36
"596","2020-05-26",110,7,95,321,3484,0.398105625717566,0,0,339,227,15,2227,40,1507,11,40
"597","2020-05-27",102,7,99,311,3484,0.398105625717566,0,0,339,227,17,2244,28,1535,12,28
"598","2020-05-28",97,7,92,295,3484,0.398105625717566,0,0,339,227,18,2262,32,1567,13,32
"599","2020-05-29",92,7,87,279,3484,0.398105625717566,0,0,339,227,12,2274,31,1598,10,31
"600","2020-05-30",87,7,80,282,3484,0.398105625717566,0,0,339,227,19,2293,24,1622,14,24
"601","2020-05-31",76,7,69,265,3484,0.398105625717566,0,0,339,227,14,2307,30,1652,6,30
"602","2020-06-01",78,7,65,242,3484,0.398105625717566,0,0,339,227,12,2319,24,1676,9,24
"603","2020-06-02",80,7,62,231,3484,0.398105625717566,0,0,339,227,11,2330,35,1711,10,35
"604","2020-06-03",80,7,51,222,3484,0.398105625717566,0,0,339,227,13,2343,28,1739,12,28
"605","2020-06-04",73,7,47,222,3484,0.398105625717566,0,0,339,227,14,2357,30,1769,10,30
"606","2020-06-05",71,7,44,215,3484,0.398105625717566,0,0,339,227,12,2369,8,1777,9,8
"607","2020-06-06",67,7,39,196,3484,0.398105625717566,0,0,339,227,19,2388,8,1785,14,8
"608","2020-06-07",65,7,40,200,3484,0.398105625717566,0,0,339,227,5,2393,17,1802,3,17
"609","2020-03-14",4,8,50,68,2991,0.491140086927449,0,0,284,660,22,76,5,26,2,5
"610","2020-03-15",6,8,54,84,2991,0.491140086927449,0,0,284,660,25,101,2,28,5,2
"611","2020-03-16",9,8,80,103,2991,0.491140086927449,0,0,284,660,23,124,2,30,10,2
"612","2020-03-17",17,8,91,134,2991,0.491140086927449,0,0,284,660,22,146,2,32,10,2
"613","2020-03-18",19,8,90,154,2991,0.491140086927449,0,0,284,660,23,169,9,41,9,9
"614","2020-03-19",25,8,95,182,2991,0.491140086927449,0,0,284,660,24,193,15,56,11,15
"615","2020-03-20",33,8,110,204,2991,0.491140086927449,0,0,284,660,21,214,6,62,13,6
"616","2020-03-21",39,8,107,236,2991,0.491140086927449,0,0,284,660,29,243,2,64,13,2
"617","2020-03-22",43,8,121,256,2991,0.491140086927449,0,0,284,660,30,273,9,73,18,9
"618","2020-03-23",48,8,109,276,2991,0.491140086927449,0,0,284,660,23,296,10,83,13,10
"619","2020-03-24",52,8,106,303,2991,0.491140086927449,0,0,284,660,30,326,17,100,17,17
"620","2020-03-25",61,8,128,307,2991,0.491140086927449,0,0,284,660,25,351,12,112,16,12
"621","2020-03-26",72,8,139,314,2991,0.491140086927449,0,0,284,660,30,381,8,120,15,8
"622","2020-03-27",79,8,148,336,2991,0.491140086927449,0,0,284,660,18,399,14,134,11,14
"623","2020-03-28",85,8,172,350,2991,0.491140086927449,0,0,284,660,24,423,28,162,16,28
"624","2020-03-29",91,8,185,356,2991,0.491140086927449,0,0,284,660,26,449,9,171,8,9
"625","2020-03-30",94,8,207,356,2991,0.491140086927449,0,0,284,660,24,473,11,182,14,11
"626","2020-03-31",96,8,215,364,2991,0.491140086927449,0,0,284,660,27,500,13,195,18,13
"627","2020-04-01",97,8,247,363,2991,0.491140086927449,0,0,284,660,44,544,9,204,23,9
"628","2020-04-02",96,8,252,363,2991,0.491140086927449,0,0,284,660,26,570,4,208,18,4
"629","2020-04-03",92,8,238,380,2991,0.491140086927449,0,0,284,660,27,597,9,217,10,9
"630","2020-04-04",88,8,224,384,2991,0.491140086927449,0,0,284,660,31,628,10,227,17,10
"631","2020-04-05",96,8,202,380,2991,0.491140086927449,0,0,284,660,32,660,20,247,21,20
"632","2020-04-06",95,8,197,373,2991,0.491140086927449,0,0,284,660,31,691,11,258,20,11
"633","2020-04-07",97,8,184,388,2991,0.491140086927449,0,0,284,660,32,723,2,260,19,2
"634","2020-04-08",95,8,176,404,2991,0.491140086927449,0,0,284,660,37,760,8,268,21,8
"635","2020-04-09",91,8,171,416,2991,0.491140086927449,0,0,284,660,25,785,10,278,11,10
"636","2020-04-10",99,8,164,433,2991,0.491140086927449,0,0,284,660,38,823,5,283,26,5
"637","2020-04-11",115,8,161,453,2991,0.491140086927449,0,0,284,660,35,858,3,286,15,3
"638","2020-04-12",108,8,184,462,2991,0.491140086927449,0,0,284,660,32,890,13,299,19,13
"639","2020-04-13",122,8,211,469,2991,0.491140086927449,0,0,284,660,21,911,10,309,11,10
"640","2020-04-14",118,8,199,473,2991,0.491140086927449,0,0,284,660,26,937,12,321,15,12
"641","2020-04-15",124,8,206,497,2991,0.491140086927449,0,0,284,660,36,973,23,344,20,23
"642","2020-04-16",132,8,210,501,2991,0.491140086927449,0,0,284,660,34,1007,5,349,14,5
"643","2020-04-17",136,8,228,516,2991,0.491140086927449,0,0,284,660,30,1037,6,355,11,6
"644","2020-04-18",131,8,227,520,2991,0.491140086927449,0,0,284,660,31,1068,20,375,17,20
"645","2020-04-19",133,8,223,543,2991,0.491140086927449,0,0,284,660,26,1094,17,392,9,17
"646","2020-04-20",127,8,224,541,2991,0.491140086927449,0,0,284,660,34,1128,26,418,17,26
"647","2020-04-21",142,8,224,543,2991,0.491140086927449,0,0,284,660,34,1162,27,445,15,27
"648","2020-04-22",147,8,209,542,2991,0.491140086927449,0,0,284,660,42,1204,23,468,18,23
"649","2020-04-23",144,8,208,535,2991,0.491140086927449,0,0,284,660,30,1234,28,496,13,28
"650","2020-04-24",148,8,212,535,2991,0.491140086927449,0,0,284,660,23,1257,12,508,10,12
"651","2020-04-25",145,8,223,525,2991,0.491140086927449,0,0,284,660,37,1294,21,529,17,21
"652","2020-04-26",154,8,253,521,2991,0.491140086927449,0,0,284,660,29,1323,14,543,17,14
"653","2020-04-27",159,8,256,510,2991,0.491140086927449,0,0,284,660,20,1343,13,556,7,13
"654","2020-04-28",159,8,257,508,2991,0.491140086927449,0,0,284,660,27,1370,17,573,9,17
"655","2020-04-29",153,8,258,497,2991,0.491140086927449,0,0,284,660,17,1387,14,587,7,14
"656","2020-04-30",161,8,265,475,2991,0.491140086927449,0,0,284,660,28,1415,19,606,7,19
"657","2020-05-01",153,8,268,472,2991,0.491140086927449,0,0,284,660,19,1434,14,620,4,14
"658","2020-05-02",151,8,244,462,2991,0.491140086927449,0,0,284,660,27,1461,9,629,6,9
"659","2020-05-03",140,8,229,448,2991,0.491140086927449,0,0,284,660,28,1489,9,638,6,9
"660","2020-05-04",140,8,214,456,2991,0.491140086927449,0,0,284,660,31,1520,9,647,9,9
"661","2020-05-05",134,8,195,454,2991,0.491140086927449,0,0,284,660,31,1551,17,664,13,17
"662","2020-05-06",142,8,190,442,2991,0.491140086927449,0,0,284,660,16,1567,12,676,12,12
"663","2020-05-07",129,8,179,420,2991,0.491140086927449,0,0,284,660,33,1600,8,684,12,8
"664","2020-05-08",122,8,175,427,2991,0.491140086927449,0,0,284,660,26,1626,16,700,7,16
"665","2020-05-09",117,8,189,421,2991,0.491140086927449,0,0,284,660,19,1645,18,718,8,18
"666","2020-05-10",127,8,190,422,2991,0.491140086927449,0,0,284,660,26,1671,40,758,6,40
"667","2020-05-11",119,8,182,403,2991,0.491140086927449,0,0,284,660,24,1695,23,781,5,23
"668","2020-05-12",112,8,172,395,2991,0.491140086927449,0,0,284,660,23,1718,14,795,7,14
"669","2020-05-13",101,8,166,390,2991,0.491140086927449,0,0,284,660,17,1735,16,811,6,16
"670","2020-05-14",106,8,174,388,2991,0.491140086927449,0,0,284,660,32,1767,11,822,12,11
"671","2020-05-15",114,8,181,362,2991,0.491140086927449,0,0,284,660,25,1792,10,832,13,10
"672","2020-05-16",113,8,203,367,2991,0.491140086927449,0,0,284,660,12,1804,11,843,4,11
"673","2020-05-17",104,8,223,338,2991,0.491140086927449,0,0,284,660,15,1819,10,853,8,10
"674","2020-05-18",104,8,211,340,2991,0.491140086927449,0,0,284,660,21,1840,7,860,10,7
"675","2020-05-19",100,8,207,335,2991,0.491140086927449,0,0,284,660,18,1858,3,863,7,3
"676","2020-05-20",107,8,210,324,2991,0.491140086927449,0,0,284,660,22,1880,6,869,6,6
"677","2020-05-21",98,8,209,320,2991,0.491140086927449,0,0,284,660,19,1899,4,873,8,4
"678","2020-05-22",92,8,205,314,2991,0.491140086927449,0,0,284,660,14,1913,15,888,7,15
"679","2020-05-23",91,8,200,301,2991,0.491140086927449,0,0,284,660,17,1930,14,902,5,14
"680","2020-05-24",88,8,213,285,2991,0.491140086927449,0,0,284,660,17,1947,13,915,7,13
"681","2020-05-25",86,8,223,287,2991,0.491140086927449,0,0,284,660,21,1968,25,940,7,25
"682","2020-05-26",90,8,239,265,2991,0.491140086927449,0,0,284,660,14,1982,20,960,7,20
"683","2020-05-27",80,8,250,259,2991,0.491140086927449,0,0,284,660,17,1999,14,974,10,14
"684","2020-05-28",80,8,254,247,2991,0.491140086927449,0,0,284,660,6,2005,12,986,2,12
"685","2020-05-29",79,8,266,246,2991,0.491140086927449,0,0,284,660,19,2024,15,1001,6,15
"686","2020-05-30",76,8,274,246,2991,0.491140086927449,0,0,284,660,18,2042,7,1008,7,7
"687","2020-05-31",77,8,279,232,2991,0.491140086927449,0,0,284,660,19,2061,6,1014,6,6
"688","2020-06-01",79,8,251,223,2991,0.491140086927449,0,0,284,660,13,2074,6,1020,5,6
"689","2020-06-02",73,8,240,211,2991,0.491140086927449,0,0,284,660,16,2090,9,1029,11,9
"690","2020-06-03",73,8,241,202,2991,0.491140086927449,0,0,284,660,16,2106,15,1044,11,15
"691","2020-06-04",69,8,237,181,2991,0.491140086927449,0,0,284,660,12,2118,13,1057,5,13
"692","2020-06-05",63,8,227,173,2991,0.491140086927449,0,0,284,660,12,2130,16,1073,7,16
"693","2020-06-06",64,8,217,165,2991,0.491140086927449,0,0,284,660,17,2147,7,1080,8,7
"694","2020-06-07",58,8,198,158,2991,0.491140086927449,0,0,284,660,13,2160,15,1095,8,15
"695","2020-03-16",1,9,27,36,7040,0.9734375,0,0,611,334,4,36,13,67,4,13
"696","2020-03-17",1,9,33,49,7040,0.9734375,0,0,611,334,10,46,7,74,7,7
"697","2020-03-18",2,9,32,54,7040,0.9734375,0,0,611,334,12,58,4,78,9,4
"698","2020-03-19",3,9,34,67,7040,0.9734375,0,0,611,334,16,74,2,80,12,2
"699","2020-03-20",7,9,38,80,7040,0.9734375,0,0,611,334,13,87,14,94,9,14
"700","2020-03-21",10,9,35,95,7040,0.9734375,0,0,611,334,13,100,27,121,10,27
"701","2020-03-22",14,9,40,112,7040,0.9734375,0,0,611,334,24,124,9,130,21,9
"702","2020-03-23",17,9,45,139,7040,0.9734375,0,0,611,334,20,144,7,137,17,7
"703","2020-03-24",22,9,64,155,7040,0.9734375,0,0,611,334,29,173,6,143,22,6
"704","2020-03-25",29,9,65,187,7040,0.9734375,0,0,611,334,18,191,6,149,17,6
"705","2020-03-26",39,9,72,223,7040,0.9734375,0,0,611,334,31,222,2,151,28,2
"706","2020-03-27",38,9,77,266,7040,0.9734375,0,0,611,334,33,255,7,158,29,7
"707","2020-03-28",46,9,69,296,7040,0.9734375,0,0,611,334,32,287,34,192,31,34
"708","2020-03-29",50,9,64,342,7040,0.9734375,0,0,611,334,26,313,18,210,25,18
"709","2020-03-30",58,9,67,387,7040,0.9734375,0,0,611,334,35,348,29,239,33,29
"710","2020-03-31",61,9,73,449,7040,0.9734375,0,0,611,334,40,388,20,259,35,20
"711","2020-04-01",67,9,64,542,7040,0.9734375,0,0,611,334,53,441,13,272,51,13
"712","2020-04-02",76,9,91,613,7040,0.9734375,0,0,611,334,49,490,23,295,46,23
"713","2020-04-03",104,9,118,714,7040,0.9734375,0,0,611,334,42,532,11,306,41,11
"714","2020-04-04",123,9,118,841,7040,0.9734375,0,0,611,334,54,586,9,315,53,9
"715","2020-04-05",145,9,119,962,7040,0.9734375,0,0,611,334,79,665,31,346,71,31
"716","2020-04-06",168,9,120,1103,7040,0.9734375,0,0,611,334,56,721,21,367,54,21
"717","2020-04-07",204,9,127,1247,7040,0.9734375,0,0,611,334,48,769,28,395,47,28
"718","2020-04-08",242,9,134,1443,7040,0.9734375,0,0,611,334,71,840,16,411,64,16
"719","2020-04-09",287,9,134,1620,7040,0.9734375,0,0,611,334,61,901,16,427,58,16
"720","2020-04-10",303,9,116,1832,7040,0.9734375,0,0,611,334,58,959,25,452,52,25
"721","2020-04-11",335,9,121,1956,7040,0.9734375,0,0,611,334,75,1034,13,465,71,13
"722","2020-04-12",389,9,128,2093,7040,0.9734375,0,0,611,334,70,1104,24,489,66,24
"723","2020-04-13",440,9,141,2265,7040,0.9734375,0,0,611,334,65,1169,18,507,63,18
"724","2020-04-14",486,9,145,2401,7040,0.9734375,0,0,611,334,52,1221,20,527,49,20
"725","2020-04-15",522,9,148,2550,7040,0.9734375,0,0,611,334,74,1295,14,541,70,14
"726","2020-04-16",568,9,140,2618,7040,0.9734375,0,0,611,334,86,1381,31,572,83,31
"727","2020-04-17",624,9,111,2728,7040,0.9734375,0,0,611,334,88,1469,11,583,84,11
"728","2020-04-18",654,9,111,2776,7040,0.9734375,0,0,611,334,93,1562,15,598,90,15
"729","2020-04-19",697,9,121,2814,7040,0.9734375,0,0,611,334,82,1644,33,631,78,33
"730","2020-04-20",738,9,107,2825,7040,0.9734375,0,0,611,334,105,1749,49,680,99,49
"731","2020-04-21",753,9,100,2778,7040,0.9734375,0,0,611,334,74,1823,44,724,70,44
"732","2020-04-22",775,9,116,2739,7040,0.9734375,0,0,611,334,77,1900,39,763,73,39
"733","2020-04-23",772,9,120,2670,7040,0.9734375,0,0,611,334,63,1963,55,818,60,55
"734","2020-04-24",771,9,127,2582,7040,0.9734375,0,0,611,334,73,2036,41,859,68,41
"735","2020-04-25",790,9,133,2469,7040,0.9734375,0,0,611,334,48,2084,30,889,46,30
"736","2020-04-26",774,9,138,2315,7040,0.9734375,0,0,611,334,64,2148,26,915,62,26
"737","2020-04-27",752,9,133,2152,7040,0.9734375,0,0,611,334,67,2215,27,942,62,27
"738","2020-04-28",735,9,114,2007,7040,0.9734375,0,0,611,334,77,2292,37,979,73,37
"739","2020-04-29",712,9,96,1848,7040,0.9734375,0,0,611,334,55,2347,45,1024,53,45
"740","2020-04-30",679,9,94,1683,7040,0.9734375,0,0,611,334,62,2409,29,1053,60,29
"741","2020-05-01",666,9,104,1533,7040,0.9734375,0,0,611,334,81,2490,17,1070,79,17
"742","2020-05-02",606,9,114,1400,7040,0.9734375,0,0,611,334,69,2559,40,1110,64,40
"743","2020-05-03",568,9,131,1237,7040,0.9734375,0,0,611,334,60,2619,56,1166,58,56
"744","2020-05-04",520,9,125,1119,7040,0.9734375,0,0,611,334,53,2672,45,1211,50,45
"745","2020-05-05",475,9,122,1000,7040,0.9734375,0,0,611,334,55,2727,31,1242,53,31
"746","2020-05-06",426,9,114,867,7040,0.9734375,0,0,611,334,65,2792,14,1256,64,14
"747","2020-05-07",389,9,106,746,7040,0.9734375,0,0,611,334,33,2825,17,1273,32,17
"748","2020-05-08",325,9,101,636,7040,0.9734375,0,0,611,334,56,2881,4,1277,52,4
"749","2020-05-09",303,9,94,542,7040,0.9734375,0,0,611,334,51,2932,10,1287,49,10
"750","2020-05-10",248,9,82,471,7040,0.9734375,0,0,611,334,40,2972,44,1331,38,44
"751","2020-05-11",213,9,110,408,7040,0.9734375,0,0,611,334,41,3013,47,1378,38,47
"752","2020-05-12",186,9,123,349,7040,0.9734375,0,0,611,334,38,3051,46,1424,36,46
"753","2020-05-13",162,9,119,295,7040,0.9734375,0,0,611,334,48,3099,40,1464,44,40
"754","2020-05-14",140,9,138,247,7040,0.9734375,0,0,611,334,37,3136,25,1489,34,25
"755","2020-05-15",123,9,141,213,7040,0.9734375,0,0,611,334,42,3178,26,1515,40,26
"756","2020-05-16",100,9,137,185,7040,0.9734375,0,0,611,334,30,3208,26,1541,27,26
"757","2020-05-17",88,9,146,169,7040,0.9734375,0,0,611,334,38,3246,27,1568,37,27
"758","2020-05-18",74,9,162,142,7040,0.9734375,0,0,611,334,29,3275,19,1587,29,19
"759","2020-05-19",62,9,158,128,7040,0.9734375,0,0,611,334,34,3309,16,1603,32,16
"760","2020-05-20",59,9,169,112,7040,0.9734375,0,0,611,334,34,3343,35,1638,31,35
"761","2020-05-21",48,9,168,99,7040,0.9734375,0,0,611,334,31,3374,34,1672,29,34
"762","2020-05-22",47,9,157,83,7040,0.9734375,0,0,611,334,27,3401,21,1693,27,21
"763","2020-05-23",43,9,131,75,7040,0.9734375,0,0,611,334,27,3428,23,1716,26,23
"764","2020-05-24",40,9,106,74,7040,0.9734375,0,0,611,334,28,3456,23,1739,25,23
"765","2020-05-25",39,9,85,62,7040,0.9734375,0,0,611,334,33,3489,26,1765,28,26
"766","2020-05-26",38,9,75,63,7040,0.9734375,0,0,611,334,20,3509,14,1779,20,14
"767","2020-05-27",28,9,56,55,7040,0.9734375,0,0,611,334,18,3527,25,1804,17,25
"768","2020-05-28",25,9,55,50,7040,0.9734375,0,0,611,334,29,3556,15,1819,27,15
"769","2020-05-29",24,9,60,49,7040,0.9734375,0,0,611,334,31,3587,7,1826,31,7
"770","2020-05-30",24,9,77,44,7040,0.9734375,0,0,611,334,19,3606,5,1831,18,5
"771","2020-05-31",22,9,84,39,7040,0.9734375,0,0,611,334,25,3631,6,1837,22,6
"772","2020-06-01",16,9,111,35,7040,0.9734375,0,0,611,334,12,3643,6,1843,12,6
"773","2020-06-02",13,9,111,38,7040,0.9734375,0,0,611,334,22,3665,13,1856,22,13
"774","2020-06-03",15,9,115,34,7040,0.9734375,0,0,611,334,19,3684,10,1866,17,10
"775","2020-06-04",15,9,108,31,7040,0.9734375,0,0,611,334,18,3702,20,1886,16,20
"776","2020-06-05",10,9,96,27,7040,0.9734375,0,0,611,334,17,3719,16,1902,16,16
"777","2020-06-06",9,9,102,26,7040,0.9734375,0,0,611,334,13,3732,18,1920,12,18
"778","2020-06-07",10,9,100,30,7040,0.9734375,0,0,611,334,17,3749,22,1942,13,22
"779","2020-03-13",1,10,39,10,1774,0.784667418263811,0,0,177,478,18,45,6,24,9,6
"780","2020-03-14",1,10,44,15,1774,0.784667418263811,0,0,177,478,21,66,6,30,8,6
"781","2020-03-15",1,10,44,21,1774,0.784667418263811,0,0,177,478,20,86,5,35,8,5
"782","2020-03-16",2,10,50,23,1774,0.784667418263811,0,0,177,478,21,107,9,44,7,9
"783","2020-03-17",2,10,46,29,1774,0.784667418263811,0,0,177,478,30,137,8,52,16,8
"784","2020-03-18",4,10,59,34,1774,0.784667418263811,0,0,177,478,40,177,9,61,21,9
"785","2020-03-19",5,10,69,40,1774,0.784667418263811,0,0,177,478,30,207,5,66,18,5
"786","2020-03-20",4,10,60,51,1774,0.784667418263811,0,0,177,478,34,241,NA,NA,26,NA
"787","2020-03-21",6,10,70,54,1774,0.784667418263811,0,0,177,478,38,279,10,76,31,10
"788","2020-03-22",12,10,85,69,1774,0.784667418263811,0,0,177,478,43,322,3,79,34,3
"789","2020-03-23",12,10,71,82,1774,0.784667418263811,0,0,177,478,48,370,3,82,33,3
"790","2020-03-24",15,10,65,90,1774,0.784667418263811,0,0,177,478,47,417,7,89,30,7
"791","2020-03-25",18,10,65,106,1774,0.784667418263811,0,0,177,478,40,457,1,90,31,1
"792","2020-03-26",20,10,63,114,1774,0.784667418263811,0,0,177,478,70,527,7,97,48,7
"793","2020-03-27",27,10,60,127,1774,0.784667418263811,0,0,177,478,52,579,11,108,39,11
"794","2020-03-28",30,10,71,145,1774,0.784667418263811,0,0,177,478,62,641,4,112,50,4
"795","2020-03-29",27,10,81,162,1774,0.784667418263811,0,0,177,478,52,693,11,123,43,11
"796","2020-03-30",28,10,68,178,1774,0.784667418263811,0,0,177,478,51,744,9,132,40,9
"797","2020-03-31",32,10,66,186,1774,0.784667418263811,0,0,177,478,68,812,10,142,59,10
"798","2020-04-01",39,10,72,204,1774,0.784667418263811,0,0,177,478,68,880,8,150,57,8
"799","2020-04-02",44,10,78,215,1774,0.784667418263811,0,0,177,478,57,937,14,164,46,14
"800","2020-04-03",46,10,73,231,1774,0.784667418263811,0,0,177,478,67,1004,7,171,54,7
"801","2020-04-04",52,10,90,252,1774,0.784667418263811,0,0,177,478,85,1089,7,178,66,7
"802","2020-04-05",62,10,79,258,1774,0.784667418263811,0,0,177,478,69,1158,8,186,56,8
"803","2020-04-06",69,10,72,270,1774,0.784667418263811,0,0,177,478,70,1228,6,192,58,6
"804","2020-04-07",72,10,93,282,1774,0.784667418263811,0,0,177,478,79,1307,10,202,65,10
"805","2020-04-08",70,10,98,279,1774,0.784667418263811,0,0,177,478,72,1379,16,218,57,16
"806","2020-04-09",72,10,100,286,1774,0.784667418263811,0,0,177,478,71,1450,24,242,58,24
"807","2020-04-10",79,10,105,296,1774,0.784667418263811,0,0,177,478,77,1527,20,262,63,20
"808","2020-04-11",83,10,119,297,1774,0.784667418263811,0,0,177,478,78,1605,13,275,68,13
"809","2020-04-12",84,10,105,303,1774,0.784667418263811,0,0,177,478,57,1662,17,292,49,17
"810","2020-04-13",86,10,97,310,1774,0.784667418263811,0,0,177,478,71,1733,9,301,60,9
"811","2020-04-14",85,10,91,309,1774,0.784667418263811,0,0,177,478,84,1817,7,308,57,7
"812","2020-04-15",84,10,100,306,1774,0.784667418263811,0,0,177,478,75,1892,NA,NA,61,NA
"813","2020-04-16",84,10,122,308,1774,0.784667418263811,0,0,177,478,63,1955,1,309,52,1
"814","2020-04-17",77,10,150,306,1774,0.784667418263811,0,0,177,478,73,2028,3,312,59,3
"815","2020-04-18",74,10,158,303,1774,0.784667418263811,0,0,177,478,69,2097,10,322,50,10
"816","2020-04-19",70,10,138,304,1774,0.784667418263811,0,0,177,478,71,2168,18,340,55,18
"817","2020-04-20",72,10,113,308,1774,0.784667418263811,0,0,177,478,77,2245,8,348,62,8
"818","2020-04-21",76,10,103,304,1774,0.784667418263811,0,0,177,478,83,2328,11,359,70,11
"819","2020-04-22",78,10,81,301,1774,0.784667418263811,0,0,177,478,68,2396,15,374,54,15
"820","2020-04-23",84,10,86,313,1774,0.784667418263811,0,0,177,478,56,2452,18,392,40,18
"821","2020-04-24",91,10,82,321,1774,0.784667418263811,0,0,177,478,59,2511,9,401,47,9
"822","2020-04-25",91,10,79,316,1774,0.784667418263811,0,0,177,478,65,2576,9,410,53,9
"823","2020-04-26",94,10,94,313,1774,0.784667418263811,0,0,177,478,54,2630,8,418,38,8
"824","2020-04-27",94,10,112,302,1774,0.784667418263811,0,0,177,478,69,2699,12,430,52,12
"825","2020-04-28",90,10,122,306,1774,0.784667418263811,0,0,177,478,45,2744,13,443,32,13
"826","2020-04-29",95,10,114,311,1774,0.784667418263811,0,0,177,478,50,2794,12,455,35,12
"827","2020-04-30",89,10,108,307,1774,0.784667418263811,0,0,177,478,71,2865,6,461,59,6
"828","2020-05-01",86,10,104,300,1774,0.784667418263811,0,0,177,478,46,2911,9,470,36,9
"829","2020-05-02",91,10,95,311,1774,0.784667418263811,0,0,177,478,57,2968,8,478,48,8
"830","2020-05-03",89,10,95,310,1774,0.784667418263811,0,0,177,478,35,3003,4,482,29,4
"831","2020-05-04",94,10,132,314,1774,0.784667418263811,0,0,177,478,47,3050,2,484,35,2
"832","2020-05-05",93,10,129,311,1774,0.784667418263811,0,0,177,478,32,3082,21,505,27,21
"833","2020-05-06",87,10,133,297,1774,0.784667418263811,0,0,177,478,36,3118,7,512,31,7
"834","2020-05-07",92,10,137,290,1774,0.784667418263811,0,0,177,478,43,3161,4,516,35,4
"835","2020-05-08",97,10,129,295,1774,0.784667418263811,0,0,177,478,53,3214,2,518,41,2
"836","2020-05-09",96,10,113,275,1774,0.784667418263811,0,0,177,478,36,3250,4,522,27,4
"837","2020-05-10",95,10,115,269,1774,0.784667418263811,0,0,177,478,40,3290,13,535,32,13
"838","2020-05-11",85,10,110,260,1774,0.784667418263811,0,0,177,478,24,3314,10,545,15,10
"839","2020-05-12",84,10,102,240,1774,0.784667418263811,0,0,177,478,46,3360,11,556,33,11
"840","2020-05-13",83,10,125,226,1774,0.784667418263811,0,0,177,478,39,3399,12,568,27,12
"841","2020-05-14",80,10,137,216,1774,0.784667418263811,0,0,177,478,28,3427,7,575,24,7
"842","2020-05-15",69,10,141,220,1774,0.784667418263811,0,0,177,478,33,3460,19,594,25,19
"843","2020-05-16",64,10,139,220,1774,0.784667418263811,0,0,177,478,35,3495,16,610,27,16
"844","2020-05-17",62,10,140,209,1774,0.784667418263811,0,0,177,478,31,3526,19,629,20,19
"845","2020-05-18",61,10,155,199,1774,0.784667418263811,0,0,177,478,32,3558,9,638,22,9
"846","2020-05-19",63,10,145,189,1774,0.784667418263811,0,0,177,478,32,3590,9,647,21,9
"847","2020-05-20",63,10,120,185,1774,0.784667418263811,0,0,177,478,23,3613,9,656,16,9
"848","2020-05-21",56,10,102,186,1774,0.784667418263811,0,0,177,478,26,3639,22,678,18,22
"849","2020-05-22",57,10,98,182,1774,0.784667418263811,0,0,177,478,27,3666,18,696,21,18
"850","2020-05-23",51,10,99,176,1774,0.784667418263811,0,0,177,478,12,3678,4,700,8,4
"851","2020-05-24",50,10,100,185,1774,0.784667418263811,0,0,177,478,33,3711,12,712,22,12
"852","2020-05-25",46,10,111,182,1774,0.784667418263811,0,0,177,478,19,3730,5,717,13,5
"853","2020-05-26",45,10,117,169,1774,0.784667418263811,0,0,177,478,18,3748,15,732,14,15
"854","2020-05-27",46,10,110,162,1774,0.784667418263811,0,0,177,478,16,3764,13,745,11,13
"855","2020-05-28",50,10,103,154,1774,0.784667418263811,0,0,177,478,19,3783,10,755,14,10
"856","2020-05-29",50,10,106,155,1774,0.784667418263811,0,0,177,478,12,3795,15,770,7,15
"857","2020-05-30",56,10,116,147,1774,0.784667418263811,0,0,177,478,15,3810,9,779,11,9
"858","2020-05-31",50,10,127,152,1774,0.784667418263811,0,0,177,478,18,3828,13,792,16,13
"859","2020-06-01",50,10,110,147,1774,0.784667418263811,0,0,177,478,19,3847,8,800,17,8
"860","2020-06-02",49,10,94,145,1774,0.784667418263811,0,0,177,478,19,3866,11,811,8,11
"861","2020-06-03",45,10,82,132,1774,0.784667418263811,0,0,177,478,11,3877,4,815,5,4
"862","2020-06-04",37,10,88,146,1774,0.784667418263811,0,0,177,478,11,3888,4,819,9,4
"863","2020-06-05",32,10,77,136,1774,0.784667418263811,0,0,177,478,14,3902,8,827,6,8
"864","2020-06-06",28,10,70,132,1774,0.784667418263811,0,0,177,478,11,3913,9,836,6,9
"865","2020-06-07",33,10,64,134,1774,0.784667418263811,0,0,177,478,8,3921,1,837,5,1
"866","2020-03-13",2,11,29,37,3315,0.601508295625943,0,0,305,367,26,65,24,51,6,24
"867","2020-03-14",2,11,45,57,3315,0.601508295625943,0,0,305,367,23,88,24,75,3,24
"868","2020-03-15",2,11,40,82,3315,0.601508295625943,0,0,305,367,31,119,16,91,9,16
"869","2020-03-16",7,11,52,100,3315,0.601508295625943,0,0,305,367,25,144,27,118,5,27
"870","2020-03-17",15,11,51,128,3315,0.601508295625943,0,0,305,367,28,172,27,145,7,27
"871","2020-03-18",19,11,43,158,3315,0.601508295625943,0,0,305,367,28,200,25,170,10,25
"872","2020-03-19",21,11,40,177,3315,0.601508295625943,0,0,305,367,22,222,39,209,6,39
"873","2020-03-20",28,11,38,197,3315,0.601508295625943,0,0,305,367,38,260,38,247,20,38
"874","2020-03-21",35,11,44,225,3315,0.601508295625943,0,0,305,367,44,304,38,285,21,38
"875","2020-03-22",43,11,50,260,3315,0.601508295625943,0,0,305,367,27,331,41,326,9,41
"876","2020-03-23",51,11,54,284,3315,0.601508295625943,0,0,305,367,33,364,30,356,18,30
"877","2020-03-24",52,11,59,331,3315,0.601508295625943,0,0,305,367,41,405,31,387,18,31
"878","2020-03-25",60,11,67,355,3315,0.601508295625943,0,0,305,367,41,446,27,414,18,27
"879","2020-03-26",72,11,74,380,3315,0.601508295625943,0,0,305,367,46,492,34,448,21,34
"880","2020-03-27",74,11,79,400,3315,0.601508295625943,0,0,305,367,29,521,31,479,15,31
"881","2020-03-28",87,11,99,443,3315,0.601508295625943,0,0,305,367,47,568,46,525,18,46
"882","2020-03-29",97,11,103,468,3315,0.601508295625943,0,0,305,367,39,607,51,576,17,51
"883","2020-03-30",103,11,110,490,3315,0.601508295625943,0,0,305,367,51,658,42,618,30,42
"884","2020-03-31",114,11,113,519,3315,0.601508295625943,0,0,305,367,50,708,26,644,28,26
"885","2020-04-01",130,11,107,539,3315,0.601508295625943,0,0,305,367,55,763,33,677,29,33
"886","2020-04-02",140,11,95,556,3315,0.601508295625943,0,0,305,367,54,817,32,709,29,32
"887","2020-04-03",152,11,88,582,3315,0.601508295625943,0,0,305,367,60,877,27,736,32,27
"888","2020-04-04",150,11,81,593,3315,0.601508295625943,0,0,305,367,33,910,32,768,23,32
"889","2020-04-05",165,11,94,628,3315,0.601508295625943,0,0,305,367,66,976,29,797,41,29
"890","2020-04-06",178,11,100,654,3315,0.601508295625943,0,0,305,367,65,1041,48,845,32,48
"891","2020-04-07",181,11,118,641,3315,0.601508295625943,0,0,305,367,51,1092,36,881,33,36
"892","2020-04-08",182,11,126,644,3315,0.601508295625943,0,0,305,367,51,1143,30,911,29,30
"893","2020-04-09",185,11,108,628,3315,0.601508295625943,0,0,305,367,55,1198,36,947,28,36
"894","2020-04-10",183,11,127,641,3315,0.601508295625943,0,0,305,367,60,1258,77,1024,40,77
"895","2020-04-11",196,11,113,628,3315,0.601508295625943,0,0,305,367,65,1323,48,1072,40,48
"896","2020-04-12",192,11,110,641,3315,0.601508295625943,0,0,305,367,54,1377,34,1106,25,34
"897","2020-04-13",186,11,120,615,3315,0.601508295625943,0,0,305,367,60,1437,40,1146,36,40
"898","2020-04-14",179,11,144,600,3315,0.601508295625943,0,0,305,367,60,1497,47,1193,34,47
"899","2020-04-15",177,11,142,587,3315,0.601508295625943,0,0,305,367,50,1547,53,1246,28,53
"900","2020-04-16",169,11,149,602,3315,0.601508295625943,0,0,305,367,41,1588,45,1291,20,45
"901","2020-04-17",177,11,159,610,3315,0.601508295625943,0,0,305,367,61,1649,50,1341,33,50
"902","2020-04-18",170,11,160,580,3315,0.601508295625943,0,0,305,367,50,1699,44,1385,29,44
"903","2020-04-19",163,11,166,558,3315,0.601508295625943,0,0,305,367,49,1748,32,1417,28,32
"904","2020-04-20",163,11,164,548,3315,0.601508295625943,0,0,305,367,47,1795,44,1461,25,44
"905","2020-04-21",166,11,151,543,3315,0.601508295625943,0,0,305,367,50,1845,43,1504,32,43
"906","2020-04-22",157,11,147,530,3315,0.601508295625943,0,0,305,367,50,1895,41,1545,19,41
"907","2020-04-23",160,11,170,518,3315,0.601508295625943,0,0,305,367,54,1949,50,1595,24,50
"908","2020-04-24",156,11,184,494,3315,0.601508295625943,0,0,305,367,48,1997,42,1637,21,42
"909","2020-04-25",160,11,184,493,3315,0.601508295625943,0,0,305,367,50,2047,41,1678,22,41
"910","2020-04-26",161,11,165,500,3315,0.601508295625943,0,0,305,367,61,2108,26,1704,30,26
"911","2020-04-27",155,11,141,469,3315,0.601508295625943,0,0,305,367,35,2143,43,1747,15,43
"912","2020-04-28",152,11,146,462,3315,0.601508295625943,0,0,305,367,52,2195,31,1778,28,31
"913","2020-04-29",154,11,131,441,3315,0.601508295625943,0,0,305,367,40,2235,24,1802,21,24
"914","2020-04-30",155,11,121,446,3315,0.601508295625943,0,0,305,367,60,2295,27,1829,27,27
"915","2020-05-01",146,11,119,456,3315,0.601508295625943,0,0,305,367,40,2335,26,1855,23,26
"916","2020-05-02",129,11,116,445,3315,0.601508295625943,0,0,305,367,45,2380,29,1884,24,29
"917","2020-05-03",123,11,142,446,3315,0.601508295625943,0,0,305,367,48,2428,20,1904,22,20
"918","2020-05-04",125,11,146,460,3315,0.601508295625943,0,0,305,367,40,2468,24,1928,19,24
"919","2020-05-05",135,11,145,451,3315,0.601508295625943,0,0,305,367,44,2512,48,1976,28,48
"920","2020-05-06",130,11,126,451,3315,0.601508295625943,0,0,305,367,46,2558,41,2017,23,41
"921","2020-05-07",120,11,104,446,3315,0.601508295625943,0,0,305,367,41,2599,62,2079,28,62
"922","2020-05-08",118,11,106,431,3315,0.601508295625943,0,0,305,367,31,2630,38,2117,14,38
"923","2020-05-09",124,11,110,429,3315,0.601508295625943,0,0,305,367,46,2676,44,2161,22,44
"924","2020-05-10",133,11,136,440,3315,0.601508295625943,0,0,305,367,42,2718,46,2207,18,46
"925","2020-05-11",125,11,136,432,3315,0.601508295625943,0,0,305,367,30,2748,43,2250,19,43
"926","2020-05-12",118,11,134,416,3315,0.601508295625943,0,0,305,367,34,2782,40,2290,15,40
"927","2020-05-13",130,11,123,390,3315,0.601508295625943,0,0,305,367,33,2815,31,2321,15,31
"928","2020-05-14",135,11,127,390,3315,0.601508295625943,0,0,305,367,51,2866,31,2352,24,31
"929","2020-05-15",135,11,154,379,3315,0.601508295625943,0,0,305,367,38,2904,60,2412,21,60
"930","2020-05-16",131,11,157,368,3315,0.601508295625943,0,0,305,367,37,2941,60,2472,14,60
"931","2020-05-17",122,11,155,350,3315,0.601508295625943,0,0,305,367,31,2972,64,2536,17,64
"932","2020-05-18",119,11,144,349,3315,0.601508295625943,0,0,305,367,35,3007,63,2599,18,63
"933","2020-05-19",119,11,137,335,3315,0.601508295625943,0,0,305,367,34,3041,60,2659,17,60
"934","2020-05-20",106,11,141,325,3315,0.601508295625943,0,0,305,367,24,3065,33,2692,7,33
"935","2020-05-21",98,11,138,317,3315,0.601508295625943,0,0,305,367,35,3100,53,2745,16,53
"936","2020-05-22",102,11,143,311,3315,0.601508295625943,0,0,305,367,22,3122,47,2792,8,47
"937","2020-05-23",101,11,133,287,3315,0.601508295625943,0,0,305,367,28,3150,52,2844,15,52
"938","2020-05-24",96,11,120,268,3315,0.601508295625943,0,0,305,367,19,3169,27,2871,7,27
"939","2020-05-25",93,11,120,255,3315,0.601508295625943,0,0,305,367,25,3194,37,2908,6,37
"940","2020-05-26",93,11,125,241,3315,0.601508295625943,0,0,305,367,27,3221,35,2943,16,35
"941","2020-05-27",86,11,120,239,3315,0.601508295625943,0,0,305,367,19,3240,30,2973,13,30
"942","2020-05-28",90,11,111,226,3315,0.601508295625943,0,0,305,367,24,3264,26,2999,13,26
"943","2020-05-29",82,11,109,209,3315,0.601508295625943,0,0,305,367,15,3279,18,3017,7,18
"944","2020-05-30",74,11,100,201,3315,0.601508295625943,0,0,305,367,28,3307,32,3049,15,32
"945","2020-05-31",69,11,103,194,3315,0.601508295625943,0,0,305,367,24,3331,27,3076,10,27
"946","2020-06-01",67,11,100,189,3315,0.601508295625943,0,0,305,367,25,3356,33,3109,16,33
"947","2020-06-02",55,11,95,188,3315,0.601508295625943,0,0,305,367,13,3369,51,3160,6,51
"948","2020-06-03",59,11,97,178,3315,0.601508295625943,0,0,305,367,16,3385,30,3190,11,30
"949","2020-06-04",52,11,87,186,3315,0.601508295625943,0,0,305,367,11,3396,23,3213,8,23
"950","2020-06-05",53,11,80,191,3315,0.601508295625943,0,0,305,367,11,3407,25,3238,5,25
"951","2020-06-06",56,11,68,189,3315,0.601508295625943,0,0,305,367,17,3424,17,3255,8,17
"952","2020-06-07",53,11,56,196,3315,0.601508295625943,0,0,305,367,9,3433,13,3268,5,13
"953","2020-03-13",3,12,31,61,2996,0.416555407209613,0,0,273,342,16,36,14,40,8,14
"954","2020-03-14",4,12,46,77,2996,0.416555407209613,0,0,273,342,12,48,4,44,3,4
"955","2020-03-15",6,12,45,95,2996,0.416555407209613,0,0,273,342,16,64,3,47,6,3
"956","2020-03-16",6,12,48,115,2996,0.416555407209613,0,0,273,342,20,84,NA,NA,14,NA
"957","2020-03-17",10,12,51,143,2996,0.416555407209613,0,0,273,342,21,105,3,50,13,3
"958","2020-03-18",15,12,43,174,2996,0.416555407209613,0,0,273,342,18,123,NA,NA,13,NA
"959","2020-03-19",24,12,38,191,2996,0.416555407209613,0,0,273,342,42,165,3,53,27,3
"960","2020-03-20",29,12,34,202,2996,0.416555407209613,0,0,273,342,37,202,3,56,24,3
"961","2020-03-21",42,12,33,219,2996,0.416555407209613,0,0,273,342,45,247,2,58,33,2
"962","2020-03-22",50,12,36,229,2996,0.416555407209613,0,0,273,342,38,285,NA,NA,25,NA
"963","2020-03-23",57,12,37,249,2996,0.416555407209613,0,0,273,342,22,307,14,72,15,14
"964","2020-03-24",63,12,42,275,2996,0.416555407209613,0,0,273,342,30,337,5,77,23,5
"965","2020-03-25",61,12,50,287,2996,0.416555407209613,0,0,273,342,44,381,19,96,31,19
"966","2020-03-26",66,12,50,299,2996,0.416555407209613,0,0,273,342,43,424,26,122,40,26
"967","2020-03-27",68,12,44,314,2996,0.416555407209613,0,0,273,342,38,462,8,130,30,8
"968","2020-03-28",64,12,41,341,2996,0.416555407209613,0,0,273,342,40,502,18,148,33,18
"969","2020-03-29",63,12,49,350,2996,0.416555407209613,0,0,273,342,40,542,18,166,36,18
"970","2020-03-30",69,12,54,353,2996,0.416555407209613,0,0,273,342,55,597,23,189,41,23
"971","2020-03-31",78,12,60,366,2996,0.416555407209613,0,0,273,342,41,638,6,195,27,6
"972","2020-04-01",92,12,66,369,2996,0.416555407209613,0,0,273,342,54,692,11,206,49,11
"973","2020-04-02",88,12,67,369,2996,0.416555407209613,0,0,273,342,66,758,19,225,53,19
"974","2020-04-03",102,12,65,383,2996,0.416555407209613,0,0,273,342,54,812,20,245,44,20
"975","2020-04-04",108,12,65,403,2996,0.416555407209613,0,0,273,342,52,864,14,259,39,14
"976","2020-04-05",116,12,79,416,2996,0.416555407209613,0,0,273,342,71,935,20,279,60,20
"977","2020-04-06",119,12,75,436,2996,0.416555407209613,0,0,273,342,52,987,24,303,36,24
"978","2020-04-07",118,12,79,442,2996,0.416555407209613,0,0,273,342,60,1047,27,330,47,27
"979","2020-04-08",117,12,73,452,2996,0.416555407209613,0,0,273,342,55,1102,34,364,42,34
"980","2020-04-09",127,12,70,462,2996,0.416555407209613,0,0,273,342,53,1155,34,398,41,34
"981","2020-04-10",121,12,72,450,2996,0.416555407209613,0,0,273,342,73,1228,18,416,61,18
"982","2020-04-11",121,12,83,460,2996,0.416555407209613,0,0,273,342,70,1298,16,432,59,16
"983","2020-04-12",119,12,86,466,2996,0.416555407209613,0,0,273,342,61,1359,11,443,55,11
"984","2020-04-13",121,12,99,476,2996,0.416555407209613,0,0,273,342,64,1423,30,473,56,30
"985","2020-04-14",124,12,101,489,2996,0.416555407209613,0,0,273,342,69,1492,8,481,59,8
"986","2020-04-15",130,12,104,496,2996,0.416555407209613,0,0,273,342,38,1530,31,512,32,31
"987","2020-04-16",132,12,96,498,2996,0.416555407209613,0,0,273,342,70,1600,33,545,64,33
"988","2020-04-17",129,12,88,502,2996,0.416555407209613,0,0,273,342,66,1666,24,569,55,24
"989","2020-04-18",138,12,71,496,2996,0.416555407209613,0,0,273,342,65,1731,21,590,50,21
"990","2020-04-19",145,12,77,494,2996,0.416555407209613,0,0,273,342,47,1778,19,609,35,19
"991","2020-04-20",153,12,89,487,2996,0.416555407209613,0,0,273,342,60,1838,18,627,46,18
"992","2020-04-21",151,12,106,478,2996,0.416555407209613,0,0,273,342,56,1894,27,654,41,27
"993","2020-04-22",152,12,117,462,2996,0.416555407209613,0,0,273,342,67,1961,12,666,60,12
"994","2020-04-23",151,12,118,468,2996,0.416555407209613,0,0,273,342,48,2009,14,680,38,14
"995","2020-04-24",158,12,137,469,2996,0.416555407209613,0,0,273,342,49,2058,19,699,38,19
"996","2020-04-25",144,12,114,480,2996,0.416555407209613,0,0,273,342,69,2127,18,717,55,18
"997","2020-04-26",142,12,106,463,2996,0.416555407209613,0,0,273,342,51,2178,30,747,44,30
"998","2020-04-27",134,12,107,458,2996,0.416555407209613,0,0,273,342,35,2213,8,755,29,8
"999","2020-04-28",130,12,102,446,2996,0.416555407209613,0,0,273,342,48,2261,14,769,40,14
"1000","2020-04-29",119,12,100,429,2996,0.416555407209613,0,0,273,342,43,2304,29,798,31,29
"1001","2020-04-30",118,12,100,457,2996,0.416555407209613,0,0,273,342,44,2348,34,832,29,34
"1002","2020-05-01",121,12,119,476,2996,0.416555407209613,0,0,273,342,44,2392,18,850,34,18
"1003","2020-05-02",135,12,128,487,2996,0.416555407209613,0,0,273,342,57,2449,15,865,46,15
"1004","2020-05-03",131,12,143,505,2996,0.416555407209613,0,0,273,342,51,2500,11,876,37,11
"1005","2020-05-04",133,12,151,507,2996,0.416555407209613,0,0,273,342,43,2543,18,894,33,18
"1006","2020-05-05",143,12,142,505,2996,0.416555407209613,0,0,273,342,44,2587,19,913,36,19
"1007","2020-05-06",146,12,150,497,2996,0.416555407209613,0,0,273,342,50,2637,25,938,40,25
"1008","2020-05-07",141,12,151,490,2996,0.416555407209613,0,0,273,342,31,2668,15,953,27,15
"1009","2020-05-08",134,12,152,473,2996,0.416555407209613,0,0,273,342,38,2706,24,977,28,24
"1010","2020-05-09",132,12,156,457,2996,0.416555407209613,0,0,273,342,37,2743,15,992,26,15
"1011","2020-05-10",140,12,142,450,2996,0.416555407209613,0,0,273,342,49,2792,14,1006,37,14
"1012","2020-05-11",142,12,137,431,2996,0.416555407209613,0,0,273,342,38,2830,31,1037,32,31
"1013","2020-05-12",130,12,146,420,2996,0.416555407209613,0,0,273,342,44,2874,24,1061,35,24
"1014","2020-05-13",130,12,155,406,2996,0.416555407209613,0,0,273,342,34,2908,28,1089,32,28
"1015","2020-05-14",127,12,156,393,2996,0.416555407209613,0,0,273,342,40,2948,31,1120,32,31
"1016","2020-05-15",131,12,146,379,2996,0.416555407209613,0,0,273,342,46,2994,32,1152,35,32
"1017","2020-05-16",127,12,154,369,2996,0.416555407209613,0,0,273,342,43,3037,21,1173,36,21
"1018","2020-05-17",124,12,159,352,2996,0.416555407209613,0,0,273,342,33,3070,14,1187,24,14
"1019","2020-05-18",123,12,153,334,2996,0.416555407209613,0,0,273,342,26,3096,20,1207,24,20
"1020","2020-05-19",117,12,129,316,2996,0.416555407209613,0,0,273,342,26,3122,9,1216,22,9
"1021","2020-05-20",115,12,143,277,2996,0.416555407209613,0,0,273,342,37,3159,21,1237,29,21
"1022","2020-05-21",118,12,149,276,2996,0.416555407209613,0,0,273,342,26,3185,17,1254,24,17
"1023","2020-05-22",104,12,149,264,2996,0.416555407209613,0,0,273,342,24,3209,32,1286,21,32
"1024","2020-05-23",96,12,152,260,2996,0.416555407209613,0,0,273,342,34,3243,21,1307,29,21
"1025","2020-05-24",84,12,145,257,2996,0.416555407209613,0,0,273,342,16,3259,15,1322,13,15
"1026","2020-05-25",75,12,151,256,2996,0.416555407209613,0,0,273,342,28,3287,14,1336,22,14
"1027","2020-05-26",75,12,125,250,2996,0.416555407209613,0,0,273,342,17,3304,13,1349,17,13
"1028","2020-05-27",71,12,120,253,2996,0.416555407209613,0,0,273,342,19,3323,15,1364,14,15
"1029","2020-05-28",63,12,106,240,2996,0.416555407209613,0,0,273,342,11,3334,9,1373,9,9
"1030","2020-05-29",65,12,100,221,2996,0.416555407209613,0,0,273,342,30,3364,12,1385,26,12
"1031","2020-05-30",62,12,107,219,2996,0.416555407209613,0,0,273,342,29,3393,20,1405,24,20
"1032","2020-05-31",66,12,103,221,2996,0.416555407209613,0,0,273,342,21,3414,10,1415,17,10
"1033","2020-06-01",61,12,111,223,2996,0.416555407209613,0,0,273,342,19,3433,8,1423,14,8
"1034","2020-06-02",67,12,111,221,2996,0.416555407209613,0,0,273,342,17,3450,8,1431,15,8
"1035","2020-06-03",66,12,117,220,2996,0.416555407209613,0,0,273,342,15,3465,3,1434,11,3
"1036","2020-06-04",73,12,108,206,2996,0.416555407209613,0,0,273,342,18,3483,17,1451,13,17
"1037","2020-06-05",75,12,104,202,2996,0.416555407209613,0,0,273,342,12,3495,2,1453,11,2
"1038","2020-06-06",75,12,107,205,2996,0.416555407209613,0,0,273,342,12,3507,5,1458,9,5
"1039","2020-06-07",73,12,101,198,2996,0.416555407209613,0,0,273,342,13,3520,2,1460,9,2
"1040","2020-03-16",1,13,57,35,1689,0.661338069863825,0,0,139,382,16,94,1,32,4,1
"1041","2020-03-17",2,13,63,48,1689,0.661338069863825,0,0,139,382,19,113,5,37,9,5
"1042","2020-03-18",2,13,63,52,1689,0.661338069863825,0,0,139,382,26,139,6,43,10,6
"1043","2020-03-19",4,13,63,63,1689,0.661338069863825,0,0,139,382,29,168,6,49,13,6
"1044","2020-03-20",5,13,60,73,1689,0.661338069863825,0,0,139,382,24,192,3,52,11,3
"1045","2020-03-21",8,13,64,81,1689,0.661338069863825,0,0,139,382,35,227,3,55,18,3
"1046","2020-03-22",10,13,67,106,1689,0.661338069863825,0,0,139,382,39,266,5,60,19,5
"1047","2020-03-23",12,13,90,118,1689,0.661338069863825,0,0,139,382,39,305,2,62,22,2
"1048","2020-03-24",18,13,90,123,1689,0.661338069863825,0,0,139,382,30,335,2,64,18,2
"1049","2020-03-25",23,13,111,133,1689,0.661338069863825,0,0,139,382,37,372,7,71,21,7
"1050","2020-03-26",26,13,117,141,1689,0.661338069863825,0,0,139,382,41,413,5,76,28,5
"1051","2020-03-27",30,13,119,151,1689,0.661338069863825,0,0,139,382,37,450,7,83,26,7
"1052","2020-03-28",32,13,119,164,1689,0.661338069863825,0,0,139,382,36,486,8,91,26,8
"1053","2020-03-29",36,13,114,168,1689,0.661338069863825,0,0,139,382,57,543,11,102,41,11
"1054","2020-03-30",37,13,126,176,1689,0.661338069863825,0,0,139,382,40,583,14,116,33,14
"1055","2020-03-31",41,13,122,178,1689,0.661338069863825,0,0,139,382,40,623,17,133,26,17
"1056","2020-04-01",42,13,124,193,1689,0.661338069863825,0,0,139,382,42,665,11,144,32,11
"1057","2020-04-02",42,13,126,212,1689,0.661338069863825,0,0,139,382,49,714,4,148,31,4
"1058","2020-04-03",46,13,126,227,1689,0.661338069863825,0,0,139,382,48,762,10,158,33,10
"1059","2020-04-04",55,13,157,228,1689,0.661338069863825,0,0,139,382,40,802,12,170,24,12
"1060","2020-04-05",61,13,161,233,1689,0.661338069863825,0,0,139,382,52,854,6,176,40,6
"1061","2020-04-06",63,13,163,242,1689,0.661338069863825,0,0,139,382,55,909,17,193,44,17
"1062","2020-04-07",61,13,167,239,1689,0.661338069863825,0,0,139,382,54,963,21,214,41,21
"1063","2020-04-08",64,13,167,247,1689,0.661338069863825,0,0,139,382,50,1013,12,226,32,12
"1064","2020-04-09",65,13,166,238,1689,0.661338069863825,0,0,139,382,53,1066,14,240,37,14
"1065","2020-04-10",64,13,152,241,1689,0.661338069863825,0,0,139,382,57,1123,12,252,38,12
"1066","2020-04-11",57,13,154,227,1689,0.661338069863825,0,0,139,382,56,1179,11,263,44,11
"1067","2020-04-12",55,13,158,236,1689,0.661338069863825,0,0,139,382,49,1228,19,282,35,19
"1068","2020-04-13",58,13,146,245,1689,0.661338069863825,0,0,139,382,36,1264,22,304,24,22
"1069","2020-04-14",56,13,136,239,1689,0.661338069863825,0,0,139,382,53,1317,24,328,33,24
"1070","2020-04-15",58,13,143,245,1689,0.661338069863825,0,0,139,382,35,1352,16,344,19,16
"1071","2020-04-16",64,13,144,251,1689,0.661338069863825,0,0,139,382,44,1396,4,348,32,4
"1072","2020-04-17",65,13,139,260,1689,0.661338069863825,0,0,139,382,57,1453,24,372,33,24
"1073","2020-04-18",69,13,136,263,1689,0.661338069863825,0,0,139,382,42,1495,21,393,28,21
"1074","2020-04-19",72,13,134,263,1689,0.661338069863825,0,0,139,382,34,1529,25,418,24,25
"1075","2020-04-20",72,13,121,254,1689,0.661338069863825,0,0,139,382,34,1563,7,425,16,7
"1076","2020-04-21",74,13,113,263,1689,0.661338069863825,0,0,139,382,37,1600,8,433,18,8
"1077","2020-04-22",76,13,95,258,1689,0.661338069863825,0,0,139,382,33,1633,15,448,19,15
"1078","2020-04-23",71,13,108,260,1689,0.661338069863825,0,0,139,382,40,1673,14,462,12,14
"1079","2020-04-24",71,13,111,253,1689,0.661338069863825,0,0,139,382,37,1710,17,479,20,17
"1080","2020-04-25",75,13,122,256,1689,0.661338069863825,0,0,139,382,35,1745,12,491,14,12
"1081","2020-04-26",69,13,129,258,1689,0.661338069863825,0,0,139,382,43,1788,16,507,25,16
"1082","2020-04-27",74,13,128,250,1689,0.661338069863825,0,0,139,382,46,1834,9,516,27,9
"1083","2020-04-28",75,13,123,247,1689,0.661338069863825,0,0,139,382,43,1877,14,530,29,14
"1084","2020-04-29",73,13,132,245,1689,0.661338069863825,0,0,139,382,23,1900,23,553,13,23
"1085","2020-04-30",75,13,132,246,1689,0.661338069863825,0,0,139,382,34,1934,19,572,15,19
"1086","2020-05-01",76,13,138,236,1689,0.661338069863825,0,0,139,382,41,1975,12,584,25,12
"1087","2020-05-02",67,13,141,247,1689,0.661338069863825,0,0,139,382,38,2013,25,609,19,25
"1088","2020-05-03",70,13,142,253,1689,0.661338069863825,0,0,139,382,20,2033,17,626,11,17
"1089","2020-05-04",72,13,141,252,1689,0.661338069863825,0,0,139,382,25,2058,19,645,17,19
"1090","2020-05-05",73,13,142,252,1689,0.661338069863825,0,0,139,382,30,2088,6,651,15,6
"1091","2020-05-06",71,13,157,255,1689,0.661338069863825,0,0,139,382,29,2117,16,667,15,16
"1092","2020-05-07",67,13,166,249,1689,0.661338069863825,0,0,139,382,34,2151,6,673,17,6
"1093","2020-05-08",65,13,164,254,1689,0.661338069863825,0,0,139,382,32,2183,4,677,20,4
"1094","2020-05-09",69,13,156,247,1689,0.661338069863825,0,0,139,382,31,2214,3,680,13,3
"1095","2020-05-10",72,13,150,246,1689,0.661338069863825,0,0,139,382,24,2238,5,685,12,5
"1096","2020-05-11",65,13,158,247,1689,0.661338069863825,0,0,139,382,29,2267,3,688,18,3
"1097","2020-05-12",61,13,161,242,1689,0.661338069863825,0,0,139,382,33,2300,7,695,21,7
"1098","2020-05-13",62,13,176,239,1689,0.661338069863825,0,0,139,382,30,2330,1,696,15,1
"1099","2020-05-14",71,13,172,230,1689,0.661338069863825,0,0,139,382,24,2354,14,710,12,14
"1100","2020-05-15",74,13,157,220,1689,0.661338069863825,0,0,139,382,28,2382,9,719,19,9
"1101","2020-05-16",76,13,168,200,1689,0.661338069863825,0,0,139,382,26,2408,7,726,19,7
"1102","2020-05-17",73,13,152,196,1689,0.661338069863825,0,0,139,382,33,2441,7,733,23,7
"1103","2020-05-18",67,13,154,197,1689,0.661338069863825,0,0,139,382,33,2474,6,739,20,6
"1104","2020-05-19",66,13,159,184,1689,0.661338069863825,0,0,139,382,28,2502,9,748,20,9
"1105","2020-05-20",59,13,143,185,1689,0.661338069863825,0,0,139,382,22,2524,6,754,12,6
"1106","2020-05-21",55,13,144,185,1689,0.661338069863825,0,0,139,382,24,2548,2,756,13,2
"1107","2020-05-22",51,13,129,191,1689,0.661338069863825,0,0,139,382,40,2588,8,764,25,8
"1108","2020-05-23",46,13,116,189,1689,0.661338069863825,0,0,139,382,26,2614,9,773,18,9
"1109","2020-05-24",41,13,120,200,1689,0.661338069863825,0,0,139,382,24,2638,11,784,19,11
"1110","2020-05-25",44,13,130,193,1689,0.661338069863825,0,0,139,382,26,2664,6,790,20,6
"1111","2020-05-26",48,13,133,192,1689,0.661338069863825,0,0,139,382,23,2687,6,796,10,6
"1112","2020-05-27",51,13,135,186,1689,0.661338069863825,0,0,139,382,23,2710,5,801,18,5
"1113","2020-05-28",55,13,131,184,1689,0.661338069863825,0,0,139,382,27,2737,5,806,16,5
"1114","2020-05-29",50,13,135,179,1689,0.661338069863825,0,0,139,382,24,2761,5,811,15,5
"1115","2020-05-30",47,13,141,179,1689,0.661338069863825,0,0,139,382,10,2771,6,817,7,6
"1116","2020-05-31",48,13,123,181,1689,0.661338069863825,0,0,139,382,22,2793,3,820,17,3
"1117","2020-06-01",49,13,122,190,1689,0.661338069863825,0,0,139,382,17,2810,8,828,7,8
"1118","2020-06-02",49,13,127,189,1689,0.661338069863825,0,0,139,382,26,2836,6,834,22,6
"1119","2020-06-03",52,13,133,190,1689,0.661338069863825,0,0,139,382,26,2862,2,836,15,2
"1120","2020-06-04",49,13,144,189,1689,0.661338069863825,0,0,139,382,29,2891,3,839,20,3
"1121","2020-06-05",57,13,146,178,1689,0.661338069863825,0,0,139,382,28,2919,7,846,20,7
"1122","2020-06-06",63,13,135,176,1689,0.661338069863825,0,0,139,382,16,2935,7,853,12,7
"1123","2020-06-07",68,13,121,171,1689,0.661338069863825,0,0,139,382,9,2944,8,861,6,8
"1124","2020-03-15",2,14,48,52,5856,0.919569672131147,0,0,544,496,23,81,22,73,15,22
"1125","2020-03-16",4,14,43,67,5856,0.919569672131147,0,0,544,496,31,112,5,78,20,5
"1126","2020-03-17",6,14,50,91,5856,0.919569672131147,0,0,544,496,47,159,6,84,30,6
"1127","2020-03-18",9,14,64,126,5856,0.919569672131147,0,0,544,496,61,220,15,99,51,15
"1128","2020-03-19",12,14,65,146,5856,0.919569672131147,0,0,544,496,78,298,6,105,71,6
"1129","2020-03-20",19,14,84,176,5856,0.919569672131147,0,0,544,496,100,398,7,112,92,7
"1130","2020-03-21",26,14,83,215,5856,0.919569672131147,0,0,544,496,97,495,17,129,86,17
"1131","2020-03-22",27,14,102,255,5856,0.919569672131147,0,0,544,496,113,608,23,152,103,23
"1132","2020-03-23",33,14,104,298,5856,0.919569672131147,0,0,544,496,158,766,24,176,146,24
"1133","2020-03-24",43,14,94,321,5856,0.919569672131147,0,0,544,496,157,923,21,197,147,21
"1134","2020-03-25",52,14,93,366,5856,0.919569672131147,0,0,544,496,222,1145,13,210,219,13
"1135","2020-03-26",64,14,110,401,5856,0.919569672131147,0,0,544,496,193,1338,15,225,187,15
"1136","2020-03-27",74,14,102,451,5856,0.919569672131147,0,0,544,496,286,1624,16,241,275,16
"1137","2020-03-28",86,14,108,505,5856,0.919569672131147,0,0,544,496,287,1911,12,253,275,12
"1138","2020-03-29",106,14,108,551,5856,0.919569672131147,0,0,544,496,304,2215,4,257,294,4
"1139","2020-03-30",116,14,106,616,5856,0.919569672131147,0,0,544,496,347,2562,23,280,342,23
"1140","2020-03-31",128,14,102,681,5856,0.919569672131147,0,0,544,496,363,2925,21,301,356,21
"1141","2020-04-01",143,14,115,758,5856,0.919569672131147,0,0,544,496,334,3259,22,323,330,22
"1142","2020-04-02",161,14,113,809,5856,0.919569672131147,0,0,544,496,414,3673,17,340,407,17
"1143","2020-04-03",173,14,105,898,5856,0.919569672131147,0,0,544,496,298,3971,17,357,291,17
"1144","2020-04-04",194,14,109,987,5856,0.919569672131147,0,0,544,496,441,4412,9,366,434,9
"1145","2020-04-05",211,14,100,1055,5856,0.919569672131147,0,0,544,496,285,4697,16,382,282,16
"1146","2020-04-06",243,14,89,1151,5856,0.919569672131147,0,0,544,496,451,5148,9,391,448,9
"1147","2020-04-07",258,14,94,1212,5856,0.919569672131147,0,0,544,496,265,5413,24,415,261,24
"1148","2020-04-08",270,14,103,1266,5856,0.919569672131147,0,0,544,496,308,5721,22,437,304,22
"1149","2020-04-09",289,14,104,1296,5856,0.919569672131147,0,0,544,496,199,5920,24,461,195,24
"1150","2020-04-10",305,14,91,1336,5856,0.919569672131147,0,0,544,496,180,6100,22,483,179,22
"1151","2020-04-11",341,14,87,1349,5856,0.919569672131147,0,0,544,496,182,6282,40,523,179,40
"1152","2020-04-12",364,14,74,1396,5856,0.919569672131147,0,0,544,496,168,6450,33,556,167,33
"1153","2020-04-13",364,14,75,1427,5856,0.919569672131147,0,0,544,496,146,6596,24,580,144,24
"1154","2020-04-14",371,14,72,1472,5856,0.919569672131147,0,0,544,496,98,6694,40,620,95,40
"1155","2020-04-15",392,14,88,1504,5856,0.919569672131147,0,0,544,496,101,6795,33,653,100,33
"1156","2020-04-16",402,14,96,1501,5856,0.919569672131147,0,0,544,496,103,6898,38,691,100,38
"1157","2020-04-17",421,14,103,1529,5856,0.919569672131147,0,0,544,496,67,6965,27,718,67,27
"1158","2020-04-18",395,14,113,1546,5856,0.919569672131147,0,0,544,496,75,7040,33,751,73,33
"1159","2020-04-19",410,14,109,1541,5856,0.919569672131147,0,0,544,496,34,7074,45,796,29,45
"1160","2020-04-20",423,14,101,1551,5856,0.919569672131147,0,0,544,496,37,7111,53,849,35,53
"1161","2020-04-21",433,14,103,1591,5856,0.919569672131147,0,0,544,496,52,7163,44,893,50,44
"1162","2020-04-22",435,14,92,1603,5856,0.919569672131147,0,0,544,496,20,7183,31,924,18,31
"1163","2020-04-23",440,14,93,1579,5856,0.919569672131147,0,0,544,496,22,7205,24,948,19,24
"1164","2020-04-24",428,14,95,1552,5856,0.919569672131147,0,0,544,496,23,7228,39,987,20,39
"1165","2020-04-25",446,14,100,1510,5856,0.919569672131147,0,0,544,496,17,7245,23,1010,16,23
"1166","2020-04-26",434,14,124,1462,5856,0.919569672131147,0,0,544,496,10,7255,26,1036,9,26
"1167","2020-04-27",440,14,135,1430,5856,0.919569672131147,0,0,544,496,12,7267,13,1049,10,13
"1168","2020-04-28",454,14,134,1372,5856,0.919569672131147,0,0,544,496,9,7276,10,1059,8,10
"1169","2020-04-29",463,14,151,1307,5856,0.919569672131147,0,0,544,496,10,7286,52,1111,9,52
"1170","2020-04-30",457,14,158,1226,5856,0.919569672131147,0,0,544,496,6,7292,43,1154,4,43
"1171","2020-05-01",457,14,153,1184,5856,0.919569672131147,0,0,544,496,10,7302,20,1174,5,20
"1172","2020-05-02",434,14,159,1129,5856,0.919569672131147,0,0,544,496,7,7309,18,1192,7,18
"1173","2020-05-03",401,14,166,1048,5856,0.919569672131147,0,0,544,496,6,7315,14,1206,4,14
"1174","2020-05-04",369,14,173,992,5856,0.919569672131147,0,0,544,496,3,7318,31,1237,2,31
"1175","2020-05-05",336,14,164,910,5856,0.919569672131147,0,0,544,496,4,7322,44,1281,4,44
"1176","2020-05-06",308,14,150,849,5856,0.919569672131147,0,0,544,496,1,7323,24,1305,1,24
"1177","2020-05-07",275,14,169,783,5856,0.919569672131147,0,0,544,496,8,7331,30,1335,4,30
"1178","2020-05-08",250,14,166,734,5856,0.919569672131147,0,0,544,496,4,7335,26,1361,2,26
"1179","2020-05-09",238,14,175,674,5856,0.919569672131147,0,0,544,496,3,7338,38,1399,2,38
"1180","2020-05-10",229,14,173,636,5856,0.919569672131147,0,0,544,496,4,7342,21,1420,3,21
"1181","2020-05-11",213,14,161,574,5856,0.919569672131147,0,0,544,496,2,7344,8,1428,2,8
"1182","2020-05-12",205,14,166,547,5856,0.919569672131147,0,0,544,496,NA,NA,8,1436,NA,8
"1183","2020-05-13",183,14,160,536,5856,0.919569672131147,0,0,544,496,2,7346,31,1467,2,31
"1184","2020-05-14",170,14,153,501,5856,0.919569672131147,0,0,544,496,3,7349,11,1478,3,11
"1185","2020-05-15",165,14,133,467,5856,0.919569672131147,0,0,544,496,2,7351,6,1484,1,6
"1186","2020-05-16",149,14,127,423,5856,0.919569672131147,0,0,544,496,3,7354,30,1514,3,30
"1187","2020-05-17",140,14,127,384,5856,0.919569672131147,0,0,544,496,5,7359,17,1531,3,17
"1188","2020-05-18",141,14,110,373,5856,0.919569672131147,0,0,544,496,1,7360,31,1562,1,31
"1189","2020-05-19",125,14,124,331,5856,0.919569672131147,0,0,544,496,3,7363,39,1601,3,39
"1190","2020-05-20",116,14,124,288,5856,0.919569672131147,0,0,544,496,1,7364,19,1620,1,19
"1191","2020-05-21",114,14,130,264,5856,0.919569672131147,0,0,544,496,NA,NA,31,1651,NA,31
"1192","2020-05-22",104,14,131,251,5856,0.919569672131147,0,0,544,496,2,7366,36,1687,1,36
"1193","2020-05-23",97,14,136,234,5856,0.919569672131147,0,0,544,496,3,7369,18,1705,2,18
"1194","2020-05-24",88,14,164,221,5856,0.919569672131147,0,0,544,496,NA,NA,17,1722,NA,17
"1195","2020-05-25",77,14,164,203,5856,0.919569672131147,0,0,544,496,6,7375,25,1747,5,25
"1196","2020-05-26",74,14,157,184,5856,0.919569672131147,0,0,544,496,2,7377,21,1768,1,21
"1197","2020-05-27",73,14,157,168,5856,0.919569672131147,0,0,544,496,2,7379,10,1778,1,10
"1198","2020-05-28",67,14,153,161,5856,0.919569672131147,0,0,544,496,2,7381,6,1784,2,6
"1199","2020-05-29",63,14,156,143,5856,0.919569672131147,0,0,544,496,1,7382,22,1806,NA,22
"1200","2020-05-30",60,14,148,138,5856,0.919569672131147,0,0,544,496,2,7384,20,1826,1,20
"1201","2020-05-31",58,14,139,135,5856,0.919569672131147,0,0,544,496,3,7387,13,1839,2,13
"1202","2020-06-01",52,14,138,120,5856,0.919569672131147,0,0,544,496,1,7388,15,1854,NA,15
"1203","2020-06-02",46,14,142,114,5856,0.919569672131147,0,0,544,496,2,7390,13,1867,1,13
"1204","2020-06-03",39,14,147,112,5856,0.919569672131147,0,0,544,496,1,7391,14,1881,1,14
"1205","2020-06-04",34,14,144,98,5856,0.919569672131147,0,0,544,496,1,7392,12,1893,1,12
"1206","2020-06-05",29,14,140,95,5856,0.919569672131147,0,0,544,496,2,7394,11,1904,2,11
"1207","2020-06-06",26,14,129,91,5856,0.919569672131147,0,0,544,496,1,7395,18,1922,1,18
"1208","2020-06-07",24,14,120,78,5856,0.919569672131147,0,0,544,496,1,7396,9,1931,1,9
"1209","2020-03-13",1,15,85,81,8073,0.880589619720054,0,0,723,504,25,63,13,25,5,13
"1210","2020-03-14",2,15,73,125,8073,0.880589619720054,0,0,723,504,22,85,5,30,2,5
"1211","2020-03-15",6,15,70,179,8073,0.880589619720054,0,0,723,504,31,116,8,38,9,8
"1212","2020-03-16",12,15,70,238,8073,0.880589619720054,0,0,723,504,24,140,12,50,9,12
"1213","2020-03-17",17,15,66,311,8073,0.880589619720054,0,0,723,504,21,161,9,59,8,9
"1214","2020-03-18",28,15,68,387,8073,0.880589619720054,0,0,723,504,27,188,8,67,6,8
"1215","2020-03-19",42,15,61,490,8073,0.880589619720054,0,0,723,504,31,219,5,72,9,5
"1216","2020-03-20",63,15,52,596,8073,0.880589619720054,0,0,723,504,34,253,6,78,18,6
"1217","2020-03-21",86,15,58,707,8073,0.880589619720054,0,0,723,504,36,289,6,84,12,6
"1218","2020-03-22",115,15,60,826,8073,0.880589619720054,0,0,723,504,35,324,1,85,18,1
"1219","2020-03-23",141,15,50,957,8073,0.880589619720054,0,0,723,504,41,365,3,88,26,3
"1220","2020-03-24",176,15,53,1138,8073,0.880589619720054,0,0,723,504,40,405,3,91,16,3
"1221","2020-03-25",211,15,84,1307,8073,0.880589619720054,0,0,723,504,41,446,13,104,22,13
"1222","2020-03-26",235,15,117,1481,8073,0.880589619720054,0,0,723,504,47,493,14,118,21,14
"1223","2020-03-27",259,15,136,1670,8073,0.880589619720054,0,0,723,504,41,534,6,124,17,6
"1224","2020-03-28",292,15,141,1997,8073,0.880589619720054,0,0,723,504,46,580,6,130,17,6
"1225","2020-03-29",334,15,139,2264,8073,0.880589619720054,0,0,723,504,44,624,10,140,20,10
"1226","2020-03-30",381,15,133,2524,8073,0.880589619720054,0,0,723,504,40,664,9,149,12,9
"1227","2020-03-31",434,15,113,2812,8073,0.880589619720054,0,0,723,504,33,697,5,154,18,5
"1228","2020-04-01",479,15,96,3058,8073,0.880589619720054,0,0,723,504,41,738,14,168,20,14
"1229","2020-04-02",554,15,89,3318,8073,0.880589619720054,0,0,723,504,50,788,14,182,21,14
"1230","2020-04-03",632,15,89,3479,8073,0.880589619720054,0,0,723,504,34,822,8,190,15,8
"1231","2020-04-04",736,15,124,3543,8073,0.880589619720054,0,0,723,504,49,871,12,202,22,12
"1232","2020-04-05",794,15,166,3694,8073,0.880589619720054,0,0,723,504,55,926,10,212,18,10
"1233","2020-04-06",881,15,166,3701,8073,0.880589619720054,0,0,723,504,41,967,9,221,25,9
"1234","2020-04-07",951,15,178,3686,8073,0.880589619720054,0,0,723,504,46,1013,15,236,20,15
"1235","2020-04-08",1013,15,225,3615,8073,0.880589619720054,0,0,723,504,49,1062,6,242,18,6
"1236","2020-04-09",1044,15,213,3543,8073,0.880589619720054,0,0,723,504,56,1118,6,248,15,6
"1237","2020-04-10",1054,15,190,3396,8073,0.880589619720054,0,0,723,504,38,1156,6,254,19,6
"1238","2020-04-11",1018,15,195,3158,8073,0.880589619720054,0,0,723,504,42,1198,13,267,22,13
"1239","2020-04-12",1010,15,183,2950,8073,0.880589619720054,0,0,723,504,62,1260,7,274,31,7
"1240","2020-04-13",982,15,185,2680,8073,0.880589619720054,0,0,723,504,52,1312,9,283,20,9
"1241","2020-04-14",926,15,201,2426,8073,0.880589619720054,0,0,723,504,67,1379,17,300,39,17
"1242","2020-04-15",879,15,226,2190,8073,0.880589619720054,0,0,723,504,49,1428,16,316,17,16
"1243","2020-04-16",831,15,261,1948,8073,0.880589619720054,0,0,723,504,55,1483,6,322,24,6
"1244","2020-04-17",781,15,262,1752,8073,0.880589619720054,0,0,723,504,54,1537,22,344,28,22
"1245","2020-04-18",736,15,233,1560,8073,0.880589619720054,0,0,723,504,51,1588,17,361,23,17
"1246","2020-04-19",659,15,218,1358,8073,0.880589619720054,0,0,723,504,52,1640,9,370,27,9
"1247","2020-04-20",571,15,202,1169,8073,0.880589619720054,0,0,723,504,58,1698,21,391,23,21
"1248","2020-04-21",507,15,242,989,8073,0.880589619720054,0,0,723,504,46,1744,12,403,22,12
"1249","2020-04-22",436,15,256,873,8073,0.880589619720054,0,0,723,504,57,1801,8,411,30,8
"1250","2020-04-23",371,15,276,740,8073,0.880589619720054,0,0,723,504,46,1847,8,419,17,8
"1251","2020-04-24",304,15,260,609,8073,0.880589619720054,0,0,723,504,44,1891,12,431,24,12
"1252","2020-04-25",242,15,259,535,8073,0.880589619720054,0,0,723,504,51,1942,6,437,17,6
"1253","2020-04-26",212,15,267,452,8073,0.880589619720054,0,0,723,504,45,1987,4,441,15,4
"1254","2020-04-27",183,15,268,378,8073,0.880589619720054,0,0,723,504,43,2030,5,446,21,5
"1255","2020-04-28",157,15,251,324,8073,0.880589619720054,0,0,723,504,54,2084,12,458,23,12
"1256","2020-04-29",131,15,221,277,8073,0.880589619720054,0,0,723,504,52,2136,3,461,22,3
"1257","2020-04-30",111,15,210,238,8073,0.880589619720054,0,0,723,504,56,2192,10,471,25,10
"1258","2020-05-01",106,15,224,215,8073,0.880589619720054,0,0,723,504,42,2234,21,492,16,21
"1259","2020-05-02",99,15,208,189,8073,0.880589619720054,0,0,723,504,41,2275,26,518,16,26
"1260","2020-05-03",89,15,204,160,8073,0.880589619720054,0,0,723,504,55,2330,25,543,30,25
"1261","2020-05-04",76,15,164,146,8073,0.880589619720054,0,0,723,504,58,2388,24,567,22,24
"1262","2020-05-05",66,15,150,129,8073,0.880589619720054,0,0,723,504,33,2421,20,587,6,20
"1263","2020-05-06",60,15,172,113,8073,0.880589619720054,0,0,723,504,45,2466,27,614,20,27
"1264","2020-05-07",54,15,172,89,8073,0.880589619720054,0,0,723,504,50,2516,16,630,19,16
"1265","2020-05-08",44,15,211,80,8073,0.880589619720054,0,0,723,504,32,2548,24,654,9,24
"1266","2020-05-09",35,15,246,70,8073,0.880589619720054,0,0,723,504,42,2590,36,690,17,36
"1267","2020-05-10",29,15,263,59,8073,0.880589619720054,0,0,723,504,34,2624,25,715,10,25
"1268","2020-05-11",24,15,246,58,8073,0.880589619720054,0,0,723,504,31,2655,20,735,10,20
"1269","2020-05-12",20,15,245,51,8073,0.880589619720054,0,0,723,504,37,2692,18,753,11,18
"1270","2020-05-13",17,15,251,43,8073,0.880589619720054,0,0,723,504,46,2738,18,771,14,18
"1271","2020-05-14",13,15,228,40,8073,0.880589619720054,0,0,723,504,39,2777,21,792,15,21
"1272","2020-05-15",11,15,213,38,8073,0.880589619720054,0,0,723,504,43,2820,28,820,16,28
"1273","2020-05-16",13,15,222,36,8073,0.880589619720054,0,0,723,504,28,2848,15,835,11,15
"1274","2020-05-17",13,15,205,34,8073,0.880589619720054,0,0,723,504,31,2879,22,857,7,22
"1275","2020-05-18",11,15,180,34,8073,0.880589619720054,0,0,723,504,27,2906,11,868,14,11
"1276","2020-05-19",9,15,177,31,8073,0.880589619720054,0,0,723,504,24,2930,12,880,9,12
"1277","2020-05-20",9,15,199,27,8073,0.880589619720054,0,0,723,504,32,2962,9,889,17,9
"1278","2020-05-21",11,15,223,32,8073,0.880589619720054,0,0,723,504,29,2991,18,907,9,18
"1279","2020-05-22",13,15,228,33,8073,0.880589619720054,0,0,723,504,32,3023,11,918,15,11
"1280","2020-05-23",10,15,216,34,8073,0.880589619720054,0,0,723,504,23,3046,12,930,8,12
"1281","2020-05-24",11,15,184,32,8073,0.880589619720054,0,0,723,504,23,3069,17,947,9,17
"1282","2020-05-25",10,15,167,29,8073,0.880589619720054,0,0,723,504,21,3090,23,970,9,23
"1283","2020-05-26",9,15,168,30,8073,0.880589619720054,0,0,723,504,28,3118,15,985,14,15
"1284","2020-05-27",10,15,157,28,8073,0.880589619720054,0,0,723,504,21,3139,25,1010,6,25
"1285","2020-05-28",8,15,161,28,8073,0.880589619720054,0,0,723,504,22,3161,12,1022,8,12
"1286","2020-05-29",8,15,130,29,8073,0.880589619720054,0,0,723,504,14,3175,13,1035,8,13
"1287","2020-05-30",10,15,121,28,8073,0.880589619720054,0,0,723,504,29,3204,9,1044,13,9
"1288","2020-05-31",8,15,151,29,8073,0.880589619720054,0,0,723,504,15,3219,5,1049,8,5
"1289","2020-06-01",9,15,163,29,8073,0.880589619720054,0,0,723,504,12,3231,11,1060,8,11
"1290","2020-06-02",10,15,150,22,8073,0.880589619720054,0,0,723,504,16,3247,3,1063,7,3
"1291","2020-06-03",9,15,135,21,8073,0.880589619720054,0,0,723,504,21,3268,4,1067,13,4
"1292","2020-06-04",11,15,114,19,8073,0.880589619720054,0,0,723,504,19,3287,6,1073,8,6
"1293","2020-06-05",9,15,119,18,8073,0.880589619720054,0,0,723,504,16,3303,9,1082,9,9
"1294","2020-06-06",6,15,125,17,8073,0.880589619720054,0,0,723,504,10,3313,1,1083,6,1
"1295","2020-06-07",5,15,133,16,8073,0.880589619720054,0,0,723,504,23,3336,5,1088,8,5
"1296","2020-03-14",1,16,32,32,2343,0.706359368331199,0,0,196,525,14,68,9,45,3,9
"1297","2020-03-15",3,16,38,47,2343,0.706359368331199,0,0,196,525,16,84,11,56,4,11
"1298","2020-03-16",3,16,48,61,2343,0.706359368331199,0,0,196,525,19,103,25,81,6,25
"1299","2020-03-17",5,16,52,76,2343,0.706359368331199,0,0,196,525,31,134,25,106,13,25
"1300","2020-03-18",7,16,56,89,2343,0.706359368331199,0,0,196,525,21,155,16,122,10,16
"1301","2020-03-19",11,16,58,102,2343,0.706359368331199,0,0,196,525,30,185,18,140,13,18
"1302","2020-03-20",16,16,79,120,2343,0.706359368331199,0,0,196,525,31,216,33,173,14,33
"1303","2020-03-21",19,16,90,144,2343,0.706359368331199,0,0,196,525,38,254,21,194,24,21
"1304","2020-03-22",23,16,94,155,2343,0.706359368331199,0,0,196,525,31,285,27,221,16,27
"1305","2020-03-23",29,16,111,165,2343,0.706359368331199,0,0,196,525,27,312,16,237,17,16
"1306","2020-03-24",33,16,132,183,2343,0.706359368331199,0,0,196,525,39,351,19,256,11,19
"1307","2020-03-25",39,16,140,202,2343,0.706359368331199,0,0,196,525,27,378,34,290,18,34
"1308","2020-03-26",43,16,135,217,2343,0.706359368331199,0,0,196,525,30,408,38,328,15,38
"1309","2020-03-27",48,16,124,229,2343,0.706359368331199,0,0,196,525,43,451,32,360,30,32
"1310","2020-03-28",57,16,120,239,2343,0.706359368331199,0,0,196,525,38,489,47,407,22,47
"1311","2020-03-29",59,16,114,247,2343,0.706359368331199,0,0,196,525,30,519,51,458,18,51
"1312","2020-03-30",63,16,114,261,2343,0.706359368331199,0,0,196,525,31,550,55,513,17,55
"1313","2020-03-31",66,16,113,268,2343,0.706359368331199,0,0,196,525,43,593,43,556,25,43
"1314","2020-04-01",74,16,107,277,2343,0.706359368331199,0,0,196,525,31,624,54,610,16,54
"1315","2020-04-02",79,16,110,280,2343,0.706359368331199,0,0,196,525,32,656,42,652,12,42
"1316","2020-04-03",83,16,124,289,2343,0.706359368331199,0,0,196,525,40,696,33,685,15,33
"1317","2020-04-04",79,16,127,284,2343,0.706359368331199,0,0,196,525,40,736,30,715,16,30
"1318","2020-04-05",76,16,142,292,2343,0.706359368331199,0,0,196,525,32,768,29,744,20,29
"1319","2020-04-06",75,16,135,289,2343,0.706359368331199,0,0,196,525,31,799,35,779,10,35
"1320","2020-04-07",75,16,129,306,2343,0.706359368331199,0,0,196,525,48,847,31,810,20,31
"1321","2020-04-08",76,16,139,315,2343,0.706359368331199,0,0,196,525,43,890,23,833,16,23
"1322","2020-04-09",80,16,149,305,2343,0.706359368331199,0,0,196,525,46,936,24,857,25,24
"1323","2020-04-10",78,16,155,293,2343,0.706359368331199,0,0,196,525,64,1000,25,882,29,25
"1324","2020-04-11",82,16,173,302,2343,0.706359368331199,0,0,196,525,47,1047,21,903,28,21
"1325","2020-04-12",88,16,168,304,2343,0.706359368331199,0,0,196,525,40,1087,41,944,19,41
"1326","2020-04-13",86,16,165,313,2343,0.706359368331199,0,0,196,525,41,1128,52,996,21,52
"1327","2020-04-14",86,16,156,322,2343,0.706359368331199,0,0,196,525,46,1174,35,1031,21,35
"1328","2020-04-15",88,16,139,310,2343,0.706359368331199,0,0,196,525,60,1234,39,1070,36,39
"1329","2020-04-16",85,16,123,313,2343,0.706359368331199,0,0,196,525,45,1279,41,1111,27,41
"1330","2020-04-17",91,16,112,324,2343,0.706359368331199,0,0,196,525,53,1332,40,1151,32,40
"1331","2020-04-18",90,16,101,327,2343,0.706359368331199,0,0,196,525,57,1389,40,1191,29,40
"1332","2020-04-19",94,16,124,335,2343,0.706359368331199,0,0,196,525,64,1453,44,1235,32,44
"1333","2020-04-20",102,16,120,330,2343,0.706359368331199,0,0,196,525,38,1491,35,1270,22,35
"1334","2020-04-21",112,16,121,334,2343,0.706359368331199,0,0,196,525,47,1538,30,1300,21,30
"1335","2020-04-22",107,16,113,346,2343,0.706359368331199,0,0,196,525,48,1586,39,1339,23,39
"1336","2020-04-23",105,16,131,352,2343,0.706359368331199,0,0,196,525,50,1636,43,1382,29,43
"1337","2020-04-24",99,16,129,365,2343,0.706359368331199,0,0,196,525,52,1688,45,1427,20,45
"1338","2020-04-25",110,16,156,356,2343,0.706359368331199,0,0,196,525,33,1721,48,1475,12,48
"1339","2020-04-26",113,16,157,346,2343,0.706359368331199,0,0,196,525,42,1763,62,1537,23,62
"1340","2020-04-27",111,16,157,344,2343,0.706359368331199,0,0,196,525,41,1804,50,1587,24,50
"1341","2020-04-28",100,16,154,352,2343,0.706359368331199,0,0,196,525,39,1843,42,1629,26,42
"1342","2020-04-29",103,16,149,349,2343,0.706359368331199,0,0,196,525,37,1880,45,1674,18,45
"1343","2020-04-30",102,16,149,344,2343,0.706359368331199,0,0,196,525,32,1912,50,1724,15,50
"1344","2020-05-01",99,16,152,335,2343,0.706359368331199,0,0,196,525,41,1953,38,1762,22,38
"1345","2020-05-02",92,16,152,336,2343,0.706359368331199,0,0,196,525,38,1991,38,1800,16,38
"1346","2020-05-03",91,16,156,325,2343,0.706359368331199,0,0,196,525,34,2025,37,1837,13,37
"1347","2020-05-04",90,16,149,313,2343,0.706359368331199,0,0,196,525,40,2065,27,1864,22,27
"1348","2020-05-05",93,16,161,317,2343,0.706359368331199,0,0,196,525,40,2105,26,1890,18,26
"1349","2020-05-06",81,16,176,321,2343,0.706359368331199,0,0,196,525,36,2141,22,1912,24,22
"1350","2020-05-07",87,16,161,308,2343,0.706359368331199,0,0,196,525,31,2172,30,1942,13,30
"1351","2020-05-08",92,16,153,309,2343,0.706359368331199,0,0,196,525,47,2219,25,1967,30,25
"1352","2020-05-09",87,16,134,319,2343,0.706359368331199,0,0,196,525,35,2254,29,1996,18,29
"1353","2020-05-10",89,16,127,293,2343,0.706359368331199,0,0,196,525,38,2292,35,2031,19,35
"1354","2020-05-11",91,16,132,308,2343,0.706359368331199,0,0,196,525,30,2322,29,2060,15,29
"1355","2020-05-12",92,16,126,316,2343,0.706359368331199,0,0,196,525,33,2355,20,2080,14,20
"1356","2020-05-13",111,16,127,318,2343,0.706359368331199,0,0,196,525,30,2385,21,2101,17,21
"1357","2020-05-14",102,16,125,325,2343,0.706359368331199,0,0,196,525,36,2421,21,2122,20,21
"1358","2020-05-15",103,16,131,317,2343,0.706359368331199,0,0,196,525,14,2435,43,2165,7,43
"1359","2020-05-16",102,16,134,323,2343,0.706359368331199,0,0,196,525,31,2466,47,2212,15,47
"1360","2020-05-17",95,16,139,326,2343,0.706359368331199,0,0,196,525,22,2488,45,2257,13,45
"1361","2020-05-18",94,16,158,314,2343,0.706359368331199,0,0,196,525,31,2519,36,2293,14,36
"1362","2020-05-19",91,16,143,308,2343,0.706359368331199,0,0,196,525,28,2547,31,2324,19,31
"1363","2020-05-20",75,16,149,297,2343,0.706359368331199,0,0,196,525,24,2571,38,2362,10,38
"1364","2020-05-21",82,16,126,282,2343,0.706359368331199,0,0,196,525,29,2600,32,2394,16,32
"1365","2020-05-22",84,16,142,284,2343,0.706359368331199,0,0,196,525,25,2625,31,2425,12,31
"1366","2020-05-23",88,16,142,284,2343,0.706359368331199,0,0,196,525,20,2645,25,2450,14,25
"1367","2020-05-24",87,16,146,282,2343,0.706359368331199,0,0,196,525,24,2669,52,2502,14,52
"1368","2020-05-25",82,16,144,284,2343,0.706359368331199,0,0,196,525,25,2694,39,2541,15,39
"1369","2020-05-26",79,16,151,294,2343,0.706359368331199,0,0,196,525,19,2713,53,2594,13,53
"1370","2020-05-27",84,16,142,296,2343,0.706359368331199,0,0,196,525,22,2735,48,2642,12,48
"1371","2020-05-28",83,16,139,290,2343,0.706359368331199,0,0,196,525,18,2753,47,2689,8,47
"1372","2020-05-29",79,16,146,293,2343,0.706359368331199,0,0,196,525,17,2770,45,2734,7,45
"1373","2020-05-30",75,16,149,292,2343,0.706359368331199,0,0,196,525,21,2791,58,2792,13,58
"1374","2020-05-31",70,16,159,283,2343,0.706359368331199,0,0,196,525,13,2804,51,2843,8,51
"1375","2020-06-01",78,16,158,280,2343,0.706359368331199,0,0,196,525,18,2822,34,2877,12,34
"1376","2020-06-02",81,16,144,287,2343,0.706359368331199,0,0,196,525,12,2834,26,2903,6,26
"1377","2020-06-03",80,16,143,285,2343,0.706359368331199,0,0,196,525,20,2854,41,2944,11,41
"1378","2020-06-04",80,16,132,280,2343,0.706359368331199,0,0,196,525,7,2861,32,2976,3,32
"1379","2020-06-05",82,16,124,275,2343,0.706359368331199,0,0,196,525,13,2874,40,3016,8,40
"1380","2020-06-06",87,16,135,276,2343,0.706359368331199,0,0,196,525,15,2889,31,3047,7,31
"1381","2020-06-07",90,16,147,256,2343,0.706359368331199,0,0,196,525,9,2898,27,3074,5,27
"1382","2020-03-13",1,17,40,35,2440,0.468852459016393,0,0,210,400,11,16,3,12,7,3
"1383","2020-03-14",1,17,45,52,2440,0.468852459016393,0,0,210,400,6,22,3,15,2,3
"1384","2020-03-15",3,17,34,71,2440,0.468852459016393,0,0,210,400,5,27,1,16,2,1
"1385","2020-03-16",8,17,35,86,2440,0.468852459016393,0,0,210,400,9,36,4,20,8,4
"1386","2020-03-17",10,17,47,108,2440,0.468852459016393,0,0,210,400,14,50,7,27,9,7
"1387","2020-03-18",12,17,53,124,2440,0.468852459016393,0,0,210,400,6,56,7,34,5,7
"1388","2020-03-19",18,17,62,141,2440,0.468852459016393,0,0,210,400,15,71,5,39,14,5
"1389","2020-03-20",23,17,69,163,2440,0.468852459016393,0,0,210,400,16,87,7,46,11,7
"1390","2020-03-21",30,17,83,181,2440,0.468852459016393,0,0,210,400,18,105,6,52,17,6
"1391","2020-03-22",32,17,87,207,2440,0.468852459016393,0,0,210,400,20,125,7,59,17,7
"1392","2020-03-23",32,17,105,227,2440,0.468852459016393,0,0,210,400,30,155,9,68,28,9
"1393","2020-03-24",40,17,100,244,2440,0.468852459016393,0,0,210,400,20,175,20,88,20,20
"1394","2020-03-25",44,17,102,250,2440,0.468852459016393,0,0,210,400,38,213,14,102,35,14
"1395","2020-03-26",45,17,105,264,2440,0.468852459016393,0,0,210,400,42,255,8,110,38,8
"1396","2020-03-27",47,17,94,273,2440,0.468852459016393,0,0,210,400,54,309,13,123,50,13
"1397","2020-03-28",52,17,108,282,2440,0.468852459016393,0,0,210,400,42,351,9,132,39,9
"1398","2020-03-29",55,17,122,297,2440,0.468852459016393,0,0,210,400,63,414,14,146,62,14
"1399","2020-03-30",72,17,126,296,2440,0.468852459016393,0,0,210,400,62,476,11,157,60,11
"1400","2020-03-31",72,17,136,296,2440,0.468852459016393,0,0,210,400,79,555,12,169,75,12
"1401","2020-04-01",78,17,162,295,2440,0.468852459016393,0,0,210,400,112,667,7,176,109,7
"1402","2020-04-02",86,17,167,291,2440,0.468852459016393,0,0,210,400,94,761,25,201,93,25
"1403","2020-04-03",93,17,159,293,2440,0.468852459016393,0,0,210,400,132,893,32,233,128,32
"1404","2020-04-04",93,17,139,290,2440,0.468852459016393,0,0,210,400,156,1049,28,261,152,28
"1405","2020-04-05",98,17,118,291,2440,0.468852459016393,0,0,210,400,161,1210,19,280,159,19
"1406","2020-04-06",84,17,133,304,2440,0.468852459016393,0,0,210,400,183,1393,29,309,179,29
"1407","2020-04-07",90,17,122,313,2440,0.468852459016393,0,0,210,400,196,1589,24,333,193,24
"1408","2020-04-08",87,17,112,329,2440,0.468852459016393,0,0,210,400,244,1833,19,352,242,19
"1409","2020-04-09",87,17,93,338,2440,0.468852459016393,0,0,210,400,251,2084,24,376,248,24
"1410","2020-04-10",83,17,93,349,2440,0.468852459016393,0,0,210,400,286,2370,13,389,283,13
"1411","2020-04-11",81,17,81,364,2440,0.468852459016393,0,0,210,400,227,2597,25,414,226,25
"1412","2020-04-12",81,17,76,375,2440,0.468852459016393,0,0,210,400,236,2833,26,440,232,26
"1413","2020-04-13",88,17,62,383,2440,0.468852459016393,0,0,210,400,298,3131,24,464,293,24
"1414","2020-04-14",86,17,70,389,2440,0.468852459016393,0,0,210,400,272,3403,26,490,269,26
"1415","2020-04-15",94,17,59,402,2440,0.468852459016393,0,0,210,400,297,3700,27,517,296,27
"1416","2020-04-16",99,17,84,412,2440,0.468852459016393,0,0,210,400,243,3943,25,542,242,25
"1417","2020-04-17",104,17,118,421,2440,0.468852459016393,0,0,210,400,301,4244,10,552,299,10
"1418","2020-04-18",116,17,136,417,2440,0.468852459016393,0,0,210,400,240,4484,15,567,238,15
"1419","2020-04-19",117,17,134,421,2440,0.468852459016393,0,0,210,400,264,4748,24,591,263,24
"1420","2020-04-20",117,17,123,420,2440,0.468852459016393,0,0,210,400,242,4990,11,602,241,11
"1421","2020-04-21",123,17,134,408,2440,0.468852459016393,0,0,210,400,206,5196,11,613,203,11
"1422","2020-04-22",118,17,165,402,2440,0.468852459016393,0,0,210,400,214,5410,26,639,211,26
"1423","2020-04-23",117,17,184,398,2440,0.468852459016393,0,0,210,400,198,5608,15,654,197,15
"1424","2020-04-24",118,17,160,389,2440,0.468852459016393,0,0,210,400,174,5782,24,678,172,24
"1425","2020-04-25",111,17,145,377,2440,0.468852459016393,0,0,210,400,153,5935,31,709,150,31
"1426","2020-04-26",116,17,146,381,2440,0.468852459016393,0,0,210,400,117,6052,31,740,117,31
"1427","2020-04-27",117,17,130,382,2440,0.468852459016393,0,0,210,400,97,6149,18,758,97,18
"1428","2020-04-28",111,17,126,375,2440,0.468852459016393,0,0,210,400,103,6252,10,768,102,10
"1429","2020-04-29",113,17,122,370,2440,0.468852459016393,0,0,210,400,78,6330,11,779,78,11
"1430","2020-04-30",113,17,125,362,2440,0.468852459016393,0,0,210,400,76,6406,10,789,75,10
"1431","2020-05-01",105,17,129,358,2440,0.468852459016393,0,0,210,400,90,6496,17,806,89,17
"1432","2020-05-02",99,17,151,361,2440,0.468852459016393,0,0,210,400,62,6558,29,835,60,29
"1433","2020-05-03",91,17,131,350,2440,0.468852459016393,0,0,210,400,43,6601,34,869,43,34
"1434","2020-05-04",92,17,127,344,2440,0.468852459016393,0,0,210,400,49,6650,20,889,47,20
"1435","2020-05-05",91,17,128,343,2440,0.468852459016393,0,0,210,400,33,6683,19,908,32,19
"1436","2020-05-06",92,17,112,336,2440,0.468852459016393,0,0,210,400,29,6712,15,923,28,15
"1437","2020-05-07",78,17,104,345,2440,0.468852459016393,0,0,210,400,25,6737,9,932,25,9
"1438","2020-05-08",82,17,106,359,2440,0.468852459016393,0,0,210,400,24,6761,11,943,23,11
"1439","2020-05-09",94,17,105,356,2440,0.468852459016393,0,0,210,400,16,6777,8,951,14,8
"1440","2020-05-10",93,17,96,351,2440,0.468852459016393,0,0,210,400,14,6791,5,956,14,5
"1441","2020-05-11",91,17,93,347,2440,0.468852459016393,0,0,210,400,13,6804,33,989,10,33
"1442","2020-05-12",88,17,93,354,2440,0.468852459016393,0,0,210,400,15,6819,28,1017,15,28
"1443","2020-05-13",86,17,92,350,2440,0.468852459016393,0,0,210,400,11,6830,17,1034,11,17
"1444","2020-05-14",96,17,116,341,2440,0.468852459016393,0,0,210,400,12,6842,35,1069,10,35
"1445","2020-05-15",96,17,123,345,2440,0.468852459016393,0,0,210,400,6,6848,23,1092,3,23
"1446","2020-05-16",89,17,148,341,2440,0.468852459016393,0,0,210,400,8,6856,22,1114,7,22
"1447","2020-05-17",100,17,137,337,2440,0.468852459016393,0,0,210,400,8,6864,23,1137,8,23
"1448","2020-05-18",101,17,163,328,2440,0.468852459016393,0,0,210,400,4,6868,39,1176,4,39
"1449","2020-05-19",106,17,176,317,2440,0.468852459016393,0,0,210,400,5,6873,27,1203,5,27
"1450","2020-05-20",107,17,163,308,2440,0.468852459016393,0,0,210,400,3,6876,39,1242,3,39
"1451","2020-05-21",102,17,140,294,2440,0.468852459016393,0,0,210,400,5,6881,32,1274,5,32
"1452","2020-05-22",111,17,137,281,2440,0.468852459016393,0,0,210,400,3,6884,22,1296,3,22
"1453","2020-05-23",106,17,125,272,2440,0.468852459016393,0,0,210,400,5,6889,10,1306,5,10
"1454","2020-05-24",96,17,149,273,2440,0.468852459016393,0,0,210,400,8,6897,8,1314,8,8
"1455","2020-05-25",95,17,151,259,2440,0.468852459016393,0,0,210,400,4,6901,8,1322,3,8
"1456","2020-05-26",92,17,152,245,2440,0.468852459016393,0,0,210,400,4,6905,7,1329,3,7
"1457","2020-05-27",88,17,149,229,2440,0.468852459016393,0,0,210,400,3,6908,1,1330,3,1
"1458","2020-05-28",87,17,144,226,2440,0.468852459016393,0,0,210,400,1,6909,3,1333,1,3
"1459","2020-05-29",69,17,154,213,2440,0.468852459016393,0,0,210,400,5,6914,12,1345,4,12
"1460","2020-05-30",64,17,147,196,2440,0.468852459016393,0,0,210,400,1,6915,28,1373,1,28
"1461","2020-05-31",59,17,136,194,2440,0.468852459016393,0,0,210,400,1,6916,18,1391,1,18
"1462","2020-06-01",52,17,123,180,2440,0.468852459016393,0,0,210,400,2,6918,30,1421,2,30
"1463","2020-06-02",49,17,128,163,2440,0.468852459016393,0,0,210,400,4,6922,22,1443,3,22
"1464","2020-06-03",46,17,112,151,2440,0.468852459016393,0,0,210,400,2,6924,21,1464,1,21
"1465","2020-06-04",42,17,116,143,2440,0.468852459016393,0,0,210,400,1,6925,16,1480,1,16
"1466","2020-06-05",41,17,117,132,2440,0.468852459016393,0,0,210,400,1,6926,17,1497,1,17
"1467","2020-06-06",47,17,123,129,2440,0.468852459016393,0,0,210,400,3,6929,21,1518,3,21
"1468","2020-06-07",45,17,106,121,2440,0.468852459016393,0,0,210,400,4,6933,13,1531,4,13
"1469","2020-03-14",1,18,38,25,2431,0.72110242698478,0,0,195,572,5,15,12,35,NA,12
"1470","2020-03-15",1,18,40,36,2431,0.72110242698478,0,0,195,572,6,21,6,41,4,6
"1471","2020-03-16",2,18,55,51,2431,0.72110242698478,0,0,195,572,2,23,11,52,NA,11
"1472","2020-03-17",4,18,50,66,2431,0.72110242698478,0,0,195,572,6,29,8,60,4,8
"1473","2020-03-18",8,18,51,85,2431,0.72110242698478,0,0,195,572,5,34,14,74,2,14
"1474","2020-03-19",9,18,67,101,2431,0.72110242698478,0,0,195,572,8,42,16,90,5,16
"1475","2020-03-20",11,18,65,123,2431,0.72110242698478,0,0,195,572,14,56,8,98,8,8
"1476","2020-03-21",17,18,64,137,2431,0.72110242698478,0,0,195,572,3,59,13,111,2,13
"1477","2020-03-22",19,18,72,163,2431,0.72110242698478,0,0,195,572,19,78,21,132,12,21
"1478","2020-03-23",29,18,82,175,2431,0.72110242698478,0,0,195,572,14,92,6,138,9,6
"1479","2020-03-24",33,18,75,192,2431,0.72110242698478,0,0,195,572,13,105,4,142,10,4
"1480","2020-03-25",37,18,79,193,2431,0.72110242698478,0,0,195,572,17,122,16,158,13,16
"1481","2020-03-26",44,18,92,219,2431,0.72110242698478,0,0,195,572,11,133,7,165,10,7
"1482","2020-03-27",52,18,101,237,2431,0.72110242698478,0,0,195,572,19,152,8,173,17,8
"1483","2020-03-28",53,18,88,258,2431,0.72110242698478,0,0,195,572,24,176,16,189,21,16
"1484","2020-03-29",62,18,84,260,2431,0.72110242698478,0,0,195,572,23,199,24,213,14,24
"1485","2020-03-30",57,18,92,279,2431,0.72110242698478,0,0,195,572,27,226,7,220,22,7
"1486","2020-03-31",63,18,73,293,2431,0.72110242698478,0,0,195,572,20,246,10,230,19,10
"1487","2020-04-01",64,18,75,314,2431,0.72110242698478,0,0,195,572,26,272,9,239,20,9
"1488","2020-04-02",69,18,93,330,2431,0.72110242698478,0,0,195,572,24,296,17,256,22,17
"1489","2020-04-03",73,18,96,341,2431,0.72110242698478,0,0,195,572,29,325,8,264,24,8
"1490","2020-04-04",79,18,104,341,2431,0.72110242698478,0,0,195,572,31,356,25,289,25,25
"1491","2020-04-05",79,18,110,347,2431,0.72110242698478,0,0,195,572,27,383,13,302,24,13
"1492","2020-04-06",81,18,112,349,2431,0.72110242698478,0,0,195,572,30,413,14,316,27,14
"1493","2020-04-07",80,18,142,345,2431,0.72110242698478,0,0,195,572,33,446,20,336,26,20
"1494","2020-04-08",87,18,147,340,2431,0.72110242698478,0,0,195,572,20,466,23,359,16,23
"1495","2020-04-09",90,18,159,346,2431,0.72110242698478,0,0,195,572,33,499,18,377,26,18
"1496","2020-04-10",89,18,172,350,2431,0.72110242698478,0,0,195,572,28,527,18,395,26,18
"1497","2020-04-11",87,18,177,356,2431,0.72110242698478,0,0,195,572,25,552,26,421,20,26
"1498","2020-04-12",92,18,187,367,2431,0.72110242698478,0,0,195,572,26,578,10,431,22,10
"1499","2020-04-13",99,18,186,379,2431,0.72110242698478,0,0,195,572,26,604,15,446,19,15
"1500","2020-04-14",105,18,184,367,2431,0.72110242698478,0,0,195,572,32,636,14,460,25,14
"1501","2020-04-15",104,18,170,382,2431,0.72110242698478,0,0,195,572,29,665,22,482,24,22
"1502","2020-04-16",102,18,153,379,2431,0.72110242698478,0,0,195,572,30,695,32,514,27,32
"1503","2020-04-17",102,18,133,386,2431,0.72110242698478,0,0,195,572,26,721,43,557,22,43
"1504","2020-04-18",103,18,127,382,2431,0.72110242698478,0,0,195,572,30,751,34,591,16,34
"1505","2020-04-19",100,18,119,388,2431,0.72110242698478,0,0,195,572,29,780,14,605,26,14
"1506","2020-04-20",103,18,121,384,2431,0.72110242698478,0,0,195,572,33,813,9,614,26,9
"1507","2020-04-21",98,18,148,389,2431,0.72110242698478,0,0,195,572,23,836,12,626,21,12
"1508","2020-04-22",94,18,155,384,2431,0.72110242698478,0,0,195,572,24,860,6,632,21,6
"1509","2020-04-23",97,18,131,390,2431,0.72110242698478,0,0,195,572,39,899,10,642,32,10
"1510","2020-04-24",108,18,115,391,2431,0.72110242698478,0,0,195,572,34,933,11,653,27,11
"1511","2020-04-25",111,18,106,400,2431,0.72110242698478,0,0,195,572,21,954,9,662,18,9
"1512","2020-04-26",119,18,117,402,2431,0.72110242698478,0,0,195,572,31,985,17,679,26,17
"1513","2020-04-27",121,18,121,392,2431,0.72110242698478,0,0,195,572,23,1008,29,708,18,29
"1514","2020-04-28",127,18,105,392,2431,0.72110242698478,0,0,195,572,30,1038,29,737,22,29
"1515","2020-04-29",139,18,95,400,2431,0.72110242698478,0,0,195,572,32,1070,17,754,23,17
"1516","2020-04-30",138,18,76,395,2431,0.72110242698478,0,0,195,572,30,1100,11,765,28,11
"1517","2020-05-01",125,18,87,379,2431,0.72110242698478,0,0,195,572,22,1122,10,775,13,10
"1518","2020-05-02",127,18,89,380,2431,0.72110242698478,0,0,195,572,36,1158,12,787,28,12
"1519","2020-05-03",115,18,109,385,2431,0.72110242698478,0,0,195,572,28,1186,18,805,23,18
"1520","2020-05-04",117,18,125,392,2431,0.72110242698478,0,0,195,572,26,1212,40,845,24,40
"1521","2020-05-05",112,18,153,397,2431,0.72110242698478,0,0,195,572,26,1238,17,862,22,17
"1522","2020-05-06",106,18,151,409,2431,0.72110242698478,0,0,195,572,17,1255,30,892,15,30
"1523","2020-05-07",113,18,166,403,2431,0.72110242698478,0,0,195,572,21,1276,25,917,13,25
"1524","2020-05-08",120,18,155,400,2431,0.72110242698478,0,0,195,572,26,1302,15,932,19,15
"1525","2020-05-09",115,18,146,388,2431,0.72110242698478,0,0,195,572,22,1324,11,943,19,11
"1526","2020-05-10",131,18,135,378,2431,0.72110242698478,0,0,195,572,20,1344,22,965,16,22
"1527","2020-05-11",122,18,127,375,2431,0.72110242698478,0,0,195,572,19,1363,8,973,12,8
"1528","2020-05-12",128,18,117,374,2431,0.72110242698478,0,0,195,572,14,1377,12,985,9,12
"1529","2020-05-13",123,18,127,361,2431,0.72110242698478,0,0,195,572,14,1391,32,1017,10,32
"1530","2020-05-14",114,18,118,354,2431,0.72110242698478,0,0,195,572,25,1416,29,1046,20,29
"1531","2020-05-15",111,18,116,339,2431,0.72110242698478,0,0,195,572,20,1436,24,1070,15,24
"1532","2020-05-16",109,18,113,329,2431,0.72110242698478,0,0,195,572,23,1459,21,1091,17,21
"1533","2020-05-17",97,18,124,324,2431,0.72110242698478,0,0,195,572,12,1471,26,1117,9,26
"1534","2020-05-18",102,18,146,319,2431,0.72110242698478,0,0,195,572,17,1488,37,1154,13,37
"1535","2020-05-19",89,18,139,310,2431,0.72110242698478,0,0,195,572,16,1504,15,1169,12,15
"1536","2020-05-20",86,18,126,306,2431,0.72110242698478,0,0,195,572,13,1517,9,1178,10,9
"1537","2020-05-21",82,18,145,292,2431,0.72110242698478,0,0,195,572,17,1534,7,1185,15,7
"1538","2020-05-22",76,18,172,288,2431,0.72110242698478,0,0,195,572,15,1549,12,1197,13,12
"1539","2020-05-23",77,18,155,263,2431,0.72110242698478,0,0,195,572,17,1566,18,1215,13,18
"1540","2020-05-24",82,18,163,269,2431,0.72110242698478,0,0,195,572,18,1584,20,1235,15,20
"1541","2020-05-25",71,18,174,266,2431,0.72110242698478,0,0,195,572,13,1597,25,1260,11,25
"1542","2020-05-26",80,18,183,250,2431,0.72110242698478,0,0,195,572,9,1606,17,1277,8,17
"1543","2020-05-27",75,18,200,234,2431,0.72110242698478,0,0,195,572,15,1621,19,1296,13,19
"1544","2020-05-28",74,18,200,224,2431,0.72110242698478,0,0,195,572,10,1631,11,1307,8,11
"1545","2020-05-29",75,18,195,214,2431,0.72110242698478,0,0,195,572,14,1645,19,1326,11,19
"1546","2020-05-30",75,18,173,207,2431,0.72110242698478,0,0,195,572,9,1654,24,1350,4,24
"1547","2020-05-31",60,18,177,197,2431,0.72110242698478,0,0,195,572,17,1671,31,1381,11,31
"1548","2020-06-01",61,18,159,179,2431,0.72110242698478,0,0,195,572,10,1681,13,1394,8,13
"1549","2020-06-02",57,18,161,168,2431,0.72110242698478,0,0,195,572,11,1692,10,1404,9,10
"1550","2020-06-03",63,18,167,165,2431,0.72110242698478,0,0,195,572,6,1698,15,1419,6,15
"1551","2020-06-04",70,18,158,162,2431,0.72110242698478,0,0,195,572,27,1725,14,1433,24,14
"1552","2020-06-05",67,18,128,159,2431,0.72110242698478,0,0,195,572,9,1734,10,1443,9,10
"1553","2020-06-06",61,18,103,165,2431,0.72110242698478,0,0,195,572,10,1744,11,1454,9,11
"1554","2020-06-07",60,18,104,159,2431,0.72110242698478,0,0,195,572,12,1756,7,1461,11,7
"1555","2020-03-14",2,19,26,76,2205,0.438095238095238,0,0,192,259,20,57,14,34,5,14
"1556","2020-03-15",5,19,21,100,2205,0.438095238095238,0,0,192,259,25,82,5,39,11,5
"1557","2020-03-16",7,19,23,123,2205,0.438095238095238,0,0,192,259,18,100,14,53,7,14
"1558","2020-03-17",9,19,23,143,2205,0.438095238095238,0,0,192,259,30,130,9,62,11,9
"1559","2020-03-18",16,19,31,164,2205,0.438095238095238,0,0,192,259,31,161,6,68,20,6
"1560","2020-03-19",20,19,45,181,2205,0.438095238095238,0,0,192,259,24,185,7,75,13,7
"1561","2020-03-20",26,19,47,199,2205,0.438095238095238,0,0,192,259,25,210,4,79,17,4
"1562","2020-03-21",38,19,39,214,2205,0.438095238095238,0,0,192,259,39,249,10,89,27,10
"1563","2020-03-22",44,19,38,236,2205,0.438095238095238,0,0,192,259,41,290,7,96,23,7
"1564","2020-03-23",49,19,43,244,2205,0.438095238095238,0,0,192,259,34,324,15,111,22,15
"1565","2020-03-24",58,19,58,260,2205,0.438095238095238,0,0,192,259,64,388,14,125,41,14
"1566","2020-03-25",66,19,55,268,2205,0.438095238095238,0,0,192,259,45,433,14,139,23,14
"1567","2020-03-26",75,19,52,279,2205,0.438095238095238,0,0,192,259,48,481,16,155,31,16
"1568","2020-03-27",78,19,66,272,2205,0.438095238095238,0,0,192,259,48,529,19,174,34,19
"1569","2020-03-28",73,19,80,278,2205,0.438095238095238,0,0,192,259,59,588,26,200,44,26
"1570","2020-03-29",79,19,72,277,2205,0.438095238095238,0,0,192,259,51,639,20,220,37,20
"1571","2020-03-30",83,19,68,276,2205,0.438095238095238,0,0,192,259,49,688,28,248,37,28
"1572","2020-03-31",87,19,70,279,2205,0.438095238095238,0,0,192,259,60,748,12,260,39,12
"1573","2020-04-01",87,19,71,299,2205,0.438095238095238,0,0,192,259,56,804,14,274,34,14
"1574","2020-04-02",78,19,60,291,2205,0.438095238095238,0,0,192,259,58,862,13,287,41,13
"1575","2020-04-03",85,19,61,288,2205,0.438095238095238,0,0,192,259,56,918,6,293,37,6
"1576","2020-04-04",88,19,60,300,2205,0.438095238095238,0,0,192,259,53,971,11,304,38,11
"1577","2020-04-05",84,19,73,309,2205,0.438095238095238,0,0,192,259,75,1046,22,326,58,22
"1578","2020-04-06",84,19,64,322,2205,0.438095238095238,0,0,192,259,74,1120,20,346,53,20
"1579","2020-04-07",79,19,54,322,2205,0.438095238095238,0,0,192,259,46,1166,37,383,37,37
"1580","2020-04-08",81,19,50,332,2205,0.438095238095238,0,0,192,259,59,1225,21,404,46,21
"1581","2020-04-09",95,19,57,332,2205,0.438095238095238,0,0,192,259,39,1264,14,418,23,14
"1582","2020-04-10",87,19,55,336,2205,0.438095238095238,0,0,192,259,67,1331,31,449,51,31
"1583","2020-04-11",89,19,55,349,2205,0.438095238095238,0,0,192,259,45,1376,16,465,27,16
"1584","2020-04-12",90,19,56,353,2205,0.438095238095238,0,0,192,259,63,1439,11,476,41,11
"1585","2020-04-13",90,19,58,341,2205,0.438095238095238,0,0,192,259,41,1480,29,505,29,29
"1586","2020-04-14",101,19,54,336,2205,0.438095238095238,0,0,192,259,51,1531,39,544,33,39
"1587","2020-04-15",91,19,78,331,2205,0.438095238095238,0,0,192,259,58,1589,23,567,43,23
"1588","2020-04-16",78,19,65,332,2205,0.438095238095238,0,0,192,259,50,1639,39,606,30,39
"1589","2020-04-17",80,19,63,334,2205,0.438095238095238,0,0,192,259,59,1698,41,647,37,41
"1590","2020-04-18",81,19,67,336,2205,0.438095238095238,0,0,192,259,43,1741,26,673,33,26
"1591","2020-04-19",81,19,75,332,2205,0.438095238095238,0,0,192,259,39,1780,29,702,23,29
"1592","2020-04-20",85,19,92,338,2205,0.438095238095238,0,0,192,259,54,1834,33,735,30,33
"1593","2020-04-21",80,19,112,345,2205,0.438095238095238,0,0,192,259,50,1884,21,756,31,21
"1594","2020-04-22",84,19,122,358,2205,0.438095238095238,0,0,192,259,34,1918,29,785,22,29
"1595","2020-04-23",92,19,120,357,2205,0.438095238095238,0,0,192,259,40,1958,45,830,26,45
"1596","2020-04-24",92,19,109,338,2205,0.438095238095238,0,0,192,259,37,1995,46,876,19,46
"1597","2020-04-25",94,19,112,341,2205,0.438095238095238,0,0,192,259,51,2046,31,907,25,31
"1598","2020-04-26",90,19,107,344,2205,0.438095238095238,0,0,192,259,48,2094,26,933,26,26
"1599","2020-04-27",91,19,103,343,2205,0.438095238095238,0,0,192,259,18,2112,17,950,12,17
"1600","2020-04-28",94,19,102,332,2205,0.438095238095238,0,0,192,259,40,2152,30,980,25,30
"1601","2020-04-29",92,19,100,308,2205,0.438095238095238,0,0,192,259,30,2182,15,995,18,15
"1602","2020-04-30",94,19,104,300,2205,0.438095238095238,0,0,192,259,44,2226,20,1015,16,20
"1603","2020-05-01",101,19,100,294,2205,0.438095238095238,0,0,192,259,46,2272,19,1034,26,19
"1604","2020-05-02",100,19,90,285,2205,0.438095238095238,0,0,192,259,34,2306,15,1049,20,15
"1605","2020-05-03",102,19,83,283,2205,0.438095238095238,0,0,192,259,47,2353,35,1084,27,35
"1606","2020-05-04",97,19,73,279,2205,0.438095238095238,0,0,192,259,55,2408,32,1116,31,32
"1607","2020-05-05",90,19,82,286,2205,0.438095238095238,0,0,192,259,41,2449,16,1132,19,16
"1608","2020-05-06",92,19,74,281,2205,0.438095238095238,0,0,192,259,34,2483,10,1142,15,10
"1609","2020-05-07",86,19,68,287,2205,0.438095238095238,0,0,192,259,37,2520,9,1151,25,9
"1610","2020-05-08",76,19,75,284,2205,0.438095238095238,0,0,192,259,38,2558,23,1174,27,23
"1611","2020-05-09",70,19,81,282,2205,0.438095238095238,0,0,192,259,36,2594,14,1188,18,14
"1612","2020-05-10",73,19,105,279,2205,0.438095238095238,0,0,192,259,38,2632,34,1222,24,34
"1613","2020-05-11",75,19,102,268,2205,0.438095238095238,0,0,192,259,34,2666,22,1244,21,22
"1614","2020-05-12",78,19,99,270,2205,0.438095238095238,0,0,192,259,23,2689,21,1265,10,21
"1615","2020-05-13",76,19,94,262,2205,0.438095238095238,0,0,192,259,21,2710,14,1279,13,14
"1616","2020-05-14",74,19,92,269,2205,0.438095238095238,0,0,192,259,32,2742,23,1302,21,23
"1617","2020-05-15",83,19,79,270,2205,0.438095238095238,0,0,192,259,33,2775,44,1346,24,44
"1618","2020-05-16",83,19,79,258,2205,0.438095238095238,0,0,192,259,31,2806,35,1381,18,35
"1619","2020-05-17",80,19,67,243,2205,0.438095238095238,0,0,192,259,27,2833,26,1407,12,26
"1620","2020-05-18",75,19,59,241,2205,0.438095238095238,0,0,192,259,25,2858,25,1432,17,25
"1621","2020-05-19",69,19,56,234,2205,0.438095238095238,0,0,192,259,23,2881,23,1455,16,23
"1622","2020-05-20",73,19,47,226,2205,0.438095238095238,0,0,192,259,26,2907,28,1483,17,28
"1623","2020-05-21",77,19,45,224,2205,0.438095238095238,0,0,192,259,20,2927,21,1504,11,21
"1624","2020-05-22",72,19,59,216,2205,0.438095238095238,0,0,192,259,24,2951,23,1527,9,23
"1625","2020-05-23",70,19,65,209,2205,0.438095238095238,0,0,192,259,15,2966,14,1541,10,14
"1626","2020-05-24",74,19,73,200,2205,0.438095238095238,0,0,192,259,17,2983,25,1566,5,25
"1627","2020-05-25",71,19,87,198,2205,0.438095238095238,0,0,192,259,17,3000,19,1585,8,19
"1628","2020-05-26",69,19,91,192,2205,0.438095238095238,0,0,192,259,17,3017,29,1614,9,29
"1629","2020-05-27",61,19,89,186,2205,0.438095238095238,0,0,192,259,16,3033,20,1634,13,20
"1630","2020-05-28",62,19,80,177,2205,0.438095238095238,0,0,192,259,16,3049,12,1646,7,12
"1631","2020-05-29",60,19,82,178,2205,0.438095238095238,0,0,192,259,13,3062,17,1663,9,17
"1632","2020-05-30",60,19,73,178,2205,0.438095238095238,0,0,192,259,14,3076,16,1679,11,16
"1633","2020-05-31",51,19,68,180,2205,0.438095238095238,0,0,192,259,13,3089,19,1698,11,19
"1634","2020-06-01",50,19,58,178,2205,0.438095238095238,0,0,192,259,20,3109,10,1708,14,10
"1635","2020-06-02",48,19,61,180,2205,0.438095238095238,0,0,192,259,16,3125,16,1724,8,16
"1636","2020-06-03",51,19,65,176,2205,0.438095238095238,0,0,192,259,18,3143,18,1742,11,18
"1637","2020-06-04",52,19,66,176,2205,0.438095238095238,0,0,192,259,19,3162,12,1754,14,12
"1638","2020-06-05",49,19,69,168,2205,0.438095238095238,0,0,192,259,18,3180,10,1764,11,10
"1639","2020-06-06",47,19,67,170,2205,0.438095238095238,0,0,192,259,17,3197,6,1770,11,6
"1640","2020-06-07",53,19,68,169,2205,0.438095238095238,0,0,192,259,22,3219,2,1772,14,2
"1641","2020-03-14",1,20,41,21,3783,0.9299497753106,0,0,298,459,6,24,9,41,1,9
"1642","2020-03-15",1,20,60,32,3783,0.9299497753106,0,0,298,459,5,29,12,53,3,12
"1643","2020-03-16",2,20,64,36,3783,0.9299497753106,0,0,298,459,8,37,16,69,3,16
"1644","2020-03-17",6,20,60,46,3783,0.9299497753106,0,0,298,459,14,51,13,82,2,13
"1645","2020-03-18",8,20,52,58,3783,0.9299497753106,0,0,298,459,5,56,11,93,5,11
"1646","2020-03-19",9,20,52,70,3783,0.9299497753106,0,0,298,459,11,67,9,102,5,9
"1647","2020-03-20",9,20,60,82,3783,0.9299497753106,0,0,298,459,13,80,14,116,7,14
"1648","2020-03-21",11,20,84,95,3783,0.9299497753106,0,0,298,459,14,94,19,135,9,19
"1649","2020-03-22",13,20,86,114,3783,0.9299497753106,0,0,298,459,26,120,15,150,16,15
"1650","2020-03-23",18,20,77,131,3783,0.9299497753106,0,0,298,459,16,136,31,181,14,31
"1651","2020-03-24",18,20,69,155,3783,0.9299497753106,0,0,298,459,11,147,22,203,6,22
"1652","2020-03-25",24,20,65,163,3783,0.9299497753106,0,0,298,459,15,162,31,234,13,31
"1653","2020-03-26",29,20,62,184,3783,0.9299497753106,0,0,298,459,19,181,22,256,14,22
"1654","2020-03-27",38,20,57,206,3783,0.9299497753106,0,0,298,459,18,199,28,284,12,28
"1655","2020-03-28",42,20,90,228,3783,0.9299497753106,0,0,298,459,21,220,27,311,13,27
"1656","2020-03-29",44,20,100,245,3783,0.9299497753106,0,0,298,459,16,236,26,337,9,26
"1657","2020-03-30",49,20,114,264,3783,0.9299497753106,0,0,298,459,22,258,25,362,13,25
"1658","2020-03-31",56,20,120,289,3783,0.9299497753106,0,0,298,459,18,276,21,383,10,21
"1659","2020-04-01",62,20,110,327,3783,0.9299497753106,0,0,298,459,27,303,28,411,21,28
"1660","2020-04-02",68,20,110,357,3783,0.9299497753106,0,0,298,459,31,334,18,429,21,18
"1661","2020-04-03",70,20,96,378,3783,0.9299497753106,0,0,298,459,32,366,27,456,24,27
"1662","2020-04-04",77,20,85,415,3783,0.9299497753106,0,0,298,459,17,383,43,499,10,43
"1663","2020-04-05",90,20,96,464,3783,0.9299497753106,0,0,298,459,24,407,26,525,18,26
"1664","2020-04-06",93,20,103,494,3783,0.9299497753106,0,0,298,459,19,426,39,564,11,39
"1665","2020-04-07",95,20,115,508,3783,0.9299497753106,0,0,298,459,12,438,30,594,4,30
"1666","2020-04-08",110,20,115,544,3783,0.9299497753106,0,0,298,459,30,468,40,634,21,40
"1667","2020-04-09",116,20,104,561,3783,0.9299497753106,0,0,298,459,16,484,24,658,9,24
"1668","2020-04-10",126,20,106,581,3783,0.9299497753106,0,0,298,459,23,507,18,676,14,18
"1669","2020-04-11",136,20,101,622,3783,0.9299497753106,0,0,298,459,11,518,39,715,5,39
"1670","2020-04-12",148,20,109,645,3783,0.9299497753106,0,0,298,459,35,553,29,744,19,29
"1671","2020-04-13",157,20,116,661,3783,0.9299497753106,0,0,298,459,26,579,29,773,17,29
"1672","2020-04-14",171,20,113,657,3783,0.9299497753106,0,0,298,459,16,595,19,792,10,19
"1673","2020-04-15",174,20,105,678,3783,0.9299497753106,0,0,298,459,29,624,37,829,16,37
"1674","2020-04-16",184,20,120,713,3783,0.9299497753106,0,0,298,459,37,661,30,859,27,30
"1675","2020-04-17",194,20,95,739,3783,0.9299497753106,0,0,298,459,24,685,26,885,18,26
"1676","2020-04-18",203,20,98,776,3783,0.9299497753106,0,0,298,459,25,710,19,904,19,19
"1677","2020-04-19",207,20,123,796,3783,0.9299497753106,0,0,298,459,19,729,23,927,10,23
"1678","2020-04-20",209,20,159,824,3783,0.9299497753106,0,0,298,459,21,750,16,943,13,16
"1679","2020-04-21",205,20,169,834,3783,0.9299497753106,0,0,298,459,28,778,12,955,17,12
"1680","2020-04-22",196,20,194,849,3783,0.9299497753106,0,0,298,459,22,800,10,965,17,10
"1681","2020-04-23",203,20,219,831,3783,0.9299497753106,0,0,298,459,28,828,22,987,20,22
"1682","2020-04-24",208,20,218,830,3783,0.9299497753106,0,0,298,459,18,846,18,1005,11,18
"1683","2020-04-25",223,20,214,807,3783,0.9299497753106,0,0,298,459,27,873,28,1033,21,28
"1684","2020-04-26",222,20,193,782,3783,0.9299497753106,0,0,298,459,23,896,26,1059,16,26
"1685","2020-04-27",229,20,165,776,3783,0.9299497753106,0,0,298,459,14,910,25,1084,10,25
"1686","2020-04-28",240,20,175,774,3783,0.9299497753106,0,0,298,459,17,927,17,1101,14,17
"1687","2020-04-29",248,20,196,757,3783,0.9299497753106,0,0,298,459,20,947,20,1121,9,20
"1688","2020-04-30",245,20,181,732,3783,0.9299497753106,0,0,298,459,30,977,26,1147,19,26
"1689","2020-05-01",232,20,164,748,3783,0.9299497753106,0,0,298,459,22,999,36,1183,14,36
"1690","2020-05-02",217,20,179,747,3783,0.9299497753106,0,0,298,459,26,1025,21,1204,15,21
"1691","2020-05-03",205,20,206,727,3783,0.9299497753106,0,0,298,459,31,1056,29,1233,20,29
"1692","2020-05-04",207,20,210,703,3783,0.9299497753106,0,0,298,459,23,1079,38,1271,18,38
"1693","2020-05-05",202,20,197,685,3783,0.9299497753106,0,0,298,459,21,1100,24,1295,14,24
"1694","2020-05-06",197,20,165,688,3783,0.9299497753106,0,0,298,459,24,1124,30,1325,14,30
"1695","2020-05-07",191,20,139,643,3783,0.9299497753106,0,0,298,459,22,1146,31,1356,8,31
"1696","2020-05-08",202,20,114,637,3783,0.9299497753106,0,0,298,459,23,1169,28,1384,15,28
"1697","2020-05-09",195,20,104,635,3783,0.9299497753106,0,0,298,459,23,1192,18,1402,17,18
"1698","2020-05-10",210,20,129,623,3783,0.9299497753106,0,0,298,459,18,1210,22,1424,16,22
"1699","2020-05-11",205,20,168,590,3783,0.9299497753106,0,0,298,459,22,1232,26,1450,16,26
"1700","2020-05-12",195,20,185,568,3783,0.9299497753106,0,0,298,459,16,1248,27,1477,8,27
"1701","2020-05-13",183,20,189,545,3783,0.9299497753106,0,0,298,459,21,1269,42,1519,11,42
"1702","2020-05-14",178,20,183,510,3783,0.9299497753106,0,0,298,459,11,1280,27,1546,7,27
"1703","2020-05-15",172,20,159,502,3783,0.9299497753106,0,0,298,459,13,1293,27,1573,8,27
"1704","2020-05-16",160,20,152,475,3783,0.9299497753106,0,0,298,459,12,1305,36,1609,5,36
"1705","2020-05-17",144,20,141,460,3783,0.9299497753106,0,0,298,459,20,1325,23,1632,11,23
"1706","2020-05-18",140,20,125,432,3783,0.9299497753106,0,0,298,459,19,1344,26,1658,13,26
"1707","2020-05-19",129,20,121,414,3783,0.9299497753106,0,0,298,459,14,1358,36,1694,12,36
"1708","2020-05-20",130,20,138,398,3783,0.9299497753106,0,0,298,459,19,1377,24,1718,12,24
"1709","2020-05-21",126,20,149,387,3783,0.9299497753106,0,0,298,459,21,1398,20,1738,14,20
"1710","2020-05-22",114,20,133,372,3783,0.9299497753106,0,0,298,459,21,1419,10,1748,16,10
"1711","2020-05-23",115,20,124,352,3783,0.9299497753106,0,0,298,459,20,1439,19,1767,17,19
"1712","2020-05-24",116,20,130,350,3783,0.9299497753106,0,0,298,459,21,1460,20,1787,15,20
"1713","2020-05-25",109,20,137,344,3783,0.9299497753106,0,0,298,459,15,1475,23,1810,13,23
"1714","2020-05-26",109,20,135,334,3783,0.9299497753106,0,0,298,459,18,1493,28,1838,16,28
"1715","2020-05-27",107,20,131,317,3783,0.9299497753106,0,0,298,459,12,1505,24,1862,10,24
"1716","2020-05-28",107,20,117,304,3783,0.9299497753106,0,0,298,459,15,1520,24,1886,13,24
"1717","2020-05-29",101,20,100,304,3783,0.9299497753106,0,0,298,459,11,1531,29,1915,9,29
"1718","2020-05-30",101,20,88,284,3783,0.9299497753106,0,0,298,459,15,1546,30,1945,12,30
"1719","2020-05-31",95,20,70,281,3783,0.9299497753106,0,0,298,459,21,1567,14,1959,17,14
"1720","2020-06-01",92,20,63,267,3783,0.9299497753106,0,0,298,459,22,1589,20,1979,19,20
"1721","2020-06-02",94,20,59,268,3783,0.9299497753106,0,0,298,459,17,1606,16,1995,15,16
"1722","2020-06-03",95,20,62,261,3783,0.9299497753106,0,0,298,459,20,1626,24,2019,18,24
"1723","2020-06-04",86,20,75,250,3783,0.9299497753106,0,0,298,459,15,1641,33,2052,11,33
"1724","2020-06-05",85,20,75,237,3783,0.9299497753106,0,0,298,459,13,1654,25,2077,10,25
"1725","2020-06-06",76,20,85,222,3783,0.9299497753106,0,0,298,459,11,1665,25,2102,10,25
"1726","2020-06-07",70,20,96,215,3783,0.9299497753106,0,0,298,459,12,1677,16,2118,9,16
